,Wilderness_Area4,Wilderness_Area1,Subalpine_Climate,Alpine_Climate,binned_elevation,Wilderness_Area3,Road-Fire,Montane_Climate,Lower_Montane_Climate,Horizontal_Distance_To_Roadways_x_Horizontal_Distance_To_Fire_Points,Elevation_x_Horizontal_Distance_To_Roadways,Sqr_Horizontal_Distance_To_Roadways,Road-Hydro,Road+Fire+Hydro,Road+Fire,Horizontal_Distance_To_Roadways,Hillshade_9am_x_Hillshade_Noon,Elevation_x_Hillshade_Noon,Elevation_x_Hillshade_9am,Ele-hydro,Ele+road,Ele+hydro,Ele+fire,Ele+Road+Fire+Hydro,sqr_Horizontal_Distance_To_firepoints,sqr_Distance_To_Hydrology,Road+Hydro,Igneus_and_Metamorphic_Soil,Horizontal_Distance_To_Roadways_x_Hillshade_9am,Horizontal_Distance_To_Hydrology_x_Hillshade_3pm,Horizontal_Distance_To_Fire_Points,Glacial_Soil,Ele-road,Ele-fire
0,0,1,1,0,51,0,5769,0,0,3202290,1323960,22.58317958127243,252,7047,6789,510,51272,602272,573716,2338,3106,2854,8875,9643,79.24014134263012,16.06237840420901,768,1,112710,38184,6279,0,2086,3683
1,0,1,1,0,51,0,5835,0,0,2427750,1010100,19.748417658131498,178,6827,6615,390,51700,608650,569800,2378,2980,2802,8815,9417,78.8986691902975,14.563134575526412,602,1,85800,32012,6225,0,2200,3635
2,0,1,0,0,56,0,2941,1,0,19464780,8916720,56.39148871948674,2912,9569,9301,3180,55692,667352,656136,2536,5984,3072,8925,12373,78.2368199762746,16.60631902507243,3448,1,744120,36180,6121,0,376,3317
3,0,1,1,0,55,0,3121,0,0,19191990,8605650,55.58776843874919,2848,9543,9301,3090,56644,662830,662830,2543,5875,3027,8996,12328,78.8098978555359,16.408411135572948,3332,1,735420,29524,6211,0,305,3426
4,0,1,1,0,51,0,5781,0,0,2413252,1014645,19.77371993328519,238,6716,6563,391,51480,607230,570900,2442,2986,2748,8767,9311,78.56207736560943,12.369448974750497,544,1,86020,22950,6172,0,2204,3577
5,0,1,1,0,51,0,5964,0,0,404077,172793,8.18535277187245,233,6398,6098,67,54510,611223,593170,2279,2646,2879,8610,8977,77.6595132614157,17.331323259275727,367,1,15410,42000,6031,0,2512,3452
6,0,1,1,0,52,0,5623,0,0,3960048,1649598,25.15949125081825,363,7159,6889,633,49950,586350,578532,2336,3239,2876,8862,9765,79.09487973314076,16.433085295458536,903,1,140526,37260,6256,0,1973,3650
7,0,1,1,0,52,0,5655,0,0,3568644,1492665,23.93741840717165,339,7035,6801,573,51060,599150,578310,2371,3178,2839,8833,9640,78.91767862779544,15.300479647433411,807,1,127206,33696,6228,0,2032,3623
8,0,1,1,0,52,0,5578,0,0,4158504,1742922,25.80697580112788,426,7150,6910,666,49283,578357,583591,2377,3283,2857,8861,9767,79.01898506055365,15.698622513201272,906,1,148518,31920,6244,0,1951,3627
9,0,1,1,0,52,0,5594,0,0,3962280,1661232,25.219040425836983,389,7113,6866,636,49932,572028,595536,2365,3248,2859,8842,9725,78.93034904268447,15.724020412848395,883,1,145008,30628,6230,0,1976,3618
10,0,1,0,0,52,0,5487,0,0,4573170,1919820,27.110883423451916,555,7137,6957,735,52974,634716,569416,2432,3347,2792,8834,9749,78.87965517166008,13.677921696369898,915,1,160230,28980,6222,0,1877,3610
11,0,1,1,0,57,0,1202,0,0,21279903,15160158,72.47758274114831,4882,9675,9304,5253,56160,692640,675324,2515,8139,3257,6937,12561,63.647466563878254,19.284966562942536,5624,1,1229202,50456,4051,0,2367,1165
12,0,1,1,0,54,0,2876,0,0,19582565,8815530,56.70097000933934,3065,9456,9306,3215,55552,614208,680016,2592,5957,2892,8833,12198,78.04485889538144,12.849476832533073,3365,1,797320,13800,6091,0,473,3349
13,0,1,0,0,52,0,5440,0,0,4788681,2011539,27.76688675382964,621,7132,6982,771,52611,644423,555717,2459,3380,2759,8820,9741,78.8098978555359,12.525768210359056,921,1,164223,25500,6211,0,1838,3602
14,0,1,0,0,50,0,4926,0,0,3774400,1687022,25.96150997149434,607,6341,6274,674,53760,600720,560672,2436,3177,2570,8103,8844,74.83314773547883,8.19263674150144,741,1,150976,10117,5600,0,1829,3097
15,0,1,0,0,49,0,4824,0,0,4193152,1876240,27.422618401604176,710,6370,6328,752,50400,561375,558880,2453,3247,2537,8071,8865,74.67261881037788,6.484411467763075,794,0,168448,5754,5576,0,1743,3081
16,0,1,1,0,52,0,5489,0,0,3700272,1584270,24.63736998950984,487,6823,6703,607,51624,623790,563760,2490,3217,2730,8706,9433,78.07688518377255,10.954641326594459,727,1,131112,19320,6096,0,2003,3486
17,0,1,0,0,50,0,5012,0,0,3336165,1497615,24.392621835300936,510,6287,6202,595,51756,571359,573876,2432,3112,2602,8124,8804,74.8799038460921,9.231007614073922,680,1,135660,11305,5607,0,1922,3090
18,0,1,0,0,50,0,4881,0,0,3850252,1730264,26.28687885618983,596,6358,6263,691,49648,580928,535856,2409,3195,2599,8076,8862,74.64583042608609,9.753537202071987,786,1,147874,14820,5572,0,1813,3068
19,0,1,0,0,50,0,4814,0,0,4116255,1854723,27.2213151776324,656,6381,6296,741,50160,570684,550660,2418,3244,2588,8058,8884,74.53187237685633,9.251281740554573,826,1,163020,12240,5555,0,1762,3052
20,0,1,0,0,50,0,4780,0,0,4254549,1918267,27.694764848252458,707,6374,6314,767,51290,557723,575230,2441,3268,2561,8048,8875,74.47818472546173,7.780166052320878,827,1,176410,7560,5547,0,1734,3046
21,0,1,1,0,57,0,663,0,0,21554478,14359680,70.61161377563892,4770,9525,9309,4986,52118,728640,593280,2664,7866,3096,7203,12405,65.74952471311104,14.767307884128202,5202,1,1027116,38664,4323,0,2106,1443
22,0,1,1,0,55,0,2633,0,0,19940508,9242352,57.784080852774665,3147,9503,9311,3339,52668,578512,697536,2576,6107,2960,8740,12271,77.27871634544663,14.449131233822257,3531,1,841428,13632,5972,0,571,3204
23,0,1,0,0,50,0,4931,0,0,3553022,1602018,25.25866188063018,514,6331,6207,638,49950,557442,564975,2387,3149,2635,8080,8842,74.62573282722254,11.135528725660043,762,1,143550,16120,5569,0,1873,3058
24,0,1,0,0,50,0,4802,0,0,4050888,1835124,27.055498516937366,612,6386,6266,732,47515,554047,539005,2387,3239,2627,8041,8893,74.39085965358916,10.991537949000206,852,1,157380,17160,5534,0,1775,3027
25,0,1,0,0,49,0,4634,0,0,4724840,2143120,29.32575659723036,860,6354,6354,860,54273,590604,570668,2492,3352,2492,7986,8846,74.1215218408257,0.0,860,1,196940,0,5494,0,1632,3002
26,0,1,0,0,49,0,4637,0,0,4657614,2113161,29.13760456866693,819,6365,6335,849,55890,604827,572470,2459,3338,2519,7975,8854,74.06753674856482,5.501408174353464,879,1,195270,4350,5486,0,1640,2997
27,0,1,1,0,59,0,2521,0,0,20084820,17523192,76.91553809211764,5593,9634,9311,5916,56640,699032,710880,2639,8878,3285,6357,12596,58.26662852782886,17.994939567361946,6239,1,1419840,38760,3395,0,2954,433
28,0,1,0,0,56,0,1973,1,0,20709810,10316370,60.58052492344384,3458,9525,9313,3670,52360,669018,618420,2599,6481,3023,8454,12336,75.11990415329349,14.632570524736149,3882,1,807400,32648,5643,0,859,2832
29,0,1,1,0,54,0,2752,0,0,19794273,8986659,57.28001396647874,3154,9441,9314,3281,53130,575190,692967,2612,6020,2866,8772,12180,77.67238891652555,11.730959300683235,3408,1,830093,9017,6033,0,542,3294
30,0,1,1,0,54,0,2932,0,0,19538493,8625273,56.4889369699944,3124,9381,9314,3191,51054,543303,686562,2636,5894,2770,8826,12084,78.24960063795854,8.499160266369426,3258,1,810514,3484,6123,0,488,3420
31,0,1,0,0,50,0,4974,0,0,3313555,1500590,24.392621835300936,475,6284,6164,595,53823,582582,587626,2402,3117,2642,8091,8806,74.62573282722254,10.954641326594459,715,1,138635,15600,5569,0,1927,3047
32,0,1,0,0,50,0,4943,0,0,3424344,1551704,24.819347291981714,492,6299,6175,616,53590,586927,579370,2395,3135,2643,8078,8818,74.55870170543476,11.138424455647513,740,1,141680,16988,5559,0,1903,3040
33,0,1,0,0,50,0,4883,0,0,3645978,1655528,25.65151067676132,508,6349,6199,658,49032,571132,543456,2366,3174,2666,8057,8865,74.43789357578571,12.24962545775264,808,1,142128,22050,5541,0,1858,3025
34,0,1,0,0,50,0,4852,0,0,3761760,1710200,26.076809620810597,518,6374,6212,680,48620,553300,555815,2353,3195,2677,8047,8889,74.3774159271482,12.729861554299685,842,1,150280,21546,5532,0,1835,3017
35,0,1,1,0,58,0,1084,0,0,21393885,15077100,72.10409142344143,4957,9556,9314,5199,43095,565500,640900,2658,8099,3142,7015,12456,64.1482657598785,15.58284440963789,5441,1,1148979,24200,4115,0,2299,1215
36,0,1,1,0,54,0,2870,0,0,19647056,8733816,56.78027826631356,3157,9385,9318,3224,52371,560763,685377,2642,5933,2776,8803,12094,78.06407624509497,8.416522024785497,3291,1,815672,4087,6094,0,515,3385
37,0,1,0,0,50,0,4772,0,0,3966668,1812942,26.870057685088806,540,6398,6216,722,52899,575019,580041,2329,3233,2693,8005,8909,74.1215218408257,13.523606909196573,904,1,166782,23842,5494,0,1789,2983
38,0,1,1,0,54,0,2689,0,0,19912580,9115684,57.584720195551874,3192,9445,9321,3316,46116,503067,692748,2625,6065,2873,8754,12194,77.4919350642375,11.612569503520847,3440,1,835632,4464,6005,0,567,3256
39,0,1,1,0,53,0,2988,0,0,19492885,8506562,56.27610505356603,3167,9322,9322,3167,43800,588234,537200,2686,5853,2686,8841,12008,78.45380806563821,0.0,3167,1,633400,0,6155,0,481,3469
40,0,1,1,0,53,0,4757,0,0,14363888,5657104,45.78209256903839,2096,8949,8949,2096,49842,631566,574887,2699,4795,2699,9552,11648,82.78284846512591,0.0,2096,0,446448,0,6853,0,603,4154
41,0,1,1,0,51,0,5414,0,0,1901595,850670,18.193405398660254,331,6076,6076,331,50525,603950,552550,2570,2901,2570,8315,8646,75.79577824654879,0.0,331,1,71165,0,5745,0,2239,3175
42,0,1,0,0,50,0,4975,0,0,3203504,1461541,24.020824298928627,427,6279,6129,577,51290,564859,582590,2383,3110,2683,8085,8812,74.51174404078863,12.248673275118406,727,1,132710,18900,5552,0,1956,3019
43,0,1,0,0,54,0,3045,0,0,19430226,8490123,56.04462507680822,3111,9357,9327,3141,28762,532491,394638,2673,5844,2733,8889,12060,78.65112840894274,5.8721273231371045,3171,0,458586,5520,6186,0,438,3483
44,0,1,0,0,53,0,4886,1,0,10866360,4445480,40.74309757492672,1565,8301,8206,1660,54044,632008,613262,2583,4338,2773,9224,10979,80.90735442467513,9.886585106410566,1755,1,380140,13395,6546,0,1018,3868
45,0,1,0,0,50,0,4818,0,0,3652344,1684314,25.80697580112788,456,6360,6150,666,51300,569025,576612,2319,3195,2739,8013,8889,74.05403432629447,14.493430076279392,876,1,151848,27300,5484,0,1863,2955
46,0,1,0,0,50,0,4790,0,0,3744216,1726416,26.153393661244042,472,6370,6158,684,53128,577996,585568,2312,3208,2736,7998,8894,73.98648525237566,14.56151545997796,896,1,158688,27560,5474,0,1840,2950
47,0,1,0,0,50,0,4816,0,0,3608025,1671224,25.67099530598687,425,6368,6134,659,53360,588352,583280,2302,3195,2770,8011,8904,73.9932429347437,15.297058540778355,893,1,151570,31824,5475,0,1877,2939
48,0,1,0,0,49,0,4457,0,0,4821300,2248200,30.0,805,6352,6257,900,51529,567046,567046,2403,3398,2593,7855,8850,73.19152956456095,9.759997214798725,995,1,204300,12825,5357,0,1598,2859
49,0,1,0,0,49,0,4524,0,0,4320540,2016090,28.460498941515414,725,6229,6144,810,53592,574959,577448,2404,3299,2574,7823,8718,73.03423854604085,9.2729914971827,895,1,187920,11135,5334,0,1679,2845
50,0,1,1,0,54,0,2742,0,0,19910583,8944761,57.41950887982237,3237,9396,9336,3297,50292,537174,689102,2653,6010,2773,8752,12109,77.71100308193171,7.896951773353783,3357,1,837438,2880,6039,0,584,3326
51,0,1,1,0,54,0,3101,0,0,19390842,8540202,55.839054433254866,3033,9422,9337,3118,30545,561495,408111,2654,5857,2824,8958,12161,78.86063656856949,9.759997214798725,3203,1,464582,16320,6219,0,379,3480
52,0,1,1,0,53,0,2800,0,0,19858241,8818616,57.19265687131522,3241,9372,9342,3271,51948,630864,598512,2666,5967,2726,8767,12068,77.91662210337407,5.477225575051661,3301,1,726162,4470,6071,0,575,3375
53,0,1,0,0,50,0,4434,0,0,4744575,2236410,29.8496231131986,699,6408,6216,891,50955,539650,594870,2318,3401,2702,7835,8918,72.97259759663213,13.89020567938961,1083,1,211167,20352,5325,0,1619,2815
54,0,1,0,0,50,0,4404,0,0,4848192,2281824,30.199337741083,737,6403,6228,912,52210,567954,575460,2327,3414,2677,7818,8905,72.91090453423274,13.241804011448092,1087,1,209760,22575,5316,0,1590,2814
55,0,1,0,0,54,0,2916,0,0,19720512,8753952,56.7097875150313,3186,9378,9348,3216,31376,577064,402856,2692,5938,2752,8854,12100,78.30708780180757,5.959073905325341,3246,0,475968,6000,6132,0,494,3410
56,0,1,0,0,50,0,4349,0,0,4909470,2325000,30.495901363953813,740,6399,6209,930,51027,547500,582500,2310,3430,2690,7779,8899,72.65672714897086,13.791774304255147,1120,1,216690,22040,5279,0,1570,2779
57,0,1,0,0,49,0,4392,0,0,4577940,2162820,29.49576240750525,690,6312,6132,870,51750,571780,559350,2306,3356,2666,7748,8798,72.53964433328854,13.418063905006207,1050,1,195750,25020,5262,0,1616,2776
58,0,1,0,0,49,0,4414,0,0,4413360,2090760,28.982753492378876,665,6269,6094,840,50112,577448,537624,2314,3329,2664,7743,8758,72.48448109768049,13.246969194075609,1015,1,181440,26775,5254,0,1649,2765
59,0,1,0,0,49,0,4437,0,0,4250070,2016090,28.460498941515414,648,6219,6057,810,50167,565003,550069,2327,3299,2651,7736,8708,72.43617880589781,12.748363342157862,972,1,179010,22842,5247,0,1679,2758
60,0,1,0,0,49,0,4408,0,0,4226580,2016900,28.460498941515414,676,6162,6028,810,52210,572700,565230,2356,3300,2624,7708,8652,72.2357252334328,11.622136368289254,944,1,183870,18358,5218,0,1680,2728
61,0,1,1,0,59,0,2336,0,0,20510105,17254440,76.4525996941896,5803,9396,9354,5845,54014,667152,705528,2910,8797,2994,6461,12348,59.23681287847955,6.5252844928085345,5887,1,1396955,4872,3509,0,2893,557
62,0,1,0,0,54,0,4592,1,0,13382145,5472215,44.97777228809804,1889,8772,8638,2023,52896,616740,627560,2571,4728,2839,9320,11477,81.33265027035576,11.65306661673843,2157,1,469336,17286,6615,0,682,3910
63,0,1,0,0,50,0,4291,0,0,4855530,2331510,30.495901363953813,777,6304,6151,930,49504,561568,554047,2354,3437,2660,7728,8811,72.2564875980005,12.382505769060717,1083,1,205530,21114,5221,0,1577,2714
64,0,1,0,0,50,0,4335,0,0,4528350,2175000,29.49576240750525,720,6225,6075,870,47250,525000,562500,2350,3370,2650,7705,8725,72.14568594171102,12.345470001201512,1020,1,195750,17400,5205,0,1630,2705
65,0,1,0,0,49,0,4357,0,0,4365480,2094120,28.982753492378876,713,6164,6037,840,50609,550953,570897,2366,3333,2620,7690,8657,72.09022125087424,11.338657706151796,967,1,192360,15748,5197,0,1653,2704
66,0,1,0,0,50,0,4284,0,0,4665600,2258100,30.0,766,6218,6084,900,51076,567034,567034,2375,3409,2643,7693,8727,72.0,11.59192030070629,1034,1,203400,17956,5184,0,1609,2675
67,0,1,1,0,58,0,1261,0,0,21603260,15531999,72.94518489934754,5231,9471,9381,5321,44298,624666,604233,2829,8240,3009,6979,12390,63.71812928829596,9.497356383238309,5411,1,1101447,12780,4060,0,2402,1141
68,0,1,0,0,54,0,4399,1,0,15290882,6266380,47.82258880487337,2069,9191,8973,2287,50848,621980,613760,2522,5027,2958,9426,11931,81.76796438703852,14.899966739097728,2505,1,512288,30084,6686,0,453,3946
69,0,1,1,0,52,0,4774,0,0,6405672,2882880,33.04542328371661,912,7138,6958,1092,51975,594000,609840,2460,3732,2820,8506,9778,76.58981655546643,13.41682193249194,1272,1,252252,22860,5866,0,1548,3226
70,0,1,1,0,56,0,522,0,0,21974904,12605862,66.58828725834597,4192,9632,9390,4434,56120,693692,653890,2601,7277,3085,7799,12475,70.39886362719217,15.739623448814104,4676,1,1019820,34848,4956,0,1591,2113
71,0,1,1,0,60,0,3335,0,0,19342356,19163968,79.81854421122951,6094,9684,9407,6371,46384,625664,670784,2731,9379,3285,6044,12692,55.09990925582364,16.648737088464458,6648,1,1420733,32132,3036,0,3363,28
72,0,1,1,0,57,0,726,0,0,21986440,14655938,71.17583859709698,4958,9514,9406,5066,54635,645139,708785,2785,7959,3001,7233,12407,65.87867636800242,10.587221077960752,5174,1,1241170,11016,4340,0,2173,1447
73,0,1,0,0,57,0,310,0,0,22094184,13845300,69.6993543729065,4858,9406,9406,4858,46830,635550,598500,2850,7708,2850,7398,12256,67.43886120034946,0.0,4858,0,1020180,0,4548,0,2008,1698
74,0,1,1,0,52,0,4685,0,0,5419200,2522880,30.983866769659336,720,6845,6605,960,47306,572904,570276,2388,3588,2868,8273,9473,75.13321502504735,15.51614992893484,1200,1,208320,32640,5645,0,1668,3017
75,0,1,1,0,57,0,282,0,0,22145383,13079888,67.57958271549181,4366,9617,9416,4567,54808,632944,710272,2663,7431,3065,7713,12481,69.63476143421474,14.635203064087827,4768,1,1132616,18693,4849,0,1703,1985
76,0,1,1,0,56,0,1526,0,0,21611352,11160996,62.83311228962003,3814,9556,9422,3948,54755,658691,664345,2693,6775,2961,8301,12383,73.98648525237566,12.203805586132633,4082,1,927780,14472,5474,0,1121,2647
77,0,1,0,0,50,0,3985,0,0,5359914,2685798,32.58834147360065,1032,6139,6109,1062,48438,591786,523503,2499,3591,2559,7576,8668,71.04224095564554,5.753771868478424,1092,0,219834,4980,5047,0,1467,2518
78,0,1,0,0,56,0,3234,1,0,19701487,8724456,55.74047003748713,2725,9830,9448,3107,53590,645840,654264,2426,5915,3190,9149,12638,79.63039620647382,19.840252475890612,3489,1,723931,49660,6341,0,299,3533
79,0,1,1,0,56,0,220,0,0,22294629,13100920,67.91906948714772,4479,9580,9446,4613,55671,656040,684440,2706,7453,2974,7673,12420,69.5197813575388,11.850228582282101,4747,1,1111733,13668,4833,0,1773,1993
80,0,1,1,0,55,0,3517,0,0,19361060,8329100,54.589376255824725,2449,10008,9477,2980,51959,623285,651235,2264,5775,3326,9292,12803,80.60397012554654,23.229468164179053,3511,0,694340,64251,6497,0,185,3702
81,0,1,0,0,54,0,4157,1,0,16096680,6700240,49.39635614091387,2373,9104,9037,2440,56635,645310,661786,2679,5186,2813,9343,11850,81.2219182240853,8.397588990243326,2507,1,588040,7973,6597,0,306,3851
82,0,1,1,0,56,0,2099,0,0,21427812,10525359,60.802960454241045,3547,9643,9493,3697,31042,532389,472602,2697,6544,2997,8643,12490,76.13146524269712,13.07479579843849,3847,1,613702,22800,5796,0,850,2949
83,0,1,0,0,56,0,2392,1,0,21113088,10087680,59.59865770300536,3336,9712,9496,3552,43260,596400,585040,2624,6392,3056,8784,12552,77.09734106958553,15.272133963327194,3768,1,731712,30240,5944,0,712,3104
84,0,1,0,0,50,0,3787,0,0,5568308,2871884,33.645207682521445,922,6261,6051,1132,49728,568288,563214,2327,3669,2747,7456,8798,70.13558298039591,14.515060165059701,1342,1,251304,28770,4919,0,1405,2382
85,0,1,1,0,57,0,2095,0,0,21489000,10596300,60.868711174132805,3530,9680,9505,3705,39346,589160,546260,2685,6565,3035,8660,12540,76.15773105863909,14.162333245144376,3880,1,707655,26425,5800,0,845,2940
86,0,1,1,0,56,0,452,0,0,22530428,12754268,67.27555276621665,4496,9534,9504,4526,29747,555146,425518,2788,7344,2848,7796,12352,70.55494312945054,5.8721273231371045,4556,1,683426,5430,4978,0,1708,2160
87,0,1,0,0,56,0,3373,1,0,19913388,8638284,55.53377350765928,2524,10101,9541,3084,48590,633026,602215,2241,5885,3361,9258,12902,80.3554602998452,23.727527462530787,3644,1,663060,82880,6457,0,283,3656
88,0,1,0,0,55,0,3664,1,0,19434852,8211122,54.24020648928247,2524,9966,9548,2942,50609,616811,639139,2373,5733,3209,9397,12757,81.2773031048644,20.512117268373917,3360,1,673718,51832,6606,0,151,3815
89,0,1,1,0,54,0,4012,0,0,15530048,6631920,49.15282290977803,2349,8911,8844,2416,44460,642330,521550,2678,5161,2812,9173,11656,80.17480901130978,8.436161057888377,2483,1,459040,12328,6428,0,329,3683
90,0,1,0,0,50,0,3729,0,0,5205502,2720148,32.89376840679705,810,6165,5893,1082,53590,585762,578220,2242,3596,2786,7325,8679,69.36137253543934,16.49381556828984,1354,1,248860,37264,4811,0,1432,2297
91,0,1,1,0,55,0,1270,0,0,22263896,11503288,64.2339474110069,4096,9552,9522,4126,41818,574328,565964,2758,6914,2818,8184,12340,73.45747068882783,5.572104574801163,4156,1,837578,4110,5396,0,1338,2608
92,0,1,1,0,51,0,3974,0,0,5317767,2708034,32.51153641401772,990,6155,6088,1057,43600,558516,512400,2495,3619,2629,7593,8717,70.92954250522133,8.222029866439447,1124,1,211400,10452,5031,0,1505,2469
93,0,1,1,0,61,0,4101,0,0,18696460,21007028,82.68010643437755,6728,9679,9571,6836,55842,755958,697571,2965,9909,3181,5808,12752,52.29722745997153,10.394308954048586,6944,1,1551772,16092,2735,0,3763,338
94,0,1,1,0,59,0,1950,0,0,21773664,17099676,75.77598564189053,5316,9960,9534,5742,51051,658138,687918,2552,8720,3404,6770,12938,61.57921727336261,20.842199586442007,6168,1,1326402,51546,3792,0,2764,814
95,0,1,0,0,57,0,2260,1,0,21514176,10421840,60.36555309114628,3349,9843,9548,3644,47524,623480,623480,2565,6504,3155,8764,12703,76.83749084919418,17.630996989473235,3939,1,794392,39825,5904,0,784,3044
96,0,1,1,0,61,0,4037,0,0,18893714,20889337,82.52878285786117,6726,9670,9585,6811,55890,745281,705410,2982,9878,3152,5841,12737,52.66877632905477,9.235136611923052,6896,1,1566530,12240,2774,0,3744,293
97,0,1,0,0,56,0,3356,1,0,20157165,8734460,55.812185049503306,2572,10129,9586,3115,51975,647724,630900,2261,5919,3347,9275,12933,80.44252606675154,23.375534063411138,3658,1,700875,76563,6471,0,311,3667
98,0,1,0,0,51,0,3975,0,0,5681556,2859192,33.406586176980134,1116,6207,6207,1116,51493,596946,566202,2562,3678,2562,7653,8769,71.35124385741288,0.0,1116,0,246636,0,5091,0,1446,2529
99,0,1,0,0,51,0,3788,0,0,5593664,2916112,33.704599092705436,946,6250,6060,1136,48399,567307,562173,2377,3703,2757,7491,8817,70.17121917139534,13.808421129276201,1326,1,248784,26220,4924,0,1431,2357
100,0,1,1,0,59,0,2121,0,0,21738082,17514316,76.43297717608546,5491,9914,9563,5842,49506,665556,668554,2647,8840,3349,6719,12912,61.0,18.74471880617533,6193,1,1302766,47034,3721,0,2844,723
101,0,1,1,0,53,0,4016,0,0,9547161,4501068,40.95119045888654,1527,7520,7370,1677,52140,590480,636108,2534,4361,2834,8377,10204,75.45197147855052,12.247993008684867,1827,1,397449,16950,5693,0,1007,3009
102,0,1,1,0,53,0,4021,0,0,9240270,4372584,40.422765862815474,1484,7439,7289,1634,47952,578016,594072,2526,4310,2826,8331,10115,75.1997340420829,12.250849366392371,1784,1,362748,19200,5655,0,1042,2979
103,0,1,1,0,57,0,795,0,0,22752576,12565707,66.24952830020754,4199,9763,9573,4389,53436,626997,698572,2673,7252,3053,8047,12626,72.0,14.241925542717267,4579,1,1070916,19000,5184,0,1526,2321
104,0,1,0,0,51,0,3730,0,0,5793800,3037320,34.351128074635334,1010,6260,6090,1180,54208,622908,576576,2404,3754,2744,7484,8834,70.07139216541941,13.097664939546313,1350,1,264320,26010,4910,0,1394,2336
105,0,1,0,0,50,0,3589,0,0,4990860,2689281,32.72613634390714,909,5893,5731,1071,52920,615195,542376,2349,3582,2673,7171,8404,68.26419266350405,12.835667595140963,1233,1,231336,26892,4660,0,1440,2149
106,0,1,1,0,61,0,3732,0,0,19683013,20484493,81.72514912803769,6649,9656,9626,6679,50370,705410,671673,3037,9746,3097,6014,12723,54.286278192559855,5.483301264452448,6709,0,1462701,4410,2947,0,3612,120
107,0,1,1,0,58,0,1418,0,0,22470168,16005318,74.17546764261078,5368,9720,9586,5502,46487,590527,666161,2775,8411,3043,6993,12629,63.90618123468183,11.66016950172314,5636,1,1259958,13668,4084,0,2593,1175
108,0,1,1,0,57,0,1777,0,0,22313010,11217234,62.5939294181153,3609,9922,9613,3918,41688,618408,552559,2554,6781,3172,8558,12785,75.46522377890362,17.932144703110684,4227,1,756174,49749,5695,0,1055,2832
109,0,1,0,0,51,0,3813,0,0,6430014,3249822,35.58089374931439,1266,6345,6345,1266,51192,608379,554472,2567,3833,2567,7646,8912,71.26710321038733,0.0,1266,0,273456,0,5079,0,1301,2512
110,0,1,1,0,63,0,4816,0,0,7104000,19092000,77.45966692414834,5592,7592,7184,6000,54240,719132,763680,2774,9182,3590,4366,10774,34.40930106817051,20.231964394935602,6408,1,1440000,46920,1184,0,2818,1998
111,0,1,0,0,56,0,1311,0,0,22720852,11711608,64.4670458451448,3914,9865,9623,4156,42903,639686,532602,2576,6974,3060,8285,12683,73.93916418245476,15.60104761947802,4398,0,785484,42834,5467,0,1338,2649
112,0,1,0,0,55,0,3759,1,0,14542732,6527744,48.703182647543684,2030,8845,8503,2372,48231,641216,569664,2410,5124,3094,8883,11597,78.3007024234138,18.51596800202138,2714,1,491004,56430,6131,0,380,3379
113,0,1,0,0,55,0,3766,1,0,14136336,6387822,48.187135212627034,1922,8810,8410,2322,52668,635481,627228,2351,5073,3151,8839,11561,78.02563681252464,20.028065867742487,2722,1,529416,54800,6088,0,429,3337
114,0,1,0,0,51,0,3578,0,0,6132504,3252354,35.58089374931439,1038,6338,6110,1266,53592,593439,596008,2341,3835,2797,7413,8907,69.59885056522126,15.123141956304947,1494,1,293712,30096,4844,0,1303,2275
115,0,1,1,0,63,0,4735,0,0,7164846,18981495,77.07788269017254,5472,7616,7147,5941,54390,709290,782775,2726,9136,3664,4401,10811,34.72751070837067,21.708304037643124,6410,1,1455545,47369,1206,0,2746,1989
116,0,1,1,0,59,0,1876,0,0,22333280,17164392,75.86830695356264,5516,9876,9636,5756,47443,623238,676914,2742,8738,3222,6862,12858,62.289646009589745,15.75217489050406,5996,1,1306612,26880,3880,0,2774,898
117,0,1,1,0,57,0,845,0,0,23020166,12522900,66.2872536767062,4099,9928,9633,4394,51075,646950,641250,2555,7244,3145,8089,12778,72.38093671679029,17.339193588026493,4689,1,988650,40415,5239,0,1544,2389
118,0,1,0,0,51,0,3585,0,0,6288750,3335940,35.91656999213594,1100,6355,6165,1290,52200,599952,581850,2396,3876,2776,7461,8941,69.82120021884471,13.86916870676514,1480,1,290250,27170,4875,0,1296,2289
119,0,1,1,0,56,0,1187,0,0,23020148,12031717,65.12296062065974,3911,9999,9669,4241,43888,598607,590096,2507,7078,3167,8265,12836,73.67496182557545,18.24976848257582,4571,1,882128,45540,5428,0,1404,2591
120,0,1,0,0,54,0,3684,1,0,12217437,5742807,45.92385001282014,1808,8203,7902,2109,53360,631736,626290,2422,4832,3024,8516,10926,76.11175993235211,17.404429874757433,2410,1,485070,40936,5793,0,614,3070
121,0,1,1,0,61,0,4032,0,0,19691620,21152300,83.00602387778854,6860,9778,9748,6890,44880,675400,626280,3040,9960,3100,5928,12848,53.46026561849464,5.531194905403055,6920,1,1405560,4590,2858,0,3820,212
122,0,1,1,0,61,0,3297,0,0,20897188,19894956,80.67217612039482,6358,9869,9719,6508,55440,706167,733680,2907,9565,3207,6268,12926,56.66568626602876,12.613010185831968,6658,1,1561920,17700,3211,0,3451,154
123,0,1,1,0,56,0,716,0,0,23442861,14690234,72.20110802473879,5183,9740,9710,5213,54560,619960,698864,2788,8031,2848,7315,12558,67.05967491719595,5.623413251903491,5243,1,1292824,2760,4497,0,2395,1679
124,0,1,1,0,56,0,256,0,0,23554641,14186601,70.59036761485238,4898,9795,9710,4983,22800,540930,341640,2762,7830,2932,7574,12642,68.75318174455637,9.67057657670449,5068,1,597960,16915,4727,0,2136,1880
125,0,1,0,0,52,0,3522,0,0,8087904,4127904,39.7994974842648,1554,6720,6690,1584,54492,594168,622834,2576,4190,2636,7712,9326,71.45628033979938,5.501408174353464,1614,0,378576,3570,5106,0,1022,2500
126,0,1,0,0,57,0,1744,1,0,23083305,11603823,63.33245613427605,3460,10317,9766,4011,52670,665390,662497,2342,6904,3444,8648,13210,75.8617163001207,23.66812895242727,4562,1,918519,74385,5755,0,1118,2862
127,0,1,0,0,54,0,3481,1,0,11720100,5703600,45.8257569495584,1866,7915,7681,2100,45732,602952,559496,2482,4816,2950,8297,10631,74.70609078247904,15.347721065664544,2334,1,432600,35802,5581,0,616,2865
128,0,1,1,0,52,0,3449,0,0,8883792,4545036,41.46082488325576,1652,6954,6887,1719,55029,584324,658356,2577,4363,2711,7812,9598,71.88880302244571,8.456490803821907,1786,1,428031,6030,5168,0,925,2524
129,0,1,0,0,52,0,3299,1,0,7318542,3969147,38.97435053981015,1303,6553,6337,1519,50380,598377,574860,2397,4132,2829,7431,9166,69.4118145563131,14.787141465807673,1735,1,334180,31536,4818,0,1094,2205
130,0,1,1,0,58,0,1740,0,0,23125869,16862253,75.87489703452651,5757,9774,9774,5757,44019,641451,588729,2929,8686,2929,6946,12703,63.3798075099633,0.0,5757,1,1157157,0,4017,0,2828,1088
131,0,1,1,0,55,0,3396,0,0,17312832,7736532,52.87721626560914,2766,9018,8988,2796,43571,644711,517429,2737,5563,2797,8959,11785,78.689262291624,5.572104574801163,2826,1,522852,5580,6192,0,29,3425
132,0,1,1,0,59,0,2586,0,0,22396987,18541209,78.7337284776988,6114,9897,9812,6199,47475,631101,672975,2906,9190,3076,6604,12888,60.108235708594876,9.219544457292887,6284,1,1394775,9945,3613,0,3208,622
133,0,1,1,0,58,0,1339,0,0,23498112,16349657,74.58552138317464,5468,9882,9787,5563,45800,587800,673031,2844,8502,3034,7163,12821,64.99230723708769,9.85304212894363,5658,1,1273927,9310,4224,0,2624,1285
134,0,1,0,0,50,0,2926,0,0,7137747,4016071,39.786932528155525,1583,6092,6092,1583,44280,547992,520085,2537,4120,2537,7046,8629,67.14908785679818,0.0,1583,0,324515,0,4509,0,954,1972
135,0,1,1,0,62,0,4104,0,0,17022960,20772540,81.60882305241266,6498,9378,9216,6660,54522,729846,726727,2957,9779,3281,5675,12497,50.556898639058154,12.740029376818088,6822,1,1551780,21546,2556,0,3541,563
136,0,1,1,0,58,0,2018,0,0,23080200,17410756,76.9285382676676,5888,9848,9818,5918,43537,650182,579574,2912,8860,2972,6842,12790,62.44997998398398,5.490867587491313,5948,1,1165846,4860,3900,0,2976,958
137,0,1,1,0,57,0,1223,0,0,23699810,12395370,65.53624951124378,3725,10383,9813,4295,48138,652236,614718,2316,7181,3456,8404,13269,74.28324171709255,24.0353673469425,4865,1,914835,85500,5518,0,1409,2632
138,0,1,1,0,55,0,3323,0,0,17629158,7919850,53.422841556772326,2812,9073,9031,2854,42486,607725,538350,2733,5629,2817,8952,11848,78.59389289251423,6.5252844928085345,2896,1,553676,6888,6177,0,79,3402
139,0,1,0,0,49,0,3306,0,0,3673552,2186220,29.631064780058107,638,5302,5062,878,51968,557760,577680,2250,3368,2730,6674,7792,64.68384651518491,15.503284344161868,1118,1,203696,29760,4184,0,1612,1694
140,0,1,1,0,62,0,4329,0,0,9903520,18586304,77.35631842325486,5326,8297,7639,5984,48514,788924,593246,2448,9090,3764,4761,11403,40.681691213615984,25.822554465470382,6642,1,1142944,128968,1655,0,2878,1451
141,0,1,1,0,56,0,597,0,0,24014088,14743848,72.16647421067486,5148,9879,9819,5208,33640,656792,410495,2771,8039,2891,7442,12710,67.90434448545984,8.016064826688304,5268,1,755160,13320,4611,0,2377,1780
142,0,1,0,0,56,0,2572,1,0,22700429,10352213,60.40695324215582,3377,10142,9870,3649,54285,655347,666695,2565,6486,3109,9058,12979,78.87331614684399,16.506670828935267,3921,1,857515,34816,6221,0,812,3384
143,0,1,1,0,57,0,370,0,0,24162336,14750560,71.442284397967,4924,10018,9838,5104,33600,647360,433500,2710,7994,3070,7624,12908,68.8040696470783,14.020454400761464,5284,1,765600,38160,4734,0,2214,1844
144,0,1,1,0,56,0,2733,0,0,22630228,10118392,59.85816569190874,3365,10117,9899,3583,54026,672112,641048,2606,6407,3042,9140,12941,79.47326594522211,14.767618398934328,3801,0,813341,31392,6316,0,759,3492
145,0,1,0,0,54,0,3265,1,0,12408750,6138000,47.43416490252569,2008,8007,7765,2250,53312,649264,611072,2486,4978,2970,8243,10735,74.2630459919333,15.623909053749601,2492,1,504000,36300,5515,0,478,2787
146,0,1,1,0,59,0,2284,0,0,23228045,18053390,78.07048097712733,5905,10096,9906,6095,51304,627944,716804,2772,9057,3152,6773,13058,61.73329733620261,13.834270577215369,6285,1,1474990,18050,3811,0,3133,849
147,0,1,1,0,62,0,4227,0,0,12363624,19530672,78.8416133777081,5792,8629,8205,6216,51957,788642,650394,2718,9358,3566,5131,11771,44.598206241955516,20.72625628538393,6640,1,1286712,75896,1989,0,3074,1153
148,0,1,1,0,56,0,2437,0,0,23270858,10696179,61.29437168288782,3582,10126,9951,3757,48548,651963,603564,2672,6604,3022,9041,12973,78.70196947980399,13.239542342149937,3932,0,796484,26950,6194,0,910,3347
149,0,1,0,0,50,0,2959,0,0,5217642,3149712,35.24202037341219,1000,5685,5443,1242,49932,578208,555384,2294,3778,2778,6737,8221,64.81512169239521,15.573321702785105,1484,1,271998,35332,4201,0,1294,1665
150,0,1,1,0,63,0,3645,0,0,6051276,15472512,69.88562083862459,4854,6153,6123,4884,52899,731808,725472,3138,8052,3198,4407,9321,35.199431813596085,5.477225575051661,4914,1,1118436,4080,1239,0,1716,1929
151,0,1,1,0,58,0,312,0,0,24676564,14998676,71.596089278675,4916,10150,9940,5126,33060,667128,424270,2716,8052,3136,7740,13076,69.38299503480663,15.236990810765432,5336,1,743270,46200,4814,0,2200,1888
152,0,1,0,0,57,0,1759,1,0,24081690,11878658,64.07807737440318,3811,10266,9971,4106,49032,656711,624888,2598,6999,3188,8758,13159,76.58328799418317,17.23915579066414,4401,1,886896,43660,5865,0,1213,2972
153,0,1,0,0,53,0,2950,1,0,9802896,5336382,44.56455991031439,1836,7072,6922,1986,46004,583079,569644,2537,4673,2837,7623,9759,70.25667228100119,12.449381359612769,2136,1,421032,21000,4936,0,701,2249
154,0,1,1,0,62,0,4072,0,0,12281513,18930701,78.03204469959762,5665,8530,8106,6089,51816,789686,634236,2685,9198,3533,5126,11639,44.91102314577124,20.677338706364363,6513,1,1242156,76744,2017,0,2980,1092
155,0,1,1,0,62,0,3920,0,0,14967969,19640343,79.3536388579629,6237,8734,8674,6297,52624,789107,648752,3059,9416,3179,5496,11853,48.75448697299562,7.745966692414834,6357,1,1309776,10320,2377,0,3178,742
156,0,1,1,0,58,0,1030,0,0,24604944,13040352,66.87301398920195,3984,10462,9974,4472,45046,650268,589032,2428,7388,3404,8418,13378,74.17546764261078,22.120715792163633,4960,1,903344,78080,5502,0,1556,2586
157,0,1,0,0,55,0,3031,1,0,18474066,8502390,55.154328932550705,2824,9333,9115,3042,50561,651235,606515,2577,5837,3013,8868,12128,77.92945527847606,14.787218784396567,3260,1,660114,33354,6073,0,247,3278
158,0,1,0,0,51,0,2928,0,0,5119729,3145205,35.08560958569767,946,5675,5390,1231,48070,533995,587650,2270,3786,2840,6714,8230,64.49030934954492,16.900669548544084,1516,1,283130,31065,4159,0,1324,1604
159,0,1,0,0,49,0,2997,0,0,3764350,2381547,30.870698080866262,456,5400,4903,953,47064,529788,554778,2002,3452,2996,6449,7899,62.849025449882674,22.294602336219153,1450,1,211566,61131,3950,0,1546,1451
160,0,1,1,0,60,0,3778,0,0,10788200,17187306,75.35250493513803,5343,7913,7578,5678,55615,741615,687129,2692,8705,3362,4927,10940,43.58898943540674,18.374508710046495,6013,1,1288906,49915,1900,0,2651,1127
161,0,1,1,0,61,0,3846,0,0,14220360,19058976,78.46018098373213,6071,8551,8466,6156,56628,749232,724464,3011,9252,3181,5406,11647,48.062459362791664,9.300149152818726,6241,1,1440504,11475,2310,0,3060,786
162,0,1,1,0,58,0,1201,0,0,24814706,16382088,74.95331880577403,5350,10303,10035,5618,53966,650268,705672,2648,8534,3184,7333,13219,66.46051459325304,16.80451046928176,5886,1,1359556,28944,4417,0,2702,1501
163,0,1,1,0,51,0,2826,0,0,5905152,3622218,37.389838191679836,1048,5972,5622,1398,47286,551883,575202,2241,3989,2941,6815,8563,64.99230723708769,18.726738823276346,1748,1,310356,43750,4224,0,1193,1633
164,0,1,1,0,63,0,3371,0,0,6630096,15170155,69.01449123191448,4636,6282,6155,4763,38982,697515,566930,3058,7948,3312,4577,9467,37.30951621235526,11.298832705339896,4890,1,847814,22860,1392,0,1578,1793
165,0,1,1,0,60,0,3738,0,0,10992475,17144175,75.33259586659682,5351,7936,7612,5675,52000,755250,628368,2697,8696,3345,4958,10957,44.01136216933077,18.064849321919272,5999,1,1180400,57348,1937,0,2654,1084
166,0,1,1,0,61,0,3490,0,0,18280899,19617129,79.76841480184999,5853,9746,9236,6363,50578,746086,644347,2573,9446,3593,5956,12829,53.600373133029585,22.596733778246925,6873,1,1329867,87210,2873,0,3280,210
167,0,1,1,0,57,0,533,0,0,25184628,15135120,72.74613391789285,5232,10111,10051,5292,25990,646360,328900,2800,8152,2920,7619,12971,68.98550572402873,8.275039169881914,5352,1,608580,14400,4759,0,2432,1899
168,0,1,1,0,60,0,3611,0,0,10649340,16649280,74.39758060582346,5307,7687,7459,5535,53965,755008,646720,2780,8543,3236,4932,10695,43.86342439892262,15.128632192459419,5763,0,1190025,37848,1924,1,2527,1084
169,0,1,1,0,60,0,3742,0,0,11577048,17457636,75.85512507405153,5370,8150,7766,5754,55000,758500,667480,2650,8788,3418,5046,11184,44.85532298401161,19.73906264951052,6138,1,1265880,61440,2012,0,2720,1022
170,0,1,1,0,57,0,2061,0,0,24546730,11578190,63.48228099241551,3963,10188,10121,4030,56120,660790,701012,2806,6903,2940,8964,13061,78.04485889538144,8.299636160530056,4097,1,983320,7370,6091,0,1157,3218
171,0,1,1,0,63,0,3254,0,0,7212471,15168594,69.04346457123947,4448,6599,6280,4767,47475,671402,715950,2863,7949,3501,4695,9781,38.897300677553446,17.86272076881258,5086,1,1072575,37642,1513,0,1585,1669
172,0,1,1,0,59,0,1905,0,0,24833146,18065948,77.6273147803014,5642,10531,10147,6026,53775,674550,716522,2614,9024,3382,7119,13529,64.19501538281614,20.37731271033109,6410,1,1440214,43776,4121,0,3028,1123
173,0,1,1,0,53,0,2689,0,0,6844742,4244826,39.96248240537617,1297,6183,5883,1597,36616,528942,489072,2358,4255,2958,6944,8841,65.46754921333164,17.459131109569366,1897,1,293848,44700,4286,0,1061,1628
174,0,1,1,0,63,0,3232,0,0,7628544,15290800,69.39740629158989,4450,6766,6400,4816,48364,717550,679450,2809,7991,3541,4759,9941,39.7994974842648,19.426418720362587,5182,1,1030624,54534,1584,0,1641,1591
175,0,1,1,0,59,0,239,0,0,25715976,14621256,70.37755323965163,4465,10633,10145,4953,48124,670104,625824,2464,7905,3440,8144,13585,72.05553413860729,22.4444848620007,5441,0,1050036,74176,5192,0,2001,2240
176,0,1,1,0,52,0,2757,0,0,5430294,3484638,36.45545226711637,845,5899,5415,1329,53058,582084,626658,2138,3951,3106,6708,8521,63.92182725798755,22.035624309222797,1813,1,317631,54208,4086,0,1293,1464
177,0,1,1,0,59,0,256,0,0,25952832,15436920,72.27724399837061,4977,10439,10192,5224,36348,688515,460980,2708,8179,3202,7923,13394,70.48404074682438,16.67920783761053,5471,1,814944,53105,4968,0,2269,2013
178,0,1,1,0,56,0,2686,0,0,23176355,10369235,60.45659600076736,3454,10197,9996,3655,50609,626977,649673,2636,6492,3038,9178,13034,79.63039620647382,14.223629663068442,3856,0,836995,24924,6341,0,818,3504
179,0,1,1,0,63,0,3062,0,0,7844903,15028586,68.72408602520662,4265,6842,6384,4723,51040,738224,700040,2724,7905,3640,4843,10024,40.755367744629666,21.69773919285862,5181,1,1039060,68242,1661,0,1541,1521
180,0,1,1,0,61,0,3035,0,0,20531256,19372792,79.3473376995095,5678,10175,9557,6296,53325,729249,692325,2459,9373,3695,6338,13252,57.105166141076936,24.889639380256696,6914,1,1416600,90846,3261,0,3219,184
181,0,1,0,0,55,0,2578,1,0,15802520,7961950,53.75872022286245,2860,8388,8358,2890,49324,650180,575795,2725,5645,2785,8223,11143,73.9459261893446,5.478746393072713,2920,1,604010,4950,5468,0,135,2713
182,0,1,1,0,60,0,2874,0,0,22705560,19543458,80.0874522007037,5814,10554,9954,6414,46440,655105,658152,2447,9461,3647,6587,13601,59.49789912257407,24.497771670273508,7014,1,1385424,80400,3540,0,3367,493
183,0,1,1,0,57,0,1537,0,0,25803314,12582720,66.09841147864296,4339,10305,10275,4369,52377,636480,682560,2850,7249,2910,8786,13185,76.8505042273634,5.490867587491313,4399,1,1035453,3390,5906,0,1489,3026
184,0,1,1,0,64,0,2691,0,0,7525710,14175621,66.34003316248794,3977,6535,6111,4401,50456,766598,682852,2797,7622,3645,4931,9756,41.352146256270665,20.659670300883477,4825,1,933012,69960,1710,0,1180,1511
185,0,1,1,0,63,0,2837,0,0,8141640,14653110,67.86015030929418,4052,6926,6373,4605,54747,735042,754134,2629,7787,3735,4950,10108,42.04759208325728,23.517874234778837,5158,1,1091385,68572,1768,0,1423,1414
186,0,1,1,0,61,0,2903,0,0,10849548,15476264,71.07038764492565,4901,7349,7199,5051,37128,557648,625056,2914,8115,3214,5212,10413,46.34652090502587,12.525768210359056,5201,1,1030404,15600,2148,0,1987,916
187,0,1,1,0,56,0,2468,0,0,21835133,10174373,59.99166608788257,3557,9708,9666,3599,40885,624767,522995,2785,6426,2869,8894,12535,77.89094941005662,6.553889165207866,3641,1,665815,7308,6067,0,772,3240
188,0,1,0,0,50,0,2969,0,0,1947666,1392454,23.515952032609693,193,4435,4075,553,53586,589212,576622,2158,3071,2878,6040,6953,59.34644049983116,19.029091885129493,913,1,126637,50040,3522,0,1965,1004
189,0,1,1,0,61,0,3061,0,0,15732822,17635100,76.03946343840151,5505,8780,8503,5782,53482,738100,674050,2773,8832,3327,5771,11830,52.16320542297991,16.643805003995034,6059,1,1277822,43212,2721,0,2732,329
190,0,1,1,0,62,0,2786,0,0,10044995,15084485,69.67783004657937,4572,7207,6924,4855,44019,680433,624507,2824,7962,3390,5176,10314,45.48626166217664,17.22395988155976,5138,1,975855,43865,2069,0,1748,1038
191,0,1,1,0,59,0,2177,0,0,26100120,18904440,79.44809626416482,6044,10715,10447,6312,56088,736770,682860,2727,9307,3263,7130,13710,64.3039656630911,17.322865108115078,6580,1,1439136,39128,4135,0,3317,1140
192,0,1,0,0,54,0,2444,1,0,7321677,4753587,41.79712908801273,1680,6005,5938,1747,53984,655761,609504,2654,4468,2788,6912,8726,64.73793323855806,8.187175587434018,1814,1,391328,10184,4191,0,974,1470
193,0,1,1,0,63,0,2571,0,0,8203950,14080350,66.52067347825036,3846,6858,6279,4425,54289,741406,741406,2603,7607,3761,5036,10040,43.05810028322197,24.064213042336732,5004,1,1031025,77007,1854,0,1243,1328
194,0,1,0,0,54,0,2155,1,0,13260000,7409280,52.15361924162119,2660,7655,7595,2720,55692,637416,648312,2664,5444,2784,7599,10379,69.82120021884471,7.748117453886108,2780,1,647360,7440,4875,0,4,2151
195,0,1,0,0,50,0,2940,0,0,1763461,1285165,22.60530911091463,198,4275,3962,511,52891,570905,585995,2202,3026,2828,5966,6790,58.74521257089806,17.76007754622255,824,1,119063,39125,3451,0,2004,936
196,0,1,1,0,60,0,2766,0,0,12037536,15441006,71.54019849007969,4906,7682,7470,5118,41548,567196,666757,2805,8135,3229,5369,10699,48.49742261192856,14.774444774483948,5330,1,1131078,19504,2352,0,2101,665
197,0,1,1,0,61,0,2496,0,0,23262820,19169710,78.93034904268447,5612,10582,9964,6230,50820,744634,646170,2459,9307,3695,6811,13659,61.106464469808756,25.548094648460104,6848,1,1308300,105060,3734,0,3153,657
198,0,1,0,0,58,0,1713,1,0,26823658,12867097,66.27971031922213,4203,10689,10499,4393,46056,667812,591658,2739,7322,3119,9035,13618,78.14089838234521,13.927000263998286,4583,1,887386,31350,6106,0,1464,3177
199,0,1,0,0,54,0,2118,1,0,13816744,7674410,52.97169055259611,2739,7797,7730,2806,55680,634520,656400,2668,5541,2802,7659,10532,70.17121917139534,8.20171446926608,2873,1,673440,8040,4924,0,71,2189
200,0,1,1,0,57,0,1158,0,0,27185275,16851725,76.32168761236873,5675,10642,10492,5825,35588,627781,474452,2743,8718,3043,7560,13535,68.31544481301428,12.491663664368078,5975,1,955300,28800,4667,0,2932,1774
201,0,1,1,0,64,0,2252,0,0,8016333,13482963,64.59876159803684,3525,6742,6094,4173,51051,746361,714051,2583,7404,3879,5152,9973,43.829214001622255,25.50843807656905,4821,1,922233,95256,1921,0,942,1310
202,0,1,1,0,51,0,2774,0,0,2562155,1871360,27.03701166919155,513,4454,4236,731,52640,573440,601600,2342,3291,2778,6065,7014,59.20304046246274,14.853802406399037,949,1,171785,26160,3505,0,1829,945
203,0,1,1,0,63,0,2469,0,0,10189516,14725434,68.24221567329127,4173,7329,6845,4657,45305,648210,698802,2678,7819,3646,5350,10491,46.776062254106,22.471478048308978,5141,1,1029197,55660,2188,0,1495,974
204,0,1,1,0,59,0,2751,0,0,15127750,16403982,74.16872656315464,5381,8371,8251,5501,55000,745500,656040,2862,8483,3102,5732,11353,52.44044240850758,10.955211796648204,5621,1,1210220,19200,2750,0,2519,232
205,0,1,1,0,54,0,2047,0,0,13771098,7717806,53.16013544000805,2826,7699,7699,2826,51750,628130,614475,2731,5557,2731,7604,10430,69.80687645210892,0.0,2826,0,635850,0,4873,0,95,2142
206,0,1,1,0,63,0,2250,0,0,8732619,13598364,65.47518613948341,3528,7083,6324,4287,48375,681980,713700,2413,7459,3931,5209,10255,45.13313638558703,27.54995462791182,5046,0,964575,93357,2037,0,1115,1135
207,0,1,1,0,58,0,2143,0,0,26703894,18513684,79.68061244744545,6222,10682,10555,6349,56069,661932,720252,2789,9265,3043,7122,13598,64.85368146836385,11.66725943004119,6476,1,1568203,12446,4206,0,3433,1290
208,0,1,1,0,57,0,2087,0,0,21128190,10606300,60.58052492344384,3517,9580,9427,3670,47066,583780,673370,2737,6560,3043,8647,12470,75.87489703452651,12.52805739248939,3823,1,855110,14688,5757,0,780,2867
209,0,1,0,0,54,0,2411,1,0,4940082,3577392,36.373066958946424,1000,5380,5057,1323,48837,592176,602992,2381,4027,3027,6438,8084,61.106464469808756,17.993008616382102,1646,1,295029,41990,3734,0,1381,1030
210,0,1,1,0,63,0,2260,0,0,10385325,14534910,67.4166151627327,3941,7434,6830,4545,41400,639600,661986,2594,7743,3802,5483,10632,47.80167361086848,25.104795234218507,5149,1,940815,74896,2285,0,1347,913
211,0,1,1,0,59,0,2300,0,0,17556525,16402575,74.12826721298698,5153,9032,8690,5495,52675,731325,641775,2643,8480,3327,6180,12017,56.52433104425032,18.648169442454932,5837,1,1181425,56772,3195,0,2510,210
212,0,1,1,0,60,0,928,0,0,28664580,17578218,76.40680597957227,5395,11191,10748,5838,35096,644354,493804,2568,8849,3454,7921,14202,70.07139216541941,21.71057639735279,6281,1,957432,83284,4910,0,2827,1899
213,0,1,1,0,60,0,824,0,0,28699385,17493840,76.05918747922567,5311,11220,10746,5785,37856,677376,511056,2550,8809,3498,7985,14244,70.43436661176133,22.493762839099613,6259,1,977665,91956,4961,0,2761,1937
214,0,1,1,0,55,0,1938,0,0,13645800,7874550,53.38539126015655,2765,7723,7638,2850,44280,596808,566415,2678,5613,2848,7551,10486,69.19537556802477,9.310388377026886,2935,1,584250,12580,4788,0,87,2025
215,0,1,0,1,64,0,1640,0,0,8599625,12538060,62.16912416947821,3247,6708,6090,3865,46716,661776,742876,2626,7109,3862,5469,9952,47.16990566028302,24.95306800861016,4483,1,885085,64272,2225,0,621,1019
216,0,1,0,0,59,0,2348,0,0,14565773,15268485,71.88184749990779,5082,8071,7986,5167,46189,653055,617595,2870,8122,3040,5774,11026,53.094255809833136,9.251281740554573,5252,0,1079903,12665,2819,0,2212,136
217,0,1,1,0,64,0,1847,0,0,9467304,13239336,64.31174076325411,3152,7409,6425,4136,43665,681813,656205,2217,7337,4185,5490,10610,47.843494855622744,31.62796146174515,5120,0,847880,140712,2289,1,935,912
218,0,1,1,0,59,0,2297,0,0,14398208,15195836,71.50524456289902,5083,7959,7929,5113,36784,523072,621148,2942,8085,3002,5788,10931,53.0659966456864,5.477225575051661,5143,1,1068617,2700,2816,0,2141,156
219,0,1,1,0,59,0,2052,0,0,19604349,16629435,74.63913182774837,5113,9548,9090,5571,56120,728340,686550,2527,8556,3443,6504,12533,59.321159799855565,21.511183681560496,6029,1,1281330,65952,3519,0,2586,534
220,0,1,1,0,50,0,2627,0,0,1520120,1239032,22.090722034374522,398,3693,3603,488,41607,510339,525573,2449,3027,2629,5654,6232,55.812185049503306,9.552038418812673,578,1,101016,11250,3115,0,2051,576
221,0,1,1,0,60,0,1887,0,0,22598370,17375790,76.0920495189872,5070,10413,9693,5790,49000,735245,600200,2281,8791,3721,6904,13414,62.473994589749104,27.06221162108231,6510,1,1158000,131760,3903,0,2789,902
222,0,1,0,0,59,0,2163,0,0,15164080,15123096,71.57513534740957,4973,8233,8083,5123,49050,643536,664200,2802,8075,3102,5912,11185,54.405882034941776,12.282138241571156,5273,0,1152675,18900,2960,0,2171,8
223,0,1,1,0,59,0,2028,0,0,17903005,15891130,73.24616030891995,5110,8957,8702,5365,52668,746424,619058,2707,8327,3217,6299,11919,57.766772456144714,16.081047146859216,5620,1,1121285,45135,3337,0,2403,375
224,0,1,0,0,60,0,772,1,0,29597120,15224272,71.18988692223074,4584,11392,10908,5068,43834,651868,606808,2520,8072,3488,8844,14396,76.4198926981712,22.167705410234827,5552,1,1023736,73568,5840,0,2064,2836
225,0,1,0,0,54,0,1960,1,0,9699825,6231195,47.80167361086848,2161,6654,6530,2285,51051,629937,602667,2603,5012,2851,6972,9381,65.1536645170477,11.214528750203367,2409,1,504985,18228,4245,0,442,1518
226,0,1,1,0,60,0,1767,0,0,23371738,17417192,76.14459928320589,5195,10432,9829,5798,56608,732976,696928,2401,8802,3607,7035,13436,63.490156717399906,24.86699026465621,6401,1,1345136,82611,4031,0,2794,1027
227,0,1,1,0,57,0,1708,0,0,21388893,11108214,62.0403094769844,3564,9691,9406,3849,47730,640692,620490,2601,6735,3171,8443,12577,74.54528824815154,16.931656959471947,4134,1,827535,41040,5557,0,963,2671
228,0,1,0,0,60,0,563,1,0,29978564,15727824,72.11795892841117,4601,11565,10965,5201,46081,686448,613872,2424,8225,3624,8788,14589,75.92101158440923,24.680320401635967,5801,1,1055803,97800,5764,0,2177,2740
229,0,1,1,0,60,0,1163,0,0,29939364,18458856,78.0,5749,11340,11005,6084,55029,755466,670514,2699,9118,3369,7955,14374,70.14983962918234,19.137300293954727,6419,1,1344564,52930,4921,0,3050,1887
230,0,1,1,0,58,0,1725,0,0,24672816,12131637,64.64518543557594,3989,10273,10083,4179,44344,699623,534152,2713,7082,3093,8807,13176,76.83749084919418,13.848129707866326,4369,1,768936,37430,5904,0,1276,3001
231,0,1,1,0,58,0,1849,0,0,17254580,15156680,71.97221686178632,5150,8541,8511,5180,51516,711018,620312,2896,8106,2956,6257,11467,57.7148161220323,5.5503012171862105,5210,0,1098160,5070,3331,1,2254,405
232,0,1,1,0,58,0,1806,0,0,18307720,15521992,72.63607918933951,5096,8926,8746,5276,53424,741384,623704,2762,8218,3122,6412,11868,58.90670590009256,13.470838687753037,5456,1,1118512,30600,3470,0,2334,528
233,0,1,0,0,59,0,1365,1,0,30131686,14503359,69.63476143421474,4354,11558,11063,4849,47897,631101,678957,2496,7840,3486,9205,14549,78.82892870006543,22.343890365257895,5344,1,1100723,56925,6214,0,1858,3223
234,0,1,0,0,54,0,1839,1,0,10677150,6786450,49.749371855331,2325,6939,6789,2475,54516,633402,647112,2592,5217,2892,7056,9681,65.68104749469211,12.30702509692623,2625,1,584100,18900,4314,0,267,1572
235,0,1,1,0,52,0,2263,0,0,2891514,2374066,30.18277654557314,844,4152,4085,911,38540,534230,489928,2539,3517,2673,5780,6758,56.3382640840131,8.47749576439433,978,1,171268,10184,3174,0,1695,568
236,0,1,1,0,64,0,1270,0,0,9175800,12100120,61.07372593840988,2980,6940,6190,3730,48438,759096,671508,2494,6974,3994,5704,10184,49.59838707054898,27.420254093748685,4480,0,772110,124500,2460,1,486,784
237,0,1,1,0,64,0,1496,0,0,10029012,12954474,63.26136261573884,3005,7505,6508,4002,44730,679770,689481,2240,7239,4234,5743,10742,50.05996404313531,31.585593838561625,4999,0,852426,129610,2506,1,765,731
238,0,1,1,0,52,0,2209,0,0,3112722,2555832,31.25699921617557,935,4205,4163,977,32912,489192,460416,2574,3593,2658,5802,6821,56.444663166680336,6.678188844436455,1019,1,171952,5964,3186,0,1639,570
239,0,1,1,0,58,0,1594,0,0,22127232,11576262,63.03967004989794,3517,9999,9542,3974,45787,632121,614643,2456,6887,3370,8481,12912,74.61903242471053,21.463127043344006,4431,1,838514,64894,5568,0,1061,2655
240,0,1,1,0,56,0,1711,0,0,14272122,8489634,54.93632677928149,2817,7948,7747,3018,50175,632925,627299,2612,5831,3014,7542,10761,68.76772498781678,14.283714794538563,3219,1,673014,27537,4729,0,205,1916
241,0,1,1,0,50,0,2492,0,0,637884,592020,15.297058540778355,85,3279,2960,234,52598,602140,559130,2211,2764,2849,5256,5809,52.21110992882645,17.973621770596065,553,1,51714,49126,2726,0,2296,196
242,0,1,0,1,65,0,1027,0,0,9005298,11599080,59.648973168026956,3055,6592,6089,3558,49950,733500,723720,2757,6818,3763,5791,9852,50.309044912421065,22.532433234293617,4061,1,789876,69414,2531,0,298,729
243,0,1,0,0,60,0,151,1,0,30902340,16709748,74.05403432629447,4614,11989,11119,5484,52416,712998,682528,2177,8531,3917,8682,15036,75.06663706334525,29.65410056765435,6354,1,1228416,127020,5635,0,2437,2588
244,0,1,1,0,59,0,1686,0,0,16025632,14579970,70.24243731534378,4733,8383,8182,4934,45045,576225,682605,2754,7889,3156,6203,11338,56.991227395100026,14.272033574834929,5135,1,1139754,17688,3248,0,1979,293
245,0,1,1,0,57,0,1330,0,0,28148184,17392716,77.53708789992051,5927,10779,10694,6012,50740,621995,682748,2808,8905,2978,7575,13672,68.42514157822401,9.235136611923052,6097,1,1418832,9095,4682,0,3119,1789
246,0,1,1,0,59,0,1568,0,0,16187145,14478095,69.87846592477543,4636,8445,8198,4883,38372,536665,628580,2718,7848,3212,6280,11410,57.57603668193913,15.868630154934264,5130,1,1035196,22724,3315,0,1918,350
247,0,1,1,0,60,0,747,0,0,31349430,18176445,77.36278174936577,5415,11793,11223,5985,49392,765324,595252,2467,9022,3607,8275,14830,72.37402849088892,24.282952198127905,6555,1,1173060,108870,5238,0,2948,2201
248,0,1,0,0,60,0,596,1,0,31428192,16091532,72.91090453423274,4524,12020,11228,5316,55920,726480,705291,2235,8343,3819,8939,15047,76.88953114696434,28.27241976206286,6108,1,1238628,109296,5912,0,2289,2885
249,0,1,0,0,55,0,1709,1,0,10529210,6892756,50.00999900019995,2381,6831,6711,2501,48880,573248,647660,2636,5257,2876,6966,9587,64.88451279003334,11.180339887498949,2621,1,587735,12000,4210,0,255,1454
250,0,1,1,0,58,0,1506,0,0,22771552,11985242,63.85922016435841,3568,10172,9662,4078,48204,687726,605434,2429,7017,3449,8523,13111,74.72616676907762,22.66615991583764,4588,0,840068,85170,5584,0,1139,2645
251,0,1,1,0,63,0,1342,0,0,12003600,13431600,64.8074069840786,3782,7476,7058,4200,54990,748332,751530,2780,7398,3616,6056,10674,53.46026561849464,20.46050578286666,4618,0,987000,54340,2858,0,1002,340
252,0,1,1,0,63,0,1363,0,0,12219840,13556385,65.13831437794502,3881,7485,7123,4243,52899,731655,738045,2833,7438,3557,6075,10680,53.665631459994955,19.04080001540113,4605,0,980133,47784,2880,1,1048,315
253,0,1,1,0,59,0,1200,0,0,25844161,17014025,75.62407024221852,5359,10598,10238,5719,52185,728875,633675,2615,8694,3335,7494,13573,67.22350779303324,19.25716073744823,6079,1,1218147,60840,4519,0,2744,1544
254,0,1,1,0,57,0,1157,0,0,28175598,17103020,76.9285382676676,5888,10709,10679,5918,51884,630020,687820,2860,8808,2920,7651,13599,69.0,5.501408174353464,5948,1,1408484,3240,4761,0,3028,1871
255,0,1,1,0,60,0,347,0,0,31999838,17603994,76.3740793725201,5018,12134,11319,5833,54502,691122,718284,2203,8851,3833,8504,15152,74.06753674856482,28.733610507742533,6648,1,1388254,98615,5486,0,2815,2468
256,0,1,0,0,60,0,586,1,0,32199275,16226279,73.40980860893181,4547,12206,11364,5389,52668,695541,686508,2169,8400,3853,8986,15217,77.29812416870153,29.090883531710144,6231,1,1228692,115354,5975,0,2378,2964
257,0,1,1,0,64,0,1100,0,0,11380224,12780928,62.99206299209449,3350,7454,6836,3968,50190,676410,769819,2603,7189,3839,6089,10675,53.55371135598354,24.86611227965631,4586,0,948352,59328,2868,1,747,353
258,0,1,1,0,60,0,634,0,0,32389511,16170532,73.36893075410055,4572,12211,11400,5383,54747,711948,693924,2193,8387,3815,9021,15215,77.56932383358772,28.54369090610844,6194,1,1243473,111918,6017,0,2379,3013
259,0,1,1,0,51,0,2118,0,0,981019,1005652,19.77371993328519,7,3284,2900,391,43008,493824,576128,2188,2963,2956,5081,5856,50.08991914547278,19.688582914543122,775,1,87584,36096,2509,0,2181,63
260,0,1,1,0,65,0,970,0,0,10913696,12466240,61.83849933496123,3081,7421,6678,3824,55454,759580,775880,2517,7084,4003,6114,10681,53.422841556772326,27.284108837121856,4567,0,910112,92132,2854,1,564,406
261,0,1,1,0,63,0,1246,0,0,14074680,14021568,66.52818951391959,4396,7636,7606,4426,50358,731808,690624,3138,7594,3198,6348,10804,56.39148871948674,5.477225575051661,4456,0,964868,4500,3180,0,1258,12
262,0,1,1,0,57,0,1435,0,0,17179836,10041342,59.06775770248944,3422,8480,8413,3489,43560,633160,569844,2811,6367,2945,7802,11358,70.17121917139534,8.18535277187245,3556,1,690822,10787,4924,0,611,2046
263,0,1,1,0,63,0,1023,0,0,12608524,13108602,64.02343321003646,3798,7476,7175,4099,47264,716352,674778,2897,7297,3499,6274,10674,55.46169849544819,17.374621106145614,4400,0,864889,45150,3076,0,901,122
264,0,1,1,0,59,0,809,0,0,31945602,18061225,77.91662210337407,5680,11724,11333,6071,49000,728875,595000,2584,9046,3366,8237,14699,72.53964433328854,19.913091406519683,6462,1,1214200,71553,5262,0,3096,2287
265,0,1,1,0,63,0,1038,0,0,13920928,13620908,65.46754921333164,4286,7534,7534,4286,47740,689626,699160,3178,7464,3178,6426,10712,56.991227395100026,0.0,4286,1,942920,0,3248,0,1108,70
266,0,1,1,0,59,0,535,0,0,33574244,18173660,77.89736837660179,5378,12291,11601,6068,55596,736770,676870,2305,9063,3685,8528,15286,74.38413809408563,26.36927694036773,6758,1,1371368,104880,5533,0,3073,2538
267,0,1,1,0,58,0,745,0,0,25927374,15957414,74.01351227985333,5268,10421,10211,5478,55448,696207,675816,2703,8391,3123,7646,13334,68.79680225126747,14.524125829022891,5688,1,1270896,29190,4733,0,2565,1820
268,0,1,0,0,59,0,1233,1,0,34235500,15706194,72.5741000633146,4843,12191,11767,5267,55125,730590,670950,2558,8249,3406,9482,15173,80.62257748298549,20.680476903300782,5691,1,1185075,64872,6500,0,2285,3518
269,0,1,1,0,58,0,523,0,0,31465458,17307765,76.66159403508382,5515,11593,11231,5877,52961,739195,621395,2583,8822,3307,8299,14538,73.17103251970687,19.073165735500613,6239,1,1240047,62626,5354,0,2932,2409
270,0,1,1,0,59,0,890,0,0,34659191,16349705,73.8850458482635,4828,12439,11808,5459,53074,712810,667885,2364,8454,3626,9344,15434,79.68061244744545,25.128052785154686,6090,1,1217357,95281,6349,0,2464,3354
271,0,1,1,0,58,0,1232,0,0,29279460,14209860,69.49820141557622,4830,10892,10892,4830,50095,685486,632530,2942,7772,2942,9004,13834,77.85884663928692,0.0,4830,0,1038450,0,6062,0,1888,3120
272,0,1,1,0,58,0,1233,0,0,28969234,14138945,69.28924880528002,4801,10835,10835,4801,48995,703855,603725,2945,7746,2945,8979,13780,77.67882594375381,0.0,4801,0,984205,0,6034,0,1856,3089
273,0,1,0,0,59,0,1237,1,0,27723360,13856997,68.4324484437025,4563,10723,10603,4683,47760,710160,588841,2839,7642,3079,8879,13682,76.94153624668537,10.991537949000206,4803,1,931917,21600,5920,0,1724,2961
274,0,1,0,0,55,0,1335,1,0,10224466,7266804,50.98038838612354,2539,6593,6533,2599,54692,631896,676632,2736,5395,2856,6730,9389,62.72160712226688,7.780166052320878,2659,1,628958,6660,3934,0,197,1138
275,0,1,1,0,55,0,1343,0,0,9518894,6923510,49.85980344927164,2426,6375,6315,2486,50718,660045,595990,2725,5271,2845,6614,9160,61.87891401761993,7.748117453886108,2546,0,532004,9660,3829,1,299,1044
276,0,1,1,0,55,0,1400,0,0,5750004,5005632,42.40283009422838,1645,5149,4996,1798,38940,612480,492768,2631,4582,2937,5982,7933,56.55086206239477,12.510730175691064,1951,1,318246,27846,3198,0,986,414
277,0,1,1,0,55,0,1403,0,0,5621154,4939319,42.08325082500163,1589,5127,4945,1771,40725,627525,504809,2607,4560,2971,5963,7916,56.3382640840131,13.738384613864339,1953,1,320551,33306,3174,0,1018,385
278,0,1,1,0,58,0,540,0,0,23024736,14832072,71.2460525222275,4836,9852,9612,5076,56635,704202,686670,2682,7998,3162,7458,12774,67.34983296193094,15.524375156057674,5316,1,1192860,30960,4536,0,2154,1614
279,0,1,1,0,60,0,369,0,0,34911792,17226816,75.67694497005016,4796,12754,11823,5727,53312,715904,673792,2077,8735,3939,9104,15762,78.07688518377255,30.523691876881834,6658,1,1282848,139650,6096,0,2719,3088
280,0,1,1,0,59,0,1208,0,0,32858880,15366480,71.83313998427188,4837,11851,11528,5160,51272,658138,690896,2655,8138,3301,9346,14829,79.79974937304002,18.074722043561273,5483,1,1197120,39083,6368,0,2182,3390
281,0,1,0,0,57,0,1279,1,0,14164346,9190776,56.37375275782161,3044,7769,7635,3178,49042,627564,653592,2758,6070,3026,7349,10661,66.76076692189807,11.59897583714774,3312,1,718228,16482,4457,0,286,1565
282,0,1,1,0,50,0,1658,0,0,842928,1028568,20.199009876724155,366,2516,2474,408,48614,549578,562183,2479,2929,2563,4587,5037,45.45327270945405,6.484411467763075,450,0,90984,5418,2066,0,2113,455
283,0,1,1,0,59,0,1110,0,0,34821304,16035420,73.29392880723478,4875,12351,11854,5372,51756,677595,680580,2488,8357,3482,9467,15336,80.51086883148137,22.29730905399437,5869,1,1224816,66101,6482,0,2387,3497
284,0,1,1,0,61,0,480,0,0,17540425,13557795,66.59579566308972,3809,9016,8390,4435,42532,599172,663369,2431,7492,3683,7012,12073,62.8887907341205,25.344601296870437,5061,1,962395,66982,3955,0,1378,898
285,0,1,1,0,56,0,1246,0,0,12313967,8320089,54.230987451824994,2881,7188,7128,2941,51736,630867,656328,2769,5770,2889,7016,10017,64.70703207534712,7.780166052320878,3001,0,682312,7380,4187,1,112,1358
286,0,1,1,0,64,0,542,0,0,13846920,12810402,63.26136261573884,4002,7462,7462,4002,48672,749034,665808,3201,7203,3201,6661,10663,58.82176467941097,0.0,4002,0,832416,0,3460,0,801,259
287,0,1,1,0,62,0,430,0,0,16057944,13259008,65.02307282803544,3439,8815,8026,4228,41701,699328,586432,2347,7364,3925,6934,11951,61.62791575252241,28.09105000394694,5017,1,790636,138075,3798,0,1092,662
288,0,1,1,0,50,0,1507,0,0,1133958,1403948,23.473389188611005,491,2669,2609,551,42355,547820,501956,2488,3099,2608,4606,5217,45.36518488885502,7.772191019407321,611,0,108547,9300,2058,0,1997,490
289,0,1,0,0,59,0,1155,1,0,29570986,14487142,69.93568473962345,4849,10979,10937,4891,52650,666450,693108,2920,7853,3004,9008,13941,77.75602870517501,6.488991180673202,4933,1,1144494,5124,6046,0,1929,3084
290,0,1,0,0,56,0,1220,1,0,8875581,6826248,49.3051721424842,2230,6283,6082,2431,44304,598104,584064,2607,5239,3009,6459,9091,60.423505360083176,14.212409159636923,2632,1,505648,28341,3651,0,377,843
291,0,1,0,0,54,0,1298,1,0,4192703,4120751,38.71692136521188,983,4812,4296,1499,52360,604780,654262,2233,4248,3265,5546,7561,52.88667128870941,22.75496796060299,2015,1,356762,57276,2797,0,1250,48
292,0,1,1,0,63,0,313,0,0,16196264,13200520,64.68384651518491,3335,8904,8055,4184,41070,700410,583675,2306,7339,4004,7026,12059,62.21736092120912,29.14125214278723,5033,1,774040,150273,3871,0,1029,716
293,0,1,1,0,59,0,129,0,0,36037852,17763549,77.06490770772389,5090,12856,12007,5939,45360,717840,565299,2142,8930,3840,9059,15847,77.89736837660179,29.234181192419452,6788,0,1122471,162159,6068,0,2948,3077
294,0,1,0,0,59,0,1152,1,0,21654945,12207384,64.13267497929586,3807,9684,9378,4113,53586,694512,679672,2662,7081,3274,8233,12652,72.56031973468694,17.603930539450378,4419,1,941877,42228,5265,0,1145,2297
295,0,1,1,0,58,0,1156,0,0,19817037,11467052,62.53798845501828,3803,9086,8978,3911,50976,633312,691952,2824,6843,3040,7999,12018,71.18286310622803,10.489171794062365,4019,1,922996,11664,5067,0,979,2135
296,0,1,1,0,56,0,1165,0,0,9738144,7278336,50.91168824543142,2439,6502,6349,2592,47443,637416,586872,2655,5400,2961,6565,9310,61.29437168288782,12.37050560560409,2745,0,541728,24021,3757,1,216,949
297,0,1,0,0,55,0,1191,1,0,5813152,5275072,43.45112196480086,1678,5177,4967,1888,53118,653796,634238,2584,4682,3004,5873,7971,55.48873759602033,14.60255500160762,2098,1,428576,29820,3079,0,906,285
298,0,1,1,0,61,0,201,0,0,18278352,13481160,66.15889962809237,3718,9212,8553,4377,41808,619080,640640,2421,7457,3739,7256,12292,64.62197768561404,26.073566332930465,5036,1,910416,82375,4176,0,1297,1096
299,0,1,1,0,58,0,200,0,0,20747136,13670016,68.23488843692792,4476,9292,9112,4656,46081,596008,666472,2756,7592,3116,7392,12228,66.75327707311455,13.491246634222138,4836,0,1056912,18900,4456,1,1720,1520
300,0,1,1,0,58,0,189,0,0,31480002,16621578,75.53806987208503,5393,11536,11223,5706,48265,713685,573861,2600,8619,3226,8430,14449,74.27651041883968,17.696318929814684,6019,1,1124082,58531,5517,0,2793,2604
301,0,1,1,0,58,0,189,0,0,31727392,16720032,75.68355171369801,5405,11590,11267,5728,51336,723912,604233,2596,8647,3242,8458,14509,74.42445834535849,17.987727509404895,6051,1,1185696,57494,5539,0,2809,2620
302,0,1,0,0,59,0,1110,1,0,28314475,14279510,69.24593850905626,4710,10785,10700,4795,50020,726632,610490,2893,7773,3063,8883,13763,76.84399781375251,9.2729914971827,4880,1,982975,15045,5905,0,1817,2927
303,0,1,1,0,51,0,1288,0,0,1223664,1637064,25.219040425836983,502,2694,2560,636,41907,589446,471042,2440,3210,2708,4498,5268,43.86342439892262,11.737458020983768,770,1,116388,25058,1924,0,1938,650
304,0,1,1,0,62,0,85,0,0,16910850,13055010,64.45928947793328,3425,8955,8225,4155,44352,603264,725802,2412,7297,3872,7212,12097,63.796551630946325,27.03148226152335,4885,1,959805,62050,4070,0,1013,928
305,0,1,0,0,56,0,1114,1,0,5810427,5375268,43.78355855797927,1705,5160,4948,1917,46209,614076,591644,2592,4721,3016,5835,7964,55.054518434003214,14.735922616710878,2129,1,404487,30528,3031,0,887,227
306,0,1,1,0,51,0,1211,0,0,1605990,2073405,28.26658805020514,757,2851,2809,799,43248,550140,529380,2553,3394,2637,4605,5446,44.83302354291979,6.78953034358522,841,1,162996,6048,2010,0,1796,585
307,0,1,1,0,58,0,59,0,0,33702960,17090715,76.38717169787084,5469,11977,11611,5835,51376,723463,609232,2563,8764,3295,8705,14906,76.0,19.169890285517887,6201,1,1213680,64782,5776,0,2906,2847
308,0,1,1,0,60,0,266,0,0,37119147,17888961,77.20751258783046,5197,12952,12188,5961,49647,741247,603201,2237,8962,3765,9228,15953,78.91134265744057,27.76053188725991,6725,1,1198161,140576,6227,0,2960,3226
309,0,1,1,0,56,0,1072,0,0,5169600,5063400,42.42640687119285,1429,5043,4672,1800,53130,646990,649803,2442,4613,3184,5685,7856,53.59104402789705,19.370147442164892,2171,1,415800,48972,2872,0,1013,59
310,0,1,0,0,59,0,1031,1,0,28041980,14357340,69.31810730249349,4613,10833,10641,4805,48048,690228,621504,2796,7793,3180,8824,13821,76.39371701913711,13.919497812052477,4997,1,999440,31104,5836,0,1817,2848
311,0,1,1,0,63,0,142,0,0,16911728,12833350,63.57672530100933,3430,8838,8226,4042,46200,635000,733425,2563,7217,3787,7359,12013,64.68384651518491,24.73863375370596,4654,0,933702,58752,4184,1,867,1009
312,0,1,1,0,57,0,992,0,0,11836560,8525780,54.589376255824725,2846,7086,6952,2980,48108,652308,603671,2727,5841,2995,6833,9947,63.02380502635492,11.59192030070629,3114,1,628780,20770,3972,0,119,1111
313,0,1,1,0,56,0,987,0,0,5192350,5153752,42.871902220452036,1476,5025,4663,1838,50850,630900,633704,2442,4642,3166,5629,7829,53.150729063673246,19.029926305868532,2200,1,415388,48146,2825,0,966,21
314,0,1,0,0,60,0,990,1,0,33569200,15965320,72.93833011524188,4985,11965,11630,5320,51714,663221,702234,2666,8321,3336,9311,14966,79.435508432942,18.33719937800071,5655,1,1244880,39530,6310,0,2319,3309
315,0,1,0,0,58,0,959,1,0,15376530,10114494,58.915193286621744,3194,8178,7901,3471,55692,693532,681876,2637,6385,3191,7344,11092,66.55824516917495,16.660858965059326,3748,1,812214,37395,4430,0,557,1516
316,0,1,1,0,53,0,964,0,0,2858240,3404368,35.7211421989835,993,3799,3516,1276,43800,533600,584292,2385,3944,2951,4908,6467,47.32863826479693,17.06033345584145,1559,1,279444,31130,2240,0,1392,428
317,0,1,1,0,63,0,374,0,0,16660427,12418315,62.44197306299666,3418,8653,8172,3899,55920,742105,764400,2704,7084,3666,7458,11838,65.36818798161687,21.93408167382258,4380,1,935760,58201,4273,0,714,1088
318,0,1,0,0,58,0,268,0,0,34192845,16647795,75.59761901012492,5447,11966,11698,5715,52539,725337,614643,2645,8628,3181,8896,14879,77.34985455707076,16.39345090320684,5983,0,1205865,46364,5983,0,2802,3070
319,0,1,1,0,63,0,539,0,0,16938870,12212640,62.08864630510155,3437,8667,8249,3855,51980,728640,715968,2750,7023,3586,7562,11835,66.2872536767062,20.446101339450014,4273,0,871230,57684,4394,1,687,1226
320,0,1,1,0,59,0,892,0,0,24046860,13232490,66.91786009728644,4448,9878,9848,4478,47960,650100,644190,2925,7433,2985,8325,12833,73.28028384224504,5.490867587491313,4508,0,976204,4110,5370,0,1523,2415
321,0,1,1,0,58,0,886,0,0,22110480,12548960,65.4217089351845,4250,9476,9446,4280,53592,677292,680224,2902,7212,2962,8098,12408,71.87489130426563,5.531194905403055,4310,0,992960,3930,5166,0,1348,2234
322,0,1,1,0,64,0,520,0,0,14747201,11606826,59.90826320300064,2931,8356,7698,3589,44880,711480,659736,2576,6823,3892,7343,11590,64.10148204214939,25.661517442713446,4247,0,732156,100674,4109,1,355,875
323,0,1,1,0,64,0,588,0,0,15603085,11738067,60.55575942881073,3179,8410,7922,3667,50400,720225,717024,2713,6868,3689,7456,11611,65.23036102920173,22.106382158193618,4155,1,821408,65880,4255,0,466,1054
324,0,1,0,0,58,0,390,0,0,34196176,16419368,75.20638270785267,5444,11914,11702,5656,51484,708332,612533,2691,8559,3115,8949,14817,77.75602870517501,14.568312119522872,5868,0,1193416,36252,6046,0,2753,3143
325,0,1,1,0,57,0,784,0,0,10480457,8245506,53.563046963368315,2469,6922,6522,2869,50976,678264,620784,2474,5743,3274,6527,9796,60.440052945046304,20.011271717548034,3269,1,619704,62800,3653,0,5,779
326,0,1,0,0,58,0,506,0,0,35243355,16515167,75.4254598925323,5477,12096,11884,5689,50264,708332,598018,2691,8592,3115,9098,14999,78.70832230456955,14.560948641917447,5901,0,1171934,37312,6195,0,2786,3292
327,0,1,1,0,56,0,714,0,0,6637752,6283200,47.37087712930804,2244,5202,5202,2244,47722,599200,624400,2800,5044,2800,5758,8002,54.38749856354859,0.0,2244,0,500412,0,2958,0,556,158
328,0,1,1,0,65,0,803,0,0,14618978,11213851,58.677082408722406,2750,8382,7689,3443,45173,739339,648143,2564,6700,3950,7503,11639,65.16133823057964,26.361870182299736,4136,0,685157,115731,4246,1,186,989
329,0,1,1,0,63,0,892,0,0,16447484,11585192,60.28266749240614,3424,8370,8160,3634,49646,768308,656728,2978,6822,3398,7714,11558,67.27555276621665,14.505240300948106,3844,1,748604,36330,4526,0,446,1338
330,0,1,1,0,59,0,764,0,0,23561237,13245624,66.9850729640567,4295,9930,9738,4487,50621,658296,670104,2760,7439,3144,8203,12882,72.46378405796926,13.940215812117822,4679,1,1018549,24960,5251,0,1535,2299
331,0,1,1,0,58,0,612,0,0,37152973,16996804,76.13803254615921,5455,12548,12206,5797,47628,738864,554148,2590,8729,3274,9341,15480,80.05623023850174,18.544258333558947,6139,1,1095633,67716,6409,0,2865,3477
332,0,1,0,0,61,0,622,1,0,34137480,16897000,74.43117626371358,4910,12332,11702,5540,50160,732000,637450,2420,8590,3680,9212,15382,78.49840762716146,25.213255768031058,6170,1,1157860,106470,6162,0,2490,3112
333,0,1,1,0,59,0,755,0,0,21755214,12712410,65.58963332722634,4090,9571,9359,4302,45120,709200,555540,2743,7257,3167,8012,12526,71.11258679024411,14.589369836921374,4514,1,808776,40704,5057,0,1347,2102
334,0,1,0,0,55,0,554,1,0,3991560,4856340,41.71330722922842,1282,4492,4034,1740,44220,560991,614020,2333,4531,3249,5085,7283,47.89572005931219,21.40919370995996,2198,1,382800,50838,2294,0,1051,497
335,0,1,1,0,63,0,992,0,0,16794368,11520704,60.266076693277455,3452,8436,8256,3632,53280,761280,704184,2992,6804,3352,7796,11608,68.0,13.421477552349653,3812,1,806304,27540,4624,0,460,1452
336,0,1,1,0,62,0,932,0,0,18583740,12058920,62.20932405998316,3573,8969,8672,3870,49608,660592,729144,2819,6986,3413,7918,12085,69.29646455628166,17.235446030730007,4167,1,905580,31779,4802,0,754,1686
337,0,1,0,0,57,0,676,1,0,13310652,9628770,57.67148342118486,3164,7490,7328,3326,49275,634005,651375,2733,6221,3057,6897,10385,63.26136261573884,12.727922061357855,3488,1,748350,20574,4002,0,431,1107
338,0,1,1,0,63,0,1075,0,0,16093350,11168820,59.2452529743945,3376,8229,8095,3510,54050,747770,731860,3048,6692,3316,7767,11411,67.7126280689208,11.583726138680884,3644,1,807300,18492,4585,0,328,1403
339,0,1,1,0,60,0,962,0,0,21233328,12555648,64.43601477434805,3934,9484,9266,4152,52192,677376,704592,2806,7176,3242,8138,12508,71.5122367151245,14.94787709726847,4370,1,967416,26814,5114,0,1128,2090
340,0,1,1,0,59,0,493,0,0,37265228,17366206,76.5702292016943,5383,12699,12219,5863,49446,728652,595362,2482,8825,3442,9318,15661,79.724525711979,22.011729909240167,6343,1,1178463,87840,6356,0,2901,3394
341,0,1,0,0,59,0,722,1,0,26299560,14234840,69.13754406977442,4588,10474,10282,4780,50140,684940,649204,2786,7758,3170,8480,13452,74.17546764261078,13.872260122783056,4972,1,1042040,28608,5502,0,1802,2524
342,0,1,0,0,59,0,710,1,0,24011544,13455216,67.512961718473,4235,10149,9826,4558,47073,628776,652392,2629,7510,3275,8220,13101,72.58098924649622,17.97220075561143,4881,1,1007318,40052,5268,0,1606,2316
343,0,1,0,0,58,0,657,1,0,16673400,11096760,61.38403701289123,3513,8448,8193,3768,42098,639065,571330,2690,6713,3200,7370,11393,66.52067347825036,16.0312195418814,4023,1,730992,41055,4425,0,823,1480
344,0,1,1,0,62,0,1113,0,0,17961658,11707982,60.975404877704584,3584,8683,8549,3718,54145,771505,695929,3015,6867,3283,7980,11832,69.50539547402057,11.622136368289254,3852,1,821678,21306,4831,0,569,1682
345,0,1,1,0,56,0,454,0,0,4700871,5532849,44.19275958796871,1711,4602,4360,1953,56644,674254,674254,2591,4786,3075,5240,7435,49.06118628814432,15.59136036785464,2195,1,464814,30492,2407,0,880,426
346,0,1,1,0,62,0,1235,0,0,17600534,11361728,60.19136150644875,3581,8523,8481,3623,55056,777728,696192,3094,6759,3178,7994,11659,69.6993543729065,6.495386533491135,3665,1,804306,6636,4858,0,487,1722
347,0,1,1,0,57,0,499,0,0,7707906,7235838,50.37856687124,2270,5843,5575,2538,47475,601561,641475,2583,5389,3119,5888,8694,55.10898293381942,16.489969848905996,2806,1,571050,31624,3037,0,313,186
348,0,1,0,0,58,0,577,1,0,15381324,10687852,60.36555309114628,3344,8165,7865,3644,54054,677523,686322,2633,6577,3233,7154,11098,64.96922348312314,17.339721092551002,3944,1,852696,38700,4221,0,711,1288
349,0,1,0,0,56,0,307,1,0,4075038,5257510,43.255057507764334,1450,4470,4049,1871,53820,657540,646300,2389,4681,3231,4988,7280,46.66904755831214,20.518284528683193,2292,1,430330,58098,2178,0,939,632
350,0,1,0,1,65,0,1324,0,0,14430492,10434798,56.515484603779164,2710,8196,7712,3194,52405,728541,767745,2783,6461,3751,7785,11463,67.21606950722423,22.089701581285205,3678,1,750590,57596,4518,0,73,1251
351,0,1,1,0,63,0,1413,0,0,15875020,10647920,57.79273310719956,3255,8178,8093,3340,43239,647164,679044,3103,6528,3273,7941,11366,68.94200461257273,9.2729914971827,3425,1,711420,10285,4753,0,152,1565
352,0,1,0,0,59,0,570,1,0,17474875,11539275,62.489999199871974,3479,8806,8380,3905,50380,676695,650100,2529,6860,3381,7430,11761,66.89544080129826,20.689741795433,4331,1,859100,61770,4475,0,950,1520
353,0,1,1,0,60,0,119,0,0,35428716,17684893,76.76587783644501,5141,12657,11905,5893,47674,726242,591197,2249,8894,3753,9013,15658,77.53708789992051,27.550337204400474,6645,1,1160921,138368,6012,0,2892,3011
354,0,1,1,0,60,0,134,0,0,35172272,17638912,76.57675887630658,5084,12642,11862,5864,46754,724928,583552,2228,8872,3788,9006,15650,77.44675590365293,28.066318314526384,6644,1,1137616,145860,5998,0,2856,2990
355,0,1,0,0,58,0,521,1,0,15673196,10905994,60.88513775955508,3316,8326,7935,3707,50140,676660,641356,2551,6649,3333,7170,11268,65.02307282803544,19.80085787566569,4098,1,808126,57868,4228,0,765,1286
356,0,1,0,0,58,0,508,1,0,14148384,10270236,59.295868321494375,3121,7935,7540,3516,46000,671830,584200,2526,6437,3316,6945,10856,63.43500610861482,19.876644695528267,3911,1,703200,66755,4024,0,595,1103
357,0,1,0,0,59,0,547,1,0,27978110,14993655,70.87312607751969,4662,10954,10593,5023,48410,701475,614910,2624,8008,3346,8555,13939,74.63243262818116,19.014562633801113,5384,1,1034738,61009,5570,0,2038,2585
358,0,1,0,0,59,0,527,1,0,22431360,13341440,66.93280212272605,3910,10057,9487,4480,42602,708764,533062,2408,7458,3548,7985,13035,70.76015828133795,23.907013067241863,5050,1,801920,112860,5007,0,1502,2029
359,0,1,1,0,57,0,360,0,0,8198761,7768521,51.85556864985669,2327,6100,5738,2689,43425,557577,650025,2527,5578,3251,5938,8989,55.21775076911409,19.18247611387753,3051,1,605025,34028,3049,0,200,160
360,0,1,0,0,56,0,171,1,0,4967820,6036030,46.314144707637645,1935,4671,4461,2145,52875,661290,633150,2604,4959,3024,5130,7485,48.12483766206386,14.492690977985127,2355,1,482625,30450,2316,0,669,498
361,0,1,0,0,58,0,343,1,0,9380144,8508448,53.81449618829484,2488,6543,6135,2896,55224,687492,693368,2530,5834,3346,6177,9481,56.91221310052878,20.53770543913746,3304,1,683456,52224,3239,0,42,301
362,0,1,1,0,56,0,247,0,0,6695438,6976676,49.66890375275057,2340,5308,5181,2467,53312,633472,673064,2701,5295,2955,5542,8136,52.09606511052442,11.308525934296243,2594,1,587146,14732,2714,0,361,114
363,0,1,1,0,62,0,1765,0,0,16605924,10340902,57.33236433289665,3047,8579,8339,3287,53058,698412,751894,2906,6433,3386,8198,11725,71.07742257566744,15.544382038814643,3527,1,785593,26880,5052,0,141,1906
364,0,1,0,0,59,0,393,1,0,20027308,12750491,65.4446330878247,3817,9425,8959,4283,53128,681733,690664,2511,7260,3443,7653,12402,68.38128398911503,21.59061094161688,4749,1,993656,60114,4676,0,1306,1699
365,0,1,0,0,60,0,54,1,0,30436560,16820496,74.45804187594514,4864,11714,11034,5544,51480,709956,667480,2354,8578,3714,8524,14748,74.09453421137081,26.106591245050847,6224,1,1219680,102680,5490,0,2510,2456
366,0,1,1,0,61,0,2060,0,0,17861600,10235560,57.619441163551734,3128,8892,8700,3320,45704,607351,715256,2891,6403,3275,8463,11975,73.348483283569,13.864011748252963,3512,1,770240,17280,5380,0,237,2297
367,0,1,1,0,60,0,1995,0,0,19061956,10596164,59.0,3271,9167,8957,3481,49476,694032,660548,2834,6525,3254,8520,12211,74.0,14.542450268973452,3691,0,755377,31080,5476,0,437,2432
368,0,1,1,0,59,0,1914,0,0,20725255,11018490,60.78651166171653,3453,9546,9304,3695,52896,679896,691824,2740,6677,3224,8591,12528,74.89325737341113,15.637067915878873,3937,0,857240,31218,5609,0,713,2627
369,0,1,1,0,58,0,179,0,0,10688160,9228081,56.4003546088143,2925,6797,6541,3181,55822,716547,655626,2645,6082,3157,6261,9698,57.96550698475775,16.14457404921792,3437,1,718906,38144,3360,0,280,459
370,0,1,1,0,59,0,356,0,0,24451020,14286150,69.06518659932803,4523,10143,9896,4770,51529,679865,679865,2748,7765,3242,8121,13138,71.596089278675,15.727106176144607,5017,1,1082790,33345,5126,0,1775,2131
371,0,1,1,0,50,0,208,0,0,233220,1511744,24.454038521274967,490,1096,988,598,54720,606720,576384,2420,3126,2636,2918,3624,19.748417658131498,10.39586690415236,706,0,136344,15660,390,1,1930,2138
372,0,1,1,0,63,0,2286,0,0,14878080,9181440,53.665631459994955,2820,8106,8046,2880,54285,736428,749180,3128,6068,3248,8354,11294,71.87489130426563,7.750803389552748,2940,1,676800,7680,5166,0,308,1978
373,0,1,1,0,58,0,134,0,0,32326107,16514241,74.95998932764064,5219,11772,11372,5619,41000,734750,481996,2539,8558,3339,8692,14711,75.8485332752058,20.052325544407463,6019,1,921516,86800,5753,0,2680,2814
374,0,1,1,0,60,0,280,0,0,32928000,17687040,76.68115805072325,5184,12176,11480,5880,52459,755008,628672,2312,8888,3704,8608,15184,74.83314773547883,26.550967952259793,6576,1,1228920,122496,5600,0,2872,2592
375,0,1,1,0,60,0,312,0,0,32454265,17687955,76.51797174520506,5040,12213,11398,5855,50592,749208,616284,2206,8876,3836,8564,15234,74.45132638173749,28.71463336433042,6670,1,1194420,147515,5543,0,2834,2522
376,0,1,0,0,58,0,260,1,0,17825276,12024078,63.984373092185564,3764,8778,8448,4094,51714,649077,687258,2607,7031,3267,7291,11715,65.98484674529449,18.175278077189866,4424,1,957996,38940,4354,0,1157,1417
377,0,1,1,0,56,0,34,0,0,7512792,7843752,52.51666402200353,2691,5549,5482,2758,44814,656964,551736,2777,5602,2911,5568,8393,52.191953402799555,8.361900766312248,2825,1,535052,11926,2724,0,86,120
378,0,1,1,0,55,0,441,0,0,3666636,5973588,46.34652090502587,1797,4206,3855,2148,50328,647973,600696,2430,4929,3132,4488,6987,41.31585652022719,18.75870963320733,2499,1,463968,54054,1707,0,633,1074
379,0,1,1,0,58,0,71,0,0,31926890,16536175,74.93330367733695,5194,11722,11301,5615,43824,733305,518320,2524,8560,3366,8631,14667,75.40557008603542,20.58191904559686,6036,1,988240,87989,5686,0,2670,2741
380,0,1,1,0,57,0,50,0,0,9833871,8888127,55.776339069537364,3026,6357,6272,3111,56406,677109,679966,2772,5968,2942,6018,9214,56.22277118748239,9.239893968762086,3196,1,740418,10795,3161,0,254,304
381,0,1,1,0,60,0,2176,0,0,20271680,10706424,59.531504264548865,3286,9522,9264,3544,50176,676704,676704,2763,6565,3279,8741,12543,75.63068160475615,16.071058428130073,3802,1,793856,34572,5720,0,523,2699
382,0,1,1,0,58,0,2055,0,0,24139624,11652648,63.182275995725256,3800,10231,10039,3992,53550,694722,656775,2727,6911,3111,8966,13150,77.76245880886226,13.857252111066721,4184,1,898200,28608,6047,0,1073,3128
383,0,1,0,0,56,0,381,1,0,4766382,6669600,48.80573736764972,2212,4553,4383,2382,54612,688800,621600,2630,5182,2970,4801,7353,44.73253849269008,13.09265514316057,2552,1,528804,26860,2001,0,418,799
384,0,1,1,0,55,0,697,0,0,1651440,4658640,40.98780306383839,1330,3013,2663,1680,56880,657201,665520,2423,4453,3123,3756,5786,31.352830813181765,19.226983277214995,2030,1,403200,41650,983,0,1093,1790
385,0,1,1,0,55,0,695,0,0,1423050,4386810,39.87480407475377,1290,2785,2485,1590,56628,645606,667678,2459,4349,3059,3654,5544,29.916550603303182,17.82818839664469,1890,1,384780,34500,895,0,1169,1864
386,0,1,1,0,54,0,691,0,0,1145130,3989580,38.34057902536163,1228,2491,2249,1470,54250,588938,678500,2472,4184,2956,3493,5205,27.910571473905726,16.101388170531447,1712,1,367500,20570,779,0,1244,1935
387,0,1,1,0,53,0,686,0,0,896400,3605850,36.742346141747674,1175,2189,2014,1350,50600,534200,675763,2496,4021,2846,3335,4860,25.768197453450252,13.543978856984436,1525,1,341550,10150,664,0,1321,2007
388,0,1,1,0,59,0,165,0,0,23472064,14169925,69.01449123191448,4643,9811,9691,4763,54990,696150,699125,2855,7738,3095,7903,12786,70.19971509913698,10.95616238207774,4883,1,1119305,15600,4928,0,1788,1953
389,0,1,1,0,55,0,709,0,0,1877970,4911750,42.07136793592526,1435,3166,2831,1770,56628,649350,671550,2440,4545,3110,3836,5941,32.57299494980466,18.70546096049085,2105,1,428340,37855,1061,0,1005,1714
390,0,1,1,0,54,0,708,0,0,1477440,4448520,40.24922359499622,1352,2800,2532,1620,56640,648056,659040,2478,4366,3014,3658,5546,30.199337741083,16.833044049570994,1888,1,388800,31892,912,0,1126,1834
391,0,1,1,0,54,0,707,0,0,1403970,4361370,39.87480407475377,1335,2728,2473,1590,56870,644605,663806,2488,4333,2998,3626,5471,29.715315916207253,16.434268214661433,1845,1,384780,29070,883,0,1153,1860
392,0,1,1,0,54,0,706,0,0,1191000,4075500,38.72983346207417,1299,2495,2294,1500,54120,597740,668382,2516,4217,2918,3511,5212,28.178005607210743,14.695835810225852,1701,1,369000,19698,794,0,1217,1923
393,0,1,1,0,55,0,713,0,0,1624560,4621680,40.98780306383839,1403,2924,2647,1680,56394,643734,662991,2474,4431,3028,3718,5675,31.096623610932426,16.95591470437829,1957,1,404880,32963,967,0,1071,1784
394,0,1,1,0,54,0,712,0,0,1470960,4437180,40.24922359499622,1378,2770,2528,1620,56144,635448,662838,2497,4359,2981,3647,5509,30.133038346638727,15.917144262962744,1862,1,392040,28072,908,0,1119,1831
395,0,1,1,0,54,0,712,0,0,1396020,4345470,39.87480407475377,1362,2696,2468,1590,56364,631323,666852,2505,4323,2961,3611,5429,29.631064780058107,15.533788019677399,1818,1,387960,25308,878,0,1143,1855
396,0,1,1,0,54,0,711,0,0,1183500,4074000,38.72983346207417,1325,2464,2289,1500,55125,611100,665420,2541,4216,2891,3505,5180,28.089143810376278,13.625648177645997,1675,1,367500,18375,789,0,1216,1927
397,0,1,1,0,52,0,705,0,0,594000,3133200,34.64101615137755,1170,1725,1695,1200,53460,574420,634473,2581,3811,2641,3106,4336,22.24859546128699,5.483301264452448,1230,1,291600,3090,495,0,1411,2116
398,0,1,1,0,61,0,2594,0,0,17301240,9403380,55.31726674375732,3060,8714,8714,3060,55209,709863,734447,3073,6133,3073,8727,11787,75.19308478842984,0.0,3060,1,731340,0,5654,0,13,2581
399,0,1,1,0,61,0,2504,0,0,18709505,9948060,57.01754116059373,3156,9101,9006,3251,56608,746640,709920,2965,6311,3155,8815,12161,75.8617163001207,9.815189597405173,3346,1,754232,12920,5755,0,191,2695
400,0,1,0,0,57,0,90,1,0,15910096,11433656,62.80127387243033,3782,8140,7978,3944,54756,678366,678366,2737,6843,3061,6933,11039,63.51377803280167,12.771467890036456,4106,1,922896,21384,4034,0,1045,1135
401,0,1,1,0,57,0,28,0,0,11696204,9824674,58.60034129593445,3404,6870,6840,3434,54054,660891,669474,2831,6295,2891,6267,9731,58.360945845659494,5.477225575051661,3464,0,803556,3870,3406,1,573,545
402,0,1,1,0,57,0,55,0,0,10985154,9534726,57.810033731178535,3342,6629,6629,3342,50076,667602,610542,2853,6195,2853,6140,9482,57.33236433289665,0.0,3342,0,715188,0,3287,1,489,434
403,0,1,0,0,55,0,569,1,0,4517940,6764765,49.28488612140643,2295,4423,4289,2429,53599,687895,604345,2651,5214,2919,4645,7208,43.12771730569565,11.627706147355314,2563,1,527093,22110,1860,0,356,925
404,0,1,1,0,54,0,715,0,0,1318200,4247880,39.496835316262995,1370,2595,2405,1560,55860,620844,667135,2533,4283,2913,3568,5318,29.068883707497267,14.217631303092665,1750,1,382200,20520,845,0,1163,1878
405,0,1,1,0,53,0,714,0,0,858600,3585600,36.742346141747674,1265,2071,1986,1350,52416,552448,669312,2571,4006,2741,3292,4727,25.219040425836983,9.587694277262452,1435,1,340200,6120,636,0,1306,2020
406,0,1,1,0,61,0,2610,0,0,17798031,9532104,55.776339069537364,3081,8862,8832,3111,54282,762936,667952,3034,6175,3094,8785,11926,75.63729238940273,5.501408174353464,3141,0,678198,4920,5721,0,47,2657
407,0,1,1,0,61,0,2554,0,0,18673307,9848450,56.824290580701486,3162,9079,9012,3229,56364,744200,704550,2983,6279,3117,8833,12129,76.04603868710059,8.20171446926608,3296,1,745899,9380,5783,0,179,2733
408,0,1,1,0,60,0,2434,0,0,20769000,10514000,59.16079783099616,3376,9558,9434,3500,56404,708944,717956,2880,6504,3128,8938,12562,77.03246069028303,11.137157851700797,3624,1,836500,15376,5934,0,496,2930
409,0,1,1,0,59,0,2342,0,0,22707408,11028672,61.1228271597445,3535,10015,9814,3736,49704,643536,673056,2751,6688,3153,9030,12967,77.9615289742319,14.199852474992882,3937,1,851808,24723,6078,0,784,3126
410,0,1,1,0,60,0,450,0,0,28305000,16838700,74.4983221287567,5188,11012,10650,5550,50112,655344,703888,2672,8584,3396,8134,14046,71.4142842854285,19.093059518737526,5912,1,1287600,41268,5100,0,2516,2066
411,0,1,1,0,54,0,720,0,0,1170000,4054500,38.72983346207417,1373,2407,2280,1500,55800,608175,670344,2576,4203,2830,3483,5110,27.92848008753788,11.66725943004119,1627,1,372000,12319,780,0,1203,1923
412,0,1,1,0,53,0,718,0,0,1039680,3866400,37.94733192202055,1345,2257,2162,1440,54718,585330,673935,2590,4125,2780,3407,4942,26.870057685088806,9.996498160997929,1535,1,361440,7695,722,0,1245,1963
413,0,1,1,0,53,0,717,0,0,914940,3672180,37.14835124201342,1313,2110,2043,1380,53130,558810,673233,2594,4041,2728,3324,4771,25.748786379167466,8.416522024785497,1447,1,349140,4690,663,0,1281,1998
414,0,1,1,0,61,0,2671,0,0,17616060,9381933,55.39855593785816,3069,8809,8809,3069,52884,715338,690882,3057,6126,3057,8797,11866,75.76278769950325,0.0,3069,0,693594,0,5740,0,12,2683
415,0,1,1,0,61,0,2643,0,0,18042790,9537350,55.91958512006326,3097,8927,8897,3127,56400,716750,732000,3020,6177,3080,8820,11977,75.96051605933177,5.490867587491313,3157,0,750480,3690,5770,0,77,2720
416,0,1,0,0,61,0,561,1,0,29292300,17442000,75.49834435270749,5205,11334,10839,5700,48488,709920,639540,2565,8760,3555,8199,14394,71.68681887209112,22.35589305271406,6195,1,1191300,79695,5139,0,2640,2079
417,0,1,1,0,58,0,66,0,0,22126527,13756095,68.3447144993671,4671,9408,9408,4671,46800,612560,662625,2945,7616,2945,7682,12353,68.82586723027906,0.0,4671,0,1050975,0,4737,1,1726,1792
418,0,1,1,0,54,0,733,0,0,1219410,4137120,39.11521443121589,1406,2451,2327,1530,55328,605696,667888,2580,4234,2828,3501,5155,28.231188426986208,11.41455123074134,1654,1,377910,12276,797,0,1174,1907
419,0,1,1,0,53,0,727,0,0,1026720,3853440,37.94733192202055,1373,2220,2153,1440,54467,580692,671676,2609,4116,2743,3389,4896,26.70205984563738,8.397588990243326,1507,1,361440,5293,713,0,1236,1963
420,0,1,1,0,52,0,719,0,0,736590,3381090,35.91656999213594,1290,1861,1861,1290,50932,560894,623798,2621,3911,2621,3192,4482,23.895606290697042,0.0,1290,1,307020,0,571,0,1331,2050
421,0,1,1,0,61,0,2722,0,0,17569328,9320760,55.190578906186516,3016,8844,8814,3046,47053,645660,682380,3030,6106,3090,8828,11904,75.9473501841901,5.490867587491313,3076,1,679258,3600,5768,0,14,2708
422,0,1,1,0,59,0,2496,0,0,21396177,10540425,59.52310475773252,3419,9706,9582,3543,56376,690200,722925,2851,6518,3099,9014,12681,77.71100308193171,11.144389776194219,3667,1,860949,14136,6039,0,568,3064
423,0,1,0,0,61,0,614,1,0,29412375,17601513,75.75618786607468,5221,11382,10864,5739,50127,708477,665539,2549,8806,3585,8192,14449,71.58910531638176,22.881118952278907,6257,1,1245363,78218,5125,0,2672,2058
424,0,1,1,0,54,0,747,0,0,1416754,4407499,40.26164427839479,1471,2645,2495,1621,55876,622651,663436,2569,4340,2869,3593,5364,29.563490998188964,12.514175867137965,1771,1,395524,16350,874,0,1098,1845
425,0,1,1,0,52,0,733,0,0,834918,3563938,36.75595189897821,1351,1969,1969,1351,51333,561894,635758,2638,3989,2638,3256,4607,24.859605789312106,0.0,1351,1,325591,0,618,0,1287,2020
426,0,1,1,0,54,0,754,0,0,1194207,4139100,39.153543900903784,1466,2379,2312,1533,54282,588600,672300,2633,4233,2767,3479,5079,27.910571473905726,8.47749576439433,1600,1,381717,6030,779,0,1167,1921
427,0,1,1,0,53,0,752,0,0,1062033,3937329,38.379682124790975,1431,2236,2194,1473,52208,555984,670923,2631,4146,2715,3394,4909,26.851443164195103,6.553889165207866,1515,1,369723,3024,721,0,1200,1952
428,0,1,1,0,53,0,749,0,0,938232,3750102,37.589892258425,1413,2077,2077,1413,50794,578572,618382,2654,4067,2654,3318,4731,25.768197453450252,0.0,1413,1,329229,0,664,0,1241,1990
429,0,1,1,0,53,0,761,0,0,988380,3849480,38.01315561749642,1445,2129,2129,1445,48150,570096,599400,2664,4109,2664,3348,4793,26.153393661244042,0.0,1445,1,325125,0,684,0,1219,1980
430,0,1,1,0,61,0,660,0,0,28065964,17195900,75.08661665037252,5278,10976,10616,5638,51975,686250,704550,2690,8688,3410,8028,14026,70.55494312945054,19.099808543375964,5998,1,1302378,45720,4978,0,2588,1928
431,0,1,0,0,57,0,254,1,0,9975792,9397104,57.3410847473258,3020,6590,6322,3288,54755,671630,665914,2590,6146,3126,5892,9448,55.08175741568164,16.37349694854184,3556,1,766104,35912,3034,0,430,176
432,0,1,0,0,57,0,272,1,0,9653604,9264084,56.97367813297646,2961,6505,6220,3246,55647,693522,653566,2569,6100,3139,5828,9359,54.53439281774392,16.883241876925904,3531,1,743334,41610,2974,0,392,120
433,0,1,1,0,60,0,2812,0,0,19072908,9695554,56.40921910468182,3087,9271,9176,3182,49486,664246,691669,2952,6229,3142,9041,12318,77.42092740338364,9.96633033441658,3277,1,722314,11685,5994,0,135,2947
434,0,1,0,0,57,0,217,1,0,11214078,9937707,58.81326381013045,3258,6902,6701,3459,48300,660790,603330,2672,6332,3074,6115,9775,56.938563381947034,14.188050253419588,3660,1,726390,31959,3242,0,586,369
435,0,1,1,0,53,0,781,0,0,1103030,4049480,38.87158345115362,1511,2241,2241,1511,45582,573520,570840,2680,4191,2680,3410,4921,27.018512172212592,0.0,1511,1,321843,0,730,0,1169,1950
436,0,1,1,0,53,0,781,0,0,1036700,3963156,38.48376280978771,1451,2211,2181,1481,43248,567312,545904,2646,4157,2706,3376,4887,26.457513110645905,5.483301264452448,1511,1,302124,4320,700,0,1195,1976
437,0,1,1,0,53,0,780,0,0,910861,3805438,37.69615364994153,1379,2104,2062,1421,42218,559702,540956,2636,4099,2720,3319,4782,25.317977802344327,6.5252844928085345,1463,1,287042,5964,641,0,1257,2037
438,0,1,0,0,56,0,443,1,0,7979660,8673145,55.27205442174191,2865,5857,5667,3055,54988,661487,670004,2649,5894,3029,5451,8696,51.10772935672255,13.834270577215369,3245,1,720980,24320,2612,0,216,227
439,0,1,0,0,55,0,580,1,0,6531084,7990704,53.49766350038102,2634,5372,5144,2862,52670,639368,642160,2564,5654,3020,5074,8164,47.77028364998475,15.100830606950982,3090,1,658260,30096,2282,0,70,510
440,0,1,1,0,62,0,3050,0,0,16990400,8905610,53.5723809439155,2669,8991,8790,2870,51027,679557,722999,2902,5973,3304,9023,12094,76.94153624668537,14.383547625038487,3071,1,668710,23316,5920,0,233,2817
441,0,1,1,0,59,0,497,0,0,24129890,15475165,71.88184749990779,4966,10038,9837,5167,43026,637935,604990,2794,8162,3196,7665,13033,68.33739825307956,14.19224997275075,5368,1,1043734,29346,4670,0,2172,1675
442,0,1,1,0,54,0,795,0,0,1609564,4666354,41.557189510360296,1727,2659,2659,1727,52156,637672,597142,2702,4429,2702,3634,5361,30.528675044947494,0.0,1727,0,381667,0,932,0,975,1770
443,0,1,1,0,59,0,442,0,0,23019968,15026784,70.8801805866774,4756,9874,9606,5024,47718,720831,592218,2723,8015,3259,7573,12865,67.6904720030818,16.428745738047,5292,1,994752,48776,4582,0,2033,1591
444,0,1,1,0,60,0,598,0,0,24146528,15686888,72.26340706055866,5042,10026,9846,5222,49932,684912,657876,2824,8226,3184,7628,13030,68.0,13.433868909381221,5402,1,1143618,26100,4624,0,2218,1620
445,0,1,1,0,58,0,2446,0,0,24780147,11392857,62.473994589749104,3753,10402,10252,3903,54054,683046,674289,2769,6822,3069,9268,13321,79.68061244744545,12.24744871391589,4053,0,901593,20400,6349,0,984,3430
446,0,1,1,0,58,0,401,0,0,28416690,16300575,74.39758060582346,5159,11045,10669,5535,45942,727415,547770,2569,8480,3321,8079,13990,71.65193647069142,19.459785326212117,5911,1,1029510,74824,5134,0,2590,2189
447,0,1,0,0,61,0,912,1,0,27733860,17536068,75.77598564189053,5352,10962,10572,5742,51385,729906,656610,2664,8796,3444,7884,14016,69.49820141557622,19.876007956237544,6132,1,1234530,62790,4830,0,2688,1776
448,0,1,1,0,59,0,392,0,0,21593385,14434366,69.62039930939781,4552,9597,9302,4847,52210,684940,676006,2683,7825,3273,7433,12575,66.74578638386096,17.297609256991084,5142,1,1100269,40415,4455,0,1869,1477
449,0,1,1,0,58,0,85,0,0,18509700,12665675,65.91661399070799,4345,8605,8605,4345,52206,658790,673365,2915,7260,2915,7175,11520,65.26867548832288,0.0,4345,0,1003695,0,4260,1,1430,1345
450,0,1,0,0,55,0,801,1,0,4550670,7085676,50.70502933634887,2421,4491,4341,2571,50358,636636,600808,2606,5327,2906,4526,7247,42.07136793592526,12.247993008684867,2721,1,560478,22350,1770,0,185,986
451,0,1,1,0,54,0,807,0,0,2505510,5534529,45.13313638558703,2037,3267,3267,2037,53760,652080,608608,2717,4754,2717,3947,5984,35.07135583350036,0.0,2037,0,456288,0,1230,0,680,1487
452,0,1,1,0,58,0,144,0,0,16985700,12280032,64.76109943476871,4044,8394,8244,4194,50955,693936,629520,2778,7122,3078,6978,11322,63.63961030678928,12.318810369945247,4344,1,901710,24000,4050,0,1266,1122
453,0,1,0,0,55,0,802,1,0,5656943,7792010,53.03772242470448,2555,5082,4824,2813,52640,650950,620480,2512,5583,3028,4781,7852,44.844174649557324,16.06533360284493,3071,1,630112,37926,2011,0,43,759
454,0,1,1,0,53,0,802,0,0,683760,3505920,36.3318042491699,1037,2121,1838,1320,45980,504640,642752,2373,3976,2939,3174,4777,22.759613353482084,16.850314261454166,1603,1,319440,18678,518,0,1336,2138
455,0,1,0,0,55,0,805,1,0,3709050,6517500,48.68264577855234,2220,4085,3935,2370,54044,649000,629750,2600,5120,2900,4315,6835,39.56008088970496,12.25845656828046,2520,1,542730,21000,1565,0,380,1185
456,0,1,1,0,58,0,258,0,0,15287103,11747187,63.56886030125127,3691,8174,7824,4041,49950,654075,645354,2557,6948,3257,6690,11081,61.506097258727124,18.71473604838165,4391,1,897102,48300,3783,0,1134,876
457,0,1,1,0,55,0,697,0,0,7794330,8793522,56.231663678038196,3120,5669,5627,3162,49648,595134,645192,2739,5943,2823,5246,8450,49.64876634922564,6.5135556243263055,3204,0,733584,4704,2465,0,381,316
458,0,1,0,0,54,0,800,1,0,2150400,5212800,43.81780460041329,1796,3164,3040,1920,53165,665175,589155,2591,4635,2839,3835,5879,33.46640106136302,11.135709774976435,2044,1,416640,20336,1120,0,795,1595
459,0,1,1,0,59,0,3082,0,0,22296408,10168368,58.532042506647585,3210,10150,9934,3426,44100,667800,581728,2752,6394,3184,9476,13118,80.67217612039482,14.738422084222227,3642,0,671496,36072,6508,0,458,3540
460,0,1,0,0,54,0,794,1,0,2950560,5916240,46.475800154489,2026,3660,3526,2160,55224,646404,640926,2605,4899,2873,4105,6399,36.959437225152655,11.683282254829438,2294,1,505440,17822,1366,0,579,1373
461,0,1,1,0,58,0,256,0,0,17247641,12514926,65.4446330878247,4065,8528,8310,4283,53325,692514,657450,2704,7205,3140,6949,11450,63.45864795282043,14.789924171248973,4501,1,963675,32046,4027,0,1361,1105
462,0,1,0,0,55,0,738,1,0,7765560,8878560,56.39148871948674,3072,5730,5622,3180,53360,647744,642160,2684,5972,2900,5234,8522,49.416596402423345,10.57476984710039,3288,1,731400,14580,2442,0,388,350
463,0,1,1,0,61,0,3535,0,0,17939454,8646608,53.1224999411737,2451,9550,9179,2822,52896,698592,710848,2693,5886,3435,9421,12614,79.73079706111058,19.279840619266558,3193,1,654704,47859,6357,0,242,3293
464,0,1,1,0,60,0,1275,0,0,27403396,17975351,76.8830280361017,5398,11060,10547,5911,48000,760250,583872,2528,8952,3554,7677,14101,68.08817812219681,22.703103041316766,6424,1,1134912,100035,4636,0,2870,1595
465,0,1,0,0,57,0,536,1,0,11706800,10685600,60.8276253029822,3230,7334,6864,3700,49056,646912,632472,2418,6588,3358,6052,10222,56.24944444170093,21.8055706739452,4170,1,810300,66270,3164,0,812,276
466,0,1,1,0,61,0,3632,0,0,17232105,8362200,52.10566188045211,2468,9309,9062,2715,52341,736120,674520,2833,5795,3327,9427,12389,79.66806135459805,15.813285326007605,2962,1,594585,38779,6347,0,365,3267
467,0,1,1,0,52,0,702,0,0,703080,3292380,35.4964786985977,1090,1988,1818,1260,53965,561795,655863,2443,3873,2783,3171,4601,23.62202362203543,13.36696240183447,1430,1,316260,12410,558,0,1353,2055
468,0,1,1,0,59,0,3329,0,0,21352272,9669566,56.9824534396335,3139,9931,9823,3247,53788,708764,673028,2870,6225,3086,9554,12909,81.09253973085318,10.429745618880121,3355,1,733822,15768,6576,0,269,3598
469,0,1,1,0,59,0,823,0,0,20229440,14547456,70.19971509913698,4928,9033,9033,4928,43800,646488,590400,2952,7880,2952,7057,11985,64.07027391856539,0.0,4928,0,985600,0,4105,0,1976,1153
470,0,1,0,0,55,0,681,1,0,7058422,8371687,54.945427471264615,2911,5465,5357,3019,51170,596195,659974,2665,5792,2881,5111,8238,48.35286961494633,10.518295179710192,3127,1,718522,11448,2338,0,246,435
471,0,1,1,0,61,0,3669,0,0,17955916,8507631,52.754146756439916,2393,9625,9235,2783,52896,696996,709224,2667,5840,3447,9509,12682,80.32434251209281,19.75672207486669,3173,1,645656,50310,6452,0,274,3395
472,0,1,1,0,61,0,1262,0,0,24521903,17228872,74.98666548127073,5395,10212,9984,5623,45269,621992,683272,2836,8687,3292,7425,13276,66.03786792439622,15.354562593986909,5851,1,1253929,25080,4361,0,2559,1297
473,0,1,0,0,54,0,730,1,0,4234875,6731610,49.54795656734998,2187,4448,4180,2455,55370,671790,619692,2474,5197,3010,4467,7190,41.53311931459037,16.400766131510736,2723,1,554830,40736,1725,0,287,1017
474,0,1,0,0,53,0,727,1,0,1601040,4497360,40.98780306383839,1595,2718,2633,1680,56364,653188,618387,2592,4357,2762,3630,5395,30.870698080866262,9.245276771705237,1765,1,388080,11900,953,0,997,1724
475,0,1,1,0,51,0,618,0,0,546120,2849370,33.31666249791537,1050,1662,1602,1110,56608,595544,626348,2507,3677,2627,3059,4229,22.181073012818835,7.789174875971784,1170,1,270840,6600,492,0,1457,2075
476,0,1,0,0,54,0,704,1,0,4340865,6751635,49.64876634922564,2237,4454,4226,2465,54731,654621,627231,2511,5204,2967,4500,7193,41.96427051671457,15.128632192459419,2693,1,564485,32604,1761,0,274,978
477,0,1,1,0,60,0,1179,0,0,26272930,17252749,75.82216034906945,5108,10960,10319,5749,44590,735245,546182,2360,8750,3642,7571,13961,67.60177512462228,25.473678847325978,6390,1,1046318,128841,4570,0,2748,1569
478,0,1,1,0,60,0,977,0,0,19666350,14919300,70.35623639735144,4855,9018,8923,4950,27060,494296,497310,2919,7964,3109,6987,12032,63.0317380372777,10.453462715764566,5045,1,816750,11685,3973,0,1936,959
479,0,1,1,0,51,0,332,0,0,389760,2098208,28.495613697550013,662,1442,1292,812,42048,565896,496128,2434,3396,2734,3064,4026,21.908902300206645,12.449381359612769,962,1,155904,24750,480,0,1772,2104
480,0,1,0,0,58,0,536,1,0,11318801,10571986,60.35726965329032,3085,7308,6750,3643,53590,676166,667460,2344,6545,3460,6009,10210,55.74047003748713,23.77084548034391,4201,1,837890,75888,3107,0,741,205
481,0,1,1,0,60,0,3901,0,0,18384360,8409720,52.53570214625479,2336,9845,9421,2760,55671,734327,703857,2623,5807,3471,9708,12892,81.61494961096282,20.795098519854925,3184,1,637560,60208,6661,0,287,3614
482,0,1,1,0,58,0,506,0,0,14673912,11903628,63.968742366877905,3880,7890,7678,4092,52890,715614,625435,2697,7001,3121,6495,10799,59.88321968631947,14.758605505875488,4304,1,879780,35616,3586,0,1183,677
483,0,1,1,0,58,0,507,0,0,14448028,11823330,63.74166612193315,3829,7853,7619,4063,53192,710040,634380,2676,6973,3144,6466,10763,59.632206063502295,15.475568323496374,4297,1,885734,37674,3556,0,1153,646
484,0,1,1,0,60,0,3720,0,0,19312384,8768032,53.96295025292817,2700,9756,9544,2912,54273,689519,713607,2799,5923,3223,9643,12767,81.43709228600933,14.664067678903075,3124,1,690144,25864,6632,0,99,3621
485,0,1,1,0,59,0,3570,0,0,19585759,8955026,54.653453687758834,2863,9668,9544,2987,51300,674550,683544,2874,5985,3122,9555,12666,80.97530487747484,11.230094695077256,3111,1,681036,16120,6557,0,11,3559
486,0,1,1,0,60,0,1367,0,0,25232658,17322283,75.8485332752058,5079,10813,10139,5753,46494,740706,569079,2337,8764,3685,7397,13824,66.2268827591938,26.135781189433978,6427,1,1087317,132104,4386,0,2742,1375
487,0,1,1,0,60,0,1403,0,0,21144350,16101824,73.16419889536138,5044,9612,9303,5353,45582,643712,640704,2699,8361,3317,6958,12620,62.849025449882674,17.637744162060443,5662,0,1140189,41715,3950,0,2345,942
488,0,1,1,0,60,0,1333,0,0,20399568,15716928,72.3325652801005,5040,9323,9131,5232,46428,657876,636848,2812,8236,3196,6903,12327,62.44197306299666,13.93476779920133,5424,1,1109184,27456,3899,0,2228,895
489,0,1,1,0,60,0,1540,0,0,22179084,16797802,74.444610281739,5029,10057,9544,5542,52440,697130,691068,2518,8573,3544,7033,13088,63.26136261573884,22.665172290143573,6055,1,1263576,69768,4002,0,2511,971
490,0,1,1,0,58,0,942,0,0,24548688,16011672,73.81056834898374,5069,10333,9954,5448,49473,702421,608373,2560,8387,3318,7445,13272,67.12674578735364,19.5192549123602,5827,1,1127736,64809,4506,0,2509,1567
491,0,1,1,0,58,0,1035,0,0,24617326,16237194,74.2024258363566,5069,10414,9977,5506,45012,713658,548514,2512,8455,3386,7420,13363,66.86553671361654,20.969944174732834,5943,1,1024116,85215,4471,0,2557,1522
492,0,1,1,0,60,0,1308,0,0,19152909,15379212,71.26710321038733,4837,9092,8850,5079,45080,696440,593488,2786,8107,3270,6799,12120,61.40846847137616,15.739623448814104,5321,1,995484,42108,3771,0,2051,743
493,0,1,0,0,58,0,485,0,0,24044384,14940800,71.77743377970545,5062,9909,9819,5152,51192,687300,626400,2810,8052,2990,7567,12809,68.31544481301428,9.486832980505138,5242,0,1112832,14310,4667,0,2252,1767
494,0,1,1,0,58,0,1724,0,0,21563685,11320452,62.13694553162394,3614,9693,9446,3861,53128,671428,680224,2685,6793,3179,8517,12625,74.73285756613352,15.73481264800746,4108,1,895752,31863,5585,0,929,2653
495,0,1,1,0,58,0,452,0,0,22797324,13247586,67.48333127521195,4230,9884,9560,4554,51980,669070,657434,2585,7463,3233,7915,12793,70.75309180523492,18.00107157783166,4878,0,1029204,44712,5006,0,1645,2097
496,0,1,1,0,58,0,403,0,0,22841270,13329038,67.6904720030818,4232,9917,9567,4582,50095,677797,625435,2559,7491,3259,7894,12826,70.60453243241541,18.709241365264994,4932,0,985130,54600,4985,0,1673,2076
497,0,1,0,0,58,0,155,0,0,23058000,13702500,68.7386354243376,4425,9905,9605,4725,53020,698900,638000,2600,7625,3200,7780,12805,69.85699678629192,17.320700522571084,5025,0,1039500,46800,4880,0,1825,1980
498,0,1,0,0,57,0,400,1,0,9964569,9641721,57.99137866959192,2926,6763,6326,3363,56169,679479,679479,2430,6230,3304,5830,9630,54.433445601027316,21.251466874363736,3800,1,797031,56373,2963,0,496,96
499,0,1,1,0,60,0,1853,0,0,21585504,17258208,75.25955088890711,5046,10093,9475,5664,45288,676434,621588,2429,8711,3665,6858,13140,61.73329733620261,24.9506379958994,6282,1,1155456,96408,3811,0,2617,764
500,0,1,1,0,52,0,269,0,0,2284716,4323284,40.64480286580315,1622,3065,3035,1652,43677,552187,541719,2587,4269,2647,4000,5682,37.1887079635741,5.477225575051661,1682,1,341964,4170,1383,0,965,1234
501,0,1,1,0,59,0,3246,0,0,18535072,8928044,54.57105459856901,2870,9310,9202,2978,47150,689540,614590,2890,5976,3106,9222,12308,78.89233169326408,10.448863694758844,3086,1,610490,17604,6224,0,20,3226
502,0,1,1,0,59,0,2048,0,0,20425380,10692820,60.08327554319921,3113,9765,9268,3610,48642,716804,595362,2465,6572,3459,8620,12727,75.21967827636595,22.343173174768676,4107,0,725610,88963,5658,0,648,2696
503,0,1,1,0,55,0,320,0,0,6849284,7675538,52.744667976962376,2662,5364,5244,2782,56386,667678,642847,2639,5541,2879,5221,8123,49.61854492022111,11.180339887498949,2902,1,648206,16680,2462,0,23,297
504,0,1,1,0,52,0,253,0,0,2688378,4686066,42.08325082500163,1711,3349,3289,1771,25740,412776,436590,2586,4417,2706,4164,5995,38.961519477556315,7.789174875971784,1831,1,292215,6720,1518,0,875,1128
505,0,1,1,0,60,0,1833,0,0,23440284,17689788,76.44605941446557,5144,10555,9855,5844,51054,768858,608427,2327,8871,3727,7038,13582,63.33245613427605,26.67259714245737,6544,1,1174644,129500,4011,0,2817,984
506,0,1,1,0,59,0,1197,0,0,15311520,13502391,67.50555532695068,4382,8092,7917,4557,55189,678527,714083,2788,7520,3138,6323,11055,57.96550698475775,13.228756555322953,4732,1,1098237,20300,3360,0,1594,397
507,0,1,1,0,58,0,1064,0,0,14485625,12770625,66.14378277661477,4200,7861,7686,4375,54900,656775,712236,2744,7294,3094,6230,10780,57.54128952326321,13.344821082527629,4550,1,1067500,18550,3311,0,1456,392
508,0,1,1,0,53,0,171,0,0,2987320,4885040,42.61455150532503,1696,3581,3461,1816,31785,524550,438470,2570,4506,2810,4335,6271,40.55859958134649,11.167976299283184,1936,1,296008,19800,1645,0,874,1045
509,0,1,1,0,53,0,58,0,0,1632443,3476620,36.15245496505044,1010,2853,2556,1307,45954,590520,550620,2363,3967,2957,3909,5513,35.34119409414458,17.406895185529212,1604,1,270549,45144,1249,0,1353,1411
510,0,1,1,0,59,0,1516,0,0,22773660,16518450,74.76630257007497,5139,10115,9664,5590,45540,747615,531900,2504,8545,3406,7029,13070,63.82789358893179,21.315282813450878,6041,1,1006200,92455,4074,0,2635,1119
511,0,1,1,0,59,0,1221,0,0,14895846,13341654,67.21606950722423,4384,7949,7815,4518,55189,676237,711673,2819,7471,3087,6250,10902,57.41950887982237,11.577287155571419,4652,1,1088838,15410,3297,0,1565,344
512,0,1,1,0,57,0,979,0,0,13916796,12275524,65.20736154760442,4157,7620,7525,4252,55596,652462,710202,2792,7139,2982,6160,10507,57.21013896155121,9.792106423183164,4347,1,1045992,9690,3273,0,1365,386
513,0,1,1,0,60,0,3281,0,0,17816072,8704432,53.74011537017761,2738,9207,9057,2888,46056,687192,608828,2864,5902,3164,9183,12221,78.54298186343577,12.318810369945247,3038,1,583376,24750,6169,0,126,3155
514,0,1,1,0,59,0,2640,0,0,18769441,9610955,56.64803615307419,2725,9542,9058,3209,49680,646920,688850,2511,6204,3479,8844,12537,76.47875521999558,22.0067821749308,3693,1,738070,57112,5849,0,214,2854
515,0,1,1,0,59,0,1495,0,0,15686174,14166770,69.12307863514182,4778,8061,8061,4778,54731,708635,678985,2965,7743,2965,6248,11026,57.29746940310715,0.0,4778,1,1094162,0,3283,0,1813,318
516,0,1,1,0,59,0,2254,0,0,19106067,10100034,58.19793810780585,2950,9465,9028,3387,49060,656040,664986,2545,6369,3419,8623,12447,75.1065909225016,20.905885785523935,3824,0,755301,57247,5641,0,405,2659
517,0,1,1,0,54,0,23,0,0,3074630,4834335,42.01190307520001,1495,3777,3507,1765,44969,638187,528627,2469,4504,3009,4481,6516,41.737273509418415,16.78101775240627,2035,1,340645,48600,1742,0,974,997
518,0,1,1,0,59,0,2194,0,0,19073600,10160098,58.360945845659494,3006,9406,9006,3406,48990,686090,635379,2583,6389,3383,8583,12389,74.83314773547883,20.00112490509058,3806,0,725478,61600,5600,0,423,2617
519,0,1,1,0,58,0,1412,0,0,21931260,15868872,73.76991256603196,5107,9807,9472,5442,51546,705672,621108,2581,8358,3251,6946,12723,63.48228099241551,18.313434191905955,5777,0,1159146,55610,4030,1,2526,1114
520,0,1,1,0,60,0,2309,0,0,21186900,17977300,76.81145747868608,4968,10423,9491,5900,53312,725186,682528,2115,8947,3979,6638,13470,59.924953066314536,30.70187993867437,6832,1,1321600,138868,3591,0,2853,544
521,0,1,1,0,55,0,156,0,0,8934016,8440068,55.389529696504916,3068,5980,5980,3068,51146,657489,588714,2751,5819,2751,5663,8731,53.96295025292817,0.0,3068,0,656552,0,2912,1,317,161
522,0,1,0,0,53,0,343,1,0,1266770,2601230,31.096623610932426,453,2791,2277,967,47268,629460,543380,2176,3657,3204,4000,5481,36.193922141707716,22.800978105779286,1481,1,195334,87894,1310,0,1723,1380
523,0,1,1,0,51,0,675,0,0,688014,1450242,23.62202362203543,528,1821,1791,558,52640,582176,610765,2569,3157,2629,3832,4420,35.11409973215888,5.478746393072713,588,0,131130,3600,1233,0,2041,1366
524,0,1,1,0,58,0,1545,0,0,21658050,16025310,74.09453421137081,5082,9843,9435,5490,49288,712236,589638,2511,8409,3327,6864,12762,62.80923498976882,20.209952062491055,5898,1,1108980,73848,3945,0,2571,1026
525,0,1,1,0,59,0,2041,0,0,21611420,17195500,76.02631123499285,5164,10135,9519,5780,47864,737800,574175,2359,8755,3591,6714,13110,61.14736298484179,24.876073575881914,6396,1,1115540,118888,3739,0,2805,764
526,0,1,0,0,52,0,717,1,0,739170,1499541,23.93741840717165,446,1990,1863,573,52192,586208,609761,2490,3190,2744,3907,4607,35.91656999213594,11.313881128525134,700,1,133509,15494,1290,0,2044,1327
527,0,1,1,0,51,0,910,0,0,537744,1050192,20.199009876724155,408,1726,1726,408,53128,589446,597168,2574,2982,2574,3892,4300,36.30426972134269,0.0,408,0,94656,0,1318,0,2166,1256
528,0,1,1,0,58,0,1036,0,0,19963680,11697220,63.08724118235002,3920,9056,8996,3980,46004,637763,623068,2879,6919,2999,7955,11995,70.8237248385031,7.772191019407321,4040,0,843760,8460,5016,0,1041,2077
529,0,1,1,0,58,0,1379,0,0,13270146,12817255,66.30987860040162,4337,7475,7415,4397,48614,635470,650045,2855,7312,2975,5933,10390,54.93632677928149,7.745966692414834,4457,1,980531,7740,3018,0,1482,103
530,0,1,1,0,55,0,156,0,0,10138141,9022195,57.12267500739089,3263,6370,6370,3263,50609,633185,611065,2765,6028,2765,5872,9135,55.74047003748713,0.0,3263,0,721123,0,3107,1,498,342
531,0,1,1,0,55,0,71,0,0,7410746,7678272,52.51666402200353,2588,5615,5445,2758,42098,604128,540096,2614,5542,2954,5471,8399,51.836280730777744,13.19014343722849,2928,1,535052,27370,2687,0,26,97
532,0,1,1,0,57,0,1005,0,0,11812696,11331600,63.05553108173778,3934,6989,6947,3976,52710,598500,715350,2808,6826,2892,5821,9839,54.506880299646575,6.653712290320142,4018,1,997976,3192,2971,0,1126,121
533,0,1,1,0,58,0,1617,0,0,21075910,15966930,73.95944834840239,5120,9673,9323,5470,51168,718074,607152,2569,8389,3269,6772,12592,62.07253821135398,18.718053408889613,5820,0,1137760,61600,3853,1,2551,934
534,0,1,1,0,59,0,2445,0,0,20684884,17766340,77.01947805587882,5294,10057,9419,5932,49392,754740,587020,2357,8927,3633,6482,13052,59.0508255657785,25.380657408646268,6570,1,1162672,121858,3487,0,2937,492
535,0,1,1,0,56,0,52,0,0,6691893,7214337,50.60632371551998,2171,5564,5174,2561,44712,583119,608472,2427,5378,3207,5430,8381,51.11751167652823,19.923815801984052,2951,1,553176,48360,2613,0,256,204
536,0,1,1,0,58,0,271,0,0,19886622,12683832,65.7723346096214,3841,9408,8923,4326,50778,686088,636244,2447,7258,3417,7529,12340,67.80117993073571,22.026670096080508,4811,0,938742,74690,4597,1,1394,1665
537,0,1,1,0,56,0,56,0,0,7160192,7483248,51.45872132107443,2282,5718,5352,2648,47925,635850,601938,2460,5474,3192,5530,8544,52.0,19.318619430386573,3014,1,564024,54900,2704,0,178,122
538,0,1,1,0,55,0,129,0,0,5399140,6316700,47.53945729601885,1809,5100,4649,2260,49056,612105,626080,2344,5055,3246,5184,7895,48.877397639399746,21.468510698376857,2711,1,506240,58179,2389,0,535,406
539,0,1,0,0,55,0,237,1,0,3829518,5083920,42.91852746774987,1295,4468,3921,1842,51520,634800,618240,2213,4602,3307,4839,7228,45.59605246071199,23.47269330850089,2389,1,412608,77674,2079,0,918,681
540,0,1,0,0,54,0,567,1,0,1900684,3034800,33.52610922848042,691,3248,2815,1124,51744,604800,623700,2267,3824,3133,4391,5948,41.12177038990418,20.814892201020058,1557,1,259644,54558,1691,0,1576,1009
541,0,1,1,0,60,0,2587,0,0,20159114,17903966,77.23988606931007,5374,9937,9345,5966,50592,744248,612204,2409,8967,3593,6380,12938,58.12916651733448,24.476641939563866,6558,1,1217064,107152,3379,0,2965,378
542,0,1,0,0,53,0,762,1,0,1516360,2450692,30.133038346638727,518,2968,2578,908,53280,647760,599178,2309,3607,3089,4369,5667,40.8656334834051,19.748547495231456,1298,1,201576,60060,1670,0,1791,1029
543,0,1,0,0,54,0,530,1,0,2547699,3693690,36.78314831549904,1083,3506,3236,1353,52212,625170,622440,2460,4083,3000,4613,6236,43.393547907494266,16.442710218315725,1623,1,308484,36450,1883,0,1377,847
544,0,1,0,0,53,0,1027,1,0,991838,1611585,24.63736998950984,223,2625,2241,607,52200,597375,615960,2271,3262,3039,4289,5280,40.422765862815474,19.94577991187618,991,1,140824,48384,1634,0,2048,1021
545,0,1,0,0,52,0,1106,1,0,841232,1369592,22.759613353482084,199,2461,2142,518,46816,552596,592256,2325,3162,2963,4268,5105,40.29888335921977,18.228549103195462,837,1,116032,37004,1624,0,2126,1020
546,0,1,1,0,59,0,2669,0,0,19429740,17808120,77.07139547199077,5387,9764,9211,5940,47864,743504,578614,2445,8938,3551,6269,12762,57.19265687131522,23.666771207792117,6493,1,1146420,106729,3271,0,2942,273
547,0,1,0,0,57,0,121,1,0,8127392,7965514,52.82991576748916,2345,6149,5703,2791,48391,636442,619318,2408,5645,3300,5766,9003,53.96295025292817,21.374179681144003,3237,1,605647,62886,2912,0,63,58
548,0,1,0,0,56,0,235,1,0,5595986,6323059,47.44470465710583,1793,5195,4737,2251,50844,626407,640452,2351,5060,3267,5295,8004,49.85980344927164,21.433913980503586,2709,1,513228,58624,2486,0,558,323
549,0,1,0,0,52,0,1197,1,0,749554,1195382,21.307275752662516,196,2363,2105,454,51168,547664,647718,2375,3087,2891,4284,4996,40.63249930782009,16.453497044727893,712,1,111684,21672,1651,0,2179,982
550,0,1,1,0,51,0,1377,0,0,458158,716876,16.64331697709324,95,2113,1931,277,55920,621120,603004,2406,2865,2770,4242,4701,40.66939881532551,13.710242244549764,459,1,64541,25116,1654,0,2311,934
551,0,1,0,0,56,0,256,1,0,5638500,6324750,47.43416490252569,1817,5189,4756,2250,52416,629664,657774,2378,5061,3244,5317,8000,50.05996404313531,20.84860278854497,2683,1,526500,52393,2506,0,561,305
552,0,1,1,0,58,0,2187,0,0,19411318,16482158,75.05331438384317,5333,9379,9079,5633,52624,740278,608608,2626,8559,3226,6372,12305,58.70264048575669,17.339721092551002,5933,0,1171664,52800,3446,1,2707,520
553,0,1,0,0,56,0,246,1,0,6199920,6728430,48.68264577855234,1882,5474,4986,2370,50055,604707,667165,2351,5209,3327,5455,8313,51.146847410177685,22.191054280718735,2858,1,556950,52216,2616,0,469,223
554,0,1,1,0,53,0,919,0,0,1725132,2506148,30.528675044947494,722,2993,2783,932,55575,664183,605025,2479,3621,2899,4540,5682,43.02324952859791,14.491705337660376,1142,1,209700,32130,1851,0,1757,838
555,0,1,1,0,60,0,1070,0,0,18307119,11387655,61.45730225123781,3442,8959,8624,3777,46765,599985,708525,2680,6792,3350,7862,11974,69.62039930939781,18.322707519969132,4112,1,887595,29480,4847,0,762,1832
556,0,1,1,0,59,0,959,0,0,18393620,11488820,61.93545026880809,3474,8993,8631,3836,48741,631945,691845,2633,6831,3357,7790,11988,69.24593850905626,19.027204963945927,4198,1,886116,39458,4795,0,841,1800
557,0,1,1,0,58,0,2235,0,0,12990496,14369758,69.93568473962345,4606,7832,7547,4891,55176,710996,669864,2653,7829,3223,5594,10770,51.536394906900505,16.907035861815707,5176,1,1115148,41610,2656,0,1953,282
558,0,1,1,0,58,0,2061,0,0,12046090,13622779,68.19824044651006,4501,7391,7241,4651,54988,691244,682457,2779,7580,3079,5519,10320,50.89204259999789,12.286588609993126,4801,0,1083683,20250,2590,1,1722,339
559,0,1,1,0,57,0,296,0,0,6480596,6848102,49.01020301937138,1944,5558,5100,2402,54026,647177,678538,2393,5253,3309,5549,8409,51.94227565288221,21.554453062019462,2860,1,571676,54502,2698,0,449,153
560,0,1,1,0,58,0,2417,0,0,13925534,15131319,71.63099887618489,4752,8224,7845,5131,55418,675321,713658,2570,8080,3328,5663,11173,52.09606511052442,19.494432367042577,5510,0,1241702,42827,2714,1,2182,235
561,0,1,1,0,51,0,1171,0,0,198150,389400,12.24744871391589,185,1806,1471,150,45144,542564,560736,2261,2746,2931,3917,4402,36.345563690772494,18.478084298533762,485,1,32400,41875,1321,0,2446,1275
562,0,1,1,0,58,0,522,0,0,18776160,13525278,67.83804242458652,4296,8988,8682,4602,49506,652458,655397,2633,7541,3245,7019,11927,63.874877690685246,17.52434274723023,4908,1,1026246,41004,4080,0,1663,1141
563,0,1,0,0,56,0,534,1,0,4633272,5335110,43.61192497471305,1732,4508,4338,1902,44400,561000,622710,2635,4707,2975,5241,7313,49.35585071701227,13.152397064008891,2072,1,422244,18360,2436,0,903,369
564,0,1,1,0,61,0,2248,0,0,16621065,9544770,55.72252686302013,3063,8500,8458,3105,49725,679354,691650,3032,6179,3116,8427,11574,73.16419889536138,6.495386533491135,3147,1,698625,5460,5353,0,31,2279
565,0,1,1,0,58,0,1160,0,0,8651604,10490696,59.81638571495272,3295,6279,5996,3578,46284,595196,668496,2649,6510,3215,5350,9211,49.17316341257699,17.521461944146527,3861,1,815784,29432,2418,0,646,514
566,0,1,1,0,57,0,901,0,0,8314692,9662292,58.0430874437258,3274,5932,5837,3369,40128,550656,599412,2773,6237,2963,5336,8800,49.678969393496885,10.028378966423087,3464,0,704121,10640,2468,1,501,400
567,0,1,0,0,57,0,28,1,0,7436333,7850224,52.354560450833695,2290,5905,5454,2741,54990,673040,670176,2413,5605,3315,5577,8769,52.08646657242167,21.339610190034733,3192,1,641394,59983,2713,0,123,151
568,0,1,1,0,58,0,1946,0,0,10108896,12661908,65.55913361233506,4128,6820,6650,4298,42120,636336,574470,2776,7244,3116,5298,9766,48.49742261192856,13.174427865266022,4468,1,838110,26860,2352,0,1352,594
569,0,1,1,0,60,0,815,0,0,17934714,11621787,62.02418882984283,3283,9073,8509,3847,45369,643473,643473,2457,6868,3585,7683,12094,68.27884006044626,23.75691103736666,4411,1,819411,75576,4662,0,826,1641
570,0,1,1,0,60,0,633,0,0,17983584,11878848,62.73754856543249,3305,9136,8505,3936,46800,627744,679050,2387,6954,3649,7587,12154,67.59437846448475,25.127343706522623,4567,1,885600,71934,4569,0,918,1551
571,0,1,0,0,57,0,292,1,0,7393413,8213947,53.563046963368315,2479,5836,5446,2869,53900,701435,629860,2473,5732,3253,5440,8699,50.76416058598822,19.87202694854532,3259,1,631180,62790,2577,0,6,286
572,0,1,1,0,59,0,2844,0,0,14870016,16474296,74.3774159271482,5008,8744,8220,5532,54948,717698,678984,2454,8510,3502,5666,11722,51.84592558726288,22.968208989347925,6056,1,1261296,77028,2688,0,2554,290
573,0,1,1,0,58,0,1283,0,0,8111958,10487145,59.67411499134277,3237,6163,5839,3561,49450,633175,677350,2621,6506,3269,5223,9108,47.7283982551269,18.497667515404984,3885,1,819030,37584,2278,0,616,667
574,0,1,1,0,52,0,1408,0,0,854628,1199044,21.400934559032695,288,2494,2324,458,39592,528836,513128,2448,3076,2788,4484,5112,43.197222132910355,13.28071670500598,628,1,89768,23800,1866,0,2160,752
575,0,1,1,0,59,0,2829,0,0,13772002,15985648,73.38937252763509,5021,8308,7943,5386,54752,688576,700448,2603,8354,3333,5525,11276,50.566787519082126,19.197546481605983,5751,1,1271096,46355,2557,0,2418,411
576,0,1,0,0,54,0,800,1,0,4022025,4497430,40.55859958134649,1368,4367,4090,1645,52896,634288,623352,2457,4379,3011,5179,7101,49.44694126030446,16.657181906610685,1922,1,375060,38226,2445,0,1089,289
577,0,1,0,0,54,0,829,1,0,3834192,4329336,39.83716857408418,1310,4280,4003,1587,51920,600160,643808,2451,4315,3005,5144,7008,49.15282290977803,16.66285869514053,1864,1,374532,31578,2416,0,1141,312
578,0,1,1,0,55,0,675,0,0,5219884,5446664,44.40720662234904,1942,4649,4619,1972,53680,673928,607640,2732,4734,2792,5409,7411,51.44900387762624,5.490867587491313,2002,1,433840,4770,2647,0,790,115
579,0,1,1,0,58,0,1261,0,0,17347626,14151246,69.59166616772443,4723,8545,8425,4843,49887,704202,604854,2802,7765,3042,6504,11467,59.84981202978001,10.969823458961839,4963,0,1002501,20760,3582,1,1921,660
580,0,1,1,0,58,0,2748,0,0,12167125,14989898,71.57513534740957,5033,7588,7498,5123,49922,637868,670054,2836,8049,3016,5301,10514,48.73397172404482,9.510461639168101,5213,0,1173167,10890,2375,0,2197,551
581,0,1,1,0,59,0,3035,0,0,13950186,16436138,74.49161026585477,5031,8581,8063,5549,48279,684222,619058,2444,8511,3480,5476,11543,50.1398045468867,22.802433186525597,6067,1,1159741,82880,2514,0,2587,448
582,0,1,1,0,52,0,1179,0,0,2836930,3135680,34.56877203488721,1135,3629,3569,1195,52675,642880,564160,2564,3819,2684,4998,6253,48.72371086031933,7.994134176674909,1255,1,256925,8700,2374,0,1429,250
583,0,1,0,0,58,0,1288,1,0,7252625,9955721,58.42088667591412,3203,5748,5538,3413,53586,682578,667993,2707,6330,3127,5042,8665,46.09772228646444,14.580022114409926,3623,1,781577,29190,2125,0,496,792
584,0,1,0,0,52,0,917,1,0,725834,1345796,22.561028345356956,424,2020,1935,509,50290,621340,565816,2559,3153,2729,4070,4664,37.76241517699841,9.224644470006377,594,1,108926,13515,1426,0,2135,1218
585,0,1,0,0,52,0,901,1,0,638856,1235215,21.61018278497431,333,1969,1835,467,50830,608350,584545,2511,3112,2779,4013,4614,36.98648401781386,11.577287155571419,601,1,103207,19430,1368,0,2178,1277
586,0,1,1,0,60,0,45,0,0,17126676,12446784,64.15605972938177,3819,8574,8277,4116,42840,616896,635040,2727,7140,3321,7185,11598,64.50581369148055,17.266611568680844,4413,1,864360,37719,4161,0,1092,1137
587,0,1,0,0,53,0,1142,1,0,1142903,1699291,25.317977802344327,399,2666,2424,641,45760,551408,583220,2409,3292,2893,4434,5317,42.22558466143482,15.557411596845162,883,1,141020,28798,1783,0,2010,868
588,0,1,1,0,58,0,3202,0,0,14842383,16949528,75.9802605944465,5488,8629,8344,5773,51660,722256,616560,2651,8709,3221,5507,11565,50.70502933634887,16.928514335822324,6058,1,1212330,49590,2571,0,2837,365
589,0,1,1,0,56,0,532,0,0,6580485,8002985,53.33854141237835,2785,5218,5158,2845,55890,646990,683559,2753,5658,2873,5126,8031,48.093658625644196,7.822290851349969,2905,1,691335,6720,2313,0,32,500
590,0,1,1,0,52,0,1199,0,0,3275342,3420419,36.15245496505044,1277,3843,3813,1307,36668,539102,465826,2587,3924,2647,5123,6460,50.05996404313531,5.531194905403055,1337,1,232646,4950,2506,0,1310,111
591,0,1,1,0,59,0,2802,0,0,9754128,14240448,69.45502141674135,4612,7058,6846,4824,49440,708480,608112,2740,7776,3164,4974,10010,44.96665431183423,14.64762860497819,5036,1,993744,36676,2022,0,1872,930
592,0,1,1,0,59,0,2743,0,0,9432120,14053480,68.81133627535509,4452,7010,6727,4735,40527,703416,507528,2685,7703,3251,4960,9978,44.63182720884279,16.910190473258453,5018,1,809685,58298,1992,0,1767,976
593,0,1,0,0,59,0,2520,1,0,8518441,13281488,66.6258208204597,3981,6816,6358,4439,51906,736032,631312,2534,7431,3450,4911,9808,43.80639222761902,21.558371475074306,4897,1,936629,78776,1919,0,1447,1073
594,0,1,0,0,59,0,2282,1,0,7891143,12418848,64.59876159803684,3896,6341,6064,4173,54990,696384,699360,2699,7149,3253,4867,9317,43.485629810317796,16.72519101875932,4450,1,980655,35733,1891,0,1197,1085
595,0,1,1,0,55,0,471,0,0,6490462,7812024,52.85830114561004,2794,5117,5117,2794,55225,657060,657060,2796,5590,2796,5119,7913,48.19751030914356,0.0,2794,1,656590,0,2323,0,2,473
596,0,1,1,0,59,0,3232,0,0,13742480,16725300,75.2329714952161,5239,8509,8088,5660,45864,691470,579180,2534,8615,3376,5383,11464,49.27473997901968,20.587422171689823,6081,1,1109360,74517,2428,0,2705,527
597,0,1,0,0,58,0,1800,1,0,7069249,10813319,60.88513775955508,3677,5644,5614,3707,56069,720499,662159,2887,6624,2947,4824,8561,43.669211121796096,5.477225575051661,3737,1,841489,4470,1907,0,790,1010
598,0,1,1,0,56,0,642,0,0,6491583,8149869,53.749418601506754,2799,5226,5136,2889,47124,558558,671398,2731,5710,2911,5068,8047,47.40253157796533,9.601845894041878,2979,1,687582,7380,2247,0,68,574
599,0,1,1,0,55,0,221,0,0,6330632,7345426,51.273774973177076,2505,5161,5037,2629,55328,690118,625856,2670,5423,2918,5202,7955,49.07137658554119,11.284767849177381,2753,1,588896,18228,2408,0,165,386
600,0,1,1,0,53,0,868,0,0,945869,1679091,25.11971337416094,564,2197,2130,631,50610,641301,558810,2594,3292,2728,4160,4858,38.71692136521188,8.19263674150144,698,0,132510,11323,1499,1,2030,1162
601,0,1,1,0,55,0,536,0,0,6389940,7848330,53.009433122794285,2780,5114,5084,2810,54834,620046,689871,2763,5603,2823,5067,7907,47.686476070265456,5.483301264452448,2840,1,694070,2910,2274,0,17,519
602,0,1,1,0,59,0,2862,0,0,9161343,14222304,69.13031173081747,4460,7015,6696,4779,36300,654720,491040,2657,7755,3295,4893,9991,43.78355855797927,18.006383777357115,5098,1,788535,61886,1917,0,1803,1059
603,0,1,1,0,56,0,661,0,0,6370340,8072932,53.62835071116769,2791,5176,5091,2876,53714,600698,704557,2722,5683,2892,5022,7983,47.06378650300037,9.257905235465769,2961,1,721876,6885,2215,0,69,592
604,0,1,1,0,62,0,1200,0,0,16196761,10785121,58.89821729050889,3023,8584,8138,3469,52102,677762,743051,2663,6578,3555,7778,11693,68.33008122342603,21.125503620884963,3915,1,829091,48168,4669,0,360,1560
605,0,1,1,0,62,0,536,0,0,16265940,11733366,61.43289021363068,3412,8446,8084,3774,50176,696416,696416,2747,6883,3471,7419,11555,65.6505902486794,19.090005747156503,4136,1,845376,48508,4310,0,665,1201
606,0,1,1,0,55,0,648,0,0,6306048,7973952,53.44155686354955,2789,5131,5064,2856,53286,597488,695208,2725,5648,2859,5000,7923,46.98936049788292,8.2143728690235,2923,1,711144,5695,2208,0,64,584
607,0,1,1,0,55,0,555,0,0,6280956,7767225,52.905576265645195,2769,5073,5043,2799,55350,624375,682650,2745,5574,2805,5019,7848,47.37087712930804,5.490867587491313,2829,1,688554,3090,2244,0,24,531
608,0,1,1,0,62,0,696,0,0,16135920,11468292,60.69596362197407,3308,8440,8064,3684,44091,663069,644391,2737,6797,3489,7493,11553,66.18156843109719,19.40883305679919,4060,1,762588,53016,4380,0,571,1267
609,0,1,1,0,58,0,1643,0,0,15393210,14098770,69.49820141557622,4363,8484,8017,4830,46056,665532,589638,2452,7749,3386,6106,11403,56.45352070508977,21.610405731380723,5297,0,975660,76588,3187,1,1911,268
610,0,1,1,0,55,0,492,0,0,6214509,7584507,52.44997616777342,2751,5010,5010,2751,55680,639624,661680,2757,5508,2757,5016,7767,47.52893855326458,0.0,2751,1,660240,0,2259,0,6,498
611,0,1,1,0,59,0,1229,0,0,15538500,13591008,67.85278181474949,4269,8314,7979,4604,45968,614016,652392,2617,7556,3287,6327,11266,58.09475019311125,18.30989196897652,4939,0,1017484,39865,3375,1,1652,423
612,0,1,1,0,55,0,573,0,0,6180424,7708796,52.81098370604357,2747,5047,5005,2789,52272,597024,668888,2722,5553,2806,4980,7811,47.07440918375928,6.5252844928085345,2831,1,674938,4200,2216,0,25,548
613,0,1,1,0,55,0,558,0,0,6132223,7628563,52.640288753007425,2711,5044,4984,2771,53568,594648,682744,2693,5524,2813,4966,7797,47.042533945356304,7.750803389552748,2831,1,687208,5280,2213,0,18,540
614,0,1,1,0,54,0,510,0,0,6120144,7524048,52.364109846344185,2712,5004,4974,2742,55056,609168,680512,2714,5486,2774,4976,7748,47.24404724407086,5.478746393072713,2772,1,680016,2820,2232,0,2,512
615,0,1,1,0,54,0,462,0,0,6111928,7425504,52.09606511052442,2714,4966,4966,2714,56364,632016,667584,2736,5450,2736,4988,7702,47.45524207081869,0.0,2714,1,662216,0,2252,0,22,484
616,0,1,0,0,59,0,2651,1,0,7138356,12725832,65.63535632568775,4007,6266,5965,4308,56144,714868,685328,2653,7262,3255,4611,9220,40.70626487409524,17.640705001746127,4609,1,999456,42441,1657,0,1354,1297
617,0,1,0,0,53,0,415,0,0,5623724,5784526,46.61544808322666,2143,4791,4761,2173,55800,598950,660176,2632,4835,2692,5250,7453,50.872389367907616,5.572104574801163,2203,0,538904,2790,2588,0,489,74
618,0,1,1,0,59,0,702,0,0,15455608,12842424,65.55913361233506,4070,8122,7894,4298,49374,630468,699192,2760,7286,3216,6584,11110,59.9666574022598,15.100322380264547,4526,0,1005732,24168,3596,0,1310,608
619,0,1,1,0,59,0,1126,0,0,15253947,13369185,67.14908785679818,4148,8253,7892,4509,49820,628580,696775,2604,7474,3326,6348,11218,58.16356247686347,19.001312008723854,4870,1,1059615,37905,3383,0,1544,418
620,0,1,0,0,53,0,332,0,0,5636844,5895882,47.05316142407437,2184,4790,4760,2214,54250,577871,665750,2633,4877,2693,5209,7453,50.457903246171455,5.652706486041966,2244,0,553500,2520,2546,0,449,117
621,0,1,0,0,52,0,918,1,0,331015,720200,16.64331697709324,30,1719,1472,277,50370,569400,598000,2353,2877,2847,3795,4319,34.56877203488721,15.785902032936304,524,1,63710,30134,1195,0,2323,1405
622,0,1,1,0,58,0,1445,0,0,14950416,13697952,68.23488843692792,4157,8366,7867,4656,49088,611936,694312,2443,7598,3441,6153,11308,56.66568626602876,22.33850975232201,5155,0,1098816,49401,3211,1,1714,269
623,0,1,1,0,54,0,512,0,0,6000833,7390242,52.14403129793476,2689,4956,4926,2719,50996,568062,663192,2688,5437,2748,4925,7674,46.97871858618538,5.483301264452448,2749,1,663436,2610,2207,0,1,511
624,0,1,1,0,53,0,317,0,0,5974928,7028560,51.068581339214816,2578,4929,4899,2608,56364,657580,622545,2665,5303,2725,4986,7624,47.86439177509728,5.478746393072713,2638,1,602448,4050,2291,0,87,404
625,0,1,0,0,53,0,863,1,0,1085064,1857624,26.38181191654584,354,2597,2255,696,51027,621877,584511,2327,3365,3011,4228,5266,39.48417404479927,18.5046549265235,1038,1,152424,51642,1559,0,1973,1110
626,0,1,1,0,55,0,690,0,0,5971999,7744189,53.03772242470448,2705,5044,4936,2813,52290,578130,685497,2645,5566,2861,4876,7797,46.07602413403309,10.518295179710192,2921,1,700437,8640,2123,0,60,630
627,0,1,1,0,54,0,545,0,0,5965050,7428330,52.24940191045253,2688,4957,4915,2730,52611,579573,672087,2679,5451,2763,4906,7678,46.74398357008097,6.63067838716079,2772,1,674310,3696,2185,0,9,536
628,0,1,1,0,53,0,299,0,0,5943456,6962112,50.91168824543142,2592,4885,4885,2592,55930,639268,631210,2686,5278,2686,4979,7571,47.885279575251516,0.0,2592,1,609120,0,2293,0,94,393
629,0,1,0,0,53,0,131,0,0,5840016,6644508,49.82971001320397,2483,4835,4835,2483,53580,628860,610128,2676,5159,2676,5028,7511,48.49742261192856,0.0,2483,0,566124,0,2352,0,193,324
630,0,1,0,0,52,0,933,1,0,405688,843030,17.97220075561143,51,1851,1579,323,54510,618570,600300,2338,2933,2882,3866,4461,35.4400902933387,16.501832763593544,595,1,74290,38352,1256,0,2287,1354
631,0,1,1,0,54,0,529,0,0,5930090,7344084,52.09606511052442,2654,4959,4899,2714,56350,622380,662970,2646,5420,2766,4891,7665,46.74398357008097,7.746504550744806,2774,1,664930,6360,2185,0,8,521
632,0,1,1,0,54,0,438,0,0,5446375,5756625,46.09772228646444,1998,4815,4688,2125,31824,563472,414477,2582,4834,2836,5272,7524,50.62608023538856,11.83366848156067,2252,1,325125,24257,2563,0,584,146
633,0,1,0,0,53,0,862,1,0,1540835,2362908,29.715315916207253,492,3019,2628,883,51726,623508,594072,2285,3559,3067,4421,5695,41.773197148410844,19.79231872240433,1274,1,196026,57477,1745,0,1793,931
634,0,1,1,0,64,0,2150,0,0,14708664,9308508,53.925875050851054,2577,8297,7966,2908,51525,720225,733029,2870,6109,3532,8259,11498,71.11961754677819,18.336226212282046,3239,1,665932,42699,5058,0,293,1857
635,0,1,0,0,53,0,417,0,0,5888188,7107072,51.419840528729765,2614,4901,4871,2644,54520,631680,623616,2658,5332,2718,4915,7589,47.19110085598767,5.490867587491313,2674,0,613408,4080,2227,0,44,461
636,0,1,0,0,53,0,376,0,0,5864697,7026645,51.15662224971465,2587,4888,4858,2617,50778,628290,582645,2655,5302,2715,4926,7573,47.3392015141785,5.501408174353464,2647,0,567889,4650,2241,0,68,444
637,0,1,0,0,53,0,415,0,0,5825450,7058920,51.28352561983234,2630,4845,4845,2630,47840,617320,558272,2684,5314,2684,4899,7529,47.06378650300037,0.0,2630,0,547040,0,2215,0,54,469
638,0,1,1,0,54,0,272,0,0,5471153,5989798,46.97871858618538,2080,4813,4686,2207,30906,548228,415242,2587,4921,2841,5193,7527,49.78955713801841,11.607617344985899,2334,1,337671,23368,2479,0,507,235
639,0,1,1,0,55,0,987,0,0,5076400,5014758,42.579337712087536,1728,4698,4613,1813,50160,630648,608520,2681,4579,2851,5566,7464,52.91502622129181,9.222414255489701,1898,1,398860,12240,2800,0,953,34
640,0,1,0,0,53,0,677,0,0,5836578,7486710,52.706735812417755,2778,4879,4879,2778,53799,611765,638715,2695,5473,2695,4796,7574,45.83666654546336,0.0,2778,0,658386,0,2101,0,83,594
641,0,1,0,0,53,0,628,0,0,5840373,7400190,52.44997616777342,2751,4874,4874,2751,49713,610630,589110,2690,5441,2690,4813,7564,46.07602413403309,0.0,2751,0,602469,0,2123,0,61,567
642,0,1,1,0,55,0,948,0,0,5092960,5072808,42.80186911806539,1765,4679,4612,1832,46398,614718,578721,2702,4601,2836,5549,7448,52.72570530585627,8.18535277187245,1899,1,382888,10050,2780,0,937,11
643,0,1,1,0,55,0,1519,0,0,5670660,9108905,57.087651904768336,3106,5152,4999,3259,54180,600925,704340,2642,6054,2948,4535,7947,41.71330722922842,12.438613279124889,3412,1,821268,11628,1740,0,464,1055
644,0,1,1,0,54,0,193,0,0,5445248,6134860,47.31807265728392,2064,4846,4671,2239,28324,531560,400040,2565,4979,2915,5172,7586,49.31531202375181,13.728829820844442,2414,1,326894,31675,2432,0,501,308
645,0,1,1,0,60,0,3440,0,0,8270801,15258639,71.21095421351971,4625,7148,6702,5071,50922,740214,622863,2563,8080,3455,4640,10157,40.38564101261734,21.165377707116726,5517,1,1049697,78942,1631,0,2062,1378
646,0,1,1,0,59,0,3173,0,0,6606438,13655148,67.87488489861327,4483,6165,6041,4607,49572,604656,720252,2840,7571,3088,4398,9129,37.86819245752297,11.316469623900245,4731,1,1119501,10292,1434,0,1643,1530
647,0,1,1,0,55,0,287,0,0,5378060,6066940,46.69047011971501,1925,4902,4647,2180,25944,523204,384054,2528,4963,3038,5250,7685,49.66890375275057,16.71294092540581,2435,1,300840,46155,2467,0,603,316
648,0,1,1,0,55,0,643,0,0,5225810,5525847,44.57577817604534,1797,4807,4617,1987,50172,617382,628506,2591,4768,2971,5411,7588,51.28352561983234,13.78643456762778,2177,1,449062,24700,2630,0,794,151
649,0,1,1,0,55,0,733,0,0,5185620,5383500,44.04543109109048,1806,4747,4613,1940,49283,618825,613275,2641,4715,2909,5448,7522,51.70106381884226,11.575836902790225,2074,1,428740,18358,2673,0,835,102
650,0,1,1,0,55,0,868,0,0,5124669,5203251,43.255057507764334,1811,4670,4610,1871,51040,645192,611820,2721,4652,2841,5520,7451,52.3354564325181,7.810249675906654,1931,1,411620,8940,2739,0,910,42
651,0,1,1,0,51,0,944,0,0,428465,868655,18.303005217723125,250,1699,1614,335,47475,583425,547123,2508,2928,2678,3872,4292,35.76310948449533,9.227509513928014,420,1,70685,12835,1279,0,2258,1314
652,0,1,1,0,62,0,831,0,0,14676822,10826262,58.63446085707619,3288,7857,7707,3438,55418,721121,762058,2999,6587,3299,7418,11006,65.33758489567853,12.393026621210916,3588,1,831996,17100,4269,0,289,1120
653,0,1,1,0,60,0,581,0,0,14573022,12538236,64.17943595888016,3777,7999,7657,4119,48279,703164,636196,2702,7163,3386,6582,11043,59.481089431852205,18.50903282713177,4461,1,860871,54720,3538,0,1075,494
654,0,1,1,0,58,0,2160,0,0,13533156,14343966,70.09992867328754,4686,7896,7668,4914,52200,677208,656775,2691,7833,3147,5673,10815,52.478567053607705,15.102282400517431,5142,0,1105650,32604,2754,1,1995,165
655,0,1,1,0,55,0,604,0,0,5231045,5585930,44.77722635447622,1823,4796,4614,2005,48816,601776,629636,2604,4791,2968,5395,7582,51.07837115648854,13.500908052461922,2187,1,453130,22386,2609,0,781,177
656,0,1,1,0,55,0,693,0,0,5195268,5446020,44.26059195266146,1835,4735,4611,1959,47276,619940,589360,2656,4739,2904,5432,7515,51.49757275833493,11.138424455647513,2083,0,415308,18352,2652,1,821,128
657,0,1,1,0,55,0,738,0,0,5176864,5382080,44.0,1841,4705,4610,1936,45472,622720,564340,2685,4716,2875,5454,7485,51.710733895391584,9.751111384664751,2031,0,393008,15200,2674,1,844,106
658,0,1,1,0,57,0,3013,0,0,5736528,12452992,65.84831053261732,4336,5659,5659,4336,51968,643328,666304,2872,7208,2872,4195,8531,36.373066958946424,0.0,4336,0,1005952,0,1323,1,1464,1549
659,0,1,1,0,55,0,475,0,0,5272766,5790516,45.50824101193101,1831,4857,4617,2071,51012,654264,609528,2556,4867,3036,5342,7653,50.457903246171455,15.518759343963225,2311,1,451478,36720,2546,0,725,250
660,0,1,1,0,55,0,564,0,0,5238112,5646960,44.98888751680797,1844,4792,4612,2024,49268,608220,630540,2610,4814,2970,5378,7582,50.872389367907616,13.436652244415649,2204,0,457424,22500,2588,1,766,202
661,0,1,1,0,55,0,1206,0,0,4771147,4604847,40.779897008207364,1568,4627,4532,1663,54026,628563,659022,2674,4432,2864,5638,7396,53.563046963368315,9.785443037298442,1758,1,395794,11305,2869,0,1106,100
662,0,1,0,0,54,0,887,1,0,2808330,3507510,35.91656999213594,929,3828,3467,1290,49952,609056,606337,2358,4009,3080,4896,6547,46.65833258915282,19.039568597447047,1651,1,287670,49096,2177,0,1429,542
663,0,1,1,0,55,0,696,0,0,5543296,7537464,52.230259428802384,2527,4961,4760,2728,33984,530496,489051,2562,5491,2964,4795,7724,45.077710678338576,14.545050792182467,2929,1,482856,29547,2032,0,35,731
664,0,1,1,0,60,0,1126,0,0,13956315,13070751,65.88626564011653,3682,8215,7556,4341,51513,671453,695541,2352,7352,3670,6226,11226,56.70097000933934,25.671719391055635,5000,1,1002771,81716,3215,0,1330,204
665,0,1,1,0,59,0,1623,0,0,13618530,13563450,67.74953874381728,4109,8038,7557,4590,49648,632370,685560,2474,7545,3436,5922,10993,54.47017532558529,21.973397504612233,5071,1,1064880,53872,2967,0,1635,12
666,0,1,1,0,62,0,1028,0,0,14145420,10335018,57.28874234961002,3215,7659,7592,3282,54747,746313,727419,3082,6431,3216,7459,10808,65.6505902486794,8.20759886765899,3349,1,758142,9246,4310,0,133,1161
667,0,1,1,0,56,0,2804,0,0,4961820,11327472,63.51377803280167,4034,5264,5264,4034,54285,648648,659880,2808,6842,2808,4038,8072,35.07135583350036,0.0,4034,0,947990,0,1230,1,1226,1578
668,0,1,1,0,56,0,319,0,0,5285280,6029595,46.314144707637645,1917,4837,4609,2145,43164,612798,556578,2583,4956,3039,5275,7648,49.63869458396343,15.187849124963682,2373,1,424710,36024,2464,0,666,347
669,0,1,0,1,64,0,2020,0,0,13473149,8964385,52.88667128870941,2227,8184,7614,2797,51296,733945,717920,2635,6002,3775,8022,11389,69.40461079784254,23.947254761271353,3367,1,626528,79800,4817,0,408,1612
670,0,1,1,0,57,0,3197,0,0,4944180,12542604,65.85590330410783,4187,5627,5477,4337,40626,529236,642024,2742,7229,3042,4032,8519,33.76388603226827,12.587015179069688,4487,1,962814,12750,1140,0,1445,1752
671,0,1,1,0,58,0,2987,0,0,11544690,15209010,72.14568594171102,4922,7706,7423,5205,42244,689592,523038,2639,8127,3205,5140,10628,47.095647357266465,16.82449396250488,5488,1,931695,55751,2218,0,2283,704
672,0,1,1,0,56,0,470,0,0,5331816,7228368,50.556898639058154,2132,5066,4642,2556,33756,548632,492072,2404,5384,3252,4914,7894,45.67274898667694,21.153370474621948,2980,1,444744,65296,2086,0,272,742
673,0,1,1,0,51,0,900,0,0,862524,1512036,24.124676163629637,552,2094,2064,582,47532,605334,529992,2568,3180,2628,4080,4692,38.49675310984031,5.477225575051661,612,0,118728,5040,1482,0,2016,1116
674,0,1,1,0,59,0,1685,0,0,13147200,13567180,67.56478372643548,4163,7847,7445,4565,44823,662756,597372,2570,7537,3374,5852,10819,53.665631459994955,20.05145731996862,4967,0,917565,64722,2880,1,1593,92
675,0,1,1,0,56,0,642,0,0,5307235,7501598,51.44900387762624,2217,5082,4652,2647,30644,532792,461942,2404,5481,3264,4839,7916,44.77722635447622,21.258132009039958,3077,1,431461,67510,2005,0,187,829
676,0,1,1,0,56,0,954,0,0,4364920,4681460,40.8166632639171,1366,4586,4286,1666,46398,587290,623820,2510,4476,3110,5430,7396,51.18593556827891,17.514300246387393,1966,1,369852,36000,2620,0,1144,190
677,0,1,1,0,53,0,940,0,0,2266029,2971188,33.27160951922825,1077,3184,3154,1107,56619,625372,652212,2654,3791,2714,4731,5868,45.24378410345447,5.478746393072713,1137,1,269001,3390,2047,0,1577,637
678,0,1,1,0,52,0,941,0,0,1113810,1789905,26.1725046566048,643,2353,2311,685,48399,572247,577473,2571,3298,2655,4239,4966,40.32369030731191,6.495386533491135,727,0,151385,5586,1626,0,1928,987
679,0,1,1,0,52,0,573,0,0,943074,1921722,26.94438717061496,403,2348,2025,726,52056,637927,571752,2324,3373,2970,3946,4995,36.0416425818802,17.9861379732897,1049,1,156816,52326,1299,0,1921,1348
680,0,1,1,0,53,0,602,0,0,893463,1842897,26.28687885618983,150,2525,1984,691,53118,605409,624078,2126,3358,3208,3960,5192,35.958309192730404,23.2627635868131,1232,1,161694,67084,1293,0,1976,1374
681,0,1,1,0,58,0,3122,0,0,11039520,15392544,72.3325652801005,4853,7721,7342,5232,46728,694312,582516,2563,8174,3321,5052,10663,45.93473631142341,19.473646027503875,5611,1,1035936,67083,2110,0,2290,832
682,0,1,1,0,59,0,3603,0,0,5354154,14064714,68.8040696470783,4649,5950,5865,4734,40579,644707,555577,2886,7705,3056,4102,8921,33.63034344160047,9.321211371972165,4819,1,885258,14280,1131,0,1763,1840
683,0,1,1,0,56,0,1007,0,0,4860870,4961076,41.92851058647326,1524,4757,4523,1758,48585,668814,578510,2588,4580,3056,5587,7579,52.583267300539625,15.592613477934277,1992,1,360390,40014,2765,0,1064,57
684,0,1,1,0,53,0,951,0,0,2085820,2780745,32.32645975048923,1015,3071,3041,1045,49464,574776,609369,2631,3706,2691,4657,5732,44.67661580737735,5.531194905403055,1075,1,239305,3570,1996,0,1616,665
685,0,1,1,0,53,0,558,0,0,1069200,2128104,28.142494558940577,355,2579,2142,792,44748,607262,532026,2250,3479,3124,4037,5266,36.742346141747674,20.936108971794695,1229,1,156816,72979,1350,0,1895,1337
686,0,1,1,0,62,0,216,0,0,13656145,11806915,61.68468205316454,3281,7918,7394,3805,52664,704381,719896,2579,6908,3627,6692,11021,59.90826320300064,22.891567321152593,4329,1,882760,67072,3589,0,702,486
687,0,1,1,0,60,0,1121,0,0,13313012,12900568,65.20736154760442,3721,7914,7383,4252,41664,564324,679616,2503,7286,3565,6165,10948,55.95533933415113,23.04866590333947,4783,1,952448,45666,3131,0,1218,97
688,0,1,1,0,53,0,950,0,0,2286600,2977020,33.31666249791537,1050,3230,3170,1110,40546,520308,560538,2622,3792,2742,4742,5912,45.387222871640866,7.765259411425052,1170,1,231990,6900,2060,0,1572,622
689,0,1,1,0,57,0,848,0,0,5193348,7885992,52.364109846344185,2210,5168,4636,2742,34371,578076,491796,2344,5618,3408,4770,8044,43.520110293977886,23.705432002923285,3274,1,468882,87780,1894,0,134,982
690,0,1,1,0,56,0,912,0,0,4518340,4813836,41.44876355212541,1285,4781,4348,1718,47880,638856,588420,2369,4520,3235,5432,7583,51.28352561983234,20.877674111501793,2151,1,360780,67548,2630,0,1084,172
691,0,1,1,0,59,0,3508,0,0,4138080,13133520,66.63332499583073,4089,5723,5372,4440,37136,520608,624138,2607,7398,3309,3890,8681,30.528675044947494,19.38320571339086,4791,1,936840,30537,932,0,1482,2026
692,0,1,1,0,57,0,1231,0,0,5089742,8537060,54.35071296680477,2524,5107,4677,2954,42640,592450,601120,2460,5844,3320,4613,7997,41.50903516103452,21.608572411569206,3384,1,614432,56330,1723,0,64,1167
693,0,1,1,0,54,0,948,0,0,2719980,3362094,35.24202037341219,1200,3474,3432,1242,39585,549521,527865,2665,3949,2749,4897,6181,46.79743582719036,6.5135556243263055,1284,0,242190,6006,2190,1,1465,517
694,0,1,1,0,54,0,951,0,0,2488156,3171432,34.23448553724738,1064,3403,3295,1172,37248,524964,519552,2598,3878,2814,4829,6109,46.07602413403309,10.435690064413366,1280,1,225024,14472,2123,0,1534,583
695,0,1,1,0,54,0,952,0,0,2414049,3104598,33.896902513356586,1029,3370,3250,1149,38540,507976,553910,2582,3851,2822,4803,6072,45.83666654546336,11.037374824906587,1269,1,235545,13320,2101,0,1553,601
696,0,1,1,0,53,0,954,0,0,2202952,2906252,32.89376840679705,987,3213,3118,1082,37720,494224,550630,2591,3768,2781,4722,5899,45.12205669071391,10.079301689331968,1177,1,221810,10070,2036,0,1604,650
697,0,1,1,0,54,0,946,0,0,3034296,3632364,36.49657518178932,1332,3610,3610,1332,45652,550854,616302,2727,4059,2727,5005,6337,47.7283982551269,0.0,1332,0,301032,0,2278,1,1395,449
698,0,1,1,0,54,0,947,0,0,2949540,3557760,36.16628264005025,1278,3593,3563,1308,43617,546720,590240,2690,4028,2750,4975,6313,47.486840282335066,5.477225575051661,1338,0,283836,3420,2255,1,1412,465
699,0,1,1,0,54,0,947,0,0,3100950,3689550,36.742346141747674,1320,3677,3647,1350,46620,573930,606726,2703,4083,2763,5030,6410,47.92702786528704,5.478746393072713,1380,0,299700,3600,2297,1,1383,436
700,0,1,1,0,54,0,950,0,0,2932104,3546648,36.08323710533743,1235,3621,3554,1302,40683,580212,520284,2657,4026,2791,4976,6345,47.45524207081869,8.19263674150144,1369,1,248682,10720,2252,0,1422,472
701,0,1,0,0,52,0,872,1,0,1384929,2144961,28.61817604250837,777,2552,2510,819,49665,604989,563085,2577,3438,2661,4310,5171,41.12177038990418,6.488991180673202,861,1,176085,6384,1691,0,1800,928
702,0,1,1,0,63,0,1449,0,0,12991752,9431640,54.3323108288245,2586,7719,7353,2952,51935,706095,750825,2829,6147,3561,7596,10914,66.34003316248794,19.230640201778346,3318,0,693720,42456,4401,1,243,1206
703,0,1,1,0,62,0,91,0,0,13280310,11297261,59.99166608788257,3068,7820,7289,3599,53592,728248,725109,2608,6738,3670,6829,10959,60.74537019394976,23.046889375184353,4130,1,831369,71685,3690,0,460,551
704,0,1,1,0,58,0,787,0,0,5155878,7902442,51.94227565288221,2107,5200,4609,2698,45288,597516,650238,2338,5627,3520,4840,8129,43.71498598878879,24.383677031692105,3289,1,598956,66192,1911,0,231,1018
705,0,1,1,0,56,0,531,0,0,5596290,6025635,45.98912915026767,1995,4881,4761,2115,35266,652421,438746,2729,4964,2969,5495,7730,51.43928459844674,11.305412972083932,2235,1,325710,25560,2646,0,734,203
706,0,1,1,0,54,0,951,0,0,3157660,3727812,36.932370625238775,1304,3739,3679,1364,52664,634056,620391,2673,4097,2793,5048,6472,48.11444689487763,7.746504550744806,1424,0,309628,8340,2315,1,1369,418
707,0,1,1,0,56,0,2597,0,0,4182404,10429963,61.0,3539,5027,4845,3721,35700,588630,476510,2621,6524,2985,3927,7830,33.52610922848042,13.799296616940163,3903,1,632570,32214,1124,0,918,1679
708,0,1,1,0,58,0,1397,0,0,4892178,8845758,54.93632677928149,2439,5218,4639,3018,44472,638958,597924,2352,5949,3510,4552,8149,40.26164427839479,24.852149578685964,3597,1,615672,86850,1621,0,87,1310
709,0,1,1,0,57,0,114,0,0,5416335,6847335,48.83646178829912,2157,4884,4656,2385,51170,617265,683298,2643,5256,3099,5142,7755,47.65501022977542,15.257585007586592,2613,1,567630,23940,2271,0,486,600
710,0,1,1,0,54,0,951,0,0,3313942,3848222,37.49666651850535,1376,3793,3763,1406,53261,604877,659617,2707,4143,2767,5094,6530,48.54894437575342,5.514871952411144,1436,0,338846,3240,2357,1,1331,380
711,0,1,1,0,54,0,952,0,0,3229305,3775590,37.1887079635741,1323,3778,3718,1383,52360,649740,600600,2670,4113,2790,5065,6508,48.321837713398274,7.789174875971784,1443,0,304260,9300,2335,1,1347,395
712,0,1,1,0,53,0,822,0,0,1549800,2387700,30.0,710,2812,2622,900,42560,594272,504070,2463,3553,2843,4375,5465,41.49698784249286,13.957257278414755,1090,1,171000,32870,1722,0,1753,931
713,0,1,1,0,53,0,1022,0,0,1040760,1672650,25.099800796022265,111,3023,2282,630,44732,562860,560205,1914,3285,3396,4307,5678,40.64480286580315,27.2463784615081,1371,1,132930,100035,1652,0,2025,1003
714,0,1,1,0,53,0,819,0,0,1626570,2472870,30.495901363953813,729,2880,2679,930,42560,595616,505210,2458,3589,2860,4408,5539,41.82104733265297,14.336946952226079,1131,1,176700,34773,1749,0,1729,910
715,0,1,1,0,53,0,798,0,0,1607040,2478450,30.495901363953813,740,2848,2658,930,45732,591630,548990,2475,3595,2855,4393,5513,41.569219381653056,13.880774245913715,1120,1,191580,29260,1728,0,1735,937
716,0,1,1,0,57,0,3381,0,0,3305016,11980683,64.59876159803684,3955,5183,4965,4173,43326,499554,714879,2653,7044,3089,3663,8054,28.142494558940577,15.446888696741146,4391,1,1039077,6104,792,0,1302,2079
717,0,1,1,0,59,0,4030,0,0,7856079,16335396,73.93916418245476,5021,7350,6904,5467,52364,738036,633456,2542,8455,3434,4425,10338,37.907782842049734,21.254982472894696,5913,1,1159004,76266,1437,0,2479,1551
718,0,1,1,0,58,0,2246,0,0,4441415,10252120,59.253691868102194,3078,5209,4776,3511,26866,589840,388360,2487,6431,3353,4185,8129,35.566838487557476,21.708499537499392,3944,1,466963,87899,1265,0,591,1655
719,0,1,0,0,54,0,940,1,0,2377644,3103956,33.793490497431605,900,3466,3224,1142,47532,554472,633294,2476,3860,2960,4800,6184,45.628938186199335,15.945523188210656,1384,1,266086,23716,2082,0,1576,636
720,0,1,1,0,53,0,890,0,0,1382024,2177784,28.495613697550013,265,3061,2514,812,51300,603450,611496,2135,3494,3229,4384,5743,41.255302689472536,23.392426736574855,1359,1,185136,71657,1702,0,1870,980
721,0,1,1,0,53,0,1222,0,0,958395,1445466,23.302360395462088,73,2924,2308,543,47765,620246,545710,2046,3205,3278,4427,5586,42.01190307520001,24.863445236412133,1159,1,111315,103488,1765,0,2119,897
722,0,1,1,0,61,0,1196,0,0,12473120,12941280,64.65291950097846,3938,7406,7164,4180,46800,643968,696600,2854,7276,3338,6080,10502,54.62600113499065,15.60104761947802,4422,1,940500,27588,2984,0,1084,112
723,0,1,0,0,59,0,1901,1,0,4532442,9763950,57.28874234961002,2649,5296,4663,3282,47520,642600,654500,2342,6257,3608,4356,8271,37.16180835212409,26.053006774665743,3915,1,722040,81657,1381,0,307,1594
724,0,1,1,0,53,0,1409,0,0,777192,1124872,20.591260281974,87,2768,2257,424,53058,588966,634067,2142,3077,3164,4486,5421,42.81354925721529,22.645220383230445,935,1,101336,56721,1833,0,2229,820
725,0,1,1,0,57,0,2672,0,0,4023204,10773496,61.204574992397426,3451,5115,4820,3746,29820,603960,408392,2581,6622,3171,3950,7991,32.77193921634788,17.856401160648872,4041,1,531932,59885,1074,0,870,1802
726,0,1,0,0,59,0,1251,1,0,4919470,8699170,54.12947441089743,2399,5140,4609,2930,50589,685839,650211,2438,5899,3500,4648,8109,40.97560249709576,23.24112689119122,3461,1,641670,78588,1679,0,39,1290
727,0,1,1,0,53,0,1360,0,0,885521,1280422,21.93171219946131,50,2853,2322,481,54984,617584,630894,2131,3143,3193,4503,5515,42.906875905849866,23.098486186331723,1012,1,113997,66375,1841,0,2181,821
728,0,1,1,0,58,0,3181,0,0,9245502,14659218,70.8660708661063,4937,6948,6863,5022,53824,677208,677208,2834,7941,3004,4760,9867,42.906875905849866,9.222414255489701,5107,0,1165104,11305,1841,0,2103,1078
729,0,1,1,0,54,0,955,0,0,3706266,4123428,38.80721582386451,1476,3997,3967,1506,45872,668072,514744,2708,4244,2768,5199,6735,49.60846701924985,5.5503012171862105,1536,1,283128,5850,2461,0,1232,277
730,0,1,1,0,53,0,687,0,0,2003400,2975049,33.36165463522455,1083,2943,2913,1113,37332,489159,545292,2643,3786,2703,4473,5616,42.42640687119285,5.652706486041966,1143,0,227052,3180,1800,0,1560,873
731,0,1,1,0,53,0,609,0,0,2072592,3146232,34.161381705077446,1047,3063,2943,1167,45980,652432,512240,2576,3863,2816,4472,5759,42.14261501141095,11.111005581829925,1287,1,221730,23040,1776,0,1529,920
732,0,1,0,0,53,0,916,1,0,1543212,2333004,29.427877939124322,386,3128,2648,866,48108,568434,614232,2214,3560,3174,4476,5822,42.21374183841087,21.926212059334947,1346,1,197448,54240,1782,0,1828,912
733,0,1,1,0,60,0,1813,0,0,11361848,13296528,66.30987860040162,4330,7048,6981,4397,46487,613872,692496,2957,7421,3091,5608,10072,50.83306010855534,8.20171446926608,4464,1,1006913,6767,2584,0,1373,440
734,0,1,1,0,59,0,4161,0,0,3094420,14347730,69.31810730249349,4571,5683,5449,4805,56088,734556,680808,2752,7791,3220,3630,8669,25.37715508089904,15.317203031147645,5039,1,1095540,33228,644,0,1819,2342
735,0,1,1,0,57,0,941,0,0,5705420,5617040,44.31703961232068,1479,5354,4869,1964,48906,669240,597740,2375,4824,3345,5765,8214,53.898051912847464,22.27635138508953,2449,1,410476,79055,2905,0,896,45
736,0,1,0,0,53,0,1020,1,0,1456000,2152000,28.284271247461902,305,3115,2620,800,47515,578350,594490,2195,3490,3185,4510,5805,42.661458015403085,22.257670040704518,1295,1,176800,62865,1820,0,1890,870
737,0,1,1,0,59,0,4082,0,0,2532063,13826823,68.03675477269621,4239,5566,5176,4629,56350,731815,687010,2597,7616,3377,3534,8553,23.388031127053,19.808163771771813,5019,1,1064670,54210,547,0,1642,2440
738,0,1,1,0,55,0,951,0,0,4802706,4924629,42.035699113967404,1549,4703,4485,1767,52430,596418,682815,2569,4554,3005,5505,7490,52.1344415909483,14.84372281104937,1985,1,432915,20274,2718,0,1020,69
739,0,1,1,0,58,0,2692,0,0,3900384,10961424,61.1228271597445,3318,5198,4780,3736,31161,648414,413694,2516,6670,3352,3978,8132,32.31098884280702,21.251466874363736,4154,1,526776,90288,1044,0,802,1890
740,0,1,0,0,54,0,716,1,0,2133852,3107952,33.85262175962151,956,3198,3008,1146,47637,642744,545112,2522,3858,2902,4574,5910,43.15089802078283,13.973411963356208,1336,1,230346,33250,1862,0,1566,850
741,0,1,0,0,59,0,1404,1,0,4843296,8897448,54.881690936048976,2622,5010,4620,3012,56386,714868,688282,2564,5966,3344,4562,7964,40.099875311526844,19.832308993558435,3402,1,701796,53430,1608,0,58,1346
742,0,1,1,0,55,0,955,0,0,4409556,4609000,40.93897898091744,1646,4337,4307,1676,51302,621500,624250,2720,4426,2780,5381,7087,51.29327441292864,5.478746393072713,1706,0,380452,3990,2631,1,1074,119
743,0,1,1,0,60,0,1706,0,0,11119755,13073980,65.53624951124378,4187,6992,6884,4295,47174,627064,697076,2936,7339,3152,5633,10036,50.882216932834204,10.397868954212262,4403,1,983555,11340,2589,0,1251,455
744,0,1,0,0,54,0,1123,1,0,1571220,2207828,28.495613697550013,441,3118,2747,812,49268,592742,614494,2348,3531,3090,4654,5837,43.98863489584554,19.263598919857333,1183,1,183512,46375,1935,0,1907,784
745,0,1,0,0,55,0,935,1,0,3408564,3971868,37.907782842049734,1114,4132,3809,1437,51983,627428,632956,2441,4201,3087,5136,6896,48.703182647543684,18.016139117858067,1760,1,329073,42313,2372,0,1327,392
746,0,1,1,0,60,0,1834,0,0,10773575,13122050,65.76473218982953,4113,7028,6816,4325,46662,612868,700854,2822,7359,3246,5525,10062,49.90991885387112,14.566775612304511,4537,1,999075,20776,2491,0,1291,543
747,0,1,0,0,55,0,917,1,0,3236370,3848694,37.389838191679836,1223,3888,3713,1398,49644,693756,542341,2578,4151,2928,5068,6641,48.11444689487763,13.398254763593743,1573,1,275406,33250,2315,0,1355,438
748,0,1,1,0,62,0,985,0,0,11691014,12271223,62.82515419798029,3917,6939,6909,3947,48825,699525,674653,3079,7056,3139,6071,10048,54.42425929675111,5.490867587491313,3977,1,856499,4320,2962,0,838,147
749,0,1,1,0,58,0,2675,0,0,9430244,13761032,68.46166810705097,4387,6999,6699,4687,53482,648856,710512,2636,7623,3236,4948,9935,44.85532298401161,17.339721092551002,4987,1,1134254,32100,2012,0,1751,924
750,0,1,1,0,57,0,104,0,0,6019412,7204750,50.05996404313531,2229,5185,4908,2506,40664,635375,529000,2598,5381,3152,5277,8060,49.01020301937138,16.742690253690217,2783,1,461104,48752,2402,0,369,473
751,0,1,1,0,57,0,3347,0,0,3014730,11756630,63.914004725099176,3951,4957,4823,4085,39524,693598,471992,2744,6963,3012,3616,7835,27.16615541441225,12.133882760385626,4219,1,669940,28810,738,0,1207,2140
752,0,1,1,0,57,0,819,0,0,6059830,5957616,45.67274898667694,1715,5362,4991,2086,49163,602616,665448,2485,4942,3227,5761,8218,53.898051912847464,19.306541339402077,2457,1,486038,40068,2905,0,770,49
753,0,1,1,0,59,0,2577,0,0,3678178,10710624,59.99166608788257,3090,5130,4621,3599,53105,735072,639840,2467,6575,3485,3998,8106,31.96873472629156,22.60498446549998,4108,1,773785,85512,1022,0,623,1954
754,0,1,0,0,54,0,802,1,0,3011160,3790860,37.14835124201342,1230,3712,3562,1380,48792,626316,587858,2597,4127,2897,4929,6459,46.71188285650665,12.312788037888811,1530,1,295320,22800,2182,0,1367,565
755,0,1,0,0,54,0,1147,1,0,1207458,1800198,25.80697580112788,347,2798,2479,666,49729,602769,602769,2384,3369,3022,4516,5501,42.579337712087536,17.860614978053484,985,1,148518,42746,1813,0,2037,890
756,0,1,1,0,61,0,1509,0,0,10844992,12700709,64.28841264178172,3917,6973,6757,4133,51832,642257,762104,2857,7206,3289,5697,10046,51.22499389946279,14.708265585304046,4349,1,1024984,17280,2624,0,1060,449
757,0,1,1,0,58,0,4518,0,0,1662120,14249520,69.7137002317335,4736,5326,5202,4860,53110,662632,689020,2808,7792,3056,3274,8258,18.49324200890693,11.181591875252034,4984,1,1142100,15252,342,0,1928,2590
758,0,1,1,0,57,0,290,0,0,6030575,7525845,51.03920062069938,2328,5197,4920,2605,31616,600912,439128,2612,5494,3166,5204,8086,48.11444689487763,16.742690253690217,2882,1,395960,52907,2315,0,284,574
759,0,1,1,0,62,0,656,0,0,11636745,11813230,61.27805479941412,3563,7046,6854,3755,52425,707850,733018,2954,6901,3338,6245,10192,55.66866263886712,13.957625053734988,3947,1,874915,23808,3099,0,609,47
760,0,1,0,0,53,0,1224,1,0,522265,888085,18.303005217723125,208,2021,1894,335,50609,585871,607079,2524,2986,2778,4210,4672,39.48417404479927,11.270999429035628,462,1,76715,15875,1559,0,2316,1092
761,0,1,1,0,58,0,2501,0,0,9336152,13391984,67.468511173732,4229,6926,6603,4552,56105,720790,673718,2619,7494,3265,4993,9868,45.28796749689701,18.058782072977426,4875,1,1042408,47481,2051,0,1610,891
762,0,1,0,0,50,0,1161,1,0,326430,592956,15.297058540778355,13,1876,1629,234,52377,600558,560014,2287,2768,2781,3929,4410,37.3496987939662,15.727106176144607,481,0,51714,37297,1395,1,2300,1139
763,0,1,0,0,55,0,930,1,0,4432111,4690834,41.12177038990418,1385,4618,4312,1691,48351,629698,590862,2468,4465,3080,5395,7392,51.19570294468082,17.563464425912073,1997,1,360183,46206,2621,0,1083,153
764,0,1,1,0,54,0,889,0,0,3844530,4278312,39.57271787481876,1566,4021,4021,1566,48840,601040,606504,2732,4298,2732,5187,6753,49.54795656734998,0.0,1566,0,347652,0,2455,0,1166,277
765,0,1,1,0,58,0,3468,0,0,7497325,14507100,70.53367989832942,4908,6549,6482,4975,50702,731916,589032,2849,7891,2983,4423,9465,38.82009788756334,8.20759886765899,5042,1,1004950,12395,1507,0,2059,1409
766,0,1,0,0,54,0,803,1,0,3573354,4201064,39.1279950930277,1489,3907,3865,1531,54808,606424,680512,2702,4275,2786,5078,6651,48.31148931672465,6.63067838716079,1573,1,379688,3990,2334,0,1213,410
767,0,1,0,0,54,0,958,1,0,1523535,2290795,29.068883707497267,737,2756,2648,845,54432,658773,607264,2603,3556,2819,4514,5467,42.46174749112429,10.410300245868545,953,1,189280,16524,1803,0,1866,908
768,0,1,1,0,60,0,1641,0,0,10306062,12488814,64.29618962271404,3933,6828,6627,4134,51300,679725,688788,2820,7155,3222,5514,9849,49.92995093127971,14.23638353206903,4335,1,942552,26130,2493,0,1113,528
769,0,1,1,0,60,0,4657,0,0,3575088,16154496,72.99315036357864,5051,6276,5999,5328,52122,664008,721616,2755,8360,3309,3703,9308,25.903667693977237,16.910190473258453,5605,1,1268064,30193,671,0,2296,2361
770,0,1,1,0,58,0,4719,0,0,1273600,14447400,70.53367989832942,4945,5261,5231,4975,39424,511104,650496,2874,7879,2934,3160,8165,16.0,5.5965095842615735,5005,1,1114400,2130,256,0,2071,2648
771,0,1,1,0,57,0,395,0,0,6374550,6692110,48.321837713398274,2093,5307,5065,2335,54050,673510,659180,2624,5201,3108,5596,8173,52.24940191045253,15.695002637885558,2577,1,537050,33396,2730,0,531,136
772,0,1,0,0,50,0,762,1,0,538768,1132394,21.118712081942874,326,1774,1654,446,49042,573814,550963,2419,2985,2659,3747,4313,34.75629439396553,10.95616238207774,566,0,96782,17520,1208,1,2093,1331
773,0,1,1,0,57,0,3722,0,0,2177304,12263220,65.08456038109192,4176,4810,4750,4236,42570,622425,573210,2835,7131,2955,3409,7705,22.67156809750927,7.7992067098508295,4296,1,838728,9240,514,0,1341,2381
774,0,1,1,0,58,0,547,0,0,6137754,8029698,52.592775169218825,2323,5428,4985,2766,55926,693817,679302,2460,5669,3346,5122,8331,47.10626285325551,21.094703521255333,3209,1,647244,59805,2219,0,137,684
775,0,1,1,0,61,0,714,0,0,10941480,11368824,60.69596362197407,3365,6973,6654,3684,55221,719038,731382,2767,6770,3405,6056,10059,54.49770637375485,17.917168335174814,4003,1,873108,40513,2970,0,598,116
776,0,1,1,0,61,0,926,0,0,10761600,11641408,61.44916598294886,3520,6882,6626,3776,50609,706007,681343,2827,6859,3339,5933,9965,53.38539126015655,16.14457404921792,4032,1,834496,36608,2850,0,693,233
777,0,1,1,0,58,0,1240,0,0,5741225,9049780,55.632724182804495,2840,5205,4950,3095,48351,663748,622812,2669,6019,3179,4779,8129,43.069710934716056,16.12004122835068,3350,1,659235,38760,1855,0,171,1069
778,0,1,0,0,54,0,709,1,0,3101742,3951080,37.97367509209505,1280,3755,3593,1442,47403,567180,627460,2578,4182,2902,4891,6495,46.37887450122092,12.740029376818088,1604,1,330218,17334,2151,0,1298,589
779,0,1,1,0,62,0,568,0,0,10908569,11189291,59.99166608788257,3280,6949,6630,3599,47586,640454,718179,2790,6708,3428,6140,10058,55.054518434003214,17.99184974732636,3918,1,831369,32857,3031,0,490,78
780,0,1,1,0,58,0,3741,0,0,1918486,12321130,64.79197481170026,4131,4722,4655,4198,41193,607545,584065,2868,7133,3002,3392,7657,21.37755832643195,8.397588990243326,4265,1,835402,9581,457,0,1263,2478
781,0,1,1,0,58,0,994,0,0,5963055,8709946,54.67174773134658,2598,5375,4984,2989,52884,681876,658564,2523,5903,3305,4909,8289,44.66542286825459,19.82785262243367,3380,1,675514,55913,1995,0,75,919
782,0,1,0,0,53,0,767,1,0,851928,1654576,24.819347291981714,616,1999,1999,616,51480,628524,590920,2686,3302,2686,4069,4685,37.1887079635741,0.0,616,1,135520,0,1383,0,2070,1303
783,0,1,0,0,51,0,372,1,0,715360,1743520,26.076809620810597,613,1799,1732,680,43979,510236,566644,2497,3244,2631,3616,4363,32.43454948045371,8.37937698914232,747,0,150280,7102,1052,1,1884,1512
784,0,1,1,0,60,0,4759,0,0,4194440,16612190,74.28997240543302,5035,6763,6279,5519,53383,761530,635110,2526,8529,3494,3770,9773,27.568097504180443,22.57094903199727,6003,1,1164509,83732,760,0,2509,2250
785,0,1,0,0,55,0,894,1,0,5294527,5222441,43.55456348076513,1807,4778,4688,1897,53820,644202,633190,2663,4650,2843,5544,7531,52.82991576748916,9.489467114586667,1987,1,436310,12330,2791,0,856,38
786,0,1,0,0,54,0,654,1,0,2206512,3246486,34.55430508634199,1127,3109,3042,1194,49220,625370,581866,2652,3913,2786,4567,5828,42.988370520409354,8.189452396126915,1261,1,255516,10318,1848,0,1525,871
787,0,1,0,0,53,0,676,1,0,1259340,2250966,28.879058156387302,774,2404,2344,834,51684,636964,591081,2639,3533,2759,4209,5103,38.8587184554509,7.754559014766193,894,1,182646,9240,1510,0,1865,1189
788,0,1,1,0,58,0,1118,0,0,5972568,8968050,55.37147279962851,2642,5438,5014,3066,52437,675675,663975,2501,5991,3349,4873,8363,44.13615298142782,20.665338187173973,3490,1,695982,58512,1948,0,141,977
789,0,1,0,0,56,0,879,1,0,6429742,6020014,46.195237849804386,1892,5389,5147,2134,53743,629083,679861,2579,4955,3063,5834,8210,54.89080068645383,15.790094819097714,2376,1,514294,26620,3013,0,687,192
790,0,1,0,0,55,0,560,1,0,3411024,4373352,39.84971769034255,1503,3821,3736,1588,53775,619650,658206,2669,4342,2839,4902,6575,46.34652090502587,9.332611979058527,1673,1,379532,9775,2148,0,1166,606
791,0,1,0,0,53,0,555,1,0,1145124,2229804,28.77498913987632,708,2331,2211,828,44485,584381,552065,2573,3521,2813,4076,5024,37.1887079635741,10.954451150103322,948,1,169740,17880,1383,0,1865,1310
792,0,1,0,0,53,0,490,1,0,698616,1673924,25.019992006393608,392,1976,1742,626,47174,612346,550844,2440,3300,2908,3790,4650,33.406586176980134,15.29733790083948,860,1,128956,37908,1116,0,2048,1558
793,0,1,1,0,63,0,189,0,0,10904182,10198202,56.64803615307419,2903,6913,6607,3209,52440,730940,724584,2872,6387,3484,6576,10091,58.29236656715869,17.590855596452492,3515,1,731652,41922,3398,0,31,220
794,0,1,0,0,56,0,796,1,0,6456780,6143724,46.62617290749907,1940,5378,5144,2174,50976,610416,666936,2592,5000,3060,5796,8204,54.49770637375485,15.504089381993905,2408,1,513064,25506,2970,0,652,144
795,0,1,1,0,54,0,536,0,0,3018740,4060250,38.600518131237564,1490,3516,3516,1490,53357,624025,634925,2725,4215,2725,4751,6241,45.0111097397076,0.0,1490,0,347170,0,2026,0,1235,699
796,0,1,1,0,59,0,2418,0,0,4428648,10766196,60.29925372672534,3486,5004,4854,3636,51088,609966,734328,2811,6597,3111,4179,7965,34.899856733230294,12.537582169683825,3786,1,901728,11550,1218,0,675,1743
797,0,1,1,0,58,0,1422,0,0,5860008,9504726,56.868268832451726,2892,5388,5046,3234,52668,670092,678909,2597,6173,3281,4751,8327,42.567593307585526,18.620350808376262,3576,1,747054,44118,1812,0,295,1127
798,0,1,0,0,55,0,902,1,0,6391223,5845037,46.010868281309364,2075,5178,5136,2117,55081,681967,615703,2719,4878,2803,5780,7939,54.945427471264615,6.495386533491135,2159,1,472091,6552,3019,0,644,258
799,0,1,0,0,55,0,491,1,0,4189512,5019424,42.61455150532503,1641,4298,4123,1816,54731,660596,632956,2589,4580,2939,5071,7062,48.03123983409131,13.271742520787742,1991,1,415864,25200,2307,0,948,457
800,0,1,1,0,59,0,4413,0,0,1205118,13877541,68.3447144993671,4310,5290,4929,4671,34080,632823,475360,2610,7642,3332,3229,8261,16.06237840420901,19.850999416526108,5032,1,747360,68590,258,0,1700,2713
801,0,1,1,0,59,0,3506,0,0,2411955,12252240,63.99218702310463,4028,4751,4684,4095,46782,676192,619344,2925,7087,3059,3581,7743,24.269322199023193,8.18535277187245,4162,1,847665,10519,589,0,1103,2403
802,0,1,0,0,50,0,210,0,0,646696,1782650,26.570660511172846,639,1689,1622,706,52212,575700,578225,2458,3231,2592,3441,4214,30.265491900843113,8.2143728690235,773,0,161674,8911,916,0,1819,1609
803,0,1,1,0,55,0,822,0,0,6410304,5923500,46.411205543489174,2154,5130,5130,2154,51513,635250,613250,2750,4904,2750,5726,7880,54.55272678794342,0.0,2154,0,480342,0,2976,0,596,226
804,0,1,1,0,54,0,436,0,0,3246701,4378974,39.96248240537617,1567,3660,3630,1597,47174,627918,564852,2712,4339,2772,4775,6402,45.088801270381985,5.483301264452448,1627,0,328982,4830,2033,0,1145,709
805,0,1,0,0,53,0,285,1,0,904176,2207205,28.61817604250837,534,2208,1923,819,48150,606375,576730,2410,3514,2980,3799,4903,33.2264954516723,16.881994976322115,1104,1,175266,42180,1104,0,1876,1591
806,0,1,1,0,59,0,4488,0,0,816025,13956359,68.28616258071617,4363,5138,4838,4663,45225,673425,601593,2693,7656,3293,3168,8131,13.228756555322953,17.332811765262047,4963,1,937263,48600,175,0,1670,2818
807,0,1,1,0,59,0,2088,0,0,8870400,12482400,64.8074069840786,3990,6522,6312,4200,40755,621148,579540,2762,7172,3182,5084,9494,45.95650117230423,14.524125829022891,4410,1,819000,31500,2112,0,1228,860
808,0,1,1,0,58,0,985,0,0,6442254,9021618,55.47972602672079,2687,5562,5171,3078,44935,612579,630165,2540,6009,3322,5024,8493,45.749316934791494,19.85406676736865,3469,1,661770,50048,2093,0,147,838
809,0,1,1,0,57,0,146,0,0,6461520,7502688,51.146847410177685,2508,5194,5086,2616,52560,688320,628092,2760,5484,2976,5338,8062,49.699094559156705,10.435690064413366,2724,1,572904,16956,2470,0,252,398
810,0,1,1,0,59,0,4465,0,0,4828500,15966240,73.24616030891995,5153,6477,6265,5365,51333,717216,633888,2764,8341,3188,3876,9453,30.0,15.241794179720499,5577,1,1142745,35192,900,0,2389,2076
811,0,1,1,0,58,0,962,0,0,6394115,8938930,55.27205442174191,2731,5472,5148,3055,50344,634942,678832,2602,5981,3250,5019,8398,45.749316934791494,18.086184595346595,3379,1,708760,37584,2093,0,129,833
812,0,1,1,0,57,0,426,0,0,6416395,7860015,52.48809388804284,2713,5126,5084,2755,46410,679014,556335,2811,5608,2895,5182,7979,48.25971404805462,6.553889165207866,2797,1,537225,7686,2329,0,98,524
813,0,1,1,0,54,0,210,0,0,1421784,2969148,33.04542328371661,815,2671,2394,1092,55687,633527,649841,2442,3811,2996,4021,5390,36.08323710533743,16.648737088464458,1369,0,260988,34071,1302,1,1627,1417
814,0,1,0,0,52,0,256,1,0,596705,2390464,30.18277654557314,784,1693,1566,911,54412,585152,640256,2497,3535,2751,3279,4317,25.592967784139454,11.30350933966113,1038,0,222284,13335,655,1,1713,1969
815,0,1,1,0,59,0,2475,0,0,8312500,13059375,66.14378277661477,4080,6570,6275,4375,52884,674610,698490,2690,7360,3280,4885,9555,43.58898943540674,17.31251586689444,4670,1,1023750,36285,1900,0,1390,1085
816,0,1,1,0,58,0,3260,0,0,7133741,13843931,68.98550572402873,4639,6378,6258,4759,51493,642889,677797,2789,7668,3029,4408,9287,38.71692136521188,10.96129127279285,4879,1,1108847,14280,1499,0,1850,1410
817,0,1,1,0,58,0,4674,0,0,4448335,15966835,74.06078584514209,5377,6404,6296,5485,52164,602577,733572,2803,8396,3019,3722,9315,28.478061731796284,10.948360265819424,5593,1,1382220,6480,811,0,2574,2100
818,0,1,1,0,55,0,617,0,0,6892920,6491300,48.321837713398274,2250,5372,5287,2335,41961,592140,547660,2695,5115,2865,5732,8152,54.3323108288245,9.2729914971827,2420,0,459995,13005,2952,1,445,172
819,0,1,1,0,57,0,4790,0,0,3861579,15677022,74.11477585475112,5493,6196,6196,5493,47150,656420,585070,2854,8347,2854,3557,9050,26.514147167125703,0.0,5493,0,1126065,0,703,0,2639,2151
820,0,1,1,0,57,0,4784,0,0,3740112,15616608,73.9459261893446,5468,6152,6152,5468,42800,611184,571200,2856,8324,2856,3540,9008,26.153393661244042,0.0,5468,0,1093600,0,684,0,2612,2172
821,0,1,1,0,59,0,3675,0,0,2434104,12731256,65.1766829472013,4218,4851,4821,4248,48616,707292,617382,2967,7245,3027,3570,7848,23.93741840717165,5.478746393072713,4278,0,875088,5040,573,1,1251,2424
822,0,1,0,1,63,0,598,0,0,10324128,9229056,54.11099703387473,2808,6574,6454,2928,50838,699744,721808,3032,6080,3272,6678,9726,59.38013135721409,10.986451322313634,3048,1,670512,15120,3526,0,224,374
823,0,1,1,0,58,0,2825,0,0,7798614,13376190,67.39436178197698,4367,6434,6259,4542,51260,647900,686185,2770,7487,3120,4662,9379,41.43669871020132,13.415268981669886,4717,1,1058286,20650,1717,0,1597,1228
824,0,1,1,0,56,0,208,0,0,6749184,7041216,49.95998398718719,2466,5230,5200,2496,48952,595231,654472,2791,5317,2851,5525,8051,52.0,5.501408174353464,2526,0,579072,3240,2704,1,325,117
825,0,1,1,0,60,0,4570,0,0,562800,14079380,68.48357467305573,4432,5068,4810,4690,53743,723482,669446,2744,7692,3260,3122,8070,10.954451150103322,16.09149730756504,4948,0,1045870,39474,120,0,1688,2882
826,0,1,1,0,60,0,4006,0,0,1800912,13374420,66.43794096749237,4329,4907,4822,4414,51170,651450,721140,2945,7444,3115,3438,7937,20.199009876724155,9.370214040084857,4499,1,1050532,9010,408,0,1384,2622
827,0,1,1,0,60,0,1663,0,0,9165068,12075811,63.0158710167526,3648,6602,6279,3971,55660,699430,735922,2718,7012,3364,5349,9643,48.041648597857254,18.215947264276064,4294,1,960982,37145,2308,0,930,733
828,0,1,1,0,57,0,4621,0,0,4789896,15808854,74.11477585475112,5463,6395,6365,5493,36400,598624,503650,2848,8371,2908,3750,9273,29.5296461204668,5.791460926441345,5523,1,961275,5100,872,0,2615,2006
829,0,1,0,0,55,0,124,1,0,2524256,4232560,39.08964057138413,1408,3300,3180,1528,48364,592780,626020,2650,4298,2890,4422,6070,40.64480286580315,10.963758173094375,1648,1,345328,14400,1652,0,1242,1118
830,0,1,0,0,54,0,192,1,0,982800,2984436,33.04542328371661,510,2574,1992,1092,51788,584862,661386,2151,3825,3315,3633,5307,30.0,24.131795234077426,1674,1,264264,57036,900,0,1641,1833
831,0,1,1,0,63,0,637,0,0,10135358,9101079,53.67494760127857,2731,6549,6399,2881,48279,660231,729729,3009,6040,3309,6677,9708,59.312730505347666,12.30152264982736,3031,1,665511,15900,3518,0,278,359
832,0,1,1,0,62,0,786,0,0,9774352,11067912,59.531504264548865,3202,6644,6302,3544,52836,693306,743274,2781,6667,3465,5881,9767,52.51666402200353,18.53613812444298,3886,1,843472,38646,2758,0,421,365
833,0,1,1,0,53,0,531,0,0,599452,2897532,32.92415526630866,844,1877,1637,1084,49374,564003,625482,2433,3757,2913,3226,4550,23.515952032609693,15.698622513201272,1324,1,253656,25440,553,0,1589,2120
834,0,1,0,0,55,0,172,1,0,4195104,5473668,44.31703961232068,1934,4130,4100,1964,53580,635436,654945,2757,4751,2817,4923,6917,46.216880033165374,5.483301264452448,1994,1,461540,3750,2136,0,823,651
835,0,1,0,0,50,0,489,1,0,541620,2594880,31.937438845342623,773,1798,1551,1020,52670,582576,585120,2297,3564,2791,3075,4342,23.043437243605826,15.732694497017132,1267,0,234600,32604,531,1,1524,2013
836,0,1,1,0,63,0,630,0,0,10051371,9078102,53.58171329847526,2681,6562,6372,2871,49494,692478,714612,2972,6033,3352,6663,9724,59.16924876994806,13.834270577215369,3061,1,648846,23940,3501,0,291,339
837,0,1,1,0,59,0,2023,0,0,8764380,12411720,64.34283176858165,4016,6381,6257,4140,55902,692538,725516,2874,7138,3122,5115,9379,46.010868281309364,11.401248222293653,4264,1,1001880,13020,2117,0,1142,881
838,0,1,1,0,59,0,3322,0,0,3902640,12607224,65.13063795173512,4152,5252,5162,4242,49280,665728,653840,2882,7214,3062,3892,8224,30.331501776206203,9.560918316574591,4332,0,933240,12510,920,1,1270,2052
839,0,1,1,0,57,0,631,0,0,6482250,8236779,53.67494760127857,2839,5173,5131,2881,53820,669006,657570,2817,5740,2901,5109,8032,47.43416490252569,6.481658975540136,2923,1,662630,5796,2250,0,22,609
840,0,1,1,0,57,0,172,0,0,7201829,7409749,50.98038838612354,2344,5625,5370,2599,44421,573051,630071,2596,5450,3106,5622,8476,52.640288753007425,16.052113007750794,2854,1,574379,28050,2771,0,252,80
841,0,1,1,0,52,0,901,0,0,425106,3233043,35.25620512760839,1081,1747,1585,1243,48384,561816,582624,2439,3844,2763,2943,4348,18.49324200890693,12.767025201137244,1405,0,278432,20088,342,1,1358,2259
842,0,1,0,0,56,0,55,1,0,3445836,5146806,42.76680956068619,1628,3914,3713,1829,46607,627522,588126,2613,4643,3015,4698,6728,43.40506882842141,14.37539151437394,2030,1,382261,30552,1884,0,985,930
843,0,1,1,0,60,0,3711,0,0,3221262,13421925,66.61080993352356,4203,5397,5163,4437,53128,692725,701800,2791,7462,3259,3751,8422,26.94438717061496,15.317203031147645,4671,1,1029384,30186,726,0,1412,2299
844,0,1,1,0,59,0,2185,0,0,8612736,12481920,64.99230723708769,4182,6305,6263,4224,43014,632370,593955,2913,7179,2997,4994,9260,45.155287619502545,6.488991180673202,4266,1,849024,6258,2039,0,1269,916
845,0,1,1,0,57,0,588,0,0,6694380,8314362,53.83307533477908,2778,5328,5208,2898,40182,636918,519289,2749,5767,2989,5179,8197,48.062459362791664,10.986451322313634,3018,1,524538,21600,2310,0,29,559
846,0,1,1,0,61,0,720,0,0,9673561,10706897,59.08468498688979,3249,6504,6262,3491,55695,720745,726879,2825,6558,3309,5838,9571,52.640288753007425,15.677709056199316,3733,1,827367,30734,2771,0,424,296
847,0,1,1,0,58,0,3369,0,0,7239910,14115395,69.70652767137379,4764,6444,6349,4859,51574,700105,621670,2810,7764,3000,4395,9349,38.600518131237564,9.779300676839927,4954,1,1039826,15675,1490,0,1954,1415
848,0,1,1,0,60,0,2558,0,0,5386659,11790929,62.68173577685928,3606,5623,5300,3929,49020,684228,645215,2678,6930,3324,4372,8624,37.027017163147235,18.051306284727975,4252,1,844735,48450,1371,0,928,1630
849,0,1,1,0,54,0,791,0,0,756560,3663912,36.75595189897821,960,2302,1911,1351,50561,588504,631896,2321,4063,3103,3272,5014,23.664319132398465,20.019502704788522,1742,0,314783,44965,560,1,1361,2152
850,0,1,1,0,61,0,819,0,0,9619822,10790900,59.481089431852205,3414,6381,6257,3538,51051,674050,704550,2926,6588,3174,5769,9431,52.14403129793476,11.255953434413934,3662,1,817278,15128,2719,0,488,331
851,0,1,1,0,57,0,4599,0,0,5864560,16251598,75.09327533141699,5639,6679,6679,5639,48180,631158,634040,2882,8521,2882,3922,9561,32.2490309931942,0.0,5639,0,1240580,0,1040,1,2757,1842
852,0,1,1,0,59,0,2520,0,0,5068800,11374080,61.96773353931867,3690,5310,5160,3840,54280,681260,699032,2812,6802,3112,4282,8272,36.3318042491699,12.24962545775264,3990,1,906240,18750,1320,0,878,1642
853,0,1,1,0,55,0,629,0,0,1376100,4223098,39.102429592034305,871,3087,2429,1529,46575,621450,571734,2104,4291,3420,3662,5849,30.0,25.651525488320978,2187,0,316503,102648,900,1,1233,1862
854,0,1,1,0,60,0,695,0,0,9666756,10570516,58.957611891934704,3416,6317,6257,3476,56406,723758,720717,2981,6517,3101,5822,9358,52.73518749374084,7.754559014766193,3536,1,823812,7740,2781,0,435,260
855,0,1,1,0,59,0,2722,0,0,4938915,11837528,62.984124983998946,3814,5365,5212,3967,55692,698256,710192,2831,6951,3137,4229,8349,35.2845575287547,12.457665419166299,4120,1,944146,18972,1245,0,983,1739
856,0,1,1,0,61,0,284,0,0,9764220,10104300,57.18391382198319,3146,6380,6256,3270,55902,713790,747780,2966,6360,3214,6076,9470,54.644304369257,11.500318471195635,3394,1,791340,14260,2986,0,180,104
857,0,1,1,0,60,0,1170,0,0,9479731,11186752,60.983604353957304,3677,6310,6268,3719,40128,628672,577536,2966,6727,3050,5557,9318,50.48762224545735,6.5252844928085345,3761,1,714048,6426,2549,0,711,459
858,0,1,1,0,58,0,4539,0,0,6310980,16399500,75.1997340420829,5613,6813,6771,5655,47970,594500,678600,2858,8555,2942,4016,9713,33.406586176980134,6.5135556243263055,5697,1,1323270,4074,1116,0,2755,1784
859,0,1,1,0,60,0,4598,0,0,4530288,16372048,73.70210309075311,5147,6551,6266,5432,45540,762542,542520,2729,8446,3299,3848,9565,28.879058156387302,17.530749761849496,5717,1,977760,58425,834,0,2418,2180
860,0,1,1,0,57,0,3367,0,0,7634288,14255262,70.13558298039591,4889,6501,6471,4919,49980,710010,591192,2868,7817,2928,4450,9399,39.395431207184416,5.531194905403055,4949,0,1003476,5370,1552,1,2021,1346
861,0,1,1,0,57,0,3415,0,0,7585284,14339304,70.3420215802759,4888,6541,6481,4948,52864,683928,649152,2838,7846,2958,4431,9439,39.153543900903784,7.754559014766193,5008,0,1108352,8820,1533,1,2050,1365
862,0,1,1,0,56,0,336,0,0,2961217,5376098,43.55456348076513,1650,3705,3458,1897,44712,586638,612144,2587,4731,3081,4395,6539,39.50949253027682,15.799040962176173,2144,0,409752,30628,1561,1,937,1273
863,0,1,0,0,55,0,714,1,0,1457632,4492480,40.19950248448356,1034,3100,2518,1616,53124,647740,633840,2198,4396,3362,3682,5880,30.033314835362415,24.132524582892888,2198,1,368448,80898,902,0,1164,1878
864,0,1,1,0,57,0,3336,0,0,7734825,14222256,70.07852738178792,4881,6516,6486,4911,48642,700832,582096,2866,7807,2926,4471,9412,39.68626966596886,5.514871952411144,4941,0,987111,5370,1575,1,2015,1321
865,0,1,1,0,57,0,3385,0,0,7688196,14319018,70.2922470831599,4881,6557,6497,4941,49862,675234,620172,2838,7839,2958,4454,9455,39.44616584663204,7.765259411425052,5001,0,1057374,9480,1556,1,2043,1342
866,0,1,1,0,56,0,127,0,0,5357508,6751602,48.774993593028796,2294,4716,4631,2379,41175,638550,519354,2753,5217,2923,5090,7554,47.45524207081869,9.370214040084857,2464,1,435357,15470,2252,0,459,586
867,0,1,0,0,56,0,615,1,0,1841716,4760598,41.2189276910499,1159,3323,2783,1699,52851,624846,664074,2262,4501,3342,3886,6125,32.92415526630866,23.244352361658322,2239,1,402663,62100,1084,0,1103,1718
868,0,1,1,0,57,0,3258,0,0,7882875,14093625,69.82120021884471,4875,6492,6492,4875,47083,690949,569527,2891,7766,2891,4508,9383,40.2119385257662,0.0,4875,0,960375,0,1617,1,1984,1274
869,0,1,1,0,58,0,3403,0,0,7742280,14402626,70.44856279584417,4896,6590,6523,4963,50055,681970,618126,2835,7865,2969,4462,9492,39.496835316262995,8.19263674150144,5030,0,1057119,10653,1560,1,2061,1342
870,0,1,0,0,57,0,275,1,0,3867906,6016977,45.92385001282014,1759,4293,3943,2109,48399,624807,630513,2503,4962,3203,4687,7146,42.82522621072771,18.822727612148498,2459,1,466089,46200,1834,0,744,1019
871,0,1,1,0,60,0,3911,0,0,7408572,16053675,72.84915922644544,4965,7045,6703,5307,54467,759275,656425,2683,8332,3367,4421,10070,37.36308338453881,18.97029782416602,5649,1,1151619,56088,1396,0,2282,1629
872,0,1,1,0,59,0,1816,0,0,5785577,10297840,58.98304841223451,3329,5292,5142,3479,52539,624560,737040,2810,6439,3110,4623,8252,40.779897008207364,12.470060607585795,3629,1,866271,12300,1663,0,519,1297
873,0,1,1,0,58,0,1698,0,0,5951088,10062624,58.58327406350724,3347,5251,5166,3432,54635,653836,718340,2847,6364,3017,4666,8183,41.641325627314025,9.332611979058527,3517,1,840840,8840,1734,0,500,1198
874,0,1,1,0,57,0,3101,0,0,8174706,13909488,69.30367955599472,4773,6535,6505,4803,46762,657392,596576,2866,7699,2926,4598,9431,41.255302689472536,5.490867587491313,4833,0,989418,4770,1702,1,1907,1194
875,0,1,1,0,58,0,3389,0,0,7916610,14463995,70.5620294492725,4937,6611,6569,4979,46556,656530,598430,2863,7884,2947,4495,9516,39.87480407475377,6.488991180673202,5021,0,1025674,6636,1590,1,2074,1315
876,0,1,1,0,58,0,3527,0,0,7796574,14797786,71.17583859709698,4958,6713,6605,5066,41496,721487,490728,2813,7987,3029,4460,9634,39.230090491866065,10.406531168715494,5174,1,851088,23220,1539,0,2145,1382
877,0,1,1,0,60,0,3475,0,0,4779150,13798380,67.30527468185537,4396,5719,5585,4530,40330,664028,563510,2912,7576,3180,4101,8765,32.48076353782343,11.727705886231366,4664,1,838050,23048,1055,0,1484,1991
878,0,1,0,0,55,0,1058,1,0,1054184,4634368,41.036569057366385,1266,2728,2310,1684,50576,599936,638464,2334,4436,3170,3378,5480,25.019992006393608,20.567538501273305,2102,1,390688,49324,626,0,1068,2126
879,0,1,1,0,58,0,3168,0,0,8190385,14098920,69.67783004657937,4825,6572,6542,4855,43665,618552,595320,2874,7759,2934,4591,9476,41.0731055558257,5.514871952411144,4885,0,995275,4320,1687,1,1951,1217
880,0,1,0,0,58,0,557,1,0,7714910,8921420,55.40758070878027,2858,5795,5583,3070,52628,648038,685816,2694,5976,3118,5419,8701,50.12983143797713,14.701031829420534,3282,1,724520,25016,2513,0,164,393
881,0,1,0,0,55,0,1053,1,0,1140088,4732052,41.43669871020132,1297,2801,2381,1717,51948,611832,644904,2336,4473,3176,3420,5557,25.768197453450252,20.494627609457737,2137,1,401778,49560,664,0,1039,2092
882,0,1,1,0,53,0,948,0,0,268128,3135216,34.292856398964496,964,1616,1404,1176,48952,562526,618512,2454,3842,2878,2894,4282,15.0996688705415,14.589369836921374,1388,0,272832,23108,228,1,1490,2438
883,0,1,1,0,53,0,858,0,0,287928,2961864,33.406586176980134,844,1646,1374,1116,51480,583880,621036,2382,3770,2926,2912,4300,16.06237840420901,16.495152579479317,1388,0,261144,31552,258,1,1538,2396
884,0,1,1,0,59,0,1868,0,0,9265500,12251050,64.17164482853778,3644,6842,6368,4118,17766,419475,374850,2501,7093,3449,5225,9817,47.43416490252569,21.77154105707724,4592,1,518868,62568,2250,0,1143,725
885,0,1,1,0,62,0,4400,0,0,4597184,16506632,72.60853944268538,4654,6762,6144,5272,42180,713868,579235,2513,8403,3749,4003,9893,29.5296461204668,24.976350463122845,5890,1,975320,113094,872,0,2141,2259
886,0,1,1,0,58,0,3013,0,0,8472464,13935792,69.16646586316233,4689,6650,6555,4784,39694,649599,518514,2818,7697,3008,4684,9563,42.08325082500163,9.799287634083276,4879,0,851552,17480,1771,1,1871,1142
887,0,1,1,0,58,0,3265,0,0,8367306,14406232,70.3846574190711,4924,6673,6643,4954,52320,697920,633944,2878,7862,2938,4597,9581,41.09744517606904,5.478746393072713,4984,0,1079972,4740,1689,1,2046,1219
888,0,1,1,0,58,0,3310,0,0,8336559,14500530,70.59036761485238,4941,6698,6656,4983,50610,701310,611100,2868,7893,2952,4583,9608,40.90232267243512,6.484411467763075,5025,0,1046430,7098,1673,1,2073,1237
889,0,1,0,0,55,0,1012,1,0,1470560,5041400,42.661458015403085,1490,2958,2628,1820,51948,648180,614940,2440,4590,3100,3578,5728,28.42534080710379,18.170946107335194,2150,1,404040,48840,808,0,950,1962
890,0,1,1,0,58,0,3142,0,0,8541083,14246546,69.92138442565336,4889,6636,6636,4889,54731,667306,696446,2914,7803,2914,4661,9550,41.79712908801273,0.0,4889,0,1168471,0,1747,1,1975,1167
891,0,1,1,0,58,0,3234,0,0,8480872,14373940,70.3420215802759,4918,6692,6662,4948,50955,688485,624575,2875,7853,2935,4619,9597,41.400483088968905,5.490867587491313,4978,0,1063820,4770,1714,1,2043,1191
892,0,1,1,0,58,0,3370,0,0,8396679,14692929,70.97182539571601,4929,6812,6704,5037,46031,702997,557147,2809,7954,3025,4584,9729,40.82891132518721,10.39586690415236,5145,0,962067,20520,1667,1,2120,1250
893,0,1,1,0,58,0,3414,0,0,8369032,14812984,71.17583859709698,4932,6852,6718,5066,47336,713456,567256,2790,7990,3058,4576,9776,40.64480286580315,11.595289322469533,5200,1,982804,25326,1652,0,2142,1272
894,0,1,1,0,59,0,3765,0,0,8149174,15837074,72.81483365359011,4937,7204,6839,5302,45034,755711,531686,2622,8289,3352,4524,10191,39.20459156782532,19.29833753312278,5667,1,943756,75555,1537,0,2315,1450
895,0,1,1,0,59,0,3180,0,0,4005036,12433854,64.389440128021,3996,5262,5112,4146,42510,653782,584805,2849,7145,3149,3965,8261,31.080540535840107,12.30702509692623,4296,1,808470,24300,966,0,1147,2033
896,0,1,1,0,57,0,281,0,0,5666100,7266950,50.24937810560445,2307,4987,4769,2525,44506,684964,538186,2660,5403,3096,5122,7865,47.37087712930804,14.99436719831913,2743,1,472175,41638,2244,0,353,634
897,0,1,1,0,58,0,2876,0,0,8808960,13805440,68.81860213634101,4628,6704,6596,4736,48790,693770,597575,2807,7651,3023,4775,9619,43.12771730569565,10.392527581411793,4844,1,970880,18576,1860,0,1821,1055
898,0,1,1,0,58,0,3338,0,0,8517483,14680458,70.92954250522133,4907,6848,6724,5031,44503,679894,557338,2794,7949,3042,4611,9766,41.14608122288197,11.15359010904883,5155,0,960921,22568,1693,1,2113,1225
899,0,1,1,0,58,0,3426,0,0,8469760,14888250,71.34423592694787,4915,6929,6754,5090,52948,713700,634725,2750,8015,3100,4589,9854,40.792156108742276,13.244279748882459,5265,1,1104530,28700,1664,0,2165,1261
900,0,1,1,0,58,0,1797,0,0,6180790,10420564,59.51470406546604,3482,5347,5287,3542,45114,644298,606052,2882,6484,3002,4687,8289,41.773197148410844,7.750803389552748,3602,1,729652,9000,1745,0,600,1197
901,0,1,1,0,58,0,2847,0,0,8913204,13805058,68.78226515607058,4646,6700,6615,4731,47912,659468,618616,2833,7649,3003,4802,9618,43.40506882842141,9.222414255489701,4816,1,1002972,12920,1884,0,1813,1034
902,0,1,1,0,58,0,3480,0,0,8559616,15077064,71.72168430816443,4902,7050,6808,5144,43610,718095,521718,2689,8075,3173,4595,9981,40.792156108742276,15.577820712846412,5386,1,915632,49610,1664,0,2213,1267
903,0,1,1,0,59,0,2525,0,0,4982754,11469519,61.862751312886175,3785,5171,5129,3827,48300,689310,629370,2955,6824,3039,4299,8168,36.08323710533743,6.484411467763075,3869,1,803670,6678,1302,0,830,1695
904,0,1,1,0,60,0,971,0,0,9886232,11136679,60.55575942881073,3249,6781,6363,3667,42705,665103,592215,2619,6704,3455,5733,9818,51.92301994298868,20.445048300260872,4085,1,715065,67716,2696,0,630,341
905,0,1,1,0,58,0,2770,0,0,9044496,13754584,68.52736679604726,4601,6717,6622,4696,50244,620948,694173,2834,7625,3024,4855,9646,43.88621651498338,9.799287634083276,4791,1,1112952,9785,1926,0,1767,1003
906,0,1,1,0,63,0,4320,0,0,5638500,17044380,73.28028384224504,4670,7120,6420,5370,42315,688758,618930,2474,8544,3874,4224,10294,32.4037034920393,26.51611857242469,6070,1,1047150,112000,1050,0,2196,2124
907,0,1,1,0,61,0,3853,0,0,3809904,14389858,68.33008122342603,4457,5697,5485,4669,51948,721188,684204,2870,7751,3294,3898,8779,28.5657137141714,14.642455140177768,4881,1,1036518,31376,816,0,1587,2266
908,0,1,0,0,56,0,616,1,0,3387092,6176334,46.62617290749907,1879,4027,3732,2174,53124,661953,647748,2546,5015,3136,4399,6868,39.4715087119811,17.333675883108953,2469,1,495672,41005,1558,0,667,1283
909,0,1,1,0,58,0,3331,0,0,8850800,14859600,71.23903424387504,4859,7035,6819,5075,48756,699792,597312,2712,8003,3144,4672,9963,41.7612260356422,14.731545485687572,5291,0,1035300,37584,1744,1,2147,1184
910,0,1,1,0,58,0,3416,0,0,8820212,15088826,71.65193647069142,4866,7120,6852,5134,46127,702421,567227,2671,8073,3207,4657,10059,41.44876355212541,16.409090174556454,5402,1,990862,49848,1718,0,2195,1221
911,0,1,1,0,62,0,166,0,0,9940827,9529313,55.41660400998964,2937,6442,6308,3071,44019,679557,623703,2969,6174,3237,6340,9545,56.894639466297704,11.59192030070629,3205,1,617271,20770,3237,0,32,134
912,0,1,1,0,61,0,54,0,0,9984871,9866952,56.45352070508977,2995,6512,6320,3187,50794,674928,721368,2904,6283,3288,6229,9608,55.97320787662612,13.872260122783056,3379,1,742571,22080,3133,0,91,37
913,0,1,1,0,61,0,382,0,0,10018760,10301168,57.982756057296896,3043,6661,6342,3362,50621,683272,695528,2745,6426,3383,6044,9725,54.589376255824725,17.86057109949175,3681,1,763174,41470,2980,0,298,84
914,0,1,1,0,58,0,2806,0,0,9200555,13841165,68.8839603971781,4715,6714,6684,4745,48825,632989,656325,2887,7662,2947,4856,9631,44.034077712607996,5.483301264452448,4775,0,1067625,3750,1939,1,1828,978
915,0,1,1,0,58,0,2944,0,0,9129537,14112360,69.5197813575388,4791,6764,6722,4833,46410,694960,569400,2878,7753,2962,4809,9684,43.46262762420146,6.503581472166948,4875,0,942435,7644,1889,1,1913,1031
916,0,1,1,0,58,0,3169,0,0,9025572,14619235,70.57619995437555,4819,6955,6793,4981,46438,628090,636895,2773,7916,3097,4747,9890,42.567593307585526,12.809104356509453,5143,1,1080877,21222,1812,0,2046,1123
917,0,1,1,0,62,0,687,0,0,9776178,8767458,52.933921071464184,2612,6481,6291,2802,47520,675864,688380,2939,5931,3319,6618,9610,59.06775770248944,13.906130088123188,2992,1,616440,24510,3489,0,327,360
918,0,1,1,0,58,0,2776,0,0,9309360,13859760,68.84765791223403,4740,6704,6704,4740,47670,614040,663748,2924,7664,2924,4888,9628,44.31703961232068,0.0,4740,0,1075980,0,1964,1,1816,960
919,0,1,1,0,58,0,2959,0,0,9225342,14229082,69.6993543729065,4773,6842,6757,4858,39560,673670,503788,2844,7787,3014,4828,9771,43.57751713900185,9.28144526553527,4943,1,835576,16830,1899,0,1929,1030
920,0,1,1,0,58,0,3181,0,0,9135950,14697616,70.75309180523492,4805,7032,6831,5006,46008,634176,625368,2735,7942,3137,4761,9968,42.720018726587654,14.240973470021874,5207,1,1066278,27738,1825,0,2070,1111
921,0,1,1,0,58,0,3310,0,0,9094575,14969110,71.37926869897169,4818,7157,6880,5095,49203,678678,625794,2661,8033,3215,4723,10095,42.24926034855522,16.688736125797796,5372,0,1085235,43212,1785,1,2157,1153
922,0,1,1,0,60,0,4517,0,0,7117698,17285016,75.85512507405153,5453,7292,6991,5754,43983,729972,543724,2703,8758,3305,4241,10296,35.17101079013795,17.749357172598316,6055,1,1041474,60501,1237,0,2750,1767
923,0,1,1,0,63,0,4319,0,0,6223260,17294112,73.8850458482635,4759,7299,6599,5459,53382,779328,687456,2468,8627,3868,4308,10467,33.76388603226827,26.50597522842749,6159,1,1184603,114800,1140,0,2291,2028
924,0,1,1,0,62,0,4099,0,0,6177612,16498230,72.60165287374662,4850,6864,6443,5271,54480,710510,751200,2709,8401,3551,4302,9994,34.23448553724738,20.593149905895086,5692,1,1265040,48415,1172,0,2141,1958
925,0,1,0,0,55,0,941,1,0,2372340,5774775,45.617978911828175,1947,3355,3221,2081,54340,685425,610500,2641,4856,2909,3915,6130,33.76388603226827,11.595289322469533,2215,1,457820,21574,1140,0,694,1635
926,0,1,1,0,54,0,1060,0,0,1092684,4670288,41.255302689472536,1532,2514,2344,1702,51465,600936,644840,2574,4446,2914,3386,5258,25.337718918639855,13.108333333204333,1872,1,399970,19380,642,0,1042,2102
927,0,1,1,0,53,0,990,0,0,876456,4192692,39.42080668885405,1524,2148,2118,1554,49585,569278,634030,2668,4252,2728,3262,4846,23.748684174075834,5.572104574801163,1584,0,365190,3120,564,0,1144,2134
928,0,1,1,0,58,0,2746,0,0,9417915,13859345,68.81133627535509,4735,6724,6724,4735,50576,638086,679064,2927,7662,2927,4916,9651,44.598206241955516,0.0,4735,0,1098520,0,1989,1,1808,938
929,0,1,1,0,58,0,3150,0,0,9263704,14710882,70.7248188403477,4786,7070,6854,5002,47936,658784,629374,2725,7943,3157,4793,10011,43.034869582700026,14.75401501978566,5218,1,1070428,31752,1852,0,2061,1089
930,0,1,1,0,58,0,3194,0,0,9248816,14804144,70.9365914038728,4790,7112,6870,5032,45472,659008,597226,2700,7974,3184,4780,10054,42.871902220452036,15.628168044365268,5274,1,1021496,38720,1838,0,2090,1104
931,0,1,1,0,62,0,4129,0,0,5122872,15958336,71.61005515987263,4918,6337,6127,5128,55926,728208,743768,2902,8240,3322,4111,9449,31.606961258558215,14.580022114409926,5338,1,1225592,25620,999,0,2016,2113
932,0,1,1,0,58,0,2671,0,0,9543030,13778631,68.5638388656878,4671,6761,6731,4701,54056,682923,679992,2901,7632,2961,4961,9692,45.05552130427524,5.501408174353464,4731,0,1090632,4050,2030,1,1770,901
933,0,1,1,0,58,0,3120,0,0,9386244,14714112,70.69653456853455,4780,7094,6876,4998,45305,650624,603520,2726,7942,3162,4822,10038,43.3358973600409,14.77111034157659,5216,1,1024590,33354,1878,0,2054,1066
934,0,1,1,0,58,0,3205,0,0,9365564,14908036,71.11258679024411,4780,7186,6909,5057,41778,622028,583704,2671,8005,3225,4800,10134,43.034869582700026,16.72519101875932,5334,1,1001286,41550,1852,0,2109,1096
935,0,1,1,0,60,0,3883,0,0,2899884,13743912,67.26068688320095,4148,5541,5165,4524,46631,671398,641018,2662,7562,3414,3679,8579,25.317977802344327,19.505053329598628,4900,1,954564,54896,641,0,1486,2397
936,0,1,1,0,59,0,3045,0,0,9525916,14658692,70.45565981523414,4782,7065,6883,4964,39601,587647,587647,2771,7917,3135,4872,10018,43.80639222761902,13.523606909196573,5146,1,987836,24206,1919,0,2011,1034
937,0,1,1,0,59,0,3132,0,0,9505408,14840896,70.8801805866774,4782,7158,6916,5024,39405,629202,546490,2712,7978,3196,4846,10112,43.497126341863094,15.58026706699109,5266,1,929440,39930,1892,0,2070,1062
938,0,1,1,0,59,0,3339,0,0,9277972,15218137,71.71471257698799,4782,7308,6947,5143,39744,612513,568128,2598,8102,3320,4763,10267,42.473521163190604,19.02095960654483,5504,1,987456,54511,1804,0,2184,1155
939,0,1,1,0,59,0,2527,0,0,5333624,11610080,62.41794613730894,3721,5440,5265,3896,48697,622820,694340,2805,6876,3155,4349,8420,37.0,13.271742520787742,4071,1,907768,18200,1369,0,916,1611
940,0,1,0,0,54,0,1067,1,0,1569060,5209355,43.53159771935783,1865,2753,2723,1895,53502,662509,610278,2719,4644,2779,3577,5502,28.77498913987632,5.483301264452448,1925,1,420690,4620,828,0,854,1921
941,0,1,1,0,58,0,2839,0,0,9691682,14247063,69.57729514719583,4781,6903,6843,4841,44344,709263,541512,2883,7784,3003,4945,9846,44.74371464239419,7.780166052320878,4901,1,890744,11760,2002,0,1898,941
942,0,1,1,0,59,0,3262,0,0,9436323,15168621,71.47726911403373,4779,7286,6956,5109,39964,611614,575986,2639,8078,3299,4816,10255,42.9767378938886,18.21392026637835,5439,1,991146,48510,1847,0,2140,1122
943,0,1,1,0,63,0,4221,0,0,6472120,17092896,73.59347797189639,4958,7069,6611,5416,50851,665916,760596,2698,8572,3614,4351,10225,34.56877203488721,21.45945979491743,5874,1,1305256,43510,1195,0,2260,1961
944,0,1,1,0,61,0,1913,0,0,10077648,13072320,65.36053855347276,3818,7085,6631,4272,50049,615060,761940,2606,7332,3514,5419,10145,48.569537778323564,21.76999046033596,4726,1,1063728,31326,2359,0,1212,701
945,0,1,1,0,59,0,3187,0,0,9588564,15106176,71.2460525222275,4776,7265,6965,5076,42098,645792,577344,2676,8052,3276,4865,10241,43.46262762420146,17.40082484267518,5376,1,984744,48300,1889,0,2100,1087
946,0,1,1,0,58,0,3885,0,0,8832744,16193364,74.11477585475112,5373,7221,7101,5493,50429,622028,704572,2828,8441,3068,4556,10169,40.099875311526844,11.06238981080611,5613,1,1312827,11880,1608,0,2545,1340
947,0,1,1,0,57,0,392,0,0,7327380,8296410,53.94441583704471,2740,5598,5428,2910,43548,650028,544541,2681,5761,3021,5369,8449,50.17967716117751,13.04122362038737,3080,0,555810,30090,2518,1,59,333
948,0,1,1,0,58,0,2690,0,0,9949016,14021238,69.0941386804988,4744,6888,6858,4774,49350,690195,616770,2907,7711,2967,5021,9825,45.65084884205331,5.478746393072713,4804,0,1002540,4890,2084,1,1837,853
949,0,1,1,0,62,0,4323,0,0,4590810,16156320,72.14568594171102,5055,6237,6087,5205,48375,667360,698400,2954,8309,3254,3986,9341,29.698484809834994,12.263881625621906,5355,1,1171125,18450,882,0,2101,2222
950,0,1,1,0,55,0,1054,0,0,1981280,5588590,45.05552130427524,2000,3036,3006,2030,52206,635943,622178,2723,4783,2783,3729,5789,31.240998703626616,5.478746393072713,2060,0,458780,4200,976,1,723,1777
951,0,1,1,0,53,0,660,0,0,931500,3599100,36.742346141747674,1308,2082,2040,1350,55926,623844,637174,2624,4016,2708,3356,4748,26.267851073127396,6.481658975540136,1392,0,322650,5166,690,1,1316,1976
952,0,1,1,0,59,0,2387,0,0,10125360,13569360,67.76429738438966,4468,6921,6797,4592,47952,656010,638280,2831,7547,3079,5160,9876,46.95742752749558,11.140052311785754,4716,0,991872,17608,2205,1,1637,750
953,0,1,1,0,59,0,2479,0,0,10101972,13734403,68.19824044651006,4584,6890,6823,4651,47508,655566,631942,2886,7604,3020,5125,9843,46.604720790924176,8.189452396126915,4718,0,995314,9648,2172,1,1698,781
954,0,1,1,0,62,0,710,0,0,10442976,11283174,60.049979184009715,2884,7224,6502,3606,46842,660219,694638,2407,6735,3851,6025,10353,53.81449618829484,26.924338350008153,4328,1,800532,87362,2896,0,477,233
955,0,1,1,0,59,0,3266,0,0,9737795,15444380,71.79832867135558,4755,7444,7044,5155,47304,647136,656124,2596,8151,3396,4885,10440,43.46262762420146,20.115280691545948,5555,1,1128945,52800,1889,0,2159,1107
956,0,1,0,0,57,0,565,1,0,5949674,7827942,52.32590180780452,2611,5038,4911,2738,55575,643275,706173,2732,5597,2986,5032,7897,46.61544808322666,11.403946263829544,2865,1,676286,12700,2173,0,121,686
957,0,1,1,0,59,0,2936,0,0,10130001,14814567,70.51950084905593,4731,7252,7010,4973,47530,729855,577926,2737,7952,3221,5016,10231,45.13313638558703,15.683350328452683,5215,1,964762,45980,2037,0,1994,942
958,0,1,0,0,59,0,1438,1,0,7668360,10578900,59.833101206606365,3322,5980,5722,3580,52650,664875,691470,2697,6535,3213,5097,8935,46.281745861624536,16.162841330949874,3838,1,837720,31476,2142,0,625,813
959,0,1,1,0,58,0,2573,0,0,10417068,14035428,69.0,4701,7009,6949,4761,46098,689832,580756,2888,7709,3008,5136,9957,46.776062254106,7.746504550744806,4821,1,937917,10620,2188,0,1813,760
960,0,1,1,0,62,0,4428,0,0,5660704,17189744,73.91887445030531,5158,6806,6500,5464,52437,714142,726726,2840,8610,3452,4182,9952,32.18695387886216,17.559910306586097,5770,1,1262184,39474,1036,0,2318,2110
961,0,1,1,0,53,0,606,0,0,1151416,3804494,37.656340767525464,1351,2297,2230,1418,52398,571479,660018,2616,4101,2750,3495,4980,28.495613697550013,8.2732738280919,1485,0,348828,5963,812,1,1265,1871
962,0,1,1,0,63,0,1054,0,0,10651907,12108447,61.91122676865643,3191,7254,6612,3833,43120,694980,619164,2517,6992,3801,5938,10413,52.716221412388805,25.496123344300578,4475,1,751268,104646,2779,0,674,380
963,0,1,1,0,59,0,2319,0,0,10554610,13605768,67.88961628997471,4524,6984,6899,4609,51282,681912,655344,2867,7561,3037,5242,9936,47.853944456021594,9.219544457292887,4694,0,1023198,12240,2290,1,1657,662
964,0,1,1,0,59,0,2500,0,0,10540941,13950550,68.76772498781678,4699,6988,6958,4729,45540,678500,584100,2920,7679,2980,5179,9938,47.21228653645151,5.572104574801163,4759,0,936342,5130,2229,1,1779,721
965,0,1,1,0,59,0,2544,0,0,10541185,14053327,68.98550572402873,4699,7034,6974,4759,45507,682143,581741,2893,7712,3013,5168,9987,47.06378650300037,7.780166052320878,4819,1,937523,10380,2215,0,1806,738
966,0,1,0,0,57,0,573,1,0,6556270,8191043,53.50700888668698,2683,5333,5153,2863,55404,695223,652308,2681,5724,3041,5151,8194,47.853944456021594,13.508622280193736,3043,1,652764,26460,2290,0,2,571
967,0,1,1,0,63,0,195,0,0,10588774,10612245,57.905094767213704,2704,7160,6511,3353,42048,693135,607680,2516,6518,3814,6323,10325,56.19608527290847,25.553505102404173,4002,1,643776,107085,3158,0,188,7
968,0,1,1,0,59,0,2292,0,0,10665205,13599864,67.87488489861327,4540,6989,6922,4607,49704,673056,643536,2885,7559,3019,5267,9941,48.11444689487763,8.18535277187245,4674,0,1004326,9849,2315,1,1655,637
969,0,1,1,0,59,0,2381,0,0,10661810,13783364,68.30812543175226,4636,6981,6951,4666,50160,673512,649880,2924,7620,2984,5239,9935,47.80167361086848,5.531194905403055,4696,0,1026520,4320,2285,1,1712,669
970,0,1,1,0,59,0,2471,0,0,10657130,13951152,68.74590896918885,4696,7011,6981,4726,49920,708480,614016,2922,7678,2982,5207,9963,47.486840282335066,5.501408174353464,4756,0,983008,5100,2255,1,1774,697
971,0,1,1,0,59,0,2515,0,0,10658196,14063492,68.96375859826666,4696,7057,6997,4756,49852,715594,609142,2897,7713,3017,5198,10014,47.3392015141785,7.864259938752337,4816,1,979736,10440,2241,0,1799,716
972,0,1,1,0,59,0,2559,0,0,10658422,14152202,69.18092222571191,4696,7103,7013,4786,51333,712637,629841,2867,7743,3047,5184,10060,47.19110085598767,9.52871847115494,4876,1,1019418,14940,2227,0,1829,730
973,0,1,1,0,63,0,417,0,0,10392658,9634136,54.97272050753901,2475,7008,6461,3022,53590,733240,742804,2641,6210,3735,6627,10196,58.642987645583,23.562433158736994,3569,1,704126,70563,3439,0,166,251
974,0,1,1,0,59,0,2263,0,0,10777964,13604820,67.85278181474949,4562,6987,6945,4604,48391,658965,641235,2913,7559,2997,5296,9942,48.38388161361178,6.488991180673202,4646,0,999068,5964,2341,1,1649,614
975,0,1,1,0,59,0,2398,0,0,10777424,13851994,68.51277253184256,4694,6990,6990,4694,52170,693485,655122,2951,7645,2951,5247,9941,47.916594202843754,0.0,4694,0,1042068,0,2296,1,1743,655
976,0,1,1,0,62,0,4561,0,0,4338152,16702959,73.27346040688948,5279,6267,6177,5369,53352,709308,727974,3021,8480,3201,3919,9378,28.42534080710379,9.489467114586667,5459,1,1256346,11340,808,0,2258,2303
977,0,1,1,0,59,0,2370,0,0,10894824,13850784,68.49817515817483,4662,7044,7014,4692,51282,681912,655344,2922,7644,2982,5274,9996,48.187135212627034,5.477225575051661,4722,0,1041624,4350,2322,1,1740,630
978,0,1,1,0,59,0,2414,0,0,10898376,13944066,68.71681017043792,4680,7072,7030,4722,51408,702814,637848,2911,7675,2995,5261,10025,48.041648597857254,6.484411467763075,4764,0,1019952,6720,2308,1,1769,645
979,0,1,1,0,62,0,4642,0,0,3011363,16288499,72.24264668462804,5092,5923,5796,5219,39600,702225,549296,2994,8340,3248,3698,9044,24.020824298928627,11.338657706151796,5346,1,918544,23876,577,0,2098,2544
980,0,1,1,0,57,0,870,0,0,4650775,7522925,51.332251070842396,2455,4580,4400,2635,44492,559580,648085,2675,5490,3035,4620,7435,42.01190307520001,13.621297777847555,2815,1,598145,16920,1765,0,220,1090
981,0,1,0,0,54,0,745,1,0,1767024,4813738,41.86884283091664,1693,2821,2761,1753,45084,560184,606866,2686,4499,2806,3754,5567,31.74901573277509,7.746504550744806,1813,1,387413,6780,1008,0,993,1738
982,0,1,1,0,62,0,4596,0,0,4959196,17175752,74.14849964766651,5280,6618,6400,5498,54480,709148,749760,2906,8622,3342,4026,9742,30.033314835362415,14.784666630329248,5716,1,1319520,25288,902,0,2374,2222
983,0,1,1,0,59,0,2618,0,0,10945883,14420921,69.76388750635962,4666,7317,7116,4867,47163,702231,589637,2762,7830,3164,5212,10280,47.4236228055175,14.21597824693016,5068,1,968533,35778,2249,0,1904,714
984,0,1,1,0,62,0,4682,0,0,3549744,16636752,73.11634564172364,5251,6105,6010,5346,46056,709536,628624,3017,8458,3207,3776,9217,25.768197453450252,9.753537202071987,5441,1,1079892,15675,664,0,2234,2448
985,0,1,1,0,58,0,688,0,0,8833728,9761136,57.758116312774604,3094,6226,5984,3336,46428,640794,620312,2684,6262,3168,5574,9152,51.45872132107443,15.666798299295518,3578,1,707232,34606,2648,0,410,278
986,0,1,1,0,56,0,945,0,0,3283000,6591795,48.425200051213004,2015,4075,3745,2345,54520,652152,660585,2481,5156,3141,4211,6886,37.416573867739416,18.246106732924538,2675,1,551075,42570,1400,0,466,1411
987,0,1,1,0,53,0,174,0,0,1187080,3134080,34.351128074635334,998,2368,2186,1180,49324,555104,626816,2474,3836,2838,3662,5024,31.71750305430741,13.535417710445202,1362,1,278480,18382,1006,0,1476,1650
988,0,1,1,0,61,0,4535,0,0,1332924,14743968,69.3685807840985,4678,5223,5089,4812,54500,667952,766000,2930,7876,3198,3341,8287,16.64331697709324,11.944787945152004,4946,1,1203000,11658,277,0,1748,2787
989,0,1,1,0,60,0,4094,0,0,2507535,13969890,68.0808343074613,4605,5206,5176,4635,45540,693220,596772,2984,7649,3044,3555,8220,23.259406699226016,5.514871952411144,4665,1,917730,5160,541,0,1621,2473
990,0,1,1,0,58,0,1087,0,0,8576070,10273674,59.34644049983116,3414,6065,5957,3522,43240,670910,548396,2809,6439,3025,5352,8982,49.345719165901315,10.414507905016443,3630,1,662136,19548,2435,0,605,482
991,0,1,1,0,60,0,4109,0,0,10436442,17831373,76.70071707617863,5588,7952,7657,5883,50500,757750,612262,2736,8914,3326,4805,10983,42.118879377305376,17.59585963107912,6178,1,1188366,54575,1774,0,2852,1257
992,0,1,1,0,62,0,4794,0,0,2956891,16778886,73.12318373812782,5131,6116,5900,5347,42780,721740,583668,2922,8485,3354,3691,9254,23.515952032609693,14.772041108151425,5563,1,994542,39744,553,0,2209,2585
993,0,1,1,0,61,0,4870,0,0,598800,15459020,70.63993204979744,4718,5382,5110,4990,54285,715638,728030,2826,8088,3370,3218,8480,10.954451150103322,16.552779992882012,5262,1,1172650,34544,120,0,1892,2978
994,0,1,1,0,60,0,4023,0,0,2836620,14053320,68.0808343074613,4508,5374,5247,4635,45248,679168,612464,2905,7667,3159,3644,8406,24.73863375370596,11.345682528620664,4762,1,936270,20320,612,0,1603,2420
995,0,1,1,0,59,0,2024,0,0,11578356,13603884,67.54257916307313,4532,7130,7100,4562,39400,596400,587454,2952,7544,3012,5520,10112,50.37856687124,5.5503012171862105,4592,0,898714,4080,2538,1,1580,444
996,0,1,1,0,60,0,4192,0,0,2439780,14280720,68.62943974709395,4615,5323,5228,4710,41391,664008,573048,2937,7742,3127,3550,8355,22.759613353482084,9.886585106410566,4805,1,890190,16055,518,0,1678,2514
997,0,1,1,0,57,0,568,0,0,8979444,9539424,57.39337940912697,2975,6339,6020,3294,49088,602368,683456,2577,6190,3215,5622,9235,52.21110992882645,17.944920888727758,3613,1,777384,31262,2726,0,398,170
998,0,1,1,0,56,0,707,0,0,7178544,8697376,55.281099844341014,3056,5405,5405,3056,52836,677348,631812,2846,5902,2846,5195,8251,48.46648326421054,0.0,3056,0,678432,0,2349,1,210,497
999,0,1,1,0,59,0,1863,0,0,11667448,13393640,66.87301398920195,4472,7081,7081,4472,43164,593010,652910,2995,7467,2995,5604,10076,51.07837115648854,0.0,4472,0,974896,0,2609,1,1477,386
1000,0,1,0,0,55,0,809,1,0,3353880,6372600,47.74934554525329,2022,4009,3751,2280,56168,665210,659620,2537,5075,3053,4266,6804,38.353617821530214,16.07779984738014,2538,1,538080,34056,1471,0,515,1324
1001,0,1,1,0,59,0,3104,0,0,11273897,15516705,72.46378405796926,5127,7522,7398,5251,55932,700335,697380,2831,8206,3079,5102,10477,46.33573135281238,11.150165195519998,5375,0,1239236,16244,2147,1,2296,808
1002,0,1,1,0,62,0,4781,0,0,4728102,17608104,74.97999733262199,5298,6787,6463,5622,50175,704700,698436,2808,8754,3456,3973,9919,29.0,18.026732228150312,5946,1,1253706,44712,841,0,2490,2291
1003,0,1,1,0,64,0,367,0,0,11441484,11573611,59.75784467331465,3294,7052,6775,3571,53714,813491,693574,2964,6812,3518,6445,10293,56.60388679233962,16.77726033594994,3848,1,764194,46813,3204,0,330,37
1004,0,1,1,0,61,0,1511,0,0,11921910,13114530,65.49809157525127,4248,7111,7069,4290,49532,620571,745908,3015,7347,3099,5836,10168,52.716221412388805,6.63067838716079,4332,1,1046760,3318,2779,0,1233,278
1005,0,1,1,0,59,0,2383,0,0,11819010,14378910,69.49820141557622,4521,7586,7277,4830,53100,669825,702572,2668,7807,3286,5424,10563,49.467160824126545,17.5932892842364,5139,0,1139880,37080,2447,1,1853,530
1006,0,1,1,0,59,0,2092,0,0,7703040,11939712,63.340350488452465,3802,6142,5932,4012,52664,675552,690432,2766,6988,3186,4896,9118,43.81780460041329,14.569686477165773,4222,0,930784,26670,1920,1,1036,1056
1007,0,1,1,0,55,0,450,0,0,2244600,4793700,41.71330722922842,1632,3138,3030,1740,49060,606100,614365,2647,4495,2863,4045,5893,35.91656999213594,10.392304845413264,1848,1,388020,14148,1290,0,1015,1465
1008,0,1,1,0,63,0,5024,0,0,1468377,16751160,72.80796659706958,5006,5873,5578,5301,53037,786840,673080,2865,8461,3455,3437,9033,16.64331697709324,17.350500409780906,5596,1,1129113,50445,277,0,2141,2883
1009,0,1,1,0,59,0,1854,0,0,8128675,11594450,62.64982043070834,3858,6063,5996,3925,49060,649880,658742,2887,6879,3021,5025,9017,45.50824101193101,8.222029866439447,3992,0,875275,8844,2071,1,971,883
1010,0,1,1,0,55,0,619,0,0,3003570,5754600,45.4972526643093,2040,3551,3521,2070,50976,656080,600480,2750,4850,2810,4231,6331,38.09199390948182,5.478746393072713,2100,1,447120,4710,1451,0,710,1329
1011,0,1,1,0,58,0,3182,0,0,11749560,15787800,73.28028384224504,5340,7588,7558,5370,52658,685020,664440,2910,8310,2970,5128,10528,46.776062254106,5.477225575051661,5400,0,1213620,4290,2188,1,2430,752
1012,0,1,1,0,58,0,3313,0,0,11722620,16068780,73.89181280764467,5400,7667,7607,5460,52580,703377,647460,2883,8403,3003,5090,10610,46.33573135281238,7.748117453886108,5520,0,1201200,9360,2147,1,2517,796
1013,0,1,1,0,61,0,4587,0,0,9381960,18965880,78.23042886243178,5516,8257,7653,6120,36192,718968,483444,2495,9219,3703,4632,11356,39.153543900903784,24.99665532885036,6724,1,954720,129256,1533,0,3021,1566
1014,0,1,1,0,57,0,827,0,0,7262820,9090300,56.0357029044876,2928,5665,5453,3140,40404,642690,526890,2683,6035,3107,5208,8560,48.093658625644196,14.799265660112745,3352,1,571480,37948,2313,0,245,582
1015,0,1,1,0,55,0,544,0,0,2843280,5502420,44.49719092257398,1980,3416,3416,1980,48150,625275,594706,2779,4759,2779,4215,6195,37.89459064299283,0.0,1980,1,423720,0,1436,0,799,1343
1016,0,1,0,0,51,0,427,1,0,1262010,2413350,30.495901363953813,712,2505,2287,930,42552,511215,560520,2377,3525,2813,3952,5100,36.837480912787726,14.962824993041291,1148,0,200880,23980,1357,1,1665,1238
1017,0,1,1,0,59,0,3021,0,0,11927520,15581280,72.6636084983398,5220,7599,7539,5280,54056,687583,684632,2891,8231,3011,5210,10550,47.52893855326458,7.789174875971784,5340,1,1224960,7980,2259,0,2329,692
1018,0,1,1,0,60,0,3926,0,0,10792560,17398950,76.0920495189872,5466,7978,7654,5790,44213,742235,537895,2681,8795,3329,4869,10983,43.174066289845804,18.1523751951612,6114,1,1036410,66744,1864,0,2785,1141
1019,0,1,1,0,60,0,3955,0,0,3743016,14398040,68.87670143089025,4702,5575,5533,4744,47632,695015,631280,2993,7779,3077,3824,8610,28.089143810376278,6.484411467763075,4786,1,986752,6636,789,0,1709,2246
1020,0,1,1,0,62,0,1154,0,0,12369167,12890933,64.35060217278468,4111,7158,7128,4141,49712,647504,744007,3083,7254,3143,6100,10271,54.653453687758834,5.623413251903491,4171,1,989699,2850,2987,0,1028,126
1021,0,1,1,0,61,0,1568,0,0,12540473,13599113,66.41535966928132,4284,7381,7254,4411,36616,613517,567272,2956,7494,3210,5926,10464,53.319789947073126,11.526200699097002,4538,1,811624,18923,2843,0,1328,240
1022,0,1,1,0,60,0,4341,0,0,9961660,18297049,77.46612162745726,5464,8198,7661,6001,41968,743956,524428,2512,9050,3586,4709,11247,40.74309757492672,23.421259050468745,6538,1,1032172,112770,1660,0,2952,1389
1023,0,1,1,0,62,0,5055,0,0,2042056,17075064,73.69531871157082,5118,6120,5807,5431,51736,729408,701112,2831,8575,3457,3520,9264,19.390719429665317,17.77856918136495,5744,0,1211113,45385,376,0,2287,2768
1024,0,1,1,0,60,0,3305,0,0,5827794,13958322,67.66091929614909,4109,6320,5851,4578,51574,734809,652486,2580,7627,3518,4322,9369,35.679125549822544,21.67707851891802,5047,1,979692,76916,1273,0,1529,1776
1025,0,1,1,0,63,0,4944,0,0,4647616,18233840,75.84194090343416,5228,7084,6560,5752,44512,678380,659360,2646,8922,3694,3978,10254,28.42534080710379,22.97332421994392,6276,1,1196416,73884,808,0,2582,2362
1026,0,1,1,0,61,0,3625,0,0,5029416,14341584,68.52736679604726,4373,6090,5767,4696,51525,699366,687150,2731,7750,3377,4125,9144,32.72613634390714,18.010835548057898,5019,1,1056600,44897,1071,0,1642,1983
1027,0,1,1,0,61,0,4033,0,0,3956784,14799148,69.63476143421474,4764,5750,5665,4849,41860,701960,555464,2967,7901,3137,3868,8802,28.5657137141714,9.257905235465769,4934,1,882518,15895,816,0,1797,2236
1028,0,1,1,0,59,0,1869,0,0,8597716,11943724,63.340350488452465,3802,6365,6155,4012,44600,663871,595400,2767,6989,3187,5120,9342,46.292547996410825,14.55997679978325,4222,1,802400,34020,2143,0,1035,834
1029,0,1,1,0,56,0,692,0,0,4897884,7310622,50.85272854036448,2462,4604,4480,2586,47637,568227,669999,2703,5413,2951,4721,7431,43.520110293977886,11.247002231352543,2710,1,612882,10912,1894,0,241,933
1030,0,1,1,0,56,0,434,0,0,3196512,5652418,44.9221548904324,1910,3710,3602,2018,42218,585409,565802,2693,4819,2909,4385,6511,39.7994974842648,10.471798365004291,2126,1,407636,15444,1584,0,783,1217
1031,0,1,1,0,53,0,370,0,0,1604175,2905035,33.090784215548595,678,2977,2560,1095,49980,541212,649985,2236,3748,3070,4118,5630,38.27531841800928,20.760790946127436,1512,1,268275,32943,1465,0,1558,1188
1032,0,1,1,0,63,0,416,0,0,12318992,11860940,61.02458520956943,3682,7074,7032,3724,55144,777140,719810,3143,6909,3227,6493,10259,57.51521537819362,6.484411467763075,3766,1,841624,6342,3308,0,539,123
1033,0,1,1,0,62,0,4960,0,0,1494825,16285725,72.42237223399962,5155,5620,5530,5245,47424,707940,645840,3015,8350,3195,3390,8725,16.881943016134134,9.52871847115494,5335,0,1090960,14310,285,0,2140,2820
1034,0,1,1,0,58,0,1102,0,0,9777024,10887372,61.04096984812741,3544,6532,6350,3726,52858,625308,721734,2740,6648,3104,5546,9454,51.22499389946279,13.710242244549764,3908,1,920322,16198,2624,0,804,298
1035,0,1,1,0,59,0,2644,0,0,12783660,15294186,71.65193647069142,5014,7744,7624,5134,52664,691128,676233,2859,8113,3099,5469,10723,49.8998997994986,11.07142749248319,5254,1,1165418,16800,2490,0,2155,489
1036,0,1,1,0,63,0,5059,0,0,3029600,17735200,74.83314773547883,5192,6549,6141,5600,48364,715742,677738,2759,8767,3575,3708,9716,23.259406699226016,20.224473758321142,6008,1,1198400,60792,541,0,2433,2626
1037,0,1,0,0,57,0,761,1,0,6785276,8731674,54.89080068645383,2663,5615,5265,3013,53655,710010,634662,2548,5911,3248,5150,8513,47.45524207081869,18.86755284149355,3363,1,659847,56700,2252,0,115,646
1038,0,1,1,0,63,0,4886,0,0,7633095,19355567,78.3007024234138,5301,8206,7376,6131,49500,789250,625086,2327,9288,3987,4402,11363,35.2845575287547,28.835822517131295,6961,1,1213938,156040,1245,0,2974,1912
1039,0,1,1,0,56,0,511,0,0,4359432,6638226,48.569537778323564,2264,4302,4207,2359,43382,613452,559986,2719,5173,2909,4662,7116,42.988370520409354,9.833118885374187,2454,1,469441,14820,1848,0,455,966
1040,0,1,1,0,64,0,409,0,0,12127812,10577764,57.30619512757761,2913,7348,6977,3284,52836,766598,715062,2850,6505,3592,6914,10569,60.77005841695399,19.292769673819564,3655,0,729048,56021,3693,1,63,472
1041,0,1,1,0,61,0,3778,0,0,5318040,14965510,69.7853852894716,4540,6292,5962,4870,52206,694498,709863,2743,7943,3403,4165,9365,33.04542328371661,18.22582436353501,5200,1,1124970,42240,1092,0,1797,1981
1042,0,1,1,0,60,0,2086,0,0,13336955,14585933,69.57729514719583,4564,7873,7596,4841,45012,560418,729146,2736,7854,3290,5768,10886,52.48809388804284,16.756894653954035,5118,1,1171522,16620,2755,0,1828,258
1043,0,1,1,0,59,0,2999,0,0,12593256,15836568,73.15736463268753,5322,7735,7705,5352,50635,730873,606595,2929,8311,2989,5312,10694,48.507731342539614,5.478746393072713,5382,0,1097160,5400,2353,1,2393,606
1044,0,1,1,0,59,0,3882,0,0,11147563,17281334,76.1774244773345,5526,8001,7724,5803,43719,735566,527106,2701,8781,3255,4899,10979,43.829214001622255,16.657181906610685,6080,1,1027131,57339,1921,0,2825,1057
1045,0,1,1,0,57,0,528,0,0,6679908,8231112,53.49766350038102,2700,5358,5196,2862,54516,664356,678736,2714,5738,3038,5210,8234,48.31148931672465,12.82193224364006,3024,1,675432,20412,2334,0,14,542
1046,0,1,1,0,63,0,4988,0,0,7182885,19486730,78.45380806563821,5384,8093,7322,6155,51623,782002,661694,2395,9321,3937,4333,11259,34.161381705077446,27.7725370503978,6926,1,1286395,134925,1167,0,2989,1999
1047,0,1,1,0,55,0,75,0,0,2853004,4564476,40.64480286580315,1222,3809,3379,1652,51385,594045,660357,2333,4415,3193,4490,6572,41.557189510360296,20.741178046223347,2082,1,394828,44720,1727,0,1111,1036
1048,0,1,1,0,59,0,3695,0,0,11567514,16953870,75.61745830163825,5538,7921,7741,5718,49862,690845,634510,2785,8683,3145,4988,10886,44.97777228809804,13.417339462953525,5898,0,1223652,28440,2023,1,2753,942
1049,0,1,1,0,60,0,3423,0,0,6739758,14583525,69.4334213473598,4337,6703,6219,4821,47560,620125,701800,2541,7846,3509,4423,9728,37.389838191679836,22.07856016806699,5305,1,1118472,48884,1398,0,1796,1627
1050,0,1,1,0,53,0,596,0,0,2137260,3203502,34.55430508634199,1004,3174,2984,1194,52320,584894,643920,2493,3877,2873,4473,5857,42.30839160261236,13.800152809104778,1384,0,286560,20140,1790,1,1489,893
1051,0,1,1,0,57,0,393,0,0,7141108,8239740,53.62835071116769,2781,5454,5359,2876,55328,707655,641760,2770,5741,2960,5348,8319,49.82971001320397,9.785443037298442,2971,1,644224,14630,2483,0,11,382
1052,0,1,1,0,59,0,3006,0,0,7885216,13970240,68.46897107449476,4476,6582,6370,4688,50621,664540,676460,2768,7668,3192,4662,9562,41.012193308819754,14.573887982115558,4900,0,1064176,27560,1682,0,1708,1298
1053,0,1,1,0,57,0,379,0,0,7678596,8488587,54.47017532558529,2843,5679,5555,2967,55176,692362,652308,2737,5828,2985,5449,8540,50.872389367907616,11.157371872753709,3091,1,676476,18104,2588,0,106,273
1054,0,1,1,0,53,0,644,0,0,2320565,3308565,35.14256678161116,1127,3222,3114,1235,50127,581343,618849,2571,3914,2787,4558,5901,43.347433603386484,10.410300245868545,1343,0,285285,12636,1879,1,1444,800
1055,0,1,1,0,62,0,4801,0,0,8964006,19568606,78.98101037591252,5536,8377,7675,6238,50430,771702,643085,2435,9375,3839,4574,11514,37.907782842049734,26.719572813254164,6940,1,1278790,125658,1437,0,3101,1700
1056,0,1,1,0,59,0,2977,0,0,8162430,13988700,68.62943974709395,4560,6593,6443,4710,50055,632610,697950,2820,7680,3120,4703,9563,41.6293165929973,12.248673275118406,4860,0,1106850,16050,1733,0,1740,1237
1057,0,1,1,0,58,0,1385,0,0,9930746,11474832,62.601916903558156,3919,6453,6453,3919,43120,644160,573888,2928,6847,2928,5462,9381,50.33885179461288,0.0,3919,1,768124,0,2534,0,991,394
1058,0,1,1,0,59,0,3243,0,0,12647110,16451750,74.36396977031282,5500,7847,7817,5530,52140,705075,654500,2945,8505,3005,5262,10822,47.82258880487337,5.477225575051661,5560,0,1216600,4620,2287,1,2555,688
1059,0,1,1,0,59,0,3869,0,0,11347050,17375534,76.28237017817419,5629,7959,7769,5819,45934,710668,576298,2796,8805,3176,4936,10945,44.15880433163923,13.791774304255147,6009,0,1123067,35150,1950,1,2833,1036
1060,0,1,1,0,54,0,545,0,0,2848134,3904329,37.907782842049734,1352,3504,3419,1437,50561,589589,633061,2632,4154,2802,4699,6221,44.51965857910413,9.245276771705237,1522,1,334821,9690,1982,0,1280,735
1061,0,1,1,0,63,0,4947,0,0,4669738,18178006,75.8814865431615,5542,6785,6569,5758,54253,754523,716639,2941,8915,3373,3968,9942,28.478061731796284,14.708265585304046,5974,1,1307066,31536,811,0,2601,2346
1062,0,1,1,0,59,0,2916,0,0,13209292,16003772,73.30757123244501,5307,7899,7832,5374,48175,699830,610490,2911,8352,3045,5436,10877,49.57822102496216,8.187175587434018,5441,0,1101670,11390,2458,1,2396,520
1063,0,1,1,0,59,0,1933,0,0,9489090,12392030,64.7688196588451,4153,6499,6457,4195,50176,661696,661696,2912,7149,2996,5216,9453,47.56048780237646,6.48074069840786,4237,0,939680,5628,2262,0,1241,692
1064,0,1,1,0,62,0,4305,0,0,6134986,16872570,73.71566997592845,5307,6690,6563,5434,41829,679995,593055,2978,8539,3232,4234,9795,33.60059523282288,11.286854851303866,5561,1,1037894,21209,1129,0,2329,1976
1065,0,1,1,0,62,0,4586,0,0,9311640,18995990,78.16648898345122,5451,8293,7634,6110,46494,764814,587601,2450,9219,3768,4633,11402,39.03844259188627,25.823382019543985,6769,1,1154790,128505,1524,0,3001,1585
1066,0,1,1,0,62,0,4436,0,0,6302976,17299776,74.61903242471053,5386,6882,6700,5568,48995,742573,636935,2925,8675,3289,4239,9989,33.645207682521445,13.505375795393066,5750,0,1141440,31486,1132,0,2461,1975
1067,0,1,1,0,59,0,2357,0,0,9144408,13086192,66.51315659326356,4394,6521,6491,4424,49056,662592,647802,2928,7382,2988,5025,9479,45.46427168667722,5.477225575051661,4454,0,968856,4230,2067,0,1466,891
1068,0,1,1,0,53,0,1015,0,0,2556450,3121560,34.20526275297414,1008,3517,3355,1170,49416,568284,618976,2506,3838,2830,4853,6185,46.74398357008097,12.797192222025664,1332,1,271440,17982,2185,0,1498,483
1069,0,1,1,0,62,0,4385,0,0,6695216,17388576,74.72616676907762,5344,7023,6783,5584,48480,747360,629028,2874,8698,3354,4313,10137,34.62657938636157,15.51614992893484,5824,1,1127968,42480,1199,0,2470,1915
1070,0,1,1,0,60,0,2809,0,0,8710472,14023673,68.3593446428504,4493,6717,6537,4673,45800,600200,687229,2821,7674,3181,4865,9718,43.174066289845804,13.4968426155072,4853,1,1070117,17460,1864,0,1672,1137
1071,0,1,1,0,59,0,2403,0,0,9180738,13217943,66.79071791798619,4461,6519,6519,4461,49720,651860,669638,2963,7424,2963,5021,9482,45.36518488885502,0.0,4461,0,1008186,0,2058,0,1498,905
1072,0,1,1,0,60,0,3439,0,0,11823500,16719820,74.59222479588607,5522,7731,7689,5564,51170,715190,646075,2963,8569,3047,5130,10736,46.09772228646444,6.48074069840786,5606,0,1196260,6762,2125,1,2559,880
1073,0,1,1,0,60,0,2484,0,0,13558432,15425024,71.61005515987263,5098,7802,7772,5128,53100,709888,676800,2978,8136,3038,5652,10810,51.419840528729765,5.483301264452448,5158,1,1153800,4380,2644,0,2120,364
1074,0,1,1,0,62,0,3873,0,0,7576558,16531636,72.81483365359011,4876,7157,6731,5302,55822,770146,704668,2692,8420,3544,4547,10275,37.8021163428716,20.65479218496691,5728,1,1198252,63900,1429,0,2184,1689
1075,0,1,1,0,60,0,1303,0,0,10082870,11756860,62.39390995922599,3593,6783,6483,3893,40392,597960,616080,2720,6913,3320,5610,9803,50.89204259999789,17.60608396191918,4193,1,794172,37800,2590,0,873,430
1076,0,1,1,0,58,0,424,0,0,7506560,8720160,54.405882034941776,2750,5706,5496,2960,32918,642228,444846,2736,5906,3156,5482,8652,50.35871324805669,14.921685106015376,3170,1,446960,42840,2536,0,14,410
1077,0,1,1,0,57,0,388,0,0,5261568,6098444,45.91296113299599,1933,4779,4604,2108,55224,676962,682748,2718,5001,3068,5389,7672,49.95998398718719,13.271742520787742,2283,1,497488,22400,2496,0,785,397
1078,0,1,1,0,62,0,3898,0,0,7911483,16682326,73.287106642301,4886,7329,6844,5371,50400,698850,695744,2621,8477,3591,4579,10435,38.379682124790975,22.025547126695304,5856,0,1203104,65960,1473,0,2265,1633
1079,0,1,1,0,58,0,831,0,0,8896492,10082234,58.540584213005594,3360,6090,6023,3427,47443,667834,614878,2875,6369,3009,5538,9032,50.950956811427986,8.261328108906353,3494,1,716243,10519,2596,0,485,346
1080,0,1,1,0,58,0,795,0,0,8671806,9908229,58.0430874437258,3261,6051,5943,3369,50370,676430,644079,2833,6310,3049,5515,8992,50.73460357586329,10.424232425346673,3477,1,737811,15876,2574,0,428,367
1081,0,1,1,0,61,0,3115,0,0,8867154,15078588,70.12845356914696,4635,7004,6721,4918,55575,757302,689850,2783,7984,3349,4869,10070,42.46174749112429,16.890250550427055,5201,1,1106550,43299,1803,0,1852,1263
1082,0,1,1,0,61,0,2754,0,0,9212760,14374920,68.62943974709395,4583,6793,6666,4710,54918,689752,741636,2925,7762,3179,5008,9845,44.22668877499196,11.444189009687426,4837,1,1144530,13843,1956,0,1658,1096
1083,0,1,1,0,63,0,4281,0,0,7988830,18098538,75.40557008603542,5126,7651,7091,5686,45333,658881,697077,2623,8869,3743,4588,10834,37.48332962798263,23.80907641253268,6246,1,1245234,67760,1405,0,2503,1778
1084,0,1,1,0,60,0,2829,0,0,12648946,15799388,72.40165743959182,5212,7685,7655,5242,53590,693220,702262,2984,8256,3044,5427,10699,49.122296363260546,5.501408174353464,5272,0,1221386,3870,2413,1,2228,601
1085,0,1,1,0,60,0,3675,0,0,11143504,17215104,75.15317691222374,5390,7879,7621,5648,47970,749808,594360,2790,8696,3306,5021,10927,44.41846462902562,16.097014461702834,5906,0,1101360,49020,1973,1,2600,1075
1086,0,1,1,0,59,0,1081,0,0,9439140,10833600,60.4979338490167,3630,6269,6239,3660,52416,663040,692640,2930,6620,2990,5539,9229,50.78385570237849,5.514871952411144,3690,1,856440,3630,2579,0,700,381
1087,0,1,1,0,58,0,663,0,0,6925864,8740136,54.62600113499065,2850,5439,5305,2984,45308,705889,550652,2795,5913,3063,5250,8368,48.176757881783615,11.837739672445862,3118,1,560992,25862,2321,0,55,608
1088,0,1,1,0,60,0,3550,0,0,11373096,16992612,74.73954776421918,5385,7823,7622,5586,48400,736164,608400,2841,8628,3243,5078,10865,45.12205669071391,14.202732991080085,5787,0,1117200,36582,2036,1,2544,1006
1089,0,1,1,0,58,0,282,0,0,4178520,5548464,43.68065933568311,1784,4222,4098,1908,45144,628128,607772,2784,4816,3032,5098,7130,46.79743582719036,11.147098121756736,2032,1,398772,17732,2190,0,1000,718
1090,0,1,1,0,57,0,579,0,0,3791182,4837199,40.97560249709576,1451,4165,3937,1679,49006,616534,659749,2653,4560,3109,5139,7046,47.51841748206689,15.106925328558159,1907,1,384491,26448,2258,0,1202,623
1091,0,1,1,0,57,0,522,0,0,3769560,4903824,41.20679555607303,1464,4152,3918,1698,49946,638248,652688,2654,4586,3122,5108,7040,47.11687595755899,15.302712601452019,1932,1,383748,29952,2220,0,1190,668
1092,0,1,1,0,55,0,1727,0,0,2389038,2523274,30.116440692751194,464,3984,3541,907,50167,631514,614822,2339,3689,3225,5416,6766,51.32250968142536,21.05359536021371,1350,1,200447,62906,2634,0,1875,148
1093,0,1,1,0,64,0,4454,0,0,9419735,19537674,77.58221445666526,5339,8264,7584,6019,52212,740088,743334,2566,9265,3926,4811,11510,39.56008088970496,26.21117075979415,6699,1,1378351,90440,1565,0,2773,1681
1094,0,1,1,0,64,0,4251,0,0,9279760,18793120,76.4198926981712,5282,7987,7429,5840,54054,743358,753012,2660,9058,3776,4807,11205,39.8622628559895,23.714416318784423,6398,1,1366560,71982,1589,0,2622,1629
1095,0,1,1,0,62,0,4116,0,0,10741536,18643560,76.99350621968063,5482,8186,7740,5928,46435,789395,581825,2699,9073,3591,4957,11331,42.567593307585526,21.30355327129107,6374,1,1096680,90092,1812,0,2783,1333
1096,0,1,1,0,59,0,1355,0,0,9688404,11496288,62.153036933041335,3833,6401,6371,3863,46440,639840,642816,2946,6839,3006,5484,9377,50.07993610219566,5.5965095842615735,3893,1,834408,3990,2508,0,887,468
1097,0,1,1,0,63,0,3973,0,0,9717930,18094672,75.38567503179898,5281,7795,7393,5683,54502,729136,757792,2782,8867,3586,4894,10979,41.352146256270665,20.090015465703637,6085,1,1352554,48642,1710,0,2499,1474
1098,0,1,1,0,55,0,1776,0,0,1987012,2169064,27.892651361962706,254,3856,3332,778,51736,621724,646816,2264,3566,3312,5342,6644,50.53711507397311,22.995396004158902,1302,1,180496,63928,2554,0,2010,234
1099,0,1,1,0,60,0,1537,0,0,10864248,12604355,64.4437739428721,3961,6961,6769,4153,52704,655560,740540,2843,7188,3227,5651,9996,51.146847410177685,13.914767815144769,4345,1,1013332,18624,2616,0,1118,419
1100,0,1,1,0,60,0,1502,0,0,9396335,11728814,62.505999712027645,3877,6342,6312,3907,47443,681454,627418,2972,6909,3032,5407,9344,49.040799340956916,5.501408174353464,3937,0,816563,4680,2405,1,905,597
1101,0,1,1,0,58,0,94,0,0,3676515,5784960,44.328320518603,1755,4046,3836,1965,54054,680064,688896,2734,4909,3154,4815,6990,43.255057507764334,14.5098253853819,2175,1,459810,27090,1871,0,979,1073
1102,0,1,1,0,55,0,1782,0,0,1743768,1957878,26.49528259898354,302,3586,3186,702,50398,621947,630314,2389,3491,3189,5273,6375,49.839743177508446,20.097287826063965,1102,1,158652,52400,2484,0,2087,305
1103,0,1,1,0,61,0,2874,0,0,10729960,15438106,70.80960386840192,5014,7154,7154,5014,50398,686617,695854,3079,8093,3079,5219,10233,46.26013402488151,0.0,5014,0,1133164,0,2140,1,1935,939
1104,0,1,1,0,62,0,1479,0,0,14072292,14200056,67.54998149518622,4155,8055,7647,4563,43338,578832,725096,2704,7675,3520,6196,11167,55.53377350765928,20.478577825785838,4971,1,1063179,29376,3084,0,1451,28
1105,0,1,1,0,61,0,3325,0,0,12209124,16933452,74.3774159271482,5490,7781,7739,5532,49887,737701,633627,3019,8593,3103,5268,10842,46.97871858618538,6.481658975540136,5574,0,1145124,7266,2207,1,2471,854
1106,0,1,1,0,60,0,1556,0,0,8973741,11684841,62.23343153000644,3765,6298,6190,3873,45998,657706,636587,2909,6890,3125,5334,9315,48.13522618623496,10.435690064413366,3981,1,817203,15336,2317,0,856,700
1107,0,1,1,0,56,0,1426,0,0,1931475,2383992,29.13760456866693,549,3424,3124,849,56635,659880,676728,2508,3657,3108,5083,6232,47.69696007084728,17.322239866749324,1149,1,204609,36000,2275,0,1959,533
1108,0,1,1,0,65,0,4339,0,0,12329526,20710833,79.3536388579629,5485,9067,8255,6297,48906,812383,651222,2477,9586,4101,5247,12356,44.24929377967517,28.708031600635454,7109,1,1246806,151844,1958,0,3008,1331
1109,0,1,1,0,58,0,496,0,0,3480420,6268590,46.151923036857305,2100,3794,3764,2130,52192,685719,659232,2913,5073,2973,4577,6737,40.422765862815474,5.478746393072713,2160,1,477120,4320,1634,0,813,1309
1110,0,1,1,0,58,0,503,0,0,2598540,4007520,37.14835124201342,1272,3371,3263,1380,55696,685344,685344,2796,4284,3012,4787,6275,43.393547907494266,10.392304845413264,1488,1,325680,14040,1883,0,1524,1021
1111,0,1,1,0,63,0,3326,0,0,11880360,17304480,74.09453421137081,5430,7714,7654,5490,50576,687136,731264,3092,8642,3212,5316,10866,46.51881339845203,7.754559014766193,5550,1,1273680,6960,2164,0,2338,988
1112,0,1,1,0,64,0,3904,0,0,12901440,19454840,77.7174369109018,5433,8783,8176,6040,50652,811692,647421,2614,9261,3828,5357,12004,46.216880033165374,25.00999400559385,6647,1,1214040,112902,2136,0,2819,1085
1113,0,1,1,0,60,0,1477,0,0,5567874,9719697,56.66568626602876,2969,5187,4945,3211,49464,693183,653832,2785,6238,3269,4761,8214,41.641325627314025,15.557411596845162,3453,1,693576,36300,1734,0,184,1293
1114,0,1,1,0,56,0,1074,0,0,1964632,2711732,31.04834939252005,874,3092,3002,964,54948,641364,677933,2723,3777,2903,4851,5905,45.14421336118285,9.522065445080457,1054,1,232324,10260,2038,0,1849,775
1115,0,1,1,0,62,0,1514,0,0,13958295,14186745,67.59437846448475,4272,7921,7624,4569,51296,695520,711045,2808,7674,3402,6160,11026,55.27205442174191,17.27747974441116,4866,1,1046301,38016,3055,0,1464,50
1116,0,1,0,1,64,0,505,0,0,14555396,13149176,63.84355879804947,3545,8178,7647,4076,45526,664556,712946,2695,7302,3757,6797,11404,59.75784467331465,23.092337171997734,4607,1,900796,62127,3571,0,850,345
1117,0,1,1,0,59,0,575,0,0,3009666,6039792,45.232731511594565,2016,3547,3517,2046,49648,684864,631728,2922,4998,2982,4423,6499,38.353617821530214,5.483301264452448,2076,1,437844,4680,1471,0,906,1481
1118,0,1,1,0,63,0,3565,0,0,13367250,18532800,76.48529270389177,5420,8565,8135,5850,44750,792000,567072,2738,9018,3598,5453,11733,47.80167361086848,21.00062085574041,6280,1,1047150,89010,2285,0,2682,883
1119,0,1,1,0,63,0,3223,0,0,12702900,17524479,74.31688906298487,5311,8035,7823,5523,47380,653638,729790,2961,8696,3385,5473,11208,47.958315233127195,14.610577240468603,5735,1,1270290,22048,2300,0,2350,873
1120,0,1,1,0,63,0,3108,0,0,12631725,17146548,73.70888684548153,5223,7968,7758,5433,46440,678540,681696,2946,8589,3366,5481,11124,48.218253804964775,14.496631529664223,5643,1,1173528,27930,2325,0,2277,831
1121,0,1,1,0,60,0,1586,0,0,5531475,9949450,57.227615711297986,3057,5182,4964,3275,49504,680512,671398,2820,6313,3256,4727,8220,41.09744517606904,14.817050448756712,3493,1,723775,30084,1689,0,237,1349
1122,0,1,1,0,57,0,303,0,0,2295054,3933399,37.027017163147235,1179,3237,3045,1371,48048,596752,662739,2677,4240,3061,4543,6106,40.91454509095757,13.914767815144769,1563,1,316701,20352,1674,0,1498,1195
1123,0,1,1,0,54,0,1863,0,0,1135948,1329548,22.0,389,2926,2831,484,43228,587858,554894,2652,3231,2842,5094,5673,48.4458460551573,9.785443037298442,579,1,97768,14060,2347,0,2263,400
1124,0,1,1,0,54,0,2370,0,0,592344,620616,15.0996688705415,94,2960,2826,228,38412,538956,528068,2588,2950,2856,5320,5682,50.97057974949863,11.622136368289254,362,1,44232,18358,2598,0,2494,124
1125,0,1,1,0,61,0,2521,0,0,13671882,15909193,71.88184749990779,4884,8096,7813,5167,48548,705091,652748,2796,8246,3362,5725,11175,51.43928459844674,16.83288680365703,5450,0,1095404,43865,2646,1,2088,433
1126,0,1,1,0,62,0,2280,0,0,12815449,15283537,69.97856814768362,4812,7599,7514,4897,49494,683499,705346,3036,8018,3206,5738,10720,51.15662224971465,9.219863456115478,4982,1,1106722,10710,2617,0,1776,504
1127,0,1,1,0,63,0,3549,0,0,14044612,18775491,76.94803441284255,5422,8792,8293,5921,52164,799092,656397,2672,9092,3670,5543,11963,48.703182647543684,22.53389725832691,6420,1,1225647,89321,2372,0,2750,799
1128,0,1,1,0,60,0,1388,0,0,3502380,8088830,51.86520991955976,2393,4289,3992,2690,48364,679582,643498,2710,5697,3304,4309,7296,36.08323710533743,17.234908893302006,2987,0,575660,43956,1302,1,317,1705
1129,0,1,1,0,61,0,1865,0,0,14049350,14768600,69.24593850905626,4645,7875,7725,4795,39776,696080,542080,2930,7875,3230,6010,10955,54.12947441089743,12.312788037888811,4945,0,843920,28350,2930,1,1715,150
1130,0,1,1,0,64,0,3168,0,0,13796388,18074730,74.97999733262199,5214,8484,8076,5622,48399,704085,710515,2807,8837,3623,5669,11699,49.53786430600334,20.333829685633,6030,1,1242462,53856,2454,0,2407,761
1131,0,1,1,0,62,0,1100,0,0,14297541,13558842,66.11353870426238,4131,7882,7642,4371,53074,691746,738276,2862,7473,3342,6373,10984,57.19265687131522,15.540719891657039,4611,1,1040298,27360,3271,0,1269,169
1132,0,1,1,0,62,0,3123,0,0,14204038,17605561,75.1065909225016,5407,8393,8159,5641,50922,767766,646047,2887,8762,3355,5639,11514,50.17967716117751,15.455495813746403,5875,1,1167687,41184,2518,0,2520,603
1133,0,1,1,0,64,0,3418,0,0,14335035,18972668,76.5702292016943,5310,8861,8308,5863,51525,741044,728100,2683,9099,3789,5681,12097,49.44694126030446,23.66343242519659,6416,1,1319175,76867,2445,0,2627,791
1134,0,1,1,0,61,0,2614,0,0,14148075,16247808,72.72551134230683,5181,8072,7964,5289,50176,688128,688128,2964,8361,3180,5747,11144,51.720402163943,10.406531168715494,5397,0,1184736,14472,2675,1,2217,397
1135,0,1,1,0,61,0,1814,0,0,5033751,10167312,57.68015256567895,3080,5087,4840,3327,50310,715104,657040,2809,6383,3303,4569,8143,38.897300677553446,15.724020412848395,3574,0,715305,38532,1513,1,271,1543
1136,0,1,1,0,60,0,1529,0,0,3405546,8335716,52.55473337388365,2462,4295,3995,2762,49680,694140,651888,2718,5780,3318,4251,7313,35.11409973215888,17.322865108115078,3062,0,596592,45600,1233,1,256,1785
1137,0,1,1,0,61,0,1905,0,0,5782726,10822262,59.48949487094339,3479,5233,5173,3539,49665,706398,657470,2998,6597,3118,4692,8291,40.422765862815474,7.746504550744806,3599,0,760885,9120,1634,1,481,1424
1138,0,1,1,0,61,0,1062,0,0,14394600,13482942,66.04543890383347,4180,7844,7662,4362,48530,652201,710930,2909,7453,3273,6391,10935,57.445626465380286,13.51672826780758,4544,0,1003260,20384,3300,1,1271,209
1139,0,1,1,0,65,0,67,0,0,14518788,12430107,61.45730225123781,3086,8312,7621,3777,47304,720729,710856,2600,7068,3982,7135,11603,62.0,26.299257090564605,4468,1,815832,95358,3844,0,486,553
1140,0,1,1,0,61,0,2517,0,0,14588640,16299360,72.6636084983398,5195,8128,8043,5280,45652,623574,697662,3002,8367,3172,5850,11215,52.5642464038057,9.344583777936014,5365,0,1193280,8755,2763,1,2193,324
1141,0,1,1,0,60,0,1462,0,0,2662583,7640127,50.18964036531842,2344,3751,3576,2519,49950,682425,673326,2858,5552,3208,4090,6784,32.51153641401772,13.295739742362471,2694,0,559218,24150,1057,1,514,1976
1142,0,1,1,0,56,0,1790,0,0,1232451,1501137,23.043437243605826,127,3256,2852,531,37410,607805,491898,2423,3358,3231,5148,6083,48.176757881783615,20.323682117934858,935,1,92394,72720,2321,0,2296,506
1143,0,1,1,0,61,0,2547,0,0,14736178,16347532,72.92461861401813,5251,8156,8089,5318,48805,660910,697798,3007,8392,3141,5845,11230,52.640288753007425,8.19672545160342,5385,0,1207186,8107,2771,1,2244,303
1144,0,1,1,0,63,0,2371,0,0,14407142,16296434,71.84705978674423,4950,8165,7953,5162,51975,710325,729267,2945,8319,3369,5948,11322,52.82991576748916,14.560543731343575,5374,1,1192422,26712,2791,0,2005,366
1145,0,1,1,0,60,0,1232,0,0,2333153,6829734,47.57099956906519,2129,3428,3294,2263,49494,682068,660942,2884,5281,3152,4049,6446,32.109188716004645,11.59192030070629,2397,1,495597,19162,1031,0,755,1987
1146,0,1,1,0,59,0,777,0,0,2185380,5678154,43.78355855797927,1675,3299,3057,1917,52398,630906,728652,2720,4879,3204,4102,6261,33.76388603226827,15.907899214107001,2159,1,471582,21538,1140,0,1045,1822
1147,0,1,1,0,63,0,1815,0,0,14617414,15260735,69.54854419756032,4447,8249,7859,4837,44238,690945,637310,2765,7992,3545,6177,11404,54.97272050753901,19.816746717257573,5227,1,977074,59670,3022,0,1682,133
1148,0,1,1,0,62,0,2130,0,0,14682304,15746166,71.00704190430693,4719,8277,7954,5042,47064,662076,693306,2800,8165,3446,6035,11400,53.96295025292817,18.12027404475674,5365,1,1119324,39729,2912,0,1919,211
1149,0,1,1,0,61,0,1406,0,0,14637891,14210742,67.7716754994297,4459,7914,7780,4593,48741,714714,652834,2960,7687,3228,6281,11008,56.45352070508977,11.576481526871955,4727,0,969123,21172,3187,1,1499,93
1150,0,1,1,0,57,0,207,0,0,2064328,4417384,39.293765408777,1544,2881,2881,1544,49416,663752,609393,2861,4405,2861,4198,5742,36.565010597564445,0.0,1544,1,328872,0,1337,0,1317,1524
1151,0,1,1,0,62,0,2121,0,0,14903352,15809808,71.16178749862878,4764,8307,8007,5064,49042,677474,705572,2822,8186,3422,6065,11429,54.249423960075376,17.474752997463312,5364,1,1144464,37200,2943,0,1942,179
1152,0,1,1,0,60,0,1647,0,0,2319940,7769755,50.547007824400445,2272,3746,3463,2555,51744,702471,681184,2758,5596,3324,3949,6787,30.133038346638727,16.879500345925535,2838,0,572320,40469,908,1,486,2133
1153,0,1,1,0,57,0,1667,0,0,1412130,1777986,24.859605789312106,168,3353,2903,618,42460,632940,555261,2427,3495,3327,5162,6230,47.80167361086848,21.649019872714156,1068,1,119274,74700,2285,0,2259,592
1154,0,1,1,0,54,0,2182,0,0,586608,660176,15.556349186104045,2,2906,2666,242,51815,586520,657448,2488,2970,2968,5152,5634,49.23413450036468,15.598413419701659,482,1,58322,24240,2424,0,2486,304
1155,0,1,1,0,54,0,2136,0,0,570240,651360,15.491933384829668,28,2828,2616,240,47800,542800,648646,2502,2954,2926,5090,5542,48.744230427815765,14.664067678903075,452,1,57360,17808,2376,0,2474,338
1156,0,1,1,0,62,0,1961,0,0,15058626,15671535,70.59036761485238,4599,8389,8005,4983,43340,619565,691900,2761,8128,3529,6167,11534,54.97272050753901,19.805171584921965,5367,1,1096260,40704,3022,0,1838,123
1157,0,1,1,0,54,0,2116,0,0,570636,657514,15.556349186104045,24,2818,2600,242,48111,551551,643929,2499,2959,2935,5075,5535,48.55924216871593,14.90638655193511,460,1,57354,19838,2358,0,2475,359
1158,0,1,1,0,55,0,2140,0,0,795549,888573,17.97220075561143,10,3099,2786,323,49234,566706,657489,2438,3074,3064,5214,5850,49.628620774710235,17.86833257284478,636,1,77197,28796,2463,0,2428,288
1159,0,1,1,0,54,0,2098,0,0,504888,590998,14.7648230602334,17,2735,2534,218,46256,531356,639796,2510,2929,2912,5027,5446,48.12483766206386,14.296051987722665,419,1,51448,16884,2316,0,2493,395
1160,0,1,1,0,53,0,2106,0,0,367416,436590,12.727922061357855,12,2580,2430,162,47897,568645,611765,2545,2857,2845,4963,5275,47.62352359916263,12.30152264982736,312,1,36774,17250,2268,0,2533,427
1161,0,1,1,0,53,0,2113,0,0,239868,290088,10.392304845413264,18,2419,2329,108,48841,593606,593606,2596,2794,2776,4907,5105,47.12748667179272,9.52871847115494,198,1,23868,12060,2221,0,2578,465
1162,0,1,1,0,61,0,2186,0,0,5518632,11401980,60.69596362197407,3589,5277,5182,3684,47276,690185,656140,3000,6779,3190,4593,8372,38.704004960727254,9.764028217990806,3779,1,781008,14060,1498,0,589,1597
1163,0,1,1,0,54,0,2061,0,0,802660,917230,18.303005217723125,12,3054,2731,335,51246,599622,640692,2415,3073,3061,5134,5792,48.948953002081666,18.12527223750085,658,1,78390,37145,2396,0,2403,342
1164,0,1,1,0,54,0,2059,0,0,742436,855429,17.69180601295413,18,2980,2685,313,50394,606726,620391,2438,3046,3028,5105,5713,48.703182647543684,17.344801852485208,608,1,71051,38055,2372,0,2420,361
1165,0,1,1,0,57,0,797,0,0,1913358,5321010,42.871902220452036,1808,2909,2879,1838,47089,628215,628215,2865,4733,2925,3936,5804,32.264531609803356,5.477225575051661,1868,0,398846,4050,1041,0,1057,1854
1166,0,1,1,0,54,0,2040,0,0,487296,585360,14.696938456699069,26,2662,2472,216,47532,552840,631430,2520,2926,2900,4966,5372,47.49736834815167,13.906130088123188,406,1,50328,18620,2256,0,2494,454
1167,0,1,1,0,62,0,1281,0,0,15148840,14309785,67.7126280689208,4458,8016,7889,4585,47083,745919,614837,2994,7706,3248,6425,11137,57.48043145279966,11.269427669584644,4712,1,903245,23114,3304,0,1464,183
1168,0,1,1,0,62,0,2806,0,0,16564616,17923120,75.55130707009641,5425,8893,8610,5708,44835,769300,574620,2857,8848,3423,6042,12033,53.87021440462252,16.901912320993087,5991,0,1044564,56883,2902,1,2568,238
1169,0,1,1,0,57,0,671,0,0,1910946,3117516,32.96968304366907,1057,2875,2845,1087,46648,562128,682584,2838,3955,2898,4626,5743,41.92851058647326,5.791460926441345,1117,1,258706,2400,1758,0,1781,1110
1170,0,1,1,0,54,0,2001,0,0,855406,992242,19.026297590440446,20,3067,2725,362,49910,594797,630430,2399,3103,3083,5104,5808,48.61069841094653,18.668183522734903,704,1,83260,40356,2363,0,2379,378
1171,0,1,1,0,58,0,1030,0,0,1843079,2736040,30.610455730027933,727,3114,2904,937,45288,648240,595680,2710,3857,3130,4887,6034,44.35087372307337,15.141611593901967,1147,1,191148,32970,1967,0,1983,953
1172,0,1,1,0,54,0,1971,0,0,882472,1031744,19.390719429665317,25,3074,2723,376,48990,584472,631120,2393,3120,3095,5091,5818,48.4458460551573,18.918562322693283,727,1,86480,40014,2347,0,2368,397
1173,0,1,1,0,54,0,1998,0,0,322200,405450,12.24744871391589,30,2418,2298,150,49032,583848,613581,2583,2853,2823,4851,5121,46.34652090502587,11.180339887498949,270,1,34050,14520,2148,0,2553,555
1174,0,1,1,0,62,0,2154,0,0,16004520,16265520,72.24956747275377,5067,8439,8286,5220,49060,685520,694868,2963,8336,3269,6182,11555,55.37147279962851,12.50242329522575,5373,0,1164060,20196,3066,1,2104,50
1175,0,1,1,0,56,0,1963,0,0,1222620,1395079,22.293496809607955,12,3442,2957,497,44037,530523,654031,2322,3304,3292,5267,6249,49.59838707054898,22.346937654639326,982,1,115801,38315,2460,0,2310,347
1176,0,1,1,0,54,0,1941,0,0,909090,1071720,19.748417658131498,30,3081,2721,390,48048,571584,634788,2388,3138,3108,5079,5829,48.28043081829324,19.170990317821552,750,1,90090,38160,2331,0,2358,417
1177,0,1,1,0,54,0,1946,0,0,830160,987480,18.973665961010276,30,2996,2666,360,50370,600717,630890,2413,3103,3073,5049,5739,48.02082881417188,18.355741004011293,690,1,82800,40260,2306,0,2383,437
1178,0,1,1,0,54,0,1934,0,0,747120,903870,18.16590212458495,30,2894,2594,330,50076,586146,640926,2439,3069,3039,5003,5633,47.58150901348127,17.520299927895543,630,1,77220,33000,2264,0,2409,475
1179,0,1,1,0,54,0,1964,0,0,317100,406350,12.24744871391589,30,2384,2264,150,49476,587853,617652,2589,2859,2829,4823,5093,45.9782557302906,11.290330617691032,270,1,34200,14400,2114,0,2559,595
1180,0,1,1,0,63,0,2357,0,0,13537770,15983140,71.00704190430693,4934,7835,7727,5042,49533,751290,662530,3062,8212,3278,5855,11005,51.81698563212646,10.39586690415236,5150,0,1053778,17928,2685,1,1872,485
1181,0,1,1,0,63,0,2346,0,0,8825707,13782252,66.08328079022712,3917,6838,6388,4367,52670,725880,722724,2706,7523,3606,5177,9994,44.955533585978046,21.225867634148774,4817,1,1000043,60750,2021,0,1211,1135
1182,0,1,1,0,58,0,1346,0,0,1640880,6228560,46.04345773288535,2090,2924,2894,2120,44676,643422,599352,2908,5058,2968,3712,5862,27.820855486487112,5.490867587491313,2150,0,432480,4560,774,0,818,2164
1183,0,1,0,0,58,0,1206,1,0,1812016,2542752,29.5296461204668,501,3321,2950,872,48391,650268,632772,2545,3788,3287,4994,6237,45.58508528016593,19.595452799071197,1243,1,189224,52682,2078,0,2044,838
1184,0,1,1,0,55,0,1902,0,0,1058400,1250550,21.213203435596427,30,3222,2802,450,43524,516894,650286,2359,3229,3199,5131,6001,48.49742261192856,20.80687604350673,870,1,105300,30240,2352,0,2329,427
1185,0,1,1,0,54,0,1937,0,0,450870,571200,14.491376746189438,30,2537,2357,210,49268,592960,614720,2540,2930,2900,4867,5257,46.33573135281238,13.740794290386374,390,1,47460,22500,2147,0,2510,573
1186,0,1,1,0,62,0,830,0,0,15343496,13610604,65.98484674529449,4269,7963,7878,4354,43848,634578,675216,3041,7480,3211,6650,11089,59.36328831862332,9.257905235465769,4439,0,940464,10030,3524,1,1228,398
1187,0,1,1,0,64,0,1394,0,0,15722867,15170276,68.72408602520662,4446,8329,8052,4723,41249,793364,536404,2935,7935,3489,6541,11541,57.697486947006624,16.925060583549502,5000,1,788741,59832,3329,0,1511,117
1188,0,1,1,0,62,0,2339,0,0,16767092,16832228,73.67496182557545,5428,8517,8517,5428,50032,731836,657412,3101,8529,3101,6190,11618,55.57877292636101,0.0,5428,0,1150736,0,3089,1,2327,12
1189,0,1,1,0,55,0,1887,0,0,1051650,1253250,21.213203435596427,29,3208,2787,450,42090,509655,640550,2364,3235,3206,5122,5993,48.342527861087284,20.859849302077112,871,1,103500,30733,2337,0,2335,448
1190,0,1,1,0,55,0,1891,0,0,970620,1165080,20.493901531919196,29,3122,2731,420,42136,510416,635246,2383,3194,3165,5085,5896,48.07286136688766,20.08942963545438,811,1,96180,29325,2311,0,2354,463
1191,0,1,1,0,55,0,1899,0,0,813240,992160,18.973665961010276,29,2950,2619,360,43618,531908,622856,2425,3116,3087,5015,5706,47.52893855326458,18.527850005310874,691,1,81360,30783,2259,0,2396,497
1192,0,1,1,0,54,0,1921,0,0,447510,571830,14.491376746189438,28,2523,2341,210,49268,593614,615398,2541,2933,2905,4854,5246,46.16275555033516,13.810035044505925,392,1,47460,22932,2131,0,2513,592
1193,0,1,1,0,54,0,1935,0,0,246600,324960,10.954451150103322,25,2270,2175,120,48438,560556,633672,2613,2828,2803,4763,4978,45.332107826572546,10.097077230934874,215,1,28080,9500,2055,0,2588,653
1194,0,1,1,0,59,0,891,0,0,1793862,5496720,43.09292285283048,1601,3079,2823,1857,36774,671920,479520,2704,4817,3216,3926,6039,31.080540535840107,16.162545278392606,2113,1,300834,52224,966,0,1103,1994
1195,0,1,1,0,56,0,1864,0,0,1213625,1439487,22.60530911091463,27,3370,2886,511,42872,518328,656361,2333,3328,3301,5192,6187,48.73397172404482,22.465152322341293,995,1,119063,33880,2375,0,2306,442
1196,0,1,1,0,55,0,1887,0,0,734158,911574,18.193405398660254,25,2855,2549,331,40140,495720,614142,2448,3085,3060,4972,5609,47.095647357266465,17.828497216432403,637,1,73813,23868,2218,0,2423,536
1197,0,1,1,0,54,0,1898,0,0,517880,660902,15.556349186104045,24,2600,2382,242,48138,581703,617206,2513,2973,2949,4871,5331,46.26013402488151,15.082574892107019,460,1,54692,25942,2140,0,2489,591
1198,0,1,1,0,54,0,1907,0,0,380198,495404,13.490737563232042,20,2433,2271,182,49713,596118,617894,2560,2904,2884,4811,5155,45.70557952810576,13.043815312217163,344,1,41314,20250,2089,0,2540,633
1199,0,1,1,0,54,0,1911,0,0,315792,415701,12.36931687685298,19,2351,2217,153,49680,586872,624910,2583,2870,2851,4781,5068,45.43126676640219,11.902759595463513,287,1,35190,15812,2064,0,2564,653
1200,0,1,1,0,64,0,2436,0,0,17630860,17921540,74.76630257007497,5420,8914,8744,5590,53592,743792,740586,3036,8796,3376,6360,12120,56.16048432839589,13.06370857217659,5760,1,1291290,22950,3154,0,2384,52
1201,0,1,1,0,57,0,1839,0,0,1472526,1718550,24.55605831561735,26,3622,3045,603,45472,558600,661200,2273,3453,3427,5292,6472,49.416596402423345,24.561054324661033,1180,1,139896,50776,2442,0,2247,408
1202,0,1,1,0,55,0,1864,0,0,813585,1012510,19.1049731745428,23,2936,2594,365,41360,521512,610280,2432,3139,3116,5003,5710,47.21228653645151,18.922216461064046,707,1,80300,31464,2229,0,2409,545
1203,0,1,1,0,55,0,1868,0,0,738005,925605,18.303005217723125,22,2851,2538,335,40275,494577,621675,2450,3098,3076,4966,5614,46.93612681080534,18.0858887887696,648,1,75375,23162,2203,0,2428,560
1204,0,1,1,0,54,0,1881,0,0,457582,594922,14.7648230602334,17,2518,2317,218,49476,592193,622212,2528,2947,2930,4828,5247,45.81484475582123,14.473434607486176,419,1,49704,24321,2099,0,2511,630
1205,0,1,1,0,54,0,1888,0,0,270948,363810,11.575836902790225,7,2283,2156,134,48805,583725,616305,2588,2849,2842,4737,4998,44.96665431183423,11.513609011867374,261,1,30418,15113,2022,0,2581,693
1206,0,1,1,0,62,0,2380,0,0,17436864,17215584,74.3774159271482,5424,8792,8684,5532,48906,768664,616176,3004,8644,3220,6264,11904,56.142675390472796,10.39586690415236,5640,0,1095336,20196,3152,1,2420,40
1207,0,1,1,0,55,0,1849,0,0,676706,863254,17.69180601295413,18,2770,2475,313,42042,501956,637098,2463,3071,3053,4920,5528,46.49731175025068,17.578764026878485,608,1,72303,20355,2162,0,2445,596
1208,0,1,1,0,54,0,1851,0,0,608760,782895,16.881943016134134,17,2689,2421,285,44969,530171,640051,2479,3032,3015,4883,5436,46.216880033165374,16.715296746065686,553,1,66405,22244,2136,0,2462,611
1209,0,1,1,0,54,0,1854,0,0,251587,344678,11.269427669584644,3,2232,2108,127,47520,586224,597080,2590,2841,2838,4695,4946,44.50842616853577,11.428142902795917,251,1,27940,16120,1981,0,2587,733
1210,0,1,1,0,63,0,1721,0,0,16585946,15842542,70.87312607751969,4662,8686,8325,5023,47196,652878,719112,2793,8177,3515,6456,11840,57.463031594234565,19.161545165485144,5384,1,1145244,39349,3302,0,1869,148
1211,0,1,1,0,62,0,2339,0,0,17567822,17175831,74.30343195303969,5426,8798,8703,5521,48755,762195,619089,3016,8632,3206,6293,11909,56.40921910468182,9.749223385359247,5616,0,1098679,17575,3182,1,2410,71
1212,0,1,1,0,64,0,2493,0,0,18182044,18273068,75.4254598925323,5471,9103,8885,5689,55221,761244,748396,2994,8901,3430,6408,12315,56.53317610041028,14.798957133179547,5907,1,1325537,29430,3196,0,2477,16
1213,0,1,1,0,63,0,2423,0,0,9858858,14545706,67.65352910233139,4026,7282,6731,4577,52800,699160,762720,2627,7755,3729,5332,10460,46.411205543489174,23.507411757268272,5128,1,1098480,59508,2154,0,1399,1024
1214,0,1,1,0,54,0,1815,0,0,294750,407850,12.24744871391589,16,2249,2115,150,50624,614494,609056,2585,2869,2853,4684,4968,44.328320518603,11.902759595463513,284,1,33600,18358,1965,0,2569,754
1215,0,1,1,0,63,0,952,0,0,16030448,14249788,67.14164132637808,4418,8154,8064,4508,43470,727030,597429,3071,7669,3251,6717,11315,59.632206063502295,9.625480693201963,4598,1,852012,16290,3556,0,1347,395
1216,0,1,1,0,62,0,2127,0,0,17561620,16742796,73.39618518697004,5357,8677,8647,5387,51067,711732,693084,3078,8495,3138,6368,11785,57.09640969448079,5.483301264452448,5417,0,1201301,4230,3260,1,2279,152
1217,0,1,1,0,63,0,2452,0,0,8871765,14030285,66.68583057891684,4052,6837,6442,4447,54056,731960,735115,2760,7602,3550,5150,9992,44.66542286825459,19.888635799143973,4842,1,1036151,51745,1995,0,1292,1160
1218,0,1,1,0,57,0,1765,0,0,1496766,1797246,25.019992006393608,26,3617,3017,626,45312,551232,677556,2271,3497,3471,5262,6488,48.8978527135906,25.129927615000625,1226,1,147736,46200,2391,0,2245,480
1219,0,1,1,0,56,0,1768,0,0,1249169,1533735,23.259406699226016,17,3374,2850,541,50128,589680,683235,2311,3376,3359,5144,6209,48.05205510693585,23.464415321277425,1065,1,130381,48208,2309,0,2294,526
1220,0,1,1,0,56,0,1770,0,0,1017739,1283713,21.37755832643195,14,3127,2684,457,49266,581463,668542,2366,3266,3252,5036,5936,47.19110085598767,21.597190436801256,900,1,108766,42085,2227,0,2352,582
1221,0,1,1,0,63,0,2462,0,0,10421664,14953026,68.45436436049933,4229,7367,6910,4686,52206,737121,721166,2734,7877,3648,5415,10558,47.15930449020638,21.383313691101645,5143,1,1059036,63980,2224,0,1495,967
1222,0,1,1,0,58,0,152,0,0,2102528,4454120,39.08964057138413,1486,2946,2904,1528,56643,690855,696685,2873,4443,2957,4291,5861,37.094473981982816,6.570697549716149,1570,1,365192,5166,1376,0,1387,1539
1223,0,1,1,0,55,0,1743,0,0,900720,1167183,20.42057785666214,9,2985,2577,417,48760,593388,643770,2391,3216,3207,4959,5784,46.475800154489,20.68593000877657,825,1,95910,46104,2160,0,2382,639
1224,0,1,1,0,55,0,1747,0,0,628218,841806,17.4928556845359,5,2660,2359,306,44693,514437,657489,2450,3057,3052,4804,5411,45.31004303683677,17.605763289500135,607,1,73134,19866,2053,0,2445,698
1225,0,1,1,0,54,0,1755,0,0,430114,595358,14.7648230602334,6,2403,2191,218,50268,581703,644516,2519,2949,2943,4704,5134,44.41846462902562,14.843417048062975,430,1,51448,22260,1973,0,2513,758
1226,0,1,1,0,54,0,1727,0,0,573420,783180,16.881943016134134,8,2574,2297,285,44154,544104,612804,2471,3033,3025,4760,5322,44.85532298401161,16.940303019898575,562,1,63555,28531,2012,0,2463,736
1227,0,1,1,0,54,0,1730,0,0,508416,701696,16.0,9,2489,2242,256,45000,548200,616725,2494,2997,2988,4727,5230,44.56455991031439,16.02271768373319,503,1,57600,25441,1986,0,2485,755
1228,0,1,1,0,54,0,1731,0,0,388332,547725,14.177446878757825,11,2323,2133,201,47034,547725,637650,2535,2926,2915,4657,5048,43.95452195167182,13.981742743041671,391,1,47034,17670,1932,0,2524,793
1229,0,1,1,0,54,0,1729,0,0,281850,406350,12.24744871391589,16,2163,2029,150,50718,579726,642033,2575,2859,2843,4588,4872,43.347433603386484,11.709062801829726,284,1,35550,14070,1879,0,2559,830
1230,0,1,1,0,64,0,2823,0,0,18651060,19127460,77.1686464828819,5496,9546,9087,5955,53410,786940,700216,2753,9167,3671,6344,12758,55.96427431853289,21.435487888755123,6414,1,1298190,74817,3132,0,2743,80
1231,0,1,1,0,56,0,1695,0,0,1084050,1396890,22.24859546128699,7,3173,2685,495,42486,547468,618018,2334,3317,3310,5012,5995,46.79743582719036,22.608057215046703,983,1,108405,50264,2190,0,2327,632
1232,0,1,1,0,56,0,1700,0,0,860064,1144848,20.199009876724155,8,2916,2516,408,39960,519110,606096,2406,3214,3206,4914,5722,45.91296113299599,20.500897708040075,808,1,88128,38000,2108,0,2398,698
1233,0,1,1,0,55,0,1703,0,0,654398,893095,17.97220075561143,10,2662,2349,323,36023,450695,611065,2452,3088,3078,4791,5427,45.0111097397076,18.0621346656467,636,1,71383,17528,2026,0,2442,739
1234,0,1,1,0,55,0,1704,0,0,528496,737000,16.3707055437449,12,2496,2240,268,40176,511500,594000,2494,3018,3006,4722,5246,44.40720662234904,16.299181598019334,524,1,57888,24320,1972,0,2482,778
1235,0,1,1,0,55,0,1676,0,0,494592,704256,16.0,14,2430,2188,256,41216,506184,616224,2509,3007,2993,4683,5181,43.95452195167182,15.935956838970615,498,1,57344,19844,1932,0,2495,819
1236,0,1,1,0,64,0,463,0,0,14849868,13131228,63.968742366877905,3786,8027,7721,4092,47322,635382,766951,2903,7301,3515,6838,11236,60.241181927316134,17.79877705424555,4398,0,977988,24786,3629,1,883,420
1237,0,1,1,0,62,0,885,0,0,15166674,13722852,66.04543890383347,4332,7869,7839,4362,45888,751894,604032,3116,7508,3176,6623,11015,58.966091951222275,5.531194905403055,4392,0,837504,5580,3477,1,1216,331
1238,0,1,1,0,63,0,2490,0,0,16317504,17417376,73.97296803562772,5382,8544,8454,5472,53124,741639,725724,3093,8655,3273,6165,11727,54.607691765904185,9.491514370027666,5562,0,1247616,12600,2982,1,2289,201
1239,0,1,1,0,58,0,316,0,0,2153612,4766378,40.422765862815474,1604,2982,2952,1634,45548,688412,562981,2887,4551,2947,4235,5899,36.30426972134269,5.478746393072713,1664,1,315362,5490,1318,0,1283,1599
1240,0,1,1,0,55,0,1651,0,0,700350,975100,18.708286933869708,15,2686,2351,350,36023,454118,615706,2451,3136,3121,4787,5472,44.73253849269008,18.752950266564092,685,1,77350,18760,2001,0,2436,785
1241,0,1,1,0,63,0,2974,0,0,18210192,19189170,77.49838707999025,5540,9504,9038,6006,51623,789165,667755,2729,9201,3661,6227,12699,55.06359959174482,21.725487843157854,6472,1,1255254,81550,3032,0,2811,163
1242,0,1,1,0,55,0,1627,0,0,720018,1012514,19.026297590440446,12,2701,2351,362,37632,469896,626528,2447,3159,3147,4786,5498,44.598206241955516,19.218641904279263,712,1,81088,20650,1989,0,2435,808
1243,0,1,1,0,55,0,1621,0,0,484782,710274,16.06237840420901,16,2379,2137,258,41170,492787,633190,2511,3011,2995,4632,5132,43.347433603386484,15.907899214107001,500,1,59340,16214,1879,0,2495,874
1244,0,1,1,0,55,0,1598,0,0,622728,902016,18.0,15,2555,2246,324,40228,495552,629184,2475,3108,3093,4706,5339,43.840620433565945,18.065230972321885,633,1,73224,21939,1922,0,2460,862
1245,0,1,1,0,61,0,2624,0,0,2739200,10573312,58.51495535331117,3242,4406,4224,3424,55596,697888,759648,2906,6512,3270,3888,7494,28.284271247461902,13.643008239482691,3606,1,842304,18564,800,0,336,2288
1246,0,1,1,0,54,0,1560,0,0,432000,658800,15.491933384829668,28,2252,2040,240,41907,502335,628605,2533,2985,2957,4545,4997,42.42640687119285,15.029763150103136,452,1,54960,15688,1800,0,2505,945
1247,0,1,1,0,54,0,1565,0,0,314100,490320,13.416407864998739,27,2078,1925,180,44352,523008,629244,2571,2904,2877,4469,4802,41.773197148410844,12.712009014913464,333,1,41580,12852,1745,0,2544,979
1248,0,1,1,0,54,0,1571,0,0,202920,324240,10.954451150103322,25,1906,1811,120,48278,545804,645778,2607,2822,2797,4393,4608,41.12177038990418,9.981197033715764,215,1,28680,8265,1691,0,2582,1011
1249,0,1,1,0,63,0,2866,0,0,17078387,18454646,76.20367445208925,5535,9020,8748,5807,48265,778610,626066,2906,8985,3450,6119,12198,54.230987451824994,16.67678278604415,6079,0,1143979,50864,2941,1,2629,237
1250,0,1,1,0,62,0,2595,0,0,6019894,12752563,63.8200595424354,3911,5713,5551,4073,54208,757702,701344,2969,7204,3293,4609,8844,38.44476557348217,12.730952129625969,4235,1,912352,24786,1478,0,942,1653
1251,0,1,1,0,56,0,1539,0,0,685900,1011161,19.0,26,2596,2261,361,39388,481772,641429,2466,3162,3136,4701,5397,43.58898943540674,18.881829665372216,696,1,82669,19765,1900,0,2440,901
1252,0,1,1,0,55,0,1544,0,0,493952,751536,16.492422502470642,25,2335,2088,272,42180,511155,629964,2516,3035,3010,4579,5098,42.61455150532503,16.278820596099706,519,1,62016,19513,1816,0,2491,947
1253,0,1,1,0,54,0,1549,0,0,373332,580880,14.560219778561036,22,2163,1973,212,42320,504160,630200,2550,2952,2930,4501,4903,41.96427051671457,14.20569896357591,402,1,48760,14250,1761,0,2528,979
1254,0,1,1,0,59,0,2286,0,0,684472,7628798,50.53711507397311,2326,3050,2822,2554,42946,651166,588439,2759,5541,3215,3255,6037,16.3707055437449,15.113881704305674,2782,1,503138,36024,268,0,433,2719
1255,0,1,1,0,58,0,540,0,0,2195136,5232096,42.14261501141095,1734,3054,3012,1776,42230,603930,606876,2904,4722,2988,4182,6000,35.156791662493895,6.570697549716149,1818,1,365856,5586,1236,0,1170,1710
1256,0,1,1,0,55,0,1528,0,0,499985,767290,16.64331697709324,21,2338,2082,277,41175,506910,623250,2514,3047,3026,4575,5108,42.485291572496,16.63419925117372,533,1,62325,20480,1805,0,2493,965
1257,0,1,1,0,54,0,1532,0,0,327180,519840,13.784048752090222,15,2087,1912,190,42224,497952,634752,2561,2926,2911,4458,4823,41.49698784249286,13.650484186641688,365,1,44080,12075,1722,0,2546,1014
1258,0,1,1,0,56,0,1509,0,0,633042,958626,18.49324200890693,19,2516,2193,342,35011,440071,625069,2480,3145,3126,4654,5319,43.02324952859791,18.720683165352195,665,1,76266,14535,1851,0,2461,952
1259,0,1,1,0,54,0,1509,0,0,343710,551343,14.177446878757825,21,2091,1911,201,40656,482768,633633,2563,2944,2923,4453,4834,41.352146256270665,13.910311642766361,381,1,46431,11160,1710,0,2542,1033
1260,0,1,1,0,54,0,1507,0,0,294350,477575,13.228756555322953,25,2007,1857,175,39648,458472,644044,2579,2904,2879,4411,4736,41.012193308819754,12.626320250454487,325,1,41300,6300,1682,0,2554,1047
1261,0,1,1,0,54,0,1505,0,0,248250,406650,12.24744871391589,30,1925,1805,150,43134,493402,642507,2591,2861,2831,4366,4636,40.681691213615984,11.193019168523147,270,1,35550,7440,1655,0,2561,1056
1262,0,1,1,0,54,0,1507,0,0,195240,324360,10.954451150103322,30,1837,1747,120,47355,554115,624393,2613,2823,2793,4330,4540,40.33608806019741,9.82680210338744,210,1,27720,9180,1627,0,2583,1076
1263,0,1,1,0,63,0,2587,0,0,10890338,15350974,69.55573304911681,4568,7359,7089,4838,52614,704406,752001,2903,8011,3443,5424,10532,47.44470465710583,16.431902120746695,5108,1,1146606,30780,2251,0,1665,922
1264,0,1,1,0,62,0,2602,0,0,9078923,14427284,67.69785816405124,4433,6714,6564,4583,54253,752372,714596,2998,7731,3298,5129,9862,44.50842616853577,12.26699777646566,4733,0,1040341,21900,1981,1,1435,1167
1265,0,1,1,0,61,0,2684,0,0,3100832,10956036,59.632206063502295,3344,4640,4428,3556,56394,742521,720954,2869,6637,3293,3953,7721,29.5296461204668,14.610577240468603,3768,1,832104,29044,872,0,475,2209
1266,0,1,1,0,57,0,1496,0,0,1420145,1905169,25.67099530598687,391,3082,2814,659,45024,581091,647584,2623,3550,3159,5046,5973,46.42197755374064,16.444059732878895,927,1,147616,28140,2155,0,2232,736
1267,0,1,1,0,56,0,1490,0,0,708351,1072570,19.467922333931785,19,2608,2248,379,36520,469780,622600,2470,3209,3190,4699,5438,43.23193264243457,19.879191040957494,739,1,83380,21960,1869,0,2451,961
1268,0,1,1,0,55,0,1489,0,0,585276,904077,17.97220075561143,23,2435,2135,323,36080,459036,615780,2499,3122,3099,4611,5234,42.567593307585526,18.049223303503535,623,1,71060,17700,1812,0,2476,987
1269,0,1,1,0,55,0,1488,0,0,414720,663120,15.491933384829668,30,2178,1968,240,38988,472473,629964,2553,3003,2973,4491,4941,41.569219381653056,15.128415585903417,450,1,54720,12180,1728,0,2523,1035
1270,0,1,1,0,54,0,1493,0,0,246450,407400,12.24744871391589,30,1913,1793,150,41949,480732,643692,2596,2866,2836,4359,4629,40.53393639902249,11.368551155324415,270,1,35550,6600,1643,0,2566,1073
1271,0,1,1,0,62,0,2640,0,0,6552000,13112400,64.8074069840786,4133,5827,5760,4200,55418,755524,714938,3055,7322,3189,4682,8949,39.496835316262995,8.187175587434018,4267,0,961800,9782,1560,1,1078,1562
1272,0,1,1,0,55,0,1477,0,0,412080,665040,15.491933384829668,30,2167,1957,240,38076,462757,631788,2561,3011,2981,4488,4938,41.43669871020132,15.195478829531048,450,1,54720,10920,1717,0,2531,1054
1273,0,1,1,0,62,0,2884,0,0,15864332,17828920,75.35250493513803,5516,8634,8472,5678,46376,778720,587180,2978,8818,3302,5934,11774,52.85830114561004,12.79158200857479,5840,0,1061786,32238,2794,1,2538,346
1274,0,1,1,0,62,0,2627,0,0,8730240,14277580,67.43144666993287,4480,6534,6467,4547,54264,747320,715920,3073,7687,3207,5060,9674,43.81780460041329,8.19263674150144,4614,0,1036716,9648,1920,1,1407,1220
1275,0,1,1,0,59,0,412,0,0,2378700,5220806,41.97618372363071,1762,3112,3112,1762,48178,654823,645934,2963,4725,2963,4313,6075,36.742346141747674,0.0,1762,1,384116,0,1350,0,1201,1613
1276,0,1,1,0,64,0,898,0,0,13577343,13323522,64.50581369148055,4008,7577,7424,4161,41514,598774,710844,3049,7363,3355,6465,10779,57.12267500739089,12.50242329522575,4314,1,923742,13617,3263,0,959,61
1277,0,1,1,0,62,0,2626,0,0,9924600,14867996,68.74590896918885,4592,6960,6826,4726,53562,745602,710996,3012,7872,3280,5246,10106,45.8257569495584,11.579864037853417,4860,0,1068076,19430,2100,0,1580,1046
1278,0,1,1,0,56,0,1448,0,0,661745,1037695,19.1049731745428,30,2513,2178,365,42840,511740,676634,2508,3208,3178,4656,5356,42.579337712087536,19.393804727538857,700,1,86870,19430,1813,0,2478,1030
1279,0,1,1,0,56,0,1450,0,0,537336,860472,17.4928556845359,29,2339,2062,306,41760,506160,652384,2535,3118,3089,4568,5151,41.90465367951393,17.579178219311,583,1,70992,18005,1756,0,2506,1056
1280,0,1,1,0,54,0,1451,0,0,261306,443556,12.727922061357855,28,1909,1775,162,35112,421652,624264,2604,2900,2872,4351,4647,40.162171256046406,12.18602306935173,296,1,36936,4422,1613,0,2576,1125
1281,0,1,1,0,60,0,2815,0,0,570950,9126185,54.817880294662984,2575,3625,3195,3005,43904,595252,680288,2607,6042,3467,3227,6662,13.784048752090222,20.73823551235931,3435,1,673120,42570,190,0,32,2847
1282,0,1,1,0,59,0,764,0,0,2268992,5788640,44.0,1756,3288,3108,1936,44400,717600,553150,2810,4926,3170,4162,6278,34.23448553724738,13.630290597404818,2116,1,358160,34920,1172,0,1054,1818
1283,0,1,1,0,57,0,1433,0,0,801090,1231950,20.73644135332772,30,2693,2293,430,51120,610245,687600,2465,3295,3265,4728,5558,43.162483709814474,21.074326419175623,830,1,103200,39600,1863,0,2435,1002
1284,0,1,1,0,56,0,1433,0,0,489630,800565,16.881943016134134,29,2259,2003,285,42456,514047,651688,2553,3094,3065,4527,5068,41.44876355212541,17.095668131953637,541,1,66120,17920,1718,0,2524,1091
1285,0,1,1,0,54,0,1426,0,0,185520,326400,10.954451150103322,25,1761,1666,120,42136,500480,622880,2625,2840,2815,4266,4481,39.319206502675,10.097077230934874,215,1,27480,7315,1546,0,2600,1174
1286,0,1,1,0,59,0,778,0,0,2482808,3650172,35.12833614050059,987,3493,3246,1234,51282,683298,656676,2711,4192,3205,4970,6451,44.85532298401161,15.716298046397663,1481,0,273948,35815,2012,1,1724,946
1287,0,1,1,0,55,0,1412,0,0,344288,588088,14.560219778561036,22,2026,1836,212,36900,454936,624150,2584,2986,2964,4398,4800,40.29888335921977,14.590255326703758,402,1,47700,9690,1624,0,2562,1150
1288,0,1,1,0,58,0,1341,0,0,2248236,2855736,31.176914536239792,810,3447,3285,972,51520,675740,658112,2776,3910,3100,5251,6385,48.093658625644196,12.740029376818088,1134,0,217728,23004,2313,1,1966,625
1289,0,1,1,0,55,0,1397,0,0,301530,526490,13.784048752090222,15,1952,1777,190,36512,451673,620704,2596,2961,2946,4358,4723,39.83716857408418,13.99571596404126,365,1,42560,9275,1587,0,2581,1184
1290,0,1,1,0,55,0,1396,0,0,252396,446310,12.727922061357855,12,1870,1720,162,33900,413250,622630,2605,2917,2905,4313,4625,39.4715087119811,12.967447346601379,312,1,36612,4350,1558,0,2593,1197
1291,0,1,1,0,55,0,1362,0,0,330120,585480,14.491376746189438,30,1962,1782,210,41118,496264,644028,2608,2998,2968,4360,4750,39.64845520319802,14.435603895983952,390,1,48510,11700,1572,0,2578,1216
1292,0,1,1,0,55,0,1363,0,0,226950,412500,12.24744871391589,30,1783,1663,150,34336,407000,638000,2630,2900,2870,4263,4533,38.897300677553446,12.079217894693505,270,1,34800,1920,1513,0,2600,1237
1293,0,1,1,0,54,0,1364,0,0,178080,327840,10.954451150103322,30,1694,1604,120,37130,431656,642020,2642,2852,2822,4216,4426,38.52272056851645,10.427100377355597,210,1,28200,2520,1484,0,2612,1248
1294,0,1,1,0,54,0,1357,0,0,177240,328440,10.954451150103322,25,1692,1597,120,36036,421498,640458,2642,2857,2832,4214,4429,38.43175770115127,10.625355722009196,215,1,28080,2280,1477,0,2617,1260
1295,0,1,1,0,64,0,2452,0,0,13458348,16361928,71.37226352022192,4692,8138,7736,5094,50055,684156,754820,2810,8306,3614,5854,11350,51.40038910358559,20.335613610512407,5496,0,1197090,43014,2642,1,1882,570
1296,0,1,1,0,62,0,2735,0,0,6461826,13212924,65.22269543648132,4074,5953,5773,4254,52440,714380,708168,2926,7360,3286,4625,9059,38.97435053981015,13.423028349552247,4434,0,969912,24660,1519,1,1148,1587
1297,0,1,1,0,61,0,2815,0,0,2012946,10446202,58.360945845659494,3194,4209,3997,3406,49324,723812,641003,2855,6473,3279,3658,7276,24.310491562286437,14.570009798918585,3618,0,711854,34980,591,1,339,2476
1298,0,1,1,0,59,0,854,0,0,2563320,3640800,35.07135583350036,1140,3404,3314,1230,51513,683760,660080,2870,4190,3050,5044,6364,45.65084884205331,9.486832980505138,1320,0,274290,12870,2084,1,1730,876
1299,0,1,1,0,57,0,1344,0,0,1017360,1560600,23.2379000772445,209,2755,2424,540,47940,589560,679150,2559,3430,3221,4774,5645,43.40506882842141,18.249974133466164,871,1,126900,31445,1884,0,2350,1006
1300,0,1,1,0,56,0,1348,0,0,436860,760860,16.431676725154983,23,2135,1888,270,46566,560782,659412,2571,3088,3065,4436,4953,40.22437072223753,16.77752502538353,517,1,63180,21983,1618,0,2548,1200
1301,0,1,1,0,55,0,1350,0,0,225000,415050,12.24744871391589,16,1784,1650,150,34398,406749,647478,2633,2917,2901,4267,4551,38.72983346207417,12.727073254321974,284,1,35100,1608,1500,0,2617,1267
1302,0,1,1,0,63,0,2690,0,0,13526031,16766807,72.53275122315436,5003,8090,7832,5261,51076,720262,720262,2929,8448,3445,5758,11277,50.70502933634887,16.342197135681385,5519,0,1188986,34572,2571,1,2074,616
1303,0,1,1,0,56,0,1341,0,0,383086,680746,15.556349186104045,14,2053,1825,242,46332,556974,658242,2585,3055,3041,4396,4866,39.786932528155525,16.45417051733747,470,1,56628,20064,1583,0,2571,1230
1304,0,1,1,0,55,0,1342,0,0,228735,424269,12.36931687685298,3,1798,1648,153,35164,413177,654428,2623,2926,2923,4268,4571,38.66522985836241,13.265214125244757,303,1,36108,1950,1495,0,2620,1278
1305,0,1,0,1,64,0,1947,0,0,12738598,15135847,68.3593446428504,4107,7965,7399,4673,53020,780599,712580,2673,7912,3805,5965,11204,52.21110992882645,23.85731182379387,5239,1,1028060,88296,2726,0,1434,513
1306,0,1,1,0,63,0,2687,0,0,13113914,16617552,72.15261603018979,4887,8044,7725,5206,53592,737352,740544,2873,8398,3511,5711,11236,50.18964036531842,18.089944299917967,5525,0,1207792,42108,2519,1,2014,673
1307,0,1,1,0,63,0,3204,0,0,13933440,17847264,75.25955088890711,5537,8251,8124,5664,44345,771995,570331,3024,8815,3278,5611,11402,49.59838707054898,11.313881128525134,5791,0,1025184,25781,2460,1,2513,691
1308,0,1,1,0,56,0,1316,0,0,352032,640452,15.0996688705415,16,1984,1772,228,47824,550564,685396,2597,3037,3021,4353,4793,39.293765408777,15.736737497798764,440,1,55632,15052,1544,0,2581,1265
1309,0,1,1,0,64,0,3142,0,0,14456955,18254535,75.39893898457723,5323,8590,8228,5685,53572,757796,728897,2849,8896,3573,5754,11801,50.428166732491874,19.0588815740217,6047,1,1290495,52128,2543,0,2474,668
1310,0,1,1,0,61,0,2809,0,0,3533442,11553080,61.24540799113024,3601,4843,4693,3751,46592,689920,640640,2930,6831,3230,4022,7923,30.692018506445613,12.248673275118406,3901,0,780208,23100,942,1,671,2138
1311,0,1,1,0,60,0,2145,0,0,1557414,8178462,52.1344415909483,2651,3358,3291,2718,55695,707115,713133,2942,5727,3076,3582,6367,23.93741840717165,8.2143728690235,2785,1,644166,8576,573,0,291,2436
1312,0,1,1,0,55,0,1297,0,0,316470,587790,14.491376746189438,9,1918,1717,210,45815,523413,685755,2598,3009,3000,4306,4717,38.82009788756334,15.402199150823579,411,1,51450,11256,1507,0,2589,1292
1313,0,1,1,0,63,0,3491,0,0,13989486,18775981,76.6355009117837,5549,8579,8255,5873,50996,780068,668173,2873,9070,3521,5579,11776,48.80573736764972,18.093954882852877,6197,0,1227457,56052,2382,1,2676,815
1314,0,1,1,0,63,0,2708,0,0,12989184,16553924,72.13875518748573,5137,7767,7700,5204,47908,750716,645743,3114,8385,3248,5677,10948,49.95998398718719,8.20171446926608,5271,0,1056412,11524,2496,1,2023,685
1315,0,1,1,0,62,0,2773,0,0,6919320,13559600,66.03029607687671,4060,6247,5947,4360,52440,715300,709080,2810,7470,3410,4697,9357,39.83716857408418,17.322239866749324,4660,0,994080,40800,1587,1,1250,1523
1316,0,1,1,0,61,0,2804,0,0,4940780,12468820,63.48228099241551,4030,5256,5256,4030,49880,717808,665210,3094,7124,3094,4320,8350,35.014282800023196,0.0,4030,0,866450,0,1226,1,936,1868
1317,0,1,1,0,55,0,1291,0,0,268086,507962,13.490737563232042,2,1835,1655,182,41520,482843,669840,2611,2973,2971,4264,4626,38.379682124790975,14.470712773397308,362,1,43680,7740,1473,0,2609,1318
1318,0,1,1,0,60,0,1170,0,0,2588719,6962207,47.92702786528704,1974,3747,3424,2297,50508,739564,627417,2708,5328,3354,4158,6778,33.57082066318904,18.12027404475674,2620,1,475479,56525,1127,0,734,1904
1319,0,1,1,0,56,0,1284,0,0,432397,783910,16.64331697709324,67,2048,1838,277,49560,594300,667880,2620,3107,3040,4391,4878,39.50949253027682,14.654941690404138,487,1,65372,21420,1561,0,2553,1269
1320,0,1,1,0,55,0,1279,0,0,233442,450036,12.727922061357855,12,1753,1603,162,38319,441702,669498,2628,2940,2928,4219,4531,37.960505792204614,13.616943205730175,312,1,39042,2850,1441,0,2616,1337
1321,0,1,1,0,64,0,1737,0,0,11625550,14235815,66.23443213314356,3823,7601,7037,4387,51260,756085,713900,2681,7632,3809,5895,10846,51.478150704935004,23.82957346164384,4951,0,965140,84600,2650,1,1142,595
1322,0,1,1,0,58,0,1283,0,0,2273160,2921210,31.575306807693888,907,3367,3277,997,52210,665110,673900,2840,3927,3020,5210,6297,47.74934554525329,9.48712577043745,1087,0,229310,11700,2280,1,1933,650
1323,0,1,1,0,60,0,2627,0,0,1833600,9747200,56.568542494923804,2990,3983,3773,3200,56406,721902,724948,2836,6246,3256,3619,7029,23.93741840717165,14.491705337660376,3410,1,761600,26670,573,0,154,2473
1324,0,1,1,0,57,0,1251,0,0,660400,1140000,20.0,292,2159,2051,400,54656,638400,695400,2742,3250,2958,4501,5009,40.63249930782009,10.429745618880121,508,1,97600,11556,1651,0,2450,1199
1325,0,1,1,0,55,0,1236,0,0,246925,484575,13.228756555322953,115,1646,1586,175,40414,462423,670098,2709,2944,2829,4180,4415,37.5632799419859,7.864259938752337,235,1,42350,1860,1411,0,2594,1358
1326,0,1,1,0,63,0,2795,0,0,12150774,16453529,71.78439941937245,4834,7830,7511,5153,53325,718425,756741,2874,8346,3512,5551,11023,48.55924216871593,17.876390289543014,5472,1,1221261,37961,2358,0,1960,835
1327,0,1,1,0,60,0,2637,0,0,1946038,9830568,56.90342696182718,3088,3989,3839,3238,56165,725604,713460,2886,6274,3186,3637,7025,24.515301344262525,12.254111330655777,3388,1,760930,20100,601,0,202,2435
1328,0,1,1,0,59,0,798,0,0,2854495,3953509,36.565010597564445,1187,3622,3472,1337,55221,688981,700809,2807,4294,3107,5092,6579,46.20606020859169,12.256148736246766,1487,0,316869,18900,2135,1,1620,822
1329,0,1,1,0,55,0,1230,0,0,211599,421668,12.36931687685298,123,1566,1536,153,38305,449228,647660,2726,2909,2786,4139,4322,37.1887079635741,5.959073905325341,183,1,35955,1080,1383,0,2603,1373
1330,0,1,1,0,65,0,1729,0,0,10938782,13928316,65.4446330878247,3694,7426,6837,4283,50838,744708,721944,2663,7535,3841,5806,10678,50.53711507397311,24.270441422981506,4872,0,950826,84227,2554,1,1031,698
1331,0,1,0,1,64,0,2385,0,0,10943716,15205361,68.62215385719105,4255,7487,7033,4709,51714,755586,713609,2775,7938,3683,5553,10716,48.2078831727758,21.316599240066267,5163,1,1040689,67646,2324,0,1480,905
1332,0,1,1,0,59,0,1804,0,0,2415605,8078107,51.95190083144215,2669,3624,3594,2699,42781,715327,535747,2963,5692,3023,3888,6617,29.916550603303182,5.623413251903491,2729,0,483121,5970,895,1,294,2098
1333,0,1,1,0,63,0,2854,0,0,10474040,15750772,70.45565981523414,4507,7531,7074,4964,50850,717098,713925,2716,8137,3630,5283,10704,45.93473631142341,21.531573820490728,5421,1,1116900,62152,2110,0,1791,1063
1334,0,1,1,0,63,0,3003,0,0,10846278,16325748,71.56116265125938,4951,7409,7239,5121,51072,714112,726864,3018,8309,3358,5306,10597,46.021733996015406,13.042463317936507,5291,0,1167588,21930,2118,1,1933,1070
1335,0,1,1,0,63,0,2872,0,0,10668528,15902712,70.73895673530957,4530,7610,7136,5004,50838,727762,705516,2704,8182,3652,5310,10788,46.17358552246078,21.9365451128399,5478,0,1110888,67782,2132,0,1826,1046
1336,0,1,1,0,63,0,2875,0,0,10468734,15805150,70.55494312945054,4532,7527,7081,4978,50621,720725,708025,2729,8153,3621,5278,10702,45.858477951192405,21.28657055878542,5424,1,1110094,62440,2103,0,1803,1072
1337,0,1,1,0,62,0,2914,0,0,7474755,14143275,67.49074010558782,4525,6226,6196,4555,55454,738990,723465,3075,7660,3135,4746,9331,40.50925820105819,5.490867587491313,4585,0,1061315,4080,1641,1,1450,1464
1338,0,1,1,0,55,0,1192,0,0,231540,469540,13.038404810405298,110,1592,1532,170,37620,455730,629736,2702,2932,2822,4124,4354,36.90528417449187,7.83531632499182,230,1,38760,2940,1362,0,2592,1400
1339,0,1,1,0,64,0,3619,0,0,12673752,18679857,76.1774244773345,5437,8353,7987,5803,47765,750027,659895,2853,9022,3585,5403,11572,46.73328578219169,19.18247611387753,6169,0,1189615,61488,2184,1,2584,1035
1340,0,1,1,0,64,0,3542,0,0,12680088,18502812,75.81556568409947,5429,8273,7954,5748,46556,727494,663114,2900,8967,3538,5425,11492,46.968074263269514,17.923597578332352,6067,1,1184088,50402,2206,0,2529,1013
1341,0,1,1,0,54,0,1157,0,0,153240,328440,10.954451150103322,30,1487,1397,120,36300,451605,602140,2647,2857,2827,4014,4224,35.73513677041127,10.195209251481318,210,1,26400,5400,1277,0,2617,1460
1342,0,1,1,0,64,0,3882,0,0,12546040,19171880,77.33045971672482,5534,8524,8078,5980,50578,775852,670054,2760,9186,3652,5304,11730,45.803929962395145,21.151151517532544,6426,0,1249820,76712,2098,1,2774,1108
1343,0,1,1,0,63,0,3029,0,0,3292422,12269992,62.27358990776106,3517,5088,4727,3878,50225,648620,775180,2803,7042,3525,4013,8252,29.13760456866693,19.36835846524051,4239,1,950110,29602,849,0,714,2315
1344,0,1,1,0,58,0,1215,0,0,2677714,3337754,33.734255586866,1138,3491,3491,1138,51290,674590,654059,2933,4071,2933,5286,6424,48.507731342539614,0.0,1138,0,253774,0,2353,1,1795,580
1345,0,1,1,0,55,0,1167,0,0,327834,652860,15.297058540778355,126,1743,1635,234,43197,521730,644490,2682,3024,2898,4191,4533,37.429934544425805,10.406531168715494,342,1,54054,8316,1401,0,2556,1389
1346,0,1,1,0,63,0,3004,0,0,12682221,17169033,73.25981162956946,5025,8072,7730,5367,53100,754964,719775,2857,8566,3541,5562,11271,48.61069841094653,18.503352789110902,5709,0,1207575,49932,2363,1,2168,836
1347,0,1,1,0,56,0,1168,0,0,435105,836055,17.233687939614086,177,1882,1762,297,45571,560185,644635,2695,3112,2935,4280,4697,38.27531841800928,10.991537949000206,417,1,68013,11640,1465,0,2518,1350
1348,0,1,1,0,64,0,3462,0,0,12354363,18178482,75.15982969645421,5336,8149,7836,5649,49450,691870,740140,2905,8867,3531,5405,11367,46.76537180435969,17.74685295501475,5962,0,1299270,36621,2187,1,2431,1031
1349,0,1,1,0,64,0,3297,0,0,12434004,17769987,74.43789357578571,5240,8086,7785,5541,51959,747231,715161,2906,8748,3508,5451,11293,47.37087712930804,17.376860899033666,5842,0,1235643,43946,2244,1,2334,963
1350,0,1,1,0,61,0,3102,0,0,2298960,11461320,60.991802727907626,3545,4513,4338,3720,55081,761007,687063,2906,6801,3256,3699,7594,24.859605789312106,13.285516829896428,3895,1,829560,27475,618,0,639,2463
1351,0,1,1,0,60,0,3035,0,0,1404744,10473606,58.677082408722406,3401,3893,3851,3443,49486,663156,690534,3000,6485,3084,3450,6935,20.199009876724155,6.484411467763075,3485,0,781561,5208,408,0,401,2634
1352,0,1,1,0,56,0,1165,0,0,450126,863226,17.4928556845359,156,1927,1777,306,46000,564200,648830,2671,3127,2971,4292,4748,38.353617821530214,12.27795318108085,456,1,70380,14550,1471,0,2515,1350
1353,0,1,1,0,55,0,1164,0,0,257260,527440,13.784048752090222,15,1719,1544,190,44215,513560,663464,2601,2966,2951,4130,4495,36.796738985948195,14.11109767230738,365,1,45410,10850,1354,0,2586,1422
1354,0,1,1,0,55,0,1162,0,0,214488,447930,12.727922061357855,12,1636,1486,162,47280,544705,663600,2615,2927,2915,4089,4401,36.38681079732051,12.9849534146292,312,1,38880,11700,1324,0,2603,1441
1355,0,1,1,0,64,0,3461,0,0,12250490,18122160,75.06663706334525,5300,8144,7809,5635,50394,713952,730032,2881,8851,3551,5390,11360,46.62617290749907,18.347246363109615,5970,0,1279145,43215,2174,1,2419,1042
1356,0,1,1,0,60,0,1446,0,0,2532775,7534079,49.70915408654627,2165,3802,3496,2471,48995,728711,625045,2743,5520,3355,4074,6851,32.01562118716424,17.669687961213416,2777,1,506555,52938,1025,0,578,2024
1357,0,1,1,0,56,0,1163,0,0,363264,718336,16.0,66,1865,1675,256,45355,541558,659410,2616,3062,2996,4225,4671,37.66961640367472,13.834270577215369,446,1,60160,15200,1419,0,2550,1387
1358,0,1,1,0,63,0,3246,0,0,9911635,16450525,71.8679344353238,5165,7084,7084,5165,50808,738920,697515,3185,8350,3185,5104,10269,43.80639222761902,0.0,5165,0,1131135,0,1919,1,1980,1266
1359,0,1,1,0,60,0,2421,0,0,1662282,8990622,54.58021619598075,2829,3687,3537,2979,53815,691122,709230,2868,5997,3168,3576,6705,23.62202362203543,12.248673275118406,3129,1,700065,18750,558,0,39,2460
1360,0,1,1,0,56,0,1160,0,0,429225,832195,17.175564037317667,83,1962,1750,295,44160,541632,648830,2609,3116,3033,4276,4783,38.144462245521304,14.589369836921374,507,1,67850,18232,1455,0,2526,1366
1361,0,1,1,0,56,0,1155,0,0,338074,677600,15.556349186104045,24,1857,1639,242,41474,498400,652400,2582,3042,3018,4197,4657,37.376463182061514,15.655278323665375,460,1,56386,13298,1397,0,2558,1403
1362,0,1,1,0,60,0,2900,0,0,1137500,9831250,57.0087712549569,3160,3690,3600,3250,45590,710875,586850,2935,6275,3115,3375,6715,18.708286933869708,9.543708938032719,3340,1,630500,16200,350,0,225,2675
1363,0,1,1,0,55,0,1144,0,0,230825,483350,13.228756555322953,25,1644,1494,175,39963,477826,638022,2612,2937,2912,4081,4406,36.318039594669756,12.967447346601379,325,1,40425,8700,1319,0,2587,1443
1364,0,1,1,0,54,0,1138,0,0,156488,339016,11.135528725660043,16,1494,1386,124,38844,453844,639756,2626,2858,2842,3996,4228,35.52463933666322,10.781717396486519,232,1,29016,4536,1262,0,2610,1472
1365,0,1,1,0,60,0,3203,0,0,963960,10603560,58.9915248150105,3310,3927,3757,3480,50218,642917,725186,2877,6527,3217,3324,6974,16.64331697709324,13.038404810405298,3650,1,828240,16830,277,0,433,2770
1366,0,1,1,0,60,0,1725,0,0,2299374,7925280,51.05878964487897,2389,3707,3489,2607,46464,735680,583680,2822,5647,3258,3922,6747,29.698484809834994,14.940611189925995,2825,1,500544,41202,882,0,433,2158
1367,0,1,1,0,59,0,781,0,0,2932802,4033798,36.959437225152655,1232,3647,3513,1366,50850,667378,664425,2819,4319,3087,5100,6600,46.33573135281238,11.586137991427458,1500,0,307350,18090,2147,1,1587,806
1368,0,1,1,0,56,0,1140,0,0,402709,799758,16.822603841260722,25,1964,1706,283,36720,480420,610416,2568,3109,3084,4249,4790,37.72267222772003,17.203324922167482,541,1,61128,18834,1423,0,2543,1403
1369,0,1,1,0,54,0,1127,0,0,159258,347472,11.269427669584644,19,1489,1381,127,38675,478800,604656,2628,2863,2844,3990,4225,35.41186241925155,10.89017689082249,235,1,28067,7884,1254,0,2609,1482
1370,0,1,1,0,54,0,1113,0,0,153388,339388,11.135528725660043,16,1469,1361,124,40734,509082,599403,2629,2861,2845,3974,4206,35.17101079013795,10.748049169056976,232,1,27156,9828,1237,0,2613,1500
1371,0,1,1,0,63,0,3376,0,0,9080772,16433832,71.70774016799024,5075,6975,6908,5142,45173,725492,636004,3129,8338,3263,4962,10171,42.02380277890139,8.20759886765899,5209,0,1023258,11189,1766,1,1946,1430
1372,0,1,1,0,61,0,3345,0,0,1857550,11727460,61.886993787063204,3830,4315,4315,3830,50955,725694,658330,3062,6892,3062,3547,7377,22.02271554554524,0.0,3830,0,823450,0,485,0,768,2577
1373,0,1,1,0,58,0,1159,0,0,1407900,2168907,27.2213151776324,483,2899,2641,741,46330,600035,661502,2669,3668,3185,4827,5826,43.58898943540674,16.131666588086507,999,1,167466,27864,1900,0,2186,1027
1374,0,1,1,0,58,0,1144,0,0,963312,1643496,23.748684174075834,229,2607,2272,564,48174,646908,632338,2579,3478,3249,4622,5521,41.32795663954365,18.358569931971438,899,1,122388,46900,1708,0,2350,1206
1375,0,1,1,0,56,0,1116,0,0,349605,715530,15.968719422671311,21,1860,1626,255,33135,395646,659410,2572,3061,3040,4177,4666,37.027017163147235,16.20248361801118,489,1,59925,0,1371,0,2551,1435
1376,0,1,1,0,60,0,2438,0,0,1552088,8942278,54.42425929675111,2962,3486,3486,2962,47705,709465,612857,3019,5981,3019,3543,6505,22.891046284519195,0.0,2962,0,601286,0,524,1,57,2495
1377,0,1,1,0,56,0,1115,0,0,370644,753348,16.3707055437449,13,1906,1651,268,37596,438516,677451,2556,3079,3066,4194,4717,37.1887079635741,16.72519101875932,523,1,64588,3825,1383,0,2543,1428
1378,0,1,1,0,63,0,4182,0,0,10273648,18931682,76.9285382676676,5702,7870,7654,5918,49572,777357,652596,2983,9117,3415,4935,11069,41.66533331199932,14.710229436817905,6134,0,1207272,38448,1736,1,2719,1463
1379,0,1,1,0,56,0,1115,0,0,485750,951735,18.303005217723125,16,2104,1785,335,49610,582405,687522,2522,3176,3160,4291,4945,38.07886552931954,18.820927929788734,654,1,81070,27434,1450,0,2506,1391
1380,0,1,1,0,56,0,1113,0,0,350464,716800,16.0,14,1867,1625,256,40655,484400,658000,2558,3056,3042,4169,4667,37.0,16.2915551666278,498,1,60160,12342,1369,0,2544,1431
1381,0,1,1,0,55,0,1113,0,0,225400,484400,13.228756555322953,5,1633,1463,175,42823,517616,633872,2598,2943,2938,4056,4401,35.888716889852724,13.631179030466164,345,1,40075,13600,1288,0,2593,1480
1382,0,1,1,0,54,0,1108,0,0,156845,348869,11.269427669584644,3,1486,1362,127,42525,519183,618075,2623,2874,2871,3982,4233,35.14256678161116,11.736839560195943,251,1,28575,10788,1235,0,2620,1512
1383,0,1,1,0,64,0,3207,0,0,8328690,15715620,70.03570517957252,4845,6663,6603,4905,52377,759348,708084,3144,8109,3264,4902,9867,41.20679555607303,7.748117453886108,4965,0,1084005,9120,1698,1,1701,1506
1384,0,1,1,0,61,0,1114,0,0,2780315,7155665,48.11444689487763,2123,3708,3516,2315,52560,676929,741840,2899,5406,3283,4292,6799,34.655446902326915,13.945841795595102,2507,1,555600,20544,1201,0,776,1890
1385,0,1,1,0,55,0,1106,0,0,216920,469710,13.038404810405298,8,1608,1446,170,43092,522207,629964,2601,2933,2925,4039,4371,35.7211421989835,13.37689542335996,332,1,38760,13446,1276,0,2593,1487
1386,0,1,1,0,63,0,3318,0,0,5250960,14226960,66.9925368977769,4313,5833,5658,4488,50160,760800,662530,2995,7658,3345,4340,9003,34.20526275297414,13.235662496037818,4663,1,937992,29575,1170,0,1318,2000
1387,0,1,1,0,56,0,1114,0,0,534312,1030614,19.026297590440446,12,2188,1838,362,43758,532389,666198,2497,3209,3197,4323,5035,38.41874542459709,19.52392590532836,712,1,84708,25550,1476,0,2485,1371
1388,0,1,1,0,56,0,1113,0,0,439398,873234,17.578395831246947,9,2031,1731,309,43792,519984,672588,2526,3135,3126,4248,4857,37.70941526992961,18.13768681480413,609,1,73542,18900,1422,0,2517,1404
1389,0,1,1,0,56,0,1113,0,0,395068,795796,16.822603841260722,6,1956,1679,283,43316,511784,669256,2535,3095,3089,4208,4768,37.36308338453881,17.492528744516264,560,1,67354,16620,1396,0,2529,1416
1390,0,1,1,0,55,0,1116,0,0,153760,341744,11.135528725660043,4,1484,1364,124,40443,504348,609076,2636,2880,2876,3996,4240,35.21363372331802,12.447178124173949,244,1,27404,10080,1240,0,2632,1516
1391,0,1,1,0,60,0,2894,0,0,958200,9658656,56.515484603779164,3164,3524,3494,3194,47998,704592,622944,2994,6218,3054,3324,6548,17.320508075688775,5.490867587491313,3224,0,657964,4950,300,1,170,2724
1392,0,1,1,0,58,0,1134,0,0,1381536,2169720,27.16615541441225,295,3053,2610,738,40976,611520,579180,2497,3678,3383,4812,5993,43.266615305567875,21.106545221583836,1181,1,145386,64678,1872,0,2202,1068
1393,0,1,1,0,55,0,1120,0,0,207684,448902,12.727922061357855,9,1597,1444,162,41109,534803,590223,2618,2933,2924,4053,4368,35.805027579936315,13.791488404131563,315,1,34506,16524,1282,0,2609,1489
1394,0,1,1,0,60,0,209,0,0,3173520,5736893,43.46262762420146,1829,3629,3569,1889,49665,701547,652955,2977,4926,3097,4717,6666,40.98780306383839,7.780166052320878,1949,1,406135,9180,1680,0,1148,1357
1395,0,1,1,0,59,0,1145,0,0,2295024,3113778,32.357379374726875,831,3455,3239,1047,46176,660228,618592,2758,4021,3190,5166,6429,46.8187996428785,14.882477907497345,1263,1,217776,32400,2192,0,1927,782
1396,0,1,1,0,55,0,1122,0,0,265923,559785,14.177446878757825,11,1714,1524,201,43416,559785,601560,2595,2986,2975,4108,4499,36.373066958946424,15.117428655022483,391,1,43416,22040,1323,0,2584,1462
1397,0,1,1,0,56,0,1118,0,0,465443,911829,17.97220075561143,10,2077,1764,323,42840,508140,671874,2510,3146,3136,4264,4900,37.960505792204614,18.473486083485888,636,1,76874,17841,1441,0,2500,1382
1398,0,1,1,0,56,0,1120,0,0,417425,829245,17.175564037317667,10,1995,1710,295,45548,542523,663396,2526,3106,3096,4226,4806,37.61648574760805,17.629719625617078,580,1,69620,22800,1415,0,2516,1396
1399,0,1,1,0,55,0,1128,0,0,284080,591904,14.560219778561036,11,1753,1552,212,44304,580736,594696,2591,3004,2993,4132,4545,36.60601043544625,15.542584580953301,413,1,45156,25929,1340,0,2580,1452
1400,0,1,1,0,64,0,3022,0,0,7626783,14969367,68.25686778632608,4539,6416,6296,4659,52884,751842,726138,3093,7872,3333,4850,9629,40.45985664828782,11.015556749295067,4779,0,1052934,17160,1637,1,1446,1576
1401,0,1,1,0,61,0,3485,0,0,1810296,12214568,62.80127387243033,3734,4613,4403,3944,52030,665855,749474,2887,7041,3307,3556,7710,21.42428528562855,14.580022114409926,4154,1,954448,20580,459,0,847,2638
1402,0,1,1,0,61,0,2034,0,0,2105695,8590120,52.81098370604357,2521,3812,3544,2789,41420,671440,585200,2812,5869,3348,3835,6892,27.477263328068172,16.552779992882012,3057,1,529910,44220,755,0,291,2325
1403,0,1,1,0,55,0,1139,0,0,295826,610182,14.7648230602334,6,1787,1575,218,46656,604584,604584,2587,3017,3011,4156,4586,36.837480912787726,16.133155202402655,430,1,47088,28832,1357,0,2581,1442
1404,0,1,1,0,64,0,4005,0,0,10449000,18732735,76.19055059520177,5558,7852,7605,5805,50032,761572,684124,2980,9032,3474,5027,11079,42.42640687119285,15.718551579159874,6052,0,1230660,40014,1800,1,2578,1427
1405,0,1,1,0,56,0,1131,0,0,503766,970254,18.49324200890693,7,2150,1815,342,37910,482290,632651,2502,3179,3172,4310,4987,38.379682124790975,19.562409421210084,677,1,76266,21440,1473,0,2495,1364
1406,0,1,1,0,56,0,1146,0,0,313272,638856,15.0996688705415,10,1820,1602,228,48608,608034,627648,2584,3030,3020,4176,4622,37.067505985701274,16.24976672233229,446,1,51072,27686,1374,0,2574,1428
1407,0,1,1,0,55,0,1149,0,0,271350,562599,14.177446878757825,11,1741,1551,201,50609,618579,640971,2609,3000,2989,4149,4540,36.742346141747674,15.362567312273002,391,1,46029,23560,1350,0,2598,1449
1408,0,1,1,0,64,0,3567,0,0,7261720,16258630,70.81666470542086,4862,6616,6463,5015,38752,726208,560866,3089,8257,3395,4690,9858,38.05259518088089,12.651333531125456,5168,1,867595,29070,1448,0,1773,1794
1409,0,1,1,0,64,0,3716,0,0,10075520,17787168,74.4043009509531,5217,7675,7356,5536,49946,726138,710073,2894,8749,3532,5033,10888,42.661458015403085,17.86272076881258,5855,0,1223456,44979,1820,1,2323,1393
1410,0,1,1,0,61,0,3484,0,0,2005461,12339765,63.14269553954757,3719,4758,4490,3987,56400,727325,742800,2827,7082,3363,3598,7853,22.427661492005804,16.495152579479317,4255,1,956880,32696,503,0,892,2592
1411,0,1,1,0,55,0,1164,0,0,173932,371582,11.575836902790225,10,1556,1432,134,24182,296711,626698,2649,2907,2897,4071,4329,36.02776706930364,12.926437583249431,258,1,30284,0,1298,0,2639,1475
1412,0,1,1,0,60,0,3442,0,0,860184,11167688,60.63002556489647,3568,4018,3910,3676,52891,689626,707854,2930,6714,3146,3272,7056,15.297058540778355,10.394308954048586,3784,0,856508,13500,234,1,638,2804
1413,0,1,1,0,60,0,3002,0,0,990600,10038080,57.463031594234565,3194,3710,3602,3302,42966,702240,565440,2932,6342,3148,3340,6750,17.320508075688775,10.46373382427936,3410,0,614172,19980,300,1,262,2740
1414,0,1,1,0,56,0,1147,0,0,496470,953745,18.303005217723125,12,2140,1817,335,37840,489684,626340,2524,3182,3170,4329,4987,38.49675310984031,19.477707126614654,658,1,73700,22610,1482,0,2512,1365
1415,0,1,1,0,56,0,1154,0,0,360960,719104,16.0,14,1908,1666,256,47235,564609,660115,2567,3065,3051,4219,4717,37.54996671103717,16.873571161827762,498,1,60160,22022,1410,0,2553,1399
1416,0,1,1,0,55,0,1168,0,0,197700,416850,12.24744871391589,16,1602,1468,150,25197,308469,630833,2645,2929,2913,4097,4381,36.30426972134269,13.362249547337647,284,1,34050,0,1318,0,2629,1461
1417,0,1,1,0,64,0,4157,0,0,7544418,17756445,74.31688906298487,5348,7064,6889,5523,37332,588345,655860,3040,8738,3390,4581,10279,36.959437225152655,13.359104871799886,5698,1,1126692,18375,1366,0,2308,1849
1418,0,1,1,0,64,0,4384,0,0,9741732,19345326,77.49838707999025,5750,7884,7628,6006,52488,782703,695736,2965,9227,3477,4843,11105,40.27406113120453,16.03801130245182,6262,0,1297296,41984,1622,1,2785,1599
1419,0,1,1,0,55,0,1176,0,0,216756,451332,12.727922061357855,12,1650,1500,162,25538,314818,629636,2636,2948,2936,4124,4436,36.578682316343766,14.135413317768977,312,1,36612,0,1338,0,2624,1448
1420,0,1,1,0,65,0,3631,0,0,6794112,16248960,70.65408693062278,4802,6543,6353,4992,41825,777945,569625,3065,8247,3445,4616,9798,36.89173349139343,14.115544213798941,5182,1,873600,38570,1361,0,1737,1894
1421,0,1,1,0,61,0,788,0,0,3171740,6822568,47.095647357266465,2084,3782,3648,2218,47742,670568,673644,2942,5294,3210,4506,6858,37.815340802378074,11.581634647011523,2352,1,485742,17956,1430,0,858,1646
1422,0,1,1,0,56,0,1175,0,0,319884,639768,15.0996688705415,12,1847,1631,228,42387,558394,597678,2590,3034,3022,4209,4653,37.456641600656084,16.12934352653768,444,1,48564,25272,1403,0,2578,1403
1423,0,1,1,0,54,0,1187,0,0,200550,411450,12.24744871391589,16,1621,1487,150,22866,282529,608946,2609,2893,2877,4080,4364,36.565010597564445,12.5131552182536,284,1,33300,0,1337,0,2593,1406
1424,0,1,1,0,54,0,1191,0,0,163060,338272,11.135528725660043,16,1547,1439,124,38180,452848,627440,2620,2852,2836,4043,4275,36.26292872893749,11.39297353269565,232,1,28520,0,1315,0,2604,1413
1425,0,1,1,0,60,0,337,0,0,3429348,5145713,41.12177038990418,1583,3827,3719,1691,41216,681632,559912,2935,4734,3151,5071,6870,45.033320996790806,10.655033166942168,1799,1,311144,19332,2028,0,1352,1015
1426,0,1,1,0,56,0,1167,0,0,481270,917966,17.97220075561143,14,2122,1813,323,39732,488824,656502,2533,3165,3151,4332,4964,38.600518131237564,19.004700107267254,632,1,74613,16995,1490,0,2519,1352
1427,0,1,1,0,56,0,1189,0,0,262010,532570,13.784048752090222,15,1744,1569,190,24864,311133,627872,2628,2993,2978,4182,4547,37.134889255254286,14.991177404417611,365,1,42560,0,1379,0,2613,1424
1428,0,1,1,0,64,0,4272,0,0,7168129,18023201,74.57211275000863,5333,7078,6850,5561,37881,593103,670887,3013,8802,3469,4530,10319,35.90264614203248,15.292307076301322,5789,1,1151127,23256,1289,0,2320,1952
1429,0,1,1,0,64,0,4459,0,0,9435150,19382425,77.62087348130012,5807,7809,7591,6025,50960,788165,669136,2999,9242,3435,4783,11026,39.57271787481876,14.765522043755604,6243,0,1253200,38150,1566,1,2808,1651
1430,0,1,1,0,57,0,1159,0,0,709686,1284257,21.047565179849187,13,2475,2045,443,42570,574002,623285,2469,3342,3329,4501,5374,40.024992192379,22.191054280718735,873,1,95245,48590,1602,0,2456,1297
1431,0,1,1,0,55,0,1204,0,0,241325,483000,13.228756555322953,5,1724,1554,175,21681,273240,604440,2590,2935,2930,4139,4484,37.134889255254286,13.955050015729233,345,1,38325,0,1379,0,2585,1381
1432,0,1,0,1,65,0,1902,0,0,7453480,12640180,61.98386886924694,3660,5964,5782,3842,43050,674450,690900,3108,7132,3472,5230,9254,44.04543109109048,13.53128240199624,4024,1,806820,23296,1940,0,552,1350
1433,0,1,1,0,57,0,1180,0,0,535500,999600,18.708286933869708,15,2215,1880,350,37687,482664,636888,2521,3206,3191,4386,5071,39.11521443121589,19.68809154962172,685,1,78050,21105,1530,0,2506,1326
1434,0,1,1,0,66,0,3961,0,0,6231402,17076935,71.88184749990779,4737,6803,6373,5167,53136,813030,713880,2875,8472,3735,4511,10108,34.72751070837067,21.067672401654697,5597,1,1116072,71380,1206,0,1862,2099
1435,0,1,1,0,64,0,4538,0,0,9193008,19457928,77.82030583337487,5846,7784,7574,6056,51129,793611,665091,3003,9269,3423,4731,10997,38.961519477556315,14.495400452462528,6266,0,1253592,37380,1518,1,2843,1695
1436,0,1,1,0,61,0,2833,0,0,1548638,10150348,57.463031594234565,3140,3933,3771,3302,43200,691650,590208,2912,6376,3236,3543,7007,21.656407827707714,12.742567532359065,3464,1,633984,27864,469,0,228,2605
1437,0,1,1,0,61,0,701,0,0,3349782,6827976,47.05316142407437,1972,3969,3727,2214,52360,678480,733992,2842,5298,3326,4597,7053,38.897300677553446,15.556415593152641,2456,0,526932,26620,1513,1,870,1571
1438,0,1,1,0,58,0,1170,0,0,770800,1369580,21.6794833886788,80,2500,2110,470,44720,606112,626510,2524,3384,3304,4554,5414,40.496913462633174,19.777566693406925,860,1,101050,49140,1640,0,2444,1274
1439,0,1,1,0,56,0,1209,0,0,337662,661752,15.297058540778355,6,1905,1677,234,25199,319564,630644,2600,3062,3056,4271,4733,37.986839826445156,16.74135840125022,462,1,52182,0,1443,0,2594,1385
1440,0,1,1,0,54,0,1250,0,0,127775,257450,9.746794344808963,5,1530,1440,95,37120,433600,628720,2620,2805,2800,4055,4240,36.6742416417845,10.219890331034485,185,1,22040,0,1345,0,2615,1365
1441,0,1,1,0,65,0,2336,0,0,6970545,13284180,63.67888189973188,4013,5816,5774,4055,45492,730548,668304,3234,7331,3318,4995,9092,41.46082488325576,6.5135556243263055,4097,0,827220,6594,1719,1,779,1557
1442,0,1,1,0,61,0,260,0,0,3532556,6197078,44.87761134463375,1924,3858,3768,2014,51736,686171,713864,2987,5091,3167,4831,6935,41.88078318274385,9.580310602724222,2104,1,467248,11160,1754,0,1063,1323
1443,0,1,1,0,56,0,1209,0,0,411622,788619,16.64331697709324,22,2018,1763,277,39246,529542,600717,2592,3124,3102,4333,4865,38.54867053479276,16.245336864356503,532,1,58447,25500,1486,0,2570,1361
1444,0,1,1,0,55,0,1227,0,0,315010,608002,14.7648230602334,17,1864,1663,218,21681,276111,610791,2588,3007,2990,4234,4653,38.01315561749642,14.283714794538563,419,1,47742,0,1445,0,2571,1344
1445,0,1,1,0,57,0,1222,0,0,429495,814245,16.881943016134134,57,2020,1792,285,42639,522831,665681,2629,3142,3085,4364,4877,38.82009788756334,15.523305947390151,513,1,66405,15960,1507,0,2572,1350
1446,0,1,1,0,54,0,1260,0,0,211500,411450,12.24744871391589,42,1668,1560,150,34804,422422,619918,2635,2893,2851,4153,4411,37.54996671103717,10.518295179710192,258,1,33900,0,1410,0,2593,1333
1447,0,1,0,1,66,0,1621,0,0,7320890,12108185,60.29096117993144,3274,6010,5649,3635,41356,702841,652876,2970,6966,3692,5345,9341,44.87761134463375,19.13419628540056,3996,1,712460,54872,2014,0,304,1317
1448,0,1,1,0,61,0,9,0,0,3646170,5852160,43.64630568559039,1845,3879,3819,1905,38804,669696,546816,3012,4977,3132,4986,6951,43.749285708454714,7.83531632499182,1965,1,339090,10740,1914,0,1167,1158
1449,0,1,1,0,56,0,1242,0,0,404680,756832,16.3707055437449,78,1968,1778,268,31200,367120,677760,2634,3092,3014,4334,4792,38.8587184554509,13.973411963356208,458,1,64320,0,1510,0,2556,1314
1450,0,1,1,0,55,0,1272,0,0,232308,445986,12.727922061357855,67,1691,1596,162,34410,426715,611166,2658,2915,2848,4187,4444,37.86819245752297,10.044946068639236,257,1,35964,3895,1434,0,2591,1319
1451,0,1,1,0,54,0,1290,0,0,150984,293976,10.392304845413264,66,1548,1506,108,33354,416466,593396,2680,2830,2764,4120,4270,37.389838191679836,6.488991180673202,150,1,23544,1890,1398,0,2614,1324
1452,0,1,1,0,61,0,3414,0,0,2986192,12664432,64.31174076325411,4076,4918,4858,4136,52884,716508,692012,3002,7198,3122,3784,7980,26.870057685088806,7.748117453886108,4196,1,934736,8640,722,0,1074,2340
1453,0,1,1,0,60,0,3197,0,0,1781604,11204964,60.67124524847005,3651,4195,4165,3681,47897,690988,642284,3014,6725,3074,3528,7239,22.0,5.490867587491313,3711,0,776691,4620,484,1,637,2560
1454,0,1,1,0,56,0,1250,0,0,433839,800041,16.822603841260722,121,1978,1816,283,27727,336413,658691,2665,3110,2989,4360,4805,39.153543900903784,12.809104356509453,445,1,65939,0,1533,0,2544,1294
1455,0,1,1,0,56,0,1257,0,0,387328,719360,16.0,106,1919,1769,256,41452,483320,677210,2660,3066,2960,4323,4729,38.897300677553446,12.376180362832391,406,1,61696,0,1513,0,2554,1297
1456,0,1,1,0,55,0,1283,0,0,255150,483700,13.228756555322953,90,1718,1633,175,35298,439476,613608,2679,2939,2849,4222,4482,38.18376618407357,9.251281740554573,260,1,38850,4080,1458,0,2589,1306
1457,0,1,1,0,60,0,1050,0,0,3558139,4366351,37.8549864614954,860,4489,3916,1433,51120,649011,731280,2474,4480,3620,5530,7536,49.82971001320397,23.998498846433016,2006,1,343920,56727,2483,0,1614,564
1458,0,1,1,0,57,0,1252,0,0,508725,929594,17.97220075561143,173,2048,1898,323,29016,356872,673452,2728,3201,3028,4453,4926,39.68626966596886,12.54961581009077,473,1,75582,0,1575,0,2555,1303
1459,0,1,1,0,56,0,1261,0,0,459020,833965,17.175564037317667,161,1985,1851,295,27494,333586,658691,2693,3122,2961,4383,4812,39.44616584663204,11.576481526871955,429,1,68735,0,1556,0,2532,1271
1460,0,1,1,0,65,0,4155,0,0,8275846,18340760,75.0066663703967,5320,7403,7097,5626,49490,798700,658520,2954,8886,3566,4731,10663,38.353617821530214,17.54659780973714,5932,0,1136452,55692,1471,1,2366,1789
1461,0,1,1,0,56,0,1270,0,0,487911,874470,17.578395831246947,201,1996,1888,309,26564,328280,648070,2722,3139,2938,4409,4826,39.736632972611055,10.392304845413264,417,1,70761,0,1579,0,2521,1251
1462,0,1,1,0,56,0,1277,0,0,441480,798060,16.822603841260722,188,1938,1843,283,41630,510420,648600,2725,3103,2915,4380,4758,39.496835316262995,9.76859066112806,378,1,65090,0,1560,0,2537,1260
1463,0,1,1,0,54,0,1322,0,0,195104,367160,11.575836902790225,134,1590,1590,134,36630,452100,608280,2740,2874,2740,4196,4330,38.157568056677825,0.0,134,1,29748,0,1456,0,2606,1284
1464,0,1,1,0,65,0,3265,0,0,5597694,14719862,67.1341939699882,4387,5869,5749,4507,49184,692392,757712,3146,7773,3386,4508,9135,35.24202037341219,11.246826503806982,4627,1,1045624,13200,1242,0,1241,2024
1465,0,1,1,0,61,0,3206,0,0,2235255,11597520,61.603571325045756,3705,4474,4384,3795,50380,699824,672320,2966,6851,3146,3645,7530,24.269322199023193,9.486832980505138,3885,0,834900,13050,589,1,739,2467
1466,0,1,1,0,62,0,2768,0,0,2144769,10540299,58.30094338859364,3122,4307,4030,3399,42173,722533,561281,2824,6500,3378,3732,7408,25.11971337416094,16.643371204424614,3676,1,615219,53184,631,0,298,2470
1467,0,1,1,0,61,0,985,0,0,3656094,4530474,38.49675310984031,890,4541,3949,1482,50851,645027,736737,2465,4539,3649,5524,7598,49.66890375275057,24.3852978225147,2074,1,357162,56832,2467,0,1575,590
1468,0,1,1,0,59,0,1212,0,0,1065573,1743450,24.310491562286437,411,2574,2394,591,50380,675550,649000,2770,3541,3130,4753,5524,42.46174749112429,13.418995158121604,771,1,130020,26280,1803,0,2359,1147
1469,0,1,1,0,56,0,1278,0,0,519048,920160,18.0,239,2011,1926,324,27951,343640,656040,2755,3164,2925,4442,4851,40.024992192379,9.251281740554573,409,1,74844,0,1602,0,2516,1238
1470,0,1,1,0,55,0,1323,0,0,332424,602208,14.696938456699069,216,1755,1755,216,37632,468384,624512,2788,3004,2788,4327,4543,39.230090491866065,0.0,216,1,48384,0,1539,0,2572,1249
1471,0,1,1,0,54,0,1342,0,0,223800,412050,12.24744871391589,83,1709,1642,150,36288,445014,615328,2680,2897,2814,4239,4456,38.62641583165593,8.20171446926608,217,1,33600,3417,1492,0,2597,1255
1472,0,1,1,0,54,0,1357,0,0,177240,327840,10.954451150103322,35,1682,1597,120,36547,439852,620164,2647,2852,2817,4209,4414,38.43175770115127,9.235136611923052,205,1,27240,3825,1477,0,2612,1255
1473,0,1,1,0,64,0,3883,0,0,8095158,17434482,73.38937252763509,4845,7430,6889,5386,56643,773643,767169,2696,8623,3778,4740,10667,38.768543949960254,23.671805004555395,5927,0,1276482,70330,1503,1,2149,1734
1474,0,1,1,0,54,0,1380,0,0,186496,339884,11.135528725660043,16,1736,1628,124,36640,438560,627689,2633,2865,2849,4245,4477,38.781438859330635,10.424232425346673,232,1,28396,4320,1504,0,2617,1237
1475,0,1,1,0,59,0,1201,0,0,1769540,2569269,29.30870177950569,689,3089,2919,859,52437,678957,690921,2821,3850,3161,5051,6080,45.387222871640866,13.152397064008891,1029,1,198429,21760,2060,0,2132,931
1476,0,1,1,0,56,0,1372,0,0,364800,638856,15.0996688705415,143,1913,1828,228,38988,479142,638856,2717,3030,2887,4402,4715,40.0,9.231007614073922,313,1,51984,4930,1600,0,2574,1202
1477,0,1,1,0,62,0,3237,0,0,3253810,12663586,63.57672530100933,3830,5059,4847,4042,30525,516945,579605,2921,7175,3345,3938,8192,28.372521918222215,14.931382449279473,4254,1,747770,21624,805,0,909,2328
1478,0,1,1,0,62,0,1005,0,0,3773536,7875751,50.08991914547278,2185,4337,4013,2509,50808,728248,687441,2815,5648,3463,4643,7476,38.781438859330635,18.003471217980266,2833,1,549471,48276,1504,0,630,1635
1479,0,1,1,0,62,0,576,0,0,3941092,7138928,47.89572005931219,2199,4107,4012,2294,51754,703312,712648,3017,5406,3207,4830,7219,41.44876355212541,9.785443037298442,2389,1,525326,12445,1718,0,818,1394
1480,0,1,1,0,66,0,2905,0,0,5477514,14030345,64.8613906727261,3967,5749,5509,4207,47008,693680,753710,3095,7542,3575,4637,9084,36.08323710533743,15.578349751943568,4447,1,950782,26880,1302,0,872,2033
1481,0,1,1,0,60,0,1163,0,0,3056664,3827135,35.510561809129406,859,4087,3685,1261,50400,682875,679840,2633,4296,3437,5459,7122,49.23413450036468,20.1431128132592,1663,1,282464,54270,2424,0,1774,611
1482,0,1,1,0,63,0,2150,0,0,3162459,9988704,56.15158056546583,2774,4535,4156,3153,48790,753984,649440,2789,6321,3547,4171,7703,31.670175244226233,19.514143222547556,3532,1,646365,65188,1003,0,15,2165
1483,0,1,1,0,54,0,1509,0,0,143910,244530,9.486832980505138,5,1774,1689,90,36498,418418,643929,2632,2807,2802,4316,4491,39.98749804626441,9.982202543931885,175,1,21330,1615,1599,0,2627,1118
1484,0,1,1,0,65,0,4456,0,0,3904500,17075680,72.15261603018979,4887,6275,5956,5206,53520,787200,731440,2961,8486,3599,4030,9555,27.386127875258307,17.930366866901547,5525,1,1160938,48488,750,0,1926,2530
1485,0,1,1,0,61,0,674,0,0,4105347,5291794,41.43669871020132,1185,4640,4108,1717,53824,715024,715024,2550,4799,3614,5473,7722,48.8978527135906,23.08108170195523,2249,1,398344,70224,2391,0,1365,691
1486,0,1,1,0,56,0,1449,0,0,409222,681472,15.556349186104045,41,2134,1933,242,42657,498432,678656,2615,3058,3017,4507,4950,41.12177038990418,14.212409159636923,443,1,58322,9849,1691,0,2574,1125
1487,0,1,1,0,54,0,1532,0,0,154565,258590,9.746794344808963,0,1817,1722,95,37128,424632,647836,2627,2817,2817,4349,4539,40.33608806019741,10.525591954947746,190,1,22610,1900,1627,0,2627,1095
1488,0,1,1,0,57,0,1425,0,0,589600,957095,18.303005217723125,160,2270,2095,335,49245,574257,699965,2682,3192,3032,4617,5127,41.95235392680606,13.30116108744132,510,1,82075,13125,1760,0,2522,1097
1489,0,1,1,0,64,0,4335,0,0,6872146,17987870,74.62573282722254,5256,7116,6803,5569,52514,781660,700910,2917,8799,3543,4464,10346,35.12833614050059,17.70983700488444,5882,0,1208473,50393,1234,1,2339,1996
1490,0,1,1,0,60,0,1174,0,0,3485280,4175760,37.013511046643494,946,4338,3914,1370,52891,710184,691896,2624,4418,3472,5592,7386,50.438080851673966,20.72240842835788,1794,1,310990,59784,2544,0,1678,504
1491,0,1,1,0,54,0,1555,0,0,213614,346964,11.269427669584644,3,1933,1809,127,38880,442584,655680,2608,2859,2856,4414,4665,41.012193308819754,11.932888170540295,251,1,30480,3224,1682,0,2605,1050
1492,0,1,1,0,54,0,1563,0,0,180468,293112,10.392304845413264,13,1874,1779,108,39196,445096,648646,2619,2822,2809,4385,4588,40.87786687193939,10.406752992522598,203,1,25812,2945,1671,0,2606,1043
1493,0,1,1,0,64,0,4941,0,0,5934060,19257480,77.07139547199077,5698,7181,6939,5940,48364,732692,693788,3000,9182,3484,4241,10423,31.606961258558215,15.571269388878848,6182,0,1271160,35816,999,1,2698,2243
1494,0,1,1,0,60,0,1208,0,0,2867988,3607074,34.55430508634199,982,3808,3596,1194,56643,715977,722019,2809,4215,3233,5423,6829,49.01020301937138,14.694496548602537,1406,1,285366,26288,2402,0,1827,619
1495,0,1,1,0,55,0,1541,0,0,332736,532224,13.856406460551018,2,2115,1925,192,41724,474012,676368,2582,2964,2962,4505,4887,41.6293165929973,14.937686855526282,382,1,46848,6460,1733,0,2580,1039
1496,0,1,1,0,62,0,2934,0,0,3612712,12021744,62.19324722186485,3838,4832,4802,3868,38325,543900,680652,3078,6976,3138,4042,7940,30.56141357987225,5.623413251903491,3898,1,847092,2250,934,0,760,2174
1497,0,1,1,0,63,0,1637,0,0,3881880,9396216,54.3323108288245,2621,4598,4267,2952,48391,709809,690711,2852,6135,3514,4498,7781,36.26292872893749,18.23065374728223,3283,1,640584,46671,1315,0,231,1868
1498,0,1,1,0,63,0,1588,0,0,3910725,9304425,54.08326913195984,2590,4597,4262,2925,48620,699820,703001,2846,6106,3516,4518,7778,36.565010597564445,18.34461467674761,3260,1,646425,44890,1337,0,256,1844
1499,0,1,1,0,63,0,990,0,0,4207075,8244825,51.03920062069938,2275,4550,4220,2605,45144,683640,661485,2835,5770,3495,4780,7715,40.18706259482024,18.33959108532256,2935,1,544445,47190,1615,0,560,1550
1500,0,1,1,0,62,0,526,0,0,4361856,7390528,48.662100242385755,2308,4270,4210,2368,48150,667894,702225,3061,5489,3181,4963,7391,42.91852746774987,7.849311256600636,2428,1,532800,7260,1842,0,753,1279
1501,0,1,1,0,54,0,1568,0,0,295460,465800,13.038404810405298,20,2058,1908,170,39600,452100,657600,2590,2910,2890,4478,4798,41.689327171351664,13.168301036937951,320,1,40800,4800,1738,0,2570,1002
1502,0,1,1,0,54,0,1593,0,0,212908,335544,11.135528725660043,16,1949,1841,124,41040,462726,649440,2598,2830,2814,4423,4655,41.43669871020132,10.8528199128497,232,1,29760,4212,1717,0,2582,989
1503,0,1,1,0,62,0,3549,0,0,7619392,15683712,71.10555533852471,4971,6648,6563,5056,49476,673134,707256,3017,8158,3187,4609,9750,38.82009788756334,9.290499583346438,5141,0,1152768,10285,1507,1,1954,1595
1504,0,1,0,1,67,0,2947,0,0,4949690,13979250,64.35837163881635,3992,5487,5337,4142,48760,715500,776250,3225,7517,3525,4570,8862,34.56877203488721,12.25234475675418,4292,1,952660,16800,1195,0,767,2180
1505,0,1,1,0,54,0,1609,0,0,312200,477750,13.228756555322953,25,2109,1959,175,40824,458640,663390,2580,2905,2880,4514,4839,42.23742416388575,13.038404810405298,325,1,42525,4650,1784,0,2555,946
1506,0,1,1,0,65,0,4031,0,0,3328002,15546456,68.8040696470783,4614,5557,5437,4734,45936,761888,650232,3164,8018,3404,3987,8841,26.514147167125703,11.261033825263985,4854,1,937332,20880,703,0,1450,2581
1507,0,1,1,0,54,0,1673,0,0,215160,324000,10.954451150103322,25,2008,1913,120,43920,486000,658800,2605,2820,2795,4493,4708,42.34383071948026,10.453462715764566,215,1,29280,4465,1793,0,2580,907
1508,0,1,1,0,65,0,4002,0,0,3291400,15446070,68.57113095173507,4612,5492,5402,4702,43616,762120,617580,3195,7987,3375,3985,8777,26.457513110645905,10.170822872186891,4792,1,883976,16650,700,0,1417,2585
1509,0,1,1,0,55,0,1641,0,0,388710,578130,14.491376746189438,20,2251,2061,210,41820,468010,677238,2563,2963,2943,4604,5004,43.02324952859791,14.701110514623295,400,1,51660,5320,1851,0,2543,902
1510,0,1,0,1,64,0,4910,0,0,3099416,17775096,74.0,5446,6072,6042,5476,51012,759564,707628,3216,8722,3276,3812,9318,23.790754506740637,5.477225575051661,5506,1,1193768,4590,566,0,2230,2680
1511,0,1,1,0,64,0,4168,0,0,6513969,17309622,73.34166619323561,5151,6818,6590,5379,51290,740140,717614,2990,8597,3446,4429,10036,34.79942528261063,15.131591550035516,5607,1,1199517,32604,1211,0,2161,2007
1512,0,1,1,0,54,0,1707,0,0,284580,416160,12.36931687685298,3,2163,2013,153,44280,489600,669120,2570,2873,2870,4580,4883,43.12771730569565,12.865825024943737,303,1,37638,6450,1860,0,2567,860
1513,0,1,1,0,61,0,3442,0,0,6672975,14909250,69.46221994724903,4765,6268,6208,4825,49720,698340,679800,3030,7915,3150,4473,9358,37.1887079635741,7.750803389552748,4885,0,1061500,8580,1383,1,1735,1707
1514,0,1,1,0,55,0,1689,0,0,415726,600590,14.7648230602334,8,2335,2125,218,42731,476615,680485,2545,2973,2965,4662,5090,43.669211121796096,15.381906354258097,428,1,53846,6510,1907,0,2537,848
1515,0,1,1,0,54,0,1745,0,0,251786,362604,11.575836902790225,14,2133,2013,134,45080,497904,662970,2586,2840,2826,4585,4839,43.347433603386484,11.436007248781129,254,1,32830,6240,1879,0,2572,827
1516,0,1,0,1,65,0,4989,0,0,3187026,18076500,74.57881736793632,5435,6262,6135,5562,48144,767000,663000,3123,8812,3377,3823,9512,23.93741840717165,11.273792045560366,5689,1,1134648,21717,573,0,2312,2677
1517,0,1,1,0,64,0,2885,0,0,4661006,13102516,63.55312738174259,3784,5448,5193,4039,26125,405500,677996,2989,7283,3499,4398,8692,33.97057550292606,17.141714936279325,4294,1,844151,0,1154,0,795,2090
1518,0,1,1,0,60,0,1196,0,0,4460421,4866059,39.96248240537617,1235,4752,4390,1597,51756,691669,694716,2685,4644,3409,5840,7799,52.848841046895245,19.030688072433485,1959,1,364116,48146,2793,0,1450,254
1519,0,1,1,0,53,0,1802,0,0,170280,241290,9.486832980505138,23,2049,1982,90,46222,512071,648802,2614,2771,2748,4573,4730,43.497126341863094,8.592096094735382,157,1,21780,4422,1892,0,2591,789
1520,0,1,1,0,64,0,5319,0,0,4895200,19739894,78.22403722641782,5929,7109,6919,6119,49729,719398,719398,3036,9345,3416,4026,10335,28.284271247461902,13.800152809104778,6309,0,1364537,25650,800,1,2893,2426
1521,0,1,1,0,64,0,1701,0,0,4523040,10076328,56.04462507680822,3051,4671,4581,3141,48697,747464,670472,3118,6349,3298,4648,7879,37.94733192202055,9.494144610579708,3231,1,656469,14580,1440,0,67,1768
1522,0,1,1,0,55,0,1689,0,0,585280,823935,17.175564037317667,18,2556,2279,295,42558,483189,687078,2516,3088,3070,4777,5349,44.54211490264017,17.70844157075606,572,1,72570,9141,1984,0,2498,809
1523,0,1,1,0,54,0,1763,0,0,353990,495950,13.490737563232042,20,2289,2127,182,43920,490500,664900,2563,2907,2887,4670,5014,44.10215414239989,13.458139030990985,344,1,44408,7614,1945,0,2543,780
1524,0,1,1,0,64,0,4724,0,0,5383677,18153600,75.31932023060219,5643,6652,6622,5673,53966,774400,713600,3170,8873,3230,4149,9852,30.805843601498726,5.477225575051661,5703,0,1265079,4620,949,0,2473,2251
1525,0,1,1,0,65,0,2992,0,0,5368548,13940358,65.22269543648132,3830,5940,5516,4254,37440,766818,524320,2853,7531,3701,4539,9217,35.52463933666322,21.453107213734217,4678,1,680640,90312,1262,0,977,2015
1526,0,1,1,0,60,0,1374,0,0,2441880,3075300,31.937438845342623,896,3538,3414,1020,50380,690435,663300,2891,4035,3139,5409,6553,48.92851929090027,11.187488446066107,1144,1,224400,18104,2394,0,1995,621
1527,0,1,1,0,59,0,1428,0,0,1967680,2564520,29.32575659723036,559,3449,3148,860,54740,685860,709716,2681,3842,3283,5270,6431,47.83304297240559,17.35011748950944,1161,1,204680,36421,2288,0,2122,694
1528,0,1,1,0,55,0,1706,0,0,615672,855270,17.4928556845359,36,2588,2318,306,40824,469560,679185,2525,3101,3065,4807,5383,44.85532298401161,17.36154631383278,576,1,74358,8370,2012,0,2489,783
1529,0,1,1,0,54,0,1804,0,0,318492,439506,12.727922061357855,12,2278,2128,162,44528,499192,656546,2563,2875,2863,4679,4991,44.339598554790726,12.75511514473605,312,1,39204,8550,1966,0,2551,747
1530,0,1,0,1,65,0,4519,0,0,2010216,16155633,70.19259220174163,4860,5402,5335,4927,50621,731217,744333,3212,8206,3346,3687,8681,20.199009876724155,8.189452396126915,4994,1,1118429,8710,408,0,1648,2871
1531,0,1,1,0,64,0,1892,0,0,4655820,10586212,57.463031594234565,3178,4836,4712,3302,47637,759822,644406,3082,6508,3330,4616,8042,37.54996671103717,11.144389776194219,3426,0,663702,21700,1410,1,96,1796
1532,0,1,1,0,64,0,1365,0,0,4821894,9566256,54.607691765904185,2897,4684,4599,2982,50175,721800,715384,3123,6190,3293,4825,7892,40.2119385257662,9.231007614073922,3067,1,664986,11645,1617,0,226,1591
1533,0,1,1,0,59,0,1491,0,0,1656886,2195578,27.23967694375247,447,3270,2975,742,47670,621390,671693,2664,3701,3254,5192,6229,47.25462940284264,17.21691018983201,1037,1,168434,33335,2233,0,2217,726
1534,0,1,1,0,54,0,1802,0,0,402603,548931,14.177446878757825,26,2379,2204,201,42720,486118,655440,2556,2932,2906,4734,5110,44.75488800120049,13.442213731224724,376,1,48240,8750,2003,0,2530,728
1535,0,1,1,0,53,0,1882,0,0,177480,241110,9.486832980505138,5,2147,2062,90,44030,495615,637602,2594,2769,2764,4651,4826,44.40720662234904,9.548881526149486,175,1,21420,5355,1972,0,2589,707
1536,0,1,1,0,65,0,5083,0,0,3359600,18540225,75.33259586659682,5405,6537,6267,5675,48880,767745,679536,2997,8942,3537,3859,9804,24.331050121192877,16.45888251172297,5945,0,1180400,44820,592,1,2408,2675
1537,0,1,1,0,63,0,3358,0,0,5748288,14596414,67.86751800382861,4366,6094,5854,4606,35550,751053,475350,2929,7775,3409,4417,9263,35.32704346531139,15.946016468228203,4846,0,690900,53520,1248,1,1437,1921
1538,0,1,1,0,63,0,2176,0,0,4838372,11185636,59.51470406546604,3326,5124,4908,3542,48960,757920,644232,2942,6700,3374,4524,8282,36.959437225152655,14.697253452969017,3758,1,722568,37800,1366,0,384,1792
1539,0,1,1,0,60,0,1294,0,0,3949491,4389606,37.986839826445156,1335,4288,4180,1443,52670,699660,696618,2934,4485,3150,5779,7330,52.316345438113316,10.410300245868545,1551,1,330447,14580,2737,0,1599,305
1540,0,1,1,0,60,0,1302,0,0,3844555,4300185,37.61648574760805,1320,4227,4132,1415,53590,708087,698970,2944,4454,3134,5756,7266,52.124850119688595,9.756499634156611,1510,1,325450,12920,2717,0,1624,322
1541,0,1,1,0,54,0,1862,0,0,389880,518130,13.784048752090222,66,2366,2242,190,42244,488133,643572,2603,2917,2851,4779,5093,45.2990066116245,11.193732213226145,314,1,44840,7316,2052,0,2537,675
1542,0,1,1,0,65,0,4315,0,0,2186034,15698397,69.0869017976635,4773,5231,5231,4773,51884,782782,717002,3289,8062,3289,3747,8520,21.400934559032695,0.0,4773,1,1040514,0,458,0,1484,2831
1543,0,1,1,0,56,0,1783,0,0,726750,963414,18.49324200890693,192,2617,2467,342,37996,453537,664812,2667,3159,2967,4942,5434,46.09772228646444,13.130475867068439,492,1,80712,4650,2125,0,2475,692
1544,0,1,1,0,54,0,1880,0,0,418281,549333,14.177446878757825,93,2390,2282,201,41418,483741,639522,2625,2934,2841,4814,5123,45.617978911828175,10.518295179710192,309,1,47034,6372,2081,0,2532,652
1545,0,1,1,0,62,0,196,0,0,5271200,6919000,46.9041575982343,1838,4958,4596,2200,49434,673030,726495,2783,5345,3507,5541,8103,48.948953002081666,19.035582960336907,2562,1,508200,40906,2396,0,945,749
1546,0,1,1,0,62,0,611,0,0,5162226,6185531,44.57577817604534,1719,4853,4585,1987,43734,691086,613261,2845,5100,3381,5711,7966,50.97057974949863,16.377596016249214,2255,1,391439,43684,2598,0,1126,515
1547,0,1,1,0,55,0,1840,0,0,629825,821870,17.175564037317667,175,2550,2430,295,38232,451332,657496,2666,3081,2906,4921,5336,46.20606020859169,11.13281192559312,415,1,69620,3960,2135,0,2491,651
1548,0,1,1,0,54,0,1923,0,0,378540,490680,13.416407864998739,113,2350,2283,180,42588,496132,637884,2659,2906,2793,4829,5076,45.858477951192405,8.314029025396882,247,1,42120,4422,2103,0,2546,623
1549,0,1,1,0,54,0,1969,0,0,250680,324480,10.954451150103322,90,2239,2209,120,43152,502944,627328,2674,2824,2734,4793,4943,45.70557952810576,5.91487205010149,150,1,27840,2250,2089,0,2584,615
1550,0,1,1,0,57,0,1731,0,0,1123702,1456185,22.427661492005804,413,2827,2737,503,49329,587685,703485,2805,3398,2985,5129,5722,47.265209192385896,9.724035232351886,593,1,122229,7380,2234,0,2392,661
1551,0,1,1,0,64,0,3360,0,0,5175184,14560840,67.14164132637808,4117,6047,5656,4508,40542,752590,562020,2839,7738,3621,4378,9277,33.88214869219483,20.01404769274308,4899,1,784392,77418,1148,0,1278,2082
1552,0,1,1,0,64,0,1895,0,0,5309816,11004800,58.642987645583,3289,5133,4983,3439,48682,771200,646400,3050,6639,3350,4744,8333,39.293765408777,12.291303419254204,3589,0,694678,26700,1544,1,239,1656
1553,0,1,1,0,62,0,459,0,0,5350630,6540590,45.77116996538323,1853,4891,4649,2095,48178,689962,680596,2880,5217,3364,5676,8013,50.53711507397311,15.55873930426897,2337,1,456710,33396,2554,0,1027,568
1554,0,1,1,0,54,0,2028,0,0,257760,325800,10.954451150103322,120,2268,2268,120,43896,504990,640740,2715,2835,2715,4863,4983,46.34652090502587,0.0,120,1,28320,0,2148,0,2595,567
1555,0,1,1,0,54,0,2052,0,0,192780,243180,9.486832980505138,60,2262,2232,90,42960,483658,648480,2672,2792,2732,4844,4964,46.281745861624536,5.531194905403055,120,1,21600,1590,2142,0,2612,560
1556,0,1,1,0,63,0,2174,0,0,5469672,11588226,60.54750201288241,3581,5243,5158,3666,48930,736513,663810,3076,6827,3246,4653,8404,38.62641583165593,9.227509513928014,3751,0,769860,13770,1492,1,505,1669
1557,0,1,1,0,54,0,2008,0,0,398580,499044,13.490737563232042,182,2372,2372,182,43896,510012,647112,2742,2924,2742,4932,5114,46.79743582719036,0.0,182,1,42952,0,2190,0,2560,552
1558,0,1,1,0,63,0,1903,0,0,5543708,11164218,59.08468498688979,3311,5259,5079,3491,47824,780312,626808,3018,6689,3378,4786,8457,39.84971769034255,13.45762619345434,3671,0,684236,33660,1588,1,293,1610
1559,0,1,1,0,54,0,2092,0,0,237600,292464,10.392304845413264,41,2375,2308,108,42456,471192,660752,2641,2816,2775,4908,5083,46.9041575982343,8.314029025396882,175,1,26352,2613,2200,0,2600,508
1560,0,1,1,0,63,0,4171,0,0,5500872,16570528,72.27724399837061,5224,6277,6277,5224,47960,697840,691496,3172,8396,3172,4225,9449,32.449961479175904,0.0,5224,1,1138832,0,1053,0,2052,2119
1561,0,1,1,0,63,0,2178,0,0,5741503,11780686,61.0,3691,5294,5264,3721,49220,728180,677524,3136,6887,3196,4709,8460,39.28103868280471,5.477225575051661,3751,0,796294,4590,1543,1,555,1623
1562,0,1,1,0,61,0,1319,0,0,5089910,5160932,41.12177038990418,1691,4701,4701,1691,51513,680596,705012,3052,4743,3052,6062,7753,54.86346689738081,0.0,1691,0,390621,0,3010,1,1361,42
1563,0,1,1,0,55,0,2048,0,0,452049,552951,14.177446878757825,159,2492,2450,201,47530,533694,673995,2709,2952,2793,5000,5243,47.4236228055175,6.538739683827756,243,1,49245,2814,2249,0,2550,502
1564,0,1,1,0,54,0,2086,0,0,335400,408900,12.24744871391589,83,2453,2386,150,46683,515214,673322,2659,2876,2793,4962,5179,47.286361670147556,8.286047041568583,217,1,37050,3819,2236,0,2576,490
1565,0,1,1,0,65,0,5159,0,0,3271830,18834510,75.69676347110224,5395,6636,6301,5730,49140,769158,690270,2952,9017,3622,3858,9923,23.895606290697042,18.322707519969132,6065,0,1203300,54605,571,1,2443,2716
1566,0,1,1,0,65,0,5880,0,0,2646000,20550600,79.37253933193772,6058,6962,6720,6300,52668,753522,743736,3020,9562,3504,3682,10224,20.493901531919196,15.562985685478784,6542,0,1436400,33154,420,1,3038,2842
1567,0,1,1,0,64,0,4825,0,0,4654776,18116343,75.15982969645421,5564,6558,6473,5649,52440,737610,731196,3122,8856,3292,4031,9765,28.705400188814647,9.227509513928014,5734,0,1287972,11560,824,1,2442,2383
1568,0,1,1,0,64,0,3706,0,0,4649040,15107032,68.52736679604726,4456,5926,5686,4696,39550,727042,562975,2977,7913,3457,4207,9143,31.464265445104548,15.847692511927205,4936,0,821800,45840,990,1,1479,2227
1569,0,1,1,0,65,0,3242,0,0,4951368,14329224,66.1362230551458,3783,6097,5506,4374,44652,799344,599508,2685,7650,3867,4408,9373,33.645207682521445,24.792913080514204,4965,1,800442,117609,1132,0,1098,2144
1570,0,1,1,0,64,0,1834,0,0,5774295,11164800,59.06775770248944,3339,5294,5144,3489,49044,780800,643200,3050,6689,3350,4855,8494,40.681691213615984,12.286588609993126,3639,0,701289,27300,1655,1,289,1545
1571,0,1,1,0,64,0,1430,0,0,5763800,10381280,56.74504383644443,3086,5144,5010,3220,50976,760864,696384,3090,6444,3358,5014,8368,42.30839160261236,11.579864037853417,3354,0,695520,21038,1790,1,4,1434
1572,0,1,1,0,58,0,1831,0,0,1318352,1615313,23.515952032609693,493,2997,2937,553,48111,592963,692277,2861,3474,2981,5305,5918,48.82622246293481,7.750803389552748,613,1,131061,5460,2384,0,2368,537
1573,0,1,1,0,55,0,2024,0,0,614256,744772,16.3707055437449,208,2620,2560,268,45816,511336,691971,2719,3047,2839,5071,5399,47.8748368143433,8.086478275311649,328,1,66732,2640,2292,0,2511,487
1574,0,1,1,0,54,0,2145,0,0,344250,408600,12.24744871391589,26,2569,2445,150,47750,520284,681000,2600,2874,2848,5019,5293,47.90615826801394,11.350985329980674,274,1,37500,6572,2295,0,2574,429
1575,0,1,1,0,65,0,5159,0,0,3461760,18961920,75.8946638440411,5400,6721,6361,5760,49842,770328,701196,2932,9052,3652,3893,10013,24.515301344262525,19.000291580982868,6120,0,1226880,57240,601,1,2468,2691
1576,0,1,1,0,64,0,1058,0,0,5985168,9769104,55.06359959174482,3032,5006,5006,3032,47736,712062,695952,3222,6254,3222,5196,8228,44.429719783046124,0.0,3032,0,654912,0,1974,1,190,1248
1577,0,1,1,0,61,0,1325,0,0,5289936,5302053,41.60528812542944,1671,4847,4787,1731,47196,634041,698364,3003,4794,3123,6119,7910,55.281099844341014,7.759379671981613,1791,1,394668,6540,3056,0,1332,7
1578,0,1,1,0,59,0,1648,0,0,2546640,2912112,31.176914536239792,810,3754,3592,972,50190,629160,716044,2834,3968,3158,5616,6750,51.18593556827891,12.797192222025664,1134,1,232308,15714,2620,0,2024,376
1579,0,1,1,0,55,0,2103,0,0,562320,663120,15.491933384829668,120,2703,2583,240,45942,513918,682461,2643,3003,2883,5106,5466,48.40454524112379,11.58292185288269,360,1,59280,6000,2343,0,2523,420
1580,0,1,1,0,55,0,2092,0,0,704165,825705,17.175564037317667,145,2832,2682,295,42978,487026,691353,2649,3094,2949,5186,5631,48.85693400122443,12.882345016608866,445,1,72865,4800,2387,0,2504,412
1581,0,1,1,0,54,0,2179,0,0,424620,492480,13.416407864998739,30,2689,2539,180,49196,536256,686736,2586,2916,2886,5095,5425,48.569537778323564,13.187419067680642,330,1,45180,8700,2359,0,2556,377
1582,0,1,1,0,54,0,2203,0,0,352950,408300,12.24744871391589,30,2623,2503,150,47880,517180,685944,2602,2872,2842,5075,5345,48.507731342539614,11.87359542803345,270,1,37800,5520,2353,0,2572,369
1583,0,1,0,1,65,0,5148,0,0,1709293,17884775,73.89857914736926,5401,5834,5774,5461,47674,792550,645175,3215,8736,3335,3588,9109,17.69180601295413,7.7992067098508295,5521,1,1075817,11040,313,0,2186,2962
1584,0,1,1,0,64,0,3910,0,0,4136016,15426480,69.10861017268398,4566,5852,5642,4776,45030,765510,613700,3020,8006,3440,4096,9082,29.427877939124322,15.076742382695786,4986,1,907440,39060,866,0,1546,2364
1585,0,1,1,0,64,0,2784,0,0,5298436,13090974,63.89053137985315,3782,5680,5380,4082,53520,715161,769680,2907,7289,3507,4505,8887,36.02776706930364,17.4171245113064,4382,0,979680,33600,1298,1,875,1909
1586,0,1,1,0,60,0,1503,0,0,4120308,4295520,37.589892258425,1171,4571,4329,1413,48760,699200,644480,2798,4453,3282,5956,7611,54.0,15.556349186104045,1655,0,299556,37752,2916,1,1627,124
1587,0,1,1,0,60,0,1693,0,0,2670878,2987964,31.52776554086889,844,3831,3681,994,52377,664326,712422,2856,4000,3156,5693,6837,51.836280730777744,12.35277120656332,1144,1,235578,17100,2687,0,2012,319
1588,0,1,1,0,54,0,2257,0,0,285240,324120,10.954451150103322,30,2587,2497,120,45360,486180,680652,2611,2821,2791,5078,5288,48.75448697299562,10.219890331034485,210,1,30240,2790,2377,0,2581,324
1589,0,1,1,0,65,0,5148,0,0,2972128,18694912,75.31268153505093,5402,6466,6196,5672,50076,771264,705344,3026,8968,3566,3820,9762,22.891046284519195,16.48556347248607,5942,0,1213808,42390,524,1,2376,2772
1590,0,1,1,0,54,0,2256,0,0,391716,442746,12.727922061357855,12,2730,2580,162,46250,505605,683250,2583,2895,2883,5151,5463,49.17316341257699,13.130475867068439,312,1,40500,6600,2418,0,2571,315
1591,0,1,1,0,53,0,2299,0,0,259956,291492,10.392304845413264,18,2605,2515,108,44250,477723,674750,2609,2807,2789,5106,5304,49.06118628814432,10.170822872186891,198,1,27000,2880,2407,0,2591,292
1592,0,1,1,0,64,0,4494,0,0,4854600,17303952,73.44385610791416,5270,6418,6294,5394,45732,712176,660848,3084,8602,3332,4108,9626,30.0,11.136252869947771,5518,0,1111164,19096,900,1,2186,2308
1593,0,1,1,0,63,0,4184,0,0,3877665,15843315,70.46275611981126,4935,5776,5746,4965,38070,749885,516942,3161,8156,3221,3972,8967,27.94637722496424,5.684275577662207,4995,0,804330,6360,781,1,1774,2410
1594,0,1,1,0,63,0,2277,0,0,5840730,12138660,61.72519744804386,3750,5403,5343,3810,49704,726408,694548,3126,6996,3246,4719,8589,39.153543900903784,7.772191019407321,3870,0,830580,8760,1533,1,624,1653
1595,0,1,1,0,56,0,2202,0,0,672928,762144,16.492422502470642,32,2986,2746,272,42066,479142,689292,2562,3074,3042,5276,5788,49.73932046178355,16.1245154965971,512,1,66912,7200,2474,0,2530,328
1596,0,1,1,0,55,0,2225,0,0,597014,673728,15.556349186104045,2,2949,2709,242,42731,481632,687648,2544,3026,3024,5251,5733,49.66890375275057,16.248309932078527,482,1,59774,7440,2467,0,2542,317
1597,0,1,1,0,53,0,2341,0,0,231420,256405,9.746794344808963,5,2621,2531,95,43824,475024,672051,2609,2794,2789,5135,5320,49.35585071701227,10.170822872186891,185,1,23655,2880,2436,0,2604,263
1598,0,1,1,0,56,0,2210,0,0,753000,846900,17.320508075688775,30,3080,2810,300,38962,454503,683166,2553,3123,3093,5333,5903,50.0999001995014,16.918198356421826,570,1,72600,5940,2510,0,2523,313
1599,0,1,1,0,56,0,2233,0,0,675810,756810,16.431676725154983,0,3043,2773,270,40504,465298,683932,2533,3073,3073,5306,5846,50.02999100539596,17.052826732986624,540,1,65880,6480,2503,0,2533,300
1600,0,1,1,0,55,0,2256,0,0,599040,668400,15.491933384829668,0,2976,2736,240,41820,473450,685110,2545,3025,3025,5281,5761,49.95998398718719,16.623760600423665,480,1,59040,6960,2496,0,2545,289
1601,0,1,1,0,54,0,2351,0,0,296520,325920,10.954451150103322,0,2711,2591,120,45431,491596,681716,2596,2836,2836,5187,5427,49.70915408654627,11.744254646274209,240,1,30120,4440,2471,0,2596,245
1602,0,1,1,0,53,0,2376,0,0,221940,242820,9.486832980505138,0,2646,2556,90,44678,480244,677198,2608,2788,2788,5164,5344,49.658836071740545,10.195209251481318,180,1,22590,2880,2466,0,2608,232
1603,0,1,1,0,64,0,4631,0,0,5132820,17853770,74.53187237685633,5431,6603,6479,5555,47025,723150,671726,3090,8769,3338,4138,9817,30.397368307141328,11.147098121756736,5679,0,1160995,19096,924,1,2341,2290
1604,0,1,1,0,55,0,2309,0,0,528990,581280,14.491376746189438,0,2939,2729,210,41912,467792,686464,2558,2978,2978,5287,5707,50.18964036531842,15.552097364952308,420,1,52080,5250,2519,0,2558,249
1605,0,1,0,1,65,0,5089,0,0,2242776,18063142,74.14175611623992,5370,6032,5905,5497,45590,772210,637484,3159,8783,3413,3694,9318,20.199009876724155,11.313881128525134,5624,1,1066418,22860,408,0,2211,2878
1606,0,1,1,0,63,0,2039,0,0,6092190,11796930,60.74537019394976,3630,5401,5341,3690,46605,764083,623415,3137,6887,3257,4848,8598,40.63249930782009,7.789174875971784,3750,0,719550,10980,1651,1,493,1546
1607,0,1,1,0,62,0,1125,0,0,5742576,5964759,43.57751713900185,1698,5124,4923,1899,45780,659610,684738,2940,5040,3342,6165,8265,54.99090833947008,14.190063084236025,2100,1,413982,25125,3024,0,1242,117
1608,0,1,1,0,56,0,2268,0,0,770400,849000,17.320508075688775,44,3124,2868,300,39606,455630,696180,2574,3130,3086,5398,5954,50.67543783727971,16.917940215049025,556,1,73800,3584,2568,0,2530,262
1609,0,1,1,0,64,0,1628,0,0,6493029,11328783,59.06775770248944,3365,5474,5350,3489,46080,779280,623424,3123,6736,3371,5108,8721,43.139309220245984,11.284767849177381,3613,1,669888,23312,1861,0,242,1386
1610,0,1,1,0,56,0,2275,0,0,859650,940170,18.16590212458495,90,3175,2935,330,43250,492877,712250,2609,3179,3089,5454,6024,51.03920062069938,15.999084394065415,570,1,82500,6000,2605,0,2519,244
1611,0,1,1,0,54,0,2391,0,0,462780,494460,13.416407864998739,5,2926,2751,180,42081,464243,684003,2572,2927,2922,5318,5673,50.70502933634887,14.162333245144376,355,1,44820,3500,2571,0,2567,176
1612,0,1,1,0,54,0,2415,0,0,384750,409050,12.24744871391589,0,2865,2715,150,42500,463590,681750,2577,2877,2877,5292,5592,50.6458290484024,13.002616415293671,300,1,37500,3150,2565,0,2577,162
1613,0,1,1,0,62,0,1274,0,0,5700072,5762428,42.82522621072771,1557,5219,4942,1834,44800,628400,703808,2865,4976,3419,6250,8361,55.749439459065414,16.652473881125413,2111,1,410816,28808,3108,0,1308,34
1614,0,1,1,0,56,0,2295,0,0,845614,919581,17.97220075561143,113,3151,2941,323,43250,492531,711750,2637,3170,3057,5465,5998,51.16639522186413,15.076742382695786,533,1,80750,5040,2618,0,2524,229
1615,0,1,1,0,56,0,2321,0,0,771720,833965,17.175564037317667,94,3112,2911,295,41750,472109,706750,2626,3122,3028,5443,5939,51.146847410177685,14.555844298125802,496,1,73750,3417,2616,0,2532,211
1616,0,1,1,0,55,0,2373,0,0,627120,668880,15.491933384829668,58,3035,2853,240,41832,468216,693963,2605,3027,2969,5400,5822,51.11751167652823,14.17288273841375,422,1,59760,3276,2613,0,2547,174
1617,0,1,1,0,54,0,2421,0,0,468180,494280,13.416407864998739,18,2943,2781,180,41664,461328,681008,2584,2926,2908,5347,5689,51.0,13.741179721005969,342,1,44640,3564,2601,0,2566,145
1618,0,1,1,0,65,0,1454,0,0,6659232,11154384,58.378078077305695,3168,5602,5362,3408,45342,749517,648054,3033,6681,3513,5227,8875,44.204072210600685,15.69144496357498,3648,1,674784,40800,1954,0,135,1319
1619,0,1,1,0,54,0,2460,0,0,309600,324960,10.954451150103322,25,2795,2700,120,41416,452236,671584,2613,2828,2803,5288,5503,50.79370039680118,10.574981251593506,215,1,29760,1900,2580,0,2588,128
1620,0,0,1,0,52,1,672,0,0,1291329,2225229,29.13760456866693,789,2430,2370,849,56376,636903,608072,2561,3470,2681,4142,5051,39.0,7.765259411425052,909,0,196968,8340,1521,0,1772,1100
1621,0,1,1,0,64,0,4253,0,0,3010278,15757685,69.79254974565696,4659,5701,5489,4871,50787,786105,676115,3023,8106,3447,3853,8936,24.859605789312106,14.595806088552747,5083,0,1018039,36464,618,1,1636,2617
1622,0,0,1,0,53,1,505,0,0,2086866,3234096,34.84250278036869,1154,2993,2933,1214,53586,623376,610056,2604,3878,2724,4383,5657,41.46082488325576,7.780166052320878,1274,0,278006,8340,1719,0,1450,945
1623,0,0,1,0,52,1,615,0,0,1560526,2577707,31.28897569432403,937,2615,2573,979,51300,592425,600324,2591,3612,2675,4227,5248,39.92492955535426,6.484411467763075,1021,0,223212,5460,1594,0,1654,1039
1624,0,0,1,0,53,1,520,0,0,2096241,3223682,34.79942528261063,1181,2972,2942,1211,53352,622908,606936,2632,3873,2692,4393,5634,41.60528812542944,5.490867587491313,1241,0,276108,4200,1731,0,1451,931
1625,0,1,1,0,64,0,5488,0,0,3058980,19469508,77.44675590365293,5874,6632,6508,5998,46176,720612,675168,3122,9244,3370,3756,9878,22.58317958127243,11.207254246462899,6122,0,1247584,18600,510,1,2752,2736
1626,0,1,1,0,64,0,2680,0,0,5343984,12866484,63.340350488452465,3888,5468,5344,4012,48510,740817,673470,3083,7219,3331,4539,8675,36.49657518178932,11.187488446066107,4136,0,842520,19840,1332,1,805,1875
1627,0,0,1,0,53,1,506,0,0,2332295,3462830,35.98610843089316,1265,3126,3096,1295,47264,598976,564214,2644,3969,2704,4475,5800,42.43819034784589,5.478746393072713,1325,0,273245,4470,1801,0,1379,873
1628,0,0,1,0,52,1,669,0,0,1550920,2516425,30.903074280724887,925,2609,2579,955,49729,587605,587605,2605,3590,2665,4259,5244,40.29888335921977,5.5965095842615735,985,1,212965,4050,1624,0,1680,1011
1629,0,1,1,0,55,0,2221,0,0,515796,589360,14.560219778561036,182,2675,2645,212,36890,430900,661640,2750,2992,2810,5213,5455,49.3254498205541,6.004624280888846,242,1,50456,540,2433,0,2568,347
1630,0,1,1,0,54,0,2335,0,0,230850,257165,9.746794344808963,95,2525,2525,95,38704,443948,638852,2707,2802,2707,5137,5232,49.29503017546495,0.0,95,1,22420,0,2430,0,2612,277
1631,0,1,1,0,64,0,2750,0,0,5265000,13024800,63.63961030678928,4008,5392,5350,4050,47096,746112,652848,3174,7266,3258,4516,8608,36.05551275463989,6.5135556243263055,4092,0,822150,7056,1300,1,834,1916
1632,0,1,1,0,54,0,2266,0,0,321600,365954,11.575836902790225,104,2564,2534,134,37513,439691,636323,2701,2865,2761,5131,5295,48.98979485566356,5.5965095842615735,164,1,31222,1080,2400,0,2597,331
1633,0,1,1,0,65,0,158,0,0,7037475,8906847,52.278102490430925,2558,5483,5308,2733,49486,710462,739793,3084,5992,3434,5834,8742,50.7444578254611,13.406666223469482,2908,1,620391,21700,2575,0,526,684
1634,0,1,1,0,54,0,2216,0,0,290160,338396,11.135528725660043,34,2554,2464,124,37835,439369,641315,2639,2853,2819,5069,5283,48.373546489791295,9.740037464252968,214,1,29140,2970,2340,0,2605,389
1635,0,1,1,0,65,0,5582,0,0,2585160,19749420,77.53708789992051,5772,6682,6442,6012,53312,781830,735840,3045,9297,3525,3715,9967,20.73644135332772,15.552097364952308,6252,0,1346688,36000,430,1,2727,2855
1636,0,1,1,0,55,0,2121,0,0,439090,526300,13.784048752090222,95,2596,2501,190,37908,448740,648180,2675,2960,2865,5081,5366,48.07286136688766,10.06192246325636,285,1,44460,3325,2311,0,2580,459
1637,0,1,1,0,54,0,2202,0,0,249480,293328,10.392304845413264,18,2508,2418,108,37604,429128,646408,2626,2824,2806,5026,5224,48.062459362791664,10.677899723724408,198,1,25704,2070,2310,0,2608,406
1638,0,0,1,0,53,1,763,0,0,1785168,2671200,31.74901573277509,948,2839,2779,1008,40976,522050,551200,2590,3658,2710,4421,5489,42.08325082500163,7.9332512824338455,1068,1,209664,7140,1771,0,1642,879
1639,0,0,1,0,52,1,893,0,0,1473780,2239468,29.103264421710495,637,2797,2587,847,26880,423040,444192,2434,3491,2854,4384,5441,41.71330722922842,15.076742382695786,1057,1,142296,23940,1740,0,1797,904
1640,0,1,1,0,64,0,4879,0,0,1553700,16660843,71.96526940128828,5059,5599,5479,5179,51272,746344,710957,3097,8396,3337,3517,8816,17.320508075688775,10.95920259392275,5299,0,1144559,17640,300,1,1962,2917
1641,0,1,0,1,64,0,2788,0,0,5132364,13098474,63.671029518926424,4012,5362,5320,4054,44814,746361,626814,3189,7285,3273,4497,8593,35.58089374931439,6.5135556243263055,4096,1,786476,7476,1266,0,823,1965
1642,0,1,1,0,55,0,2054,0,0,520296,637032,15.0996688705415,108,2630,2510,228,36895,438658,656590,2674,3022,2914,5076,5424,47.77028364998475,11.40175425099138,348,1,53580,3240,2282,0,2566,512
1643,0,1,1,0,66,0,1368,0,0,6570553,11015437,57.766772456144714,2935,5708,5306,3337,52398,812046,703113,2899,6638,3703,5270,9009,44.37341546466758,20.270374012721092,3739,1,710781,67938,1969,0,36,1332
1644,0,1,1,0,61,0,1198,0,0,3621224,4270364,37.36308338453881,1269,4117,3990,1396,56400,734160,718865,2932,4455,3186,5653,7176,50.93132631298737,11.353036033505358,1523,1,328060,16891,2594,0,1663,465
1645,0,1,1,0,60,0,1486,0,0,2130995,2702900,29.916550603303182,768,3403,3276,895,51920,712720,664400,2893,3915,3147,5401,6423,48.79549159502341,11.270999429035628,1022,1,196900,19431,2381,0,2125,639
1646,0,1,1,0,56,0,2012,0,0,540480,672000,15.491933384829668,90,2642,2492,240,37604,442400,666400,2650,3040,2950,5052,5442,47.45524207081869,12.574334296829354,390,1,57120,3600,2252,0,2560,548
1647,0,1,1,0,55,0,2070,0,0,405000,497340,13.416407864998739,18,2592,2430,180,39600,455895,663120,2601,2943,2925,5013,5355,47.43416490252569,13.170380740752039,342,1,43200,5022,2250,0,2583,513
1648,0,1,1,0,54,0,2130,0,0,270000,327000,10.954451150103322,12,2478,2370,120,37994,427825,659450,2617,2845,2833,4975,5203,47.43416490252569,11.344655320703637,228,1,29040,1404,2250,0,2605,475
1649,0,0,1,0,53,1,738,0,0,2051280,2979240,33.31666249791537,960,3108,2958,1110,40723,518012,566324,2534,3794,2834,4532,5792,42.988370520409354,12.613010185831968,1260,1,234210,16650,1848,0,1574,836
1650,0,1,1,0,55,0,2011,0,0,466410,584850,14.491376746189438,28,2613,2431,210,40748,465095,679540,2603,2995,2967,5006,5398,47.12748667179272,13.901758655477392,392,1,51240,4914,2221,0,2575,564
1651,0,1,1,0,54,0,2070,0,0,333000,412200,12.24744871391589,0,2520,2370,150,40180,450672,673260,2598,2898,2898,4968,5268,47.11687595755899,13.284983739583302,300,1,36750,3150,2220,0,2598,528
1652,0,0,1,0,53,1,939,0,0,1630530,2392335,29.8496231131986,636,2976,2721,891,45552,588015,558480,2430,3576,2940,4515,5661,42.77849927241488,16.475119085166593,1146,1,185328,37740,1830,0,1794,855
1653,0,1,0,1,65,0,2513,0,0,5456964,12778521,62.52199612936234,3719,5495,5305,3909,43183,709373,650531,3079,7178,3459,4665,8764,37.36308338453881,13.981742743041671,4099,1,777891,29450,1396,0,640,1873
1654,0,1,1,0,65,0,424,0,0,6982857,9370599,53.50700888668698,2563,5602,5302,2863,56386,792066,762609,2973,6136,3573,5712,8875,49.38623289946298,17.46424919657298,3163,1,667079,41400,2439,0,410,834
1655,0,1,1,0,65,0,244,0,0,7012917,9051072,52.65928218272634,2490,5585,5302,2773,55696,770304,770304,2981,6037,3547,5793,8849,50.28916384272063,16.927947446898056,3056,1,654428,37073,2529,0,491,735
1656,0,1,1,0,65,0,124,0,0,7023957,8833528,52.08646657242167,2479,5536,5302,2713,55209,778184,752136,3022,5969,3490,5845,8792,50.882216932834204,15.391788551355644,2947,1,626703,32760,2589,0,543,667
1657,0,1,1,0,56,0,1895,0,0,658500,854400,17.320508075688775,110,2685,2495,300,38151,447136,692064,2658,3148,3038,5043,5533,46.850827100489916,14.025893816633586,490,1,72900,2280,2195,0,2548,653
1658,0,1,1,0,55,0,1981,0,0,460110,585060,14.491376746189438,0,2611,2401,210,42160,473620,690928,2576,2996,2996,4977,5397,46.8081189538738,15.800308688642719,420,1,52080,5040,2191,0,2576,595
1659,0,1,1,0,54,0,2101,0,0,197190,243630,9.486832980505138,0,2371,2281,90,38394,427706,657801,2617,2797,2797,4898,5078,46.8081189538738,10.564395459581663,180,1,21870,1260,2191,0,2617,516
1660,0,0,1,0,55,1,888,0,0,2935764,3667716,36.41428291206625,1206,3660,3540,1326,49050,622350,602988,2646,4092,2886,4980,6426,47.05316142407437,10.996993508431213,1446,1,289068,17160,2214,0,1440,552
1661,0,1,0,1,64,0,4115,0,0,2818374,15199425,68.65129277733959,4563,5461,5311,4713,46320,774000,622425,3075,7938,3375,3823,8686,24.454038521274967,12.312788037888811,4863,1,909609,28050,598,0,1488,2627
1662,0,1,1,0,65,0,608,0,0,6935385,9656940,54.35991169970753,2685,5572,5302,2955,56069,807196,741836,2998,6223,3538,5615,8840,48.4458460551573,16.57077561114505,3225,1,670785,39960,2347,0,313,921
1663,0,1,1,0,65,0,548,0,0,6952725,9558900,54.08326913195984,2655,5572,5302,2925,55800,810464,735300,2998,6193,3538,5645,8840,48.75448697299562,16.57077561114505,3195,1,658125,40770,2377,0,343,891
1664,0,1,1,0,65,0,429,0,0,6984442,9363222,53.53503525729669,2596,5573,5303,2866,56350,800415,751410,2997,6133,3537,5704,8840,49.36598018878993,16.56533358479352,3136,1,659180,38610,2437,0,401,830
1665,0,1,1,0,58,0,1783,0,0,847470,1133730,19.748417658131498,180,2773,2563,390,44322,517446,723843,2697,3297,3117,5080,5680,46.61544808322666,14.495400452462528,600,1,97110,7350,2173,0,2517,734
1666,0,1,0,1,64,0,3361,0,0,4211676,14064918,65.82552696332935,4213,5425,5305,4333,47073,717366,691398,3126,7579,3366,4218,8671,31.176914536239792,10.97739094653235,4453,1,922929,17280,972,0,1087,2274
1667,0,1,1,0,64,0,841,0,0,5715936,6424407,44.799553569204235,1707,5155,4855,2007,52864,755436,717024,2901,5208,3501,6049,8356,53.36665625650534,17.321710763476855,2307,1,449568,44100,2848,0,1194,353
1668,0,1,1,0,61,0,1018,0,0,3922944,4724736,39.191835884530846,1409,4217,4090,1536,49680,664416,707480,2949,4612,3203,5630,7293,50.53711507397311,11.319573475552495,1663,1,353280,14859,2554,0,1540,522
1669,0,1,1,0,59,0,1600,0,0,1239641,1694728,23.895606290697042,401,2912,2742,571,49464,641088,679672,2798,3539,3138,5139,5880,46.593991028886975,13.042463317936507,741,1,130759,20230,2171,0,2397,797
1670,0,1,1,0,58,0,1726,0,0,903887,1230162,20.518284528683193,181,2808,2568,421,46686,543492,733422,2682,3343,3162,5069,5730,46.33573135281238,15.524375156057674,661,1,105671,10560,2147,0,2501,775
1671,0,1,1,0,56,0,1834,0,0,642635,857248,17.349351572897472,54,2683,2436,301,40176,461376,706304,2601,3149,3095,4983,5531,46.20606020859169,15.881128101263423,548,1,74648,2964,2135,0,2547,713
1672,0,0,1,0,55,1,865,0,0,3108984,3844740,37.1887079635741,1293,3721,3631,1383,42705,608820,542100,2690,4163,2870,5028,6501,47.41307836451879,9.724035232351886,1473,1,269685,14580,2248,0,1397,532
1673,0,1,1,0,65,0,320,0,0,7012809,9145063,53.03772242470448,2603,5516,5306,2813,56120,793244,747730,3041,6064,3461,5744,8767,49.92995093127971,14.580022114409926,3023,1,646990,30240,2493,0,438,758
1674,0,1,1,0,64,0,337,0,0,7017978,8047182,49.85980344927164,2391,5404,5309,2486,53815,741273,760695,3142,5723,3332,6060,8641,53.131911315140925,9.886585106410566,2581,1,584210,11970,2823,0,751,414
1675,0,1,1,0,56,0,1855,0,0,519194,693576,15.716233645501712,5,2591,2349,247,39852,460512,682344,2566,3055,3050,4910,5399,45.8475735453906,16.873571161827762,489,1,60021,5808,2102,0,2561,706
1676,0,1,1,0,55,0,1938,0,0,340200,446148,12.727922061357855,9,2415,2262,162,40152,462672,658206,2601,2916,2907,4854,5169,45.8257569495584,13.748592947072089,315,1,38718,5661,2100,0,2592,654
1677,0,1,0,1,65,0,5022,0,0,3877360,18765282,75.51158851461145,5522,6562,6382,5702,49504,783258,684528,3111,8993,3471,3971,9853,26.076809620810597,13.418995158121604,5882,1,1186016,30420,680,0,2411,2611
1678,0,1,1,0,65,0,1102,0,0,6734808,10438632,56.60388679233962,2992,5518,5306,3204,56635,785178,765630,3046,6462,3470,5360,8776,45.8475735453906,14.652955522209124,3416,1,752940,28196,2102,0,54,1156
1679,0,1,1,0,64,0,743,0,0,6903050,9816125,55.0,2845,5487,5307,3025,56334,798270,743105,3065,6270,3425,5527,8732,47.77028364998475,13.491246634222138,3205,1,692725,26100,2282,0,220,963
1680,0,1,1,0,64,0,445,0,0,6996864,9332988,53.637673327615545,2697,5489,5309,2877,55527,807756,723412,3064,6121,3424,5676,8733,49.31531202375181,13.485847547000814,3057,1,641571,27900,2432,0,367,812
1681,0,1,1,0,64,0,151,0,0,7045980,8364360,50.79370039680118,2430,5461,5311,2580,53058,774838,719724,3092,5822,3392,5973,8703,52.25897052181568,12.384480471957746,2730,1,572760,22800,2731,0,662,511
1682,0,1,1,0,64,0,211,0,0,7040550,8264550,50.49752469181039,2423,5438,5311,2550,53325,768117,729225,3114,5791,3368,6002,8679,52.54521862167861,11.433666374303913,2677,1,573750,18542,2761,0,691,480
1683,0,1,1,0,64,0,509,0,0,6992222,7720028,49.01020301937138,2402,5313,5313,2402,56133,742434,781002,3214,5616,3214,6125,8527,53.95368384086484,0.0,2402,1,583686,0,2911,0,812,303
1684,0,1,1,0,59,0,1583,0,0,1088318,1532762,22.759613353482084,263,2874,2619,518,50190,621390,707201,2704,3477,3214,5060,5833,45.83666654546336,15.982515305448514,773,1,123802,24735,2101,0,2441,858
1685,0,1,1,0,55,0,1895,0,0,362250,483000,13.228756555322953,13,2407,2245,175,38305,449880,648600,2598,2935,2922,4830,5167,45.4972526643093,14.074476481582899,337,1,41125,5994,2070,0,2585,690
1686,0,0,1,0,54,1,827,0,0,2326998,3180075,34.161381705077446,1137,3191,3161,1167,36966,550450,498675,2695,3892,2755,4719,5916,44.654227123532216,5.753771868478424,1197,1,213561,4620,1994,0,1558,731
1687,0,1,0,1,65,0,4939,0,0,1124226,16894332,71.81225522151495,4826,5706,5375,5157,47952,707616,727272,2945,8433,3607,3494,8982,14.7648230602334,18.361114849482025,5488,1,1144854,42368,218,0,1881,3058
1688,0,1,0,1,65,0,4946,0,0,300360,16279512,70.75309180523492,4882,5190,5066,5006,42768,643896,702432,3128,8258,3376,3312,8442,7.745966692414834,11.546879086349044,5130,1,1081296,13764,60,0,1754,3192
1689,0,1,1,0,64,0,569,0,0,6970740,9510900,54.22176684690383,2790,5461,5311,2940,55552,802280,724640,3085,6175,3385,5606,8696,48.692915295759406,12.286588609993126,3090,1,658560,22800,2371,0,295,864
1690,0,1,1,0,64,0,390,0,0,7016311,9225836,53.39475629684998,2701,5462,5312,2851,55552,802528,724864,3086,6087,3386,5697,8698,49.60846701924985,12.296281753706847,3001,1,638624,22800,2461,0,385,775
1691,0,1,1,0,64,0,27,0,0,7062124,8569204,51.419840528729765,2469,5490,5315,2644,53192,790804,706538,3066,5885,3416,5912,8731,51.6817182376902,13.424061915817928,2819,1,576392,28350,2671,0,597,570
1692,0,1,1,0,64,0,147,0,0,7056904,8374744,50.83306010855534,2450,5449,5315,2584,53743,781081,722743,3107,5825,3375,5972,8690,52.25897052181568,11.727705886231366,2718,1,576232,20502,2731,0,657,510
1693,0,1,1,0,64,0,385,0,0,7030566,7947918,49.658836071740545,2424,5359,5317,2466,55056,715506,799304,3181,5689,3265,6074,8582,53.39475629684998,6.7040592262067955,2508,1,611568,3990,2851,0,757,372
1694,0,1,1,0,64,0,504,0,0,7006777,7724063,49.06118628814432,2407,5318,5318,2407,56376,744488,779787,3209,5616,3209,6120,8527,53.95368384086484,0.0,2407,1,584901,0,2911,0,802,298
1695,0,1,1,0,63,0,748,0,0,5750453,6553176,45.31004303683677,1783,5124,4854,2053,56880,766080,756504,2922,5245,3462,5993,8316,52.92447448959697,16.593584716209165,2323,1,486561,35100,2801,0,1139,391
1696,0,1,1,0,63,0,757,0,0,5628744,6456560,44.98888751680797,1754,5075,4805,2024,56088,784740,727320,2920,5214,3460,5971,8265,52.73518749374084,16.581972606744092,2294,1,461472,39690,2781,0,1166,409
1697,0,1,0,1,65,0,4894,0,0,1729475,17169350,72.2841614740048,4771,6010,5556,5225,50838,752494,729492,2832,8511,3740,3617,9296,18.193405398660254,21.45118260951273,5679,1,1159950,64922,331,0,1939,2955
1698,0,1,0,1,64,0,4126,0,0,2369507,14945051,68.09552114493287,4529,5256,5148,4637,44368,760628,605924,3115,7860,3331,3734,8479,22.60530911091463,10.480278705357403,4745,1,871756,20304,511,0,1414,2712
1699,0,1,1,0,58,0,1582,0,0,904488,1302320,21.118712081942874,86,2834,2474,446,46500,543120,730000,2560,3366,3280,4948,5754,45.033320996790806,19.054004624699736,806,1,111500,15840,2028,0,2474,892
1700,0,1,1,0,57,0,1631,0,0,788190,1126710,19.748417658131498,30,2771,2411,390,45816,531576,719361,2529,3279,3249,4910,5660,44.955533585978046,18.977324946034468,750,1,97110,16560,2021,0,2499,868
1701,0,1,1,0,56,0,1753,0,0,518838,724206,16.06237840420901,16,2511,2269,258,40869,479997,670873,2565,3065,3049,4818,5318,44.844174649557324,17.04884263360742,500,1,61662,10164,2011,0,2549,796
1702,0,1,1,0,64,0,222,0,0,7068600,8928612,52.64978632435273,2682,5412,5322,2772,54467,808471,698957,3131,5993,3311,5771,8633,50.49752469181039,9.580310602724222,2862,1,601524,14760,2550,0,449,671
1703,0,1,1,0,63,0,651,0,0,6338032,7077174,47.042533945356304,2021,5269,5077,2213,56619,777114,745134,3006,5411,3390,6062,8467,53.51635264103861,13.867762834025882,2405,1,515629,26496,2864,0,985,334
1704,0,1,1,0,63,0,667,0,0,6076434,6873414,46.411205543489174,1926,5203,4975,2154,56640,765840,753076,2963,5345,3419,6012,8394,53.113086899558006,15.29964203757375,2382,1,508344,29412,2821,0,1037,370
1705,0,1,1,0,58,0,1564,0,0,857420,1248290,20.73644135332772,40,2814,2424,430,47690,551570,728653,2513,3333,3293,4897,5717,44.654227123532216,19.880050211732332,820,1,107930,19110,1994,0,2473,909
1706,0,1,1,0,57,0,1636,0,0,695100,1000300,18.708286933869708,15,2671,2336,350,45816,525872,711642,2523,3208,3193,4844,5529,44.56455991031439,19.978527946060005,685,1,87150,15075,1986,0,2508,872
1707,0,1,1,0,56,0,1660,0,0,642816,920808,18.0,15,2617,2308,324,44888,514402,704816,2533,3166,3151,4826,5459,44.54211490264017,19.17120320542915,633,1,80352,13287,1984,0,2518,858
1708,0,1,1,0,54,0,1850,0,0,265856,364346,11.575836902790225,10,2242,2118,134,42872,500296,633527,2595,2853,2843,4703,4961,44.54211490264017,11.932888170540295,258,1,31222,8680,1984,0,2585,735
1709,0,1,0,1,65,0,3833,0,0,2970534,14609994,67.03730304837748,4226,5423,5155,4494,48441,783491,653451,2983,7745,3519,3912,8674,25.709920264364882,16.500441727537666,4762,1,903294,47972,661,0,1243,2590
1710,0,1,1,0,64,0,584,0,0,7000980,9503018,54.35071296680477,2894,5384,5324,2954,54692,778514,727042,3157,6171,3277,5587,8601,48.68264577855234,7.745966692414834,3014,1,667604,8940,2370,0,263,847
1711,0,1,1,0,64,0,465,0,0,7034850,9304530,53.80520420925842,2835,5385,5325,2895,55632,784216,732792,3154,6109,3274,5644,8599,49.29503017546495,7.745966692414834,2955,1,660060,8880,2430,0,319,784
1712,0,1,1,0,64,0,227,0,0,7081350,8922501,52.69724850502159,2717,5387,5327,2777,53965,806463,690795,3153,5990,3273,5763,8600,50.49752469181039,7.83531632499182,2837,1,597055,10080,2550,0,436,663
1713,0,1,1,0,64,0,49,0,0,7098960,8677403,51.85556864985669,2604,5414,5329,2689,52164,813204,667989,3142,5916,3312,5867,8641,51.38093031466052,9.412769291411893,2774,1,556623,15215,2640,0,538,587
1714,0,1,1,0,64,0,248,0,0,7092180,8197950,50.41825066382212,2500,5374,5332,2542,56376,748200,783675,3183,5767,3267,6015,8599,52.820450584977024,6.7040592262067955,2584,1,617706,4704,2790,0,683,435
1715,0,1,1,0,57,0,1567,0,0,765578,1122561,19.77371993328519,15,2725,2349,391,47750,548361,717750,2495,3262,3247,4829,5596,44.24929377967517,20.99446385155917,767,1,97750,19928,1958,0,2480,913
1716,0,1,1,0,55,0,1673,0,0,540150,774769,16.64331697709324,22,2482,2227,277,44954,509054,690859,2542,3074,3052,4747,5279,44.15880433163923,17.0,532,1,68419,11730,1950,0,2520,847
1717,0,1,0,1,65,0,4843,0,0,1418240,16885760,71.55417527999327,4702,5815,5397,5120,44308,699176,689282,2880,8418,3716,3575,9113,16.64331697709324,20.66295824300685,5538,1,1070080,57684,277,0,1822,3021
1718,0,1,0,1,65,0,4857,0,0,1106350,16717050,71.23903424387504,4713,5655,5293,5075,47085,721386,708210,2932,8369,3656,3512,8949,14.7648230602334,19.32000626596122,5437,1,1091125,50318,218,0,1781,3076
1719,0,1,0,1,64,0,1661,0,0,6393852,11314080,59.09314681077663,3258,5557,5323,3492,54000,777600,729000,3006,6732,3474,5071,8797,42.790185790669334,15.305502420098039,3726,1,785700,35100,1831,0,252,1409
1720,0,1,1,0,64,0,648,0,0,6997249,9609635,54.67174773134658,2959,5360,5330,2989,52377,761955,710515,3185,6204,3245,5556,8575,48.38388161361178,5.478746393072713,3019,1,660569,4560,2341,0,226,874
1721,0,1,1,0,64,0,6,0,0,7118215,8589295,51.62363799656123,2605,5396,5336,2665,55278,802527,715506,3163,5888,3283,5894,8619,51.6817182376902,8.086478275311649,2725,1,591630,9300,2671,0,558,552
1722,0,1,1,0,57,0,1542,0,0,739584,1096704,19.595917942265423,18,2676,2310,384,46065,528360,711144,2490,3240,3222,4782,5532,43.88621651498338,20.541831061042583,750,1,95616,16836,1926,0,2472,930
1723,0,1,1,0,55,0,1652,0,0,514560,745576,16.3707055437449,13,2443,2188,268,46128,517452,689936,2527,3050,3037,4702,5225,43.81780460041329,16.904811057762124,523,1,66464,13005,1920,0,2514,862
1724,0,0,1,0,55,1,759,0,0,3133890,3986766,37.82856063875548,1191,3861,3621,1431,46125,571130,626850,2546,4217,3026,4976,6647,46.79743582719036,16.089156800274484,1671,1,321975,26400,2190,0,1355,596
1725,0,0,1,0,54,1,1335,0,0,1943014,2411866,29.631064780058107,677,3292,3091,878,36594,587858,469737,2546,3625,2948,4960,6039,47.042533945356304,14.600386728658112,1079,1,150138,36381,2213,0,1869,534
1726,0,1,0,1,64,0,831,0,0,6942916,9927260,55.52476924760696,3053,5365,5335,3083,51504,747040,714840,3190,6303,3250,5472,8585,47.45524207081869,5.483301264452448,3113,1,684426,4380,2252,0,137,968
1727,0,1,0,1,64,0,772,0,0,6969228,9827772,55.263007518592396,3054,5336,5336,3054,51051,743358,711178,3218,6272,3218,5500,8554,47.77028364998475,0.0,3054,1,674934,0,2282,0,164,936
1728,0,1,1,0,64,0,118,0,0,7130760,8752380,52.24940191045253,2700,5372,5342,2730,52371,811118,663642,3176,5936,3236,5818,8578,51.10772935672255,5.501408174353464,2760,1,565110,5280,2612,0,476,594
1729,0,1,1,0,63,0,606,0,0,5625072,6583464,45.69463863518345,1968,4902,4782,2088,56628,763026,737802,3033,5241,3273,5847,8055,51.90375708944392,10.996993508431213,2208,1,488592,16320,2694,0,1065,459
1730,0,1,1,0,56,0,1512,0,0,723508,1084498,19.544820285692065,21,2637,2276,382,46314,528054,706911,2478,3221,3200,4733,5476,43.520110293977886,20.14057347549935,743,1,95118,17328,1894,0,2457,945
1731,0,1,1,0,55,0,1607,0,0,534870,787306,16.822603841260722,15,2441,2173,283,47559,531362,692718,2514,3065,3050,4672,5223,43.474130238568314,17.24617824879332,551,1,70467,14472,1890,0,2499,892
1732,0,1,1,0,55,0,1663,0,0,431148,628140,15.0996688705415,12,2335,2119,228,47918,534470,680485,2539,2983,2971,4646,5090,43.485629810317796,15.511530043917954,444,1,56316,13608,1891,0,2527,864
1733,0,1,1,0,54,0,1719,0,0,331450,477575,13.228756555322953,13,2231,2069,175,48265,537613,668605,2567,2904,2891,4623,4960,43.520110293977886,13.329963566490761,337,1,42875,11340,1894,0,2554,835
1734,0,1,1,0,54,0,1746,0,0,284400,407700,12.24744871391589,16,2180,2046,150,49532,551754,663192,2584,2868,2852,4614,4898,43.54308211415448,12.151058826387683,284,1,36600,10854,1896,0,2568,822
1735,0,1,0,1,64,0,1251,0,0,6734980,10636260,57.40209055426466,3253,5381,5339,3295,53550,768264,726300,3186,6523,3270,5272,8609,45.21061822182926,6.484411467763075,3337,1,741375,6258,2044,0,67,1184
1736,0,1,1,0,63,0,361,0,0,7115022,9118530,53.422841556772326,2824,5377,5347,2854,55932,754020,757215,3165,6049,3225,5688,8572,49.92995093127971,5.5503012171862105,2884,1,676398,3870,2493,0,341,702
1737,0,1,1,0,63,0,521,0,0,6637650,7361969,48.25971404805462,2205,5303,5179,2329,55527,787089,704903,3037,5490,3285,6011,8464,53.38539126015655,11.230094695077256,2453,1,519367,19096,2850,0,832,311
1738,0,1,1,0,61,0,805,0,0,3240174,4424056,37.97367509209505,1292,3839,3689,1442,46460,705640,619736,2918,4510,3218,5315,6907,47.40253157796533,12.25234475675418,1592,1,291284,24900,2247,0,1626,821
1739,0,1,1,0,61,0,899,0,0,2642232,3779035,35.17101079013795,1117,3493,3373,1237,51429,662935,724035,2935,4292,3175,5191,6548,46.216880033165374,10.996993508431213,1357,1,293169,13080,2136,0,1818,919
1740,0,1,1,0,60,0,943,0,0,2406950,3499450,33.91164991562634,1120,3273,3243,1150,49952,681632,678589,3013,4193,3073,5136,6316,45.749316934791494,5.490867587491313,1180,0,256450,4080,2093,1,1893,950
1741,0,1,1,0,58,0,1343,0,0,1019244,1585671,23.259406699226016,95,2871,2425,541,49800,586200,729819,2485,3472,3377,4815,5802,43.40506882842141,21.270378462892687,987,1,134709,29882,1884,0,2390,1047
1742,0,1,1,0,57,0,1403,0,0,877968,1354003,21.656407827707714,19,2791,2341,469,46937,539869,724637,2437,3356,3337,4759,5678,43.266615305567875,22.59361305351954,919,1,117719,19800,1872,0,2418,1015
1743,0,1,1,0,55,0,1565,0,0,548700,820395,17.175564037317667,12,2438,2155,295,48500,539514,695250,2498,3076,3064,4641,5219,43.12771730569565,17.671183205605452,578,1,73750,16131,1860,0,2486,921
1744,0,1,1,0,55,0,1592,0,0,498480,741556,16.3707055437449,12,2384,2128,268,48804,542332,688983,2511,3035,3023,4627,5151,43.12771730569565,16.78947592936195,524,1,66732,16128,1860,0,2499,907
1745,0,1,1,0,54,0,1652,0,0,391020,575820,14.491376746189438,9,2273,2072,210,49104,542916,680016,2541,2952,2943,4604,5015,43.15089802078283,14.78598154140589,411,1,52080,13467,1862,0,2532,880
1746,0,1,0,1,66,0,2266,0,0,5845211,12610748,61.66846844214635,3337,5806,5340,3803,51529,752732,752732,2850,7119,3782,4853,9122,39.20459156782532,21.752231897593067,4269,1,863281,62910,1537,0,487,1779
1747,0,1,0,1,64,0,1552,0,0,6537408,11147384,58.71967302361279,3314,5478,5344,3448,53100,762988,727425,3099,6681,3367,5129,8711,43.54308211415448,11.5784147532791,3582,1,775800,19430,1896,0,215,1337
1748,0,1,0,1,64,0,1433,0,0,6628884,10949859,58.215118311311535,3304,5430,5345,3389,52851,765747,720513,3146,6620,3316,5187,8661,44.22668877499196,9.220820253968727,3474,1,755747,12750,1956,0,158,1275
1749,0,1,1,0,63,0,48,0,0,7181824,8477952,51.536394906900505,2626,5390,5360,2656,56069,788424,724584,3162,5848,3222,5896,8582,52.0,5.5965095842615735,2686,1,602912,4350,2704,0,536,488
1750,0,1,1,0,62,0,533,0,0,5938830,6878380,46.74398357008097,2095,4993,4903,2185,56376,764964,730336,3058,5333,3238,5866,8141,52.1344415909483,9.515978740065268,2275,1,506920,12600,2718,0,963,430
1751,0,1,1,0,61,0,653,0,0,4292904,5481245,42.08325082500163,1741,4225,4195,1771,52891,702565,721135,3065,4866,3125,5519,7320,49.23413450036468,5.514871952411144,1801,0,412643,3780,2424,0,1324,671
1752,0,1,1,0,60,0,909,0,0,2393586,3526110,34.02939905434711,1128,3255,3225,1158,50176,682080,682080,3015,4203,3075,5112,6300,45.46427168667722,5.514871952411144,1188,0,259392,4050,2067,1,1887,978
1753,0,1,1,0,58,0,1278,0,0,1082520,1711662,24.124676163629637,132,2892,2442,582,52539,620551,732309,2491,3523,3391,4801,5833,43.12771730569565,21.347683725458317,1032,1,144918,36450,1860,0,2359,1081
1754,0,1,1,0,55,0,1500,0,0,603900,922020,18.16590212458495,7,2483,2160,330,47250,528066,698500,2471,3124,3117,4624,5277,42.77849927241488,18.81631388577983,653,1,82500,16473,1830,0,2464,964
1755,0,1,1,0,54,0,1719,0,0,220680,324840,10.954451150103322,0,2079,1959,120,50388,552228,668629,2587,2827,2827,4546,4786,42.883563284783136,11.471280364317135,240,1,29640,9240,1839,0,2587,868
1756,0,1,1,0,65,0,4497,0,0,1107054,15375750,68.78226515607058,4549,5147,4965,4731,47724,630500,799500,3068,7981,3432,3484,8397,15.297058540778355,13.710242244549764,4913,0,1163826,11830,234,1,1481,3016
1757,0,1,1,0,64,0,548,0,0,7112685,9494415,54.35991169970753,2925,5392,5362,2955,53520,716499,771120,3183,6168,3243,5620,8605,49.06118628814432,5.5503012171862105,2985,1,709200,3360,2407,0,258,806
1758,0,1,1,0,63,0,75,0,0,7199766,8660943,52.16320542297991,2661,5427,5367,2721,54500,795750,693894,3123,5904,3243,5829,8610,51.43928459844674,7.7992067098508295,2781,1,593178,9720,2646,0,462,537
1759,0,1,1,0,63,0,16,0,0,7203792,8571328,51.884487084291386,2632,5428,5368,2692,55552,789632,713216,3124,5876,3244,5860,8612,51.73006862551025,7.822290851349969,2752,1,603008,9180,2676,0,492,508
1760,0,1,1,0,63,0,400,0,0,7174596,7868190,49.85980344927164,2378,5480,5372,2486,56386,737445,765930,3057,5651,3273,6051,8645,53.72150407425317,10.748049169056976,2594,1,601612,12636,2886,0,679,279
1761,0,1,1,0,63,0,454,0,0,6992187,7654758,49.26459174701441,2307,5428,5308,2427,56168,750652,744344,3034,5581,3274,6035,8582,53.67494760127857,11.015556749295067,2547,1,572772,15840,2881,0,727,273
1762,0,1,1,0,62,0,474,0,0,6574456,7355348,48.35286961494633,2271,5217,5150,2338,55902,761332,726726,3079,5484,3213,5958,8363,53.028294334251406,8.2143728690235,2405,1,540078,9447,2812,0,808,334
1763,0,1,1,0,58,0,1267,0,0,1006460,1610336,23.515952032609693,42,2884,2373,553,50347,579488,736736,2401,3465,3423,4732,5796,42.661458015403085,22.818694259512608,1064,1,139909,29127,1820,0,2359,1092
1764,0,1,1,0,57,0,1355,0,0,814506,1285350,21.236760581595302,8,2700,2257,451,48636,550050,718200,2407,3301,3293,4656,5550,42.49705872175156,21.946130412670342,894,1,113652,23479,1806,0,2399,1044
1765,0,1,1,0,56,0,1411,0,0,704582,1103793,19.77371993328519,1,2583,2193,391,49000,553308,705750,2433,3214,3213,4625,5406,42.44997055358225,20.626219908738804,781,1,97750,23010,1802,0,2432,1021
1766,0,1,1,0,54,0,1685,0,0,224316,335668,11.135528725660043,4,2053,1933,124,49200,541400,665922,2587,2831,2827,4516,4760,42.532340636273474,11.808089875718325,244,1,30504,8760,1809,0,2583,898
1767,0,0,1,0,57,1,1458,0,0,3239923,3467967,34.828149534535996,834,4263,3884,1213,43844,554646,646134,2480,4072,3238,5530,7122,51.6817182376902,19.76064356751854,1592,1,274138,35247,2671,0,1646,188
1768,0,0,1,0,56,1,1187,0,0,3589968,3921264,37.30951621235526,1182,4181,3971,1392,43884,583119,597204,2607,4209,3027,5396,6998,50.78385570237849,14.534640317255622,1602,1,295104,27090,2579,0,1425,238
1769,0,1,0,1,65,0,2090,0,0,6085016,12266856,61.02458520956943,3359,5723,5358,3724,50128,685152,793854,2929,7018,3659,4928,9017,40.422765862815474,19.232749017330665,4089,1,897484,33215,1634,0,430,1660
1770,0,1,0,1,65,0,1854,0,0,6323071,11726357,60.05830500438719,3360,5607,5360,3607,50076,695714,760734,3004,6858,3498,5004,8858,41.86884283091664,15.73481264800746,3854,1,844038,27170,1753,0,356,1498
1771,0,1,1,0,62,0,477,0,0,6007024,6983360,47.15930449020638,2194,4955,4925,2224,53703,763020,693940,3110,5364,3170,5841,8095,51.97114584074513,5.490867587491313,2254,0,491504,4710,2701,1,916,439
1772,0,1,1,0,62,0,521,0,0,5256696,6421439,45.24378410345447,2047,4615,4615,2047,51051,724647,693277,3137,5184,3137,5705,7752,50.67543783727971,0.0,2047,1,452387,0,2568,0,1090,569
1773,0,1,1,0,56,0,1350,0,0,752176,1201616,20.591260281974,4,2618,2198,424,49698,561132,711334,2414,3258,3254,4608,5452,42.118879377305376,21.385537853435437,844,1,106424,25620,1774,0,2410,1060
1774,0,1,1,0,55,0,1464,0,0,541620,850068,17.4928556845359,6,2376,2076,306,47616,533376,688944,2478,3084,3078,4548,5154,42.07136793592526,17.99605494466097,606,1,75888,17400,1770,0,2472,1008
1775,0,1,1,0,54,0,1645,0,0,238386,362872,11.575836902790225,14,2033,1913,134,48068,533476,660752,2588,2842,2828,4487,4741,42.17819341792628,11.765341641478667,254,1,32696,8760,1779,0,2574,929
1776,0,1,0,1,66,0,2152,0,0,6046080,12423040,61.318838867023565,3369,5759,5368,3760,51304,700448,799568,2913,7064,3695,4912,9063,40.099875311526844,19.930292662585,4151,1,909920,37536,1608,0,456,1696
1777,0,1,0,1,64,0,1797,0,0,6399238,11637584,59.85816569190874,3371,5581,5369,3583,51051,717808,750288,3036,6831,3460,5034,8829,42.261093218230876,14.576068100328353,3795,1,827673,25864,1786,0,335,1462
1778,0,1,1,0,64,0,498,0,0,7179480,9410940,54.22176684690383,2940,5382,5382,2940,52185,681813,784245,3201,6141,3201,5643,8583,49.416596402423345,0.0,2940,1,720300,0,2442,0,261,759
1779,0,1,1,0,62,0,438,0,0,6242103,7182882,47.843494855622744,2289,5016,5016,2289,53966,759396,699774,3138,5427,3138,5865,8154,52.22068555658763,0.0,2289,0,510447,0,2727,1,849,411
1780,0,1,1,0,62,0,525,0,0,4764496,6051936,44.0,1906,4427,4397,1936,49268,681468,706476,3096,5062,3156,5587,7553,49.60846701924985,5.477225575051661,1966,1,437536,3750,2461,0,1190,665
1781,0,1,0,1,66,0,2233,0,0,5884998,12569053,61.538605769061746,3337,5791,5341,3787,52392,736818,783284,2869,7106,3769,4873,9110,39.42080668885405,21.3999397569623,4237,1,893732,52650,1554,0,468,1765
1782,0,1,1,0,63,0,262,0,0,7245864,8972550,53.16013544000805,2796,5420,5390,2826,53118,720725,742950,3145,6001,3205,5739,8595,50.635955604688654,5.490867587491313,2856,1,661284,3750,2564,0,349,611
1783,0,1,1,0,62,0,426,0,0,5952232,7014332,47.286361670147556,2206,4928,4898,2236,52030,759154,674455,3107,5373,3167,5799,8065,51.59457335805772,5.477225575051661,2266,0,480740,4920,2662,1,901,475
1784,0,1,1,0,55,0,1387,0,0,552330,899232,17.97220075561143,17,2339,2033,323,44556,523392,659808,2478,3107,3090,4494,5123,41.352146256270665,18.310339949785384,629,1,76551,21114,1710,0,2461,1074
1785,0,1,1,0,54,0,1569,0,0,257850,407100,12.24744871391589,16,2003,1869,150,44082,504804,643218,2580,2864,2848,4433,4717,41.46082488325576,12.295609359105146,284,1,35550,8978,1719,0,2564,995
1786,0,1,1,0,54,0,1603,0,0,206760,324240,10.954451150103322,12,1951,1843,120,45220,513380,643076,2594,2822,2810,4425,4653,41.50903516103452,11.009004714545675,228,1,28560,7668,1723,0,2582,979
1787,0,1,1,0,62,0,414,0,0,5669251,6852437,46.72258554489466,2123,4840,4780,2183,48672,734526,652912,3079,5322,3199,5736,7979,50.96076922496363,7.746504550744806,2243,1,454064,9900,2597,0,956,542
1788,0,0,1,0,56,1,882,0,0,3600223,4230149,38.82009788756334,1507,3896,3896,1507,38412,555786,544558,2807,4314,2807,5196,6703,48.877397639399746,0.0,1507,0,292358,0,2389,0,1300,418
1789,0,1,0,1,66,0,2172,0,0,5848405,12403103,61.1310068623117,3287,5752,5302,3737,53325,746775,786603,2869,7056,3769,4884,9071,39.56008088970496,21.3999397569623,4187,1,885669,53550,1565,0,418,1754
1790,0,1,1,0,62,0,455,0,0,4474500,5933700,43.58898943540674,1766,4389,4255,1900,51968,699552,724536,2989,5023,3257,5478,7512,48.52834223420371,11.583726138680884,2034,1,440800,16750,2355,0,1223,768
1791,0,1,1,0,57,0,1074,0,0,999856,1732406,24.454038521274967,16,2852,2270,598,50430,593885,712662,2315,3495,3479,4569,5749,40.890096600521744,25.12127468967194,1180,1,147108,46560,1672,0,2299,1225
1792,0,1,1,0,55,0,1410,0,0,399784,668646,15.556349186104045,2,2134,1894,242,43010,516681,635490,2523,3005,3003,4415,4897,40.64480286580315,16.394415485858392,482,1,55660,18960,1652,0,2521,1111
1793,0,1,1,0,54,0,1539,0,0,206212,336288,11.135528725660043,4,1907,1787,124,42897,490872,642744,2592,2836,2832,4375,4619,40.779897008207364,11.621977114038057,244,1,29388,7200,1663,0,2588,1049
1794,0,1,1,0,53,0,1572,0,0,158365,256310,9.746794344808963,5,1852,1762,95,43020,485640,644822,2608,2793,2788,4365,4550,40.82891132518721,10.400314334861214,185,1,22705,4950,1667,0,2603,1031
1795,0,1,0,1,65,0,5133,0,0,3707550,18826500,75.99342076785332,5745,6447,6417,5775,44505,674820,700900,3230,9035,3290,3902,9707,25.337718918639855,5.477225575051661,5805,1,1241625,3750,642,0,2515,2618
1796,0,1,0,1,67,0,4478,0,0,4089168,17749512,72.49827584156743,4979,6311,6034,5256,40152,807103,567336,3100,8633,3654,4155,9688,27.892651361962706,17.253240816649747,5533,1,883008,57893,778,0,1879,2599
1797,0,1,0,1,64,0,3859,0,0,2439836,14334588,66.42288762166245,4412,4965,4965,4412,48790,773262,666045,3249,7661,3249,3802,8214,23.515952032609693,0.0,4412,1,904460,0,553,0,1163,2696
1798,0,1,0,1,66,0,2185,0,0,5752304,12384416,61.05735008989499,3248,5751,5271,3728,53590,774026,764060,2842,7050,3802,4865,9073,39.28103868280471,22.090722034374522,4208,1,857440,65760,1543,0,406,1779
1799,0,1,1,0,64,0,1391,0,0,6846836,11029123,58.33523806414096,3403,5415,5415,3403,48825,729225,703297,3241,6644,3241,5253,8656,44.85532298401161,0.0,3403,1,738451,0,2012,0,162,1229
1800,0,0,1,0,57,1,895,0,0,4489134,4927224,41.44876355212541,1658,4391,4331,1718,38055,616620,507636,2808,4586,2928,5481,7259,51.11751167652823,8.016064826688304,1778,1,304086,10560,2613,0,1150,255
1801,0,1,1,0,56,0,1109,0,0,779336,1389824,22.090722034374522,31,2542,2085,488,50635,583840,703456,2391,3336,3305,4445,5390,39.96248240537617,21.849059450775776,945,1,120536,35646,1597,0,2360,1251
1802,0,1,1,0,54,0,1425,0,0,280000,478800,13.228756555322953,13,1937,1775,175,41108,470592,653904,2574,2911,2898,4336,4673,40.0,13.759930259148186,337,1,41825,7128,1600,0,2561,1136
1803,0,0,1,0,58,1,1788,0,0,2256268,2503074,29.223278392404914,76,4274,3496,854,31740,674130,404478,2153,3785,3709,5573,7205,51.40038910358559,30.904556599988577,1632,1,117852,176606,2642,0,2077,289
1804,0,1,0,1,66,0,4404,0,0,5017077,17850963,73.09582751429797,5071,6554,6282,5343,43710,785135,621426,3069,8684,3613,4280,9895,30.643106892089126,16.781705456760008,5615,1,993798,51408,939,0,2002,2402
1805,0,1,1,0,63,0,84,0,0,7396636,8550854,51.749396131742444,2636,5482,5440,2678,48351,680109,724811,3151,5871,3235,5955,8675,52.55473337388365,6.495386533491135,2720,1,607906,4956,2762,0,515,431
1806,0,1,1,0,64,0,682,0,0,7303895,9942860,55.362442142665635,2915,5598,5448,3065,52884,733144,759096,3094,6309,3394,5627,8842,48.815980989835694,12.410850817228189,3215,1,717210,18600,2383,0,179,861
1807,0,1,1,0,63,0,82,0,0,7429395,8570520,51.81698563212646,2655,5482,5452,2685,53312,715008,759696,3162,5877,3222,5959,8674,52.602281319349636,5.514871952411144,2715,1,639030,3450,2767,0,507,425
1808,0,1,1,0,54,0,1429,0,0,185880,324960,10.954451150103322,12,1777,1669,120,43296,476608,666168,2600,2828,2816,4257,4485,39.35733730830886,10.73170258584833,228,1,29520,4104,1549,0,2588,1159
1809,0,0,0,0,51,1,389,1,0,935352,2021184,28.142494558940577,732,2033,1973,792,38009,507848,487432,2492,3344,2612,3733,4585,34.36568055487916,8.038779614196052,852,1,151272,8520,1181,0,1760,1371
1810,0,0,0,0,51,1,336,1,0,945945,2093364,28.61817604250837,734,2059,1974,819,34944,531648,429408,2471,3375,2641,3711,4615,33.98529093593286,9.460074866898333,904,1,137592,14960,1155,0,1737,1401
1811,0,1,1,0,63,0,215,0,0,6730256,7872707,49.889878733065686,2429,5253,5193,2489,46434,689534,673719,3103,5652,3223,5867,8416,52.0,7.748117453886108,2549,1,530157,8460,2704,0,674,459
1812,0,1,1,0,53,0,1429,0,0,144780,255835,9.746794344808963,28,1686,1619,95,42108,468582,651706,2626,2788,2760,4217,4379,39.03844259188627,8.456490803821907,162,1,22990,2680,1524,0,2598,1169
1813,0,0,0,0,51,1,577,1,0,1005660,1937330,27.477263328068172,499,2343,2087,755,44004,585048,495238,2310,3321,2822,3898,4909,36.49657518178932,16.443216325215204,1011,1,145715,44800,1332,0,1811,1234
1814,0,0,0,0,51,1,284,1,0,1014125,2254875,29.58039891549808,725,2184,2034,875,44620,592710,499938,2427,3452,2727,3736,4761,34.044089061098404,12.68159626954734,1025,1,169750,26250,1159,0,1702,1418
1815,0,1,1,0,65,0,1035,0,0,7220626,10650342,57.043842787806646,3074,5653,5473,3254,46607,729879,684057,3093,6527,3453,5492,8926,47.10626285325551,13.541462557970705,3434,1,680086,27360,2219,0,19,1054
1816,0,0,1,0,59,1,1547,0,0,2575440,2982672,31.74901573277509,287,4284,3563,1008,46592,662816,615472,2238,3967,3680,5514,7243,50.547007824400445,27.287456175923968,1729,1,209664,110313,2555,0,1951,404
1817,0,0,1,0,53,1,450,0,0,1731600,2969250,33.31666249791537,1050,2730,2670,1110,46842,564425,593850,2615,3785,2735,4235,5405,39.496835316262995,7.849311256600636,1170,1,246420,7320,1560,0,1565,1115
1818,0,0,0,0,51,1,630,1,0,1099800,1991340,27.92848008753788,429,2541,2190,780,47564,645909,479964,2202,3333,2904,3963,5094,37.54996671103717,19.0690569180082,1131,1,146640,69849,1410,0,1773,1143
1819,0,0,0,0,51,1,363,1,0,1049698,2207630,29.30870177950569,735,2205,2081,859,43316,567970,503720,2446,3429,2694,3792,4775,34.95711658589707,11.442020048593916,983,1,168364,20212,1222,0,1711,1348
1820,1,0,0,0,40,0,104,0,1,121200,812444,20.09975124224178,91,1017,704,404,38613,424321,368013,1698,2415,2324,2311,3028,17.320508075688775,17.729652552337875,717,1,73932,51332,300,0,1607,1711
1821,0,1,1,0,54,0,1250,0,0,291651,552549,14.177446878757825,106,1747,1652,201,43472,483824,679003,2654,2950,2844,4200,4496,38.09199390948182,10.133790967822552,296,1,49647,3420,1451,0,2548,1298
1822,0,1,1,0,54,0,1310,0,0,219000,407700,12.24744871391589,108,1652,1610,150,42303,481086,649602,2676,2868,2760,4178,4370,38.2099463490856,6.538739683827756,192,1,35850,2142,1460,0,2568,1258
1823,0,0,1,0,57,1,857,0,0,2610300,3586055,35.25620512760839,859,3727,3343,1243,40194,501990,666435,2501,4128,3269,4985,6612,45.8257569495584,19.939255063893846,1627,1,287133,23040,2100,0,1642,785
1824,1,0,0,0,40,0,88,0,1,214289,1029198,22.561028345356956,118,1321,930,509,44944,428664,428664,1631,2531,2413,2443,3343,20.518284528683193,19.83051398238212,900,1,107908,52394,421,0,1513,1601
1825,1,0,0,0,40,0,191,0,1,134142,966012,21.77154105707724,66,1165,757,474,45200,407600,460588,1630,2512,2446,2321,3203,16.822603841260722,20.35022411643368,882,1,107124,41616,283,0,1564,1755
1826,0,0,1,0,58,1,848,0,0,2730660,3720364,35.805027579936315,891,3803,3412,1282,41768,533968,658754,2511,4184,3293,5032,6705,46.151923036857305,20.223748416156685,1673,1,291014,30498,2130,0,1620,772
1827,1,0,0,0,40,0,200,0,1,74100,787020,19.748417658131498,39,931,580,390,28576,379384,306736,1667,2408,2369,2208,2949,13.784048752090222,18.778788002554194,741,1,59280,58968,190,0,1628,1828
1828,0,1,0,1,66,0,2369,0,0,4980162,12279699,60.91797764207213,3093,5671,5053,3711,49086,804087,668418,2691,7020,3927,4651,8980,36.6333181680284,24.872353708917885,4329,1,749622,110622,1342,0,402,1967
1829,0,1,1,0,66,0,1869,0,0,5770216,11761688,59.262129560116215,3104,5563,5155,3512,50127,726733,773619,2941,6861,3757,4992,8912,40.53393639902249,20.303789298290454,3920,1,811272,47736,1643,0,163,1706
1830,0,1,1,0,58,0,735,0,0,955924,1980902,26.019223662515376,152,2614,2089,677,50820,614460,708092,2401,3603,3451,4338,5540,37.57658845611187,23.39664419177775,1202,1,163834,48300,1412,0,2249,1514
1831,0,1,1,0,57,0,909,0,0,655542,1353744,21.77154105707724,123,2208,1857,474,43281,539784,654024,2505,3330,3207,4239,5064,37.1887079635741,19.096973388691374,825,1,108546,28782,1383,0,2382,1473
1832,0,1,1,0,65,0,1001,0,0,6999056,10514549,56.50663677834667,3073,5505,5385,3193,39044,747511,566396,3173,6486,3413,5485,8798,46.8187996428785,11.167976299283184,3313,1,549196,23400,2192,0,100,1101
1833,0,1,1,0,61,0,185,0,0,3614756,5567014,42.555845661906424,1751,3867,3807,1811,53823,716242,710094,3014,4885,3134,5070,6941,44.67661580737735,7.746504550744806,1871,0,418341,8160,1996,1,1263,1078
1834,0,1,1,0,56,0,920,0,0,580500,1220770,20.73644135332772,145,2065,1780,430,47561,564961,678521,2554,3269,3124,4189,4904,36.742346141747674,17.220974610725445,715,1,102770,23370,1350,0,2409,1489
1835,0,1,1,0,56,0,974,0,0,507600,1060320,19.390719429665317,148,1954,1726,376,49028,580920,671160,2592,3196,3048,4170,4774,36.742346141747674,15.46280395471841,604,1,89488,21204,1350,0,2444,1470
1836,0,0,1,0,56,1,1155,0,0,4188496,4392964,39.35733730830886,1519,4283,4253,1549,40200,567200,570036,2806,4385,2866,5540,7119,52.0,5.652706486041966,1579,0,311349,3990,2704,0,1287,132
1837,1,0,0,0,41,0,289,0,1,156782,1173884,23.790754506740637,67,1342,843,566,38064,431392,379542,1575,2640,2573,2351,3416,16.64331697709324,22.590772937153282,1065,1,103578,80339,277,0,1508,1797
1838,0,1,0,1,66,0,2249,0,0,5088420,12075885,60.37383539249432,3009,5677,5041,3645,47520,795120,655974,2677,6958,3949,4709,8990,37.36308338453881,25.234986082758308,4281,1,721710,115752,1396,0,332,1917
1839,0,1,1,0,61,0,347,0,0,1906170,3736824,34.899856733230294,899,3102,2783,1218,54054,708708,717912,2749,4286,3387,4633,6170,39.56008088970496,17.864124215683127,1537,1,285012,41151,1565,0,1850,1503
1840,0,1,1,0,58,0,730,0,0,811559,1761514,24.63736998950984,190,2361,1944,607,51815,623930,699382,2485,3509,3319,4239,5263,36.565010597564445,20.906761287207704,1024,1,146287,41700,1337,0,2295,1565
1841,0,1,1,0,57,0,826,0,0,657531,1422414,22.293496809607955,178,2139,1820,497,50141,580986,706914,2543,3359,3181,4185,5001,36.373066958946424,18.24404860264438,816,1,122759,24244,1323,0,2365,1539
1842,0,1,1,0,56,0,877,0,0,584760,1258120,21.047565179849187,166,2040,1763,443,50922,587880,698640,2563,3283,3117,4160,4880,36.3318042491699,17.004933736171072,720,1,108978,22714,1320,0,2397,1520
1843,0,1,0,1,65,0,3378,0,0,3382288,13721708,64.69930447848725,4101,5079,4994,4186,52416,734272,767052,3193,7464,3363,4086,8357,28.42534080710379,9.28144526553527,4271,1,979524,10285,808,0,908,2470
1844,0,1,1,0,60,0,386,0,0,1575651,3282696,32.817678162843876,631,2986,2540,1077,55454,710184,725424,2602,4125,3494,4511,6034,38.24918299781056,21.12086167589852,1523,1,256326,55750,1463,0,1971,1585
1845,0,1,1,0,57,0,735,0,0,732636,1626012,23.748684174075834,214,2213,1863,564,52539,608313,717867,2533,3447,3233,4182,5096,36.0416425818802,19.169854797451837,914,1,140436,28700,1299,0,2319,1584
1846,0,1,1,0,56,0,807,0,0,624844,1378916,22.0,207,2052,1775,484,51832,595441,706552,2572,3333,3126,4140,4901,35.93048844644336,16.996538735441106,761,1,120032,22160,1291,0,2365,1558
1847,0,1,1,0,54,0,1228,0,0,161760,324360,10.954451150103322,12,1576,1468,120,39380,483837,594660,2595,2823,2811,4051,4279,36.71511950137164,11.204411569190134,228,1,26400,8640,1348,0,2583,1355
1848,0,0,1,0,59,1,840,0,0,5574004,5910264,44.474711915874174,1574,5200,4796,1978,41567,588636,630468,2584,4966,3392,5806,8188,53.08483775994799,20.71793997817214,2382,1,417358,47268,2818,0,1010,170
1849,1,0,0,0,41,0,160,0,1,178500,1065390,22.58317958127243,86,1284,860,510,42486,405266,457491,1665,2599,2513,2439,3373,18.708286933869708,20.776614167531445,934,1,111690,43672,350,0,1579,1739
1850,0,1,0,1,66,0,1993,0,0,5390190,11752728,59.3548650070068,2959,5617,5053,3523,43608,790632,613824,2772,6859,3900,4866,8953,39.11521443121589,23.752341613142203,4087,1,648232,108852,1530,0,187,1806
1851,0,1,0,1,67,0,1903,0,0,5518338,11692044,59.04235767650204,2976,5579,5069,3486,39312,784836,563472,2844,6840,3864,4937,8933,39.786932528155525,22.605374038319127,3996,1,585648,104550,1583,0,132,1771
1852,0,1,1,0,61,0,55,0,0,4495764,6475742,45.749316934791494,2063,4271,4241,2093,54056,717808,720902,3064,5187,3124,5242,7365,46.34652090502587,5.483301264452448,2123,0,487669,3930,2148,1,1001,946
1853,0,1,1,0,61,0,70,0,0,3974811,6027843,44.26059195266146,1929,4018,3988,1959,53808,726172,701556,3047,5036,3107,5106,7095,45.044422518220834,5.490867587491313,1989,0,446652,4260,2029,1,1118,1048
1854,0,1,1,0,56,0,834,0,0,536760,1201320,20.639767440550294,234,1878,1686,426,52704,609120,688080,2628,3246,3012,4080,4698,35.4964786985977,14.215195019013525,618,1,103944,18624,1260,0,2394,1560
1855,0,1,1,0,56,0,857,0,0,509444,1136048,20.09975124224178,234,1835,1665,404,51940,596144,688940,2642,3216,2982,4073,4647,35.510561809129406,13.36696240183447,574,1,98980,15300,1261,0,2408,1551
1856,0,0,0,0,48,1,689,1,0,832920,1528282,25.11971337416094,546,2036,1951,631,47945,520730,540106,2337,3053,2507,3742,4458,36.3318042491699,9.2729914971827,716,1,140713,10625,1320,0,1791,1102
1857,1,0,0,0,40,0,108,0,1,27360,242160,10.954451150103322,60,408,348,120,31900,443960,292610,1958,2138,2078,2246,2426,15.0996688705415,8.016064826688304,180,1,17400,12660,228,0,1898,1790
1858,1,0,0,0,42,0,138,0,1,164160,1008960,21.908902300206645,98,1204,822,480,46652,449828,458236,1720,2582,2484,2444,3306,18.49324200890693,19.834199638935317,862,1,104640,50042,342,0,1622,1760
1859,0,1,1,0,66,0,1641,0,0,5836932,11265852,58.0689245638319,3012,5463,5103,3372,50430,684905,821886,2981,6713,3701,5072,8804,41.60528812542944,18.9868649392261,3732,1,829512,28440,1731,0,31,1610
1860,0,1,1,0,66,0,1597,0,0,5898090,11175505,57.92236183029832,3025,5443,5113,3355,50932,712834,792778,3001,6686,3661,5089,8774,41.92851058647326,18.235602977756567,3685,1,798490,34320,1758,0,24,1573
1861,0,1,0,1,66,0,815,0,0,6938834,10180849,55.4346462061408,2898,5506,5331,3073,49585,778555,699043,3138,6386,3488,5571,8819,47.51841748206689,13.398254763593743,3248,1,648403,28525,2258,0,240,1055
1862,0,1,1,0,57,0,670,0,0,699576,1621024,23.790754506740637,271,2097,1802,566,53750,615760,716000,2569,3430,3159,4100,4961,35.156791662493895,17.58727210452475,861,1,141500,24485,1236,0,2298,1628
1863,0,1,1,0,56,0,761,0,0,576870,1325863,21.656407827707714,277,1891,1699,469,53874,619113,695442,2635,3296,3019,4057,4718,35.07135583350036,14.182970611648413,661,1,115374,18624,1230,0,2358,1597
1864,0,1,1,0,54,0,1120,0,0,207684,442098,12.727922061357855,67,1539,1444,162,42768,540342,589464,2634,2891,2824,4011,4268,35.805027579936315,9.764028217990806,257,1,34992,10640,1282,0,2567,1447
1865,0,1,1,0,54,0,1156,0,0,172860,364480,11.575836902790225,10,1548,1424,134,41040,489600,620160,2596,2854,2844,4010,4268,35.91656999213594,11.137157851700797,258,1,30552,8804,1290,0,2586,1430
1866,0,0,1,0,59,1,952,0,0,3967728,4675128,39.64845520319802,1253,4415,4096,1572,41610,651306,565060,2655,4546,3293,5498,7389,50.23942674832188,18.08381773621633,1891,1,298680,53273,2524,0,1402,450
1867,0,0,1,0,60,1,817,0,0,5065784,5642637,43.347433603386484,1651,4803,4575,1879,41610,657657,570570,2775,4882,3231,5699,7806,51.92301994298868,15.691962593877312,2107,1,357010,38304,2696,0,1124,307
1868,0,0,1,0,48,1,394,0,0,370791,1083578,21.047565179849187,443,1280,1280,443,48168,545458,528336,2446,2889,2446,3283,3726,28.930952282978865,0.0,443,0,95688,0,837,0,2003,1609
1869,1,0,0,0,40,0,136,0,1,30720,243000,10.954451150103322,53,443,376,120,31780,459675,283500,1958,2145,2092,2281,2468,16.0,8.567952416355485,187,1,16800,14941,256,0,1905,1769
1870,1,0,0,0,41,0,174,0,1,176472,1082052,22.715633383201094,108,1266,858,516,42636,427788,438273,1689,2613,2505,2439,3363,18.49324200890693,20.435124191631246,924,1,107844,52224,342,0,1581,1755
1871,1,0,0,0,42,0,306,0,1,244915,1423191,25.903667693977237,107,1600,1036,671,27150,383901,318150,1557,2792,2685,2486,3721,19.1049731745428,23.983508037669942,1235,1,100650,90804,365,0,1450,1756
1872,1,0,0,0,42,0,374,0,1,208080,1442280,26.076809620810597,109,1557,986,680,34600,366933,424200,1550,2801,2692,2427,3678,17.4928556845359,24.35145282316996,1251,1,136000,55387,306,0,1441,1815
1873,1,0,0,0,40,0,363,0,1,28810,868600,20.73644135332772,129,798,497,430,48278,408040,482780,1719,2450,2321,2087,2818,8.18535277187245,17.51364874715959,731,1,102770,26488,67,0,1590,1953
1874,0,1,1,0,57,0,624,0,0,701892,1663356,24.124676163629637,299,2071,1788,582,54216,617328,717358,2575,3440,3141,4064,4929,34.72751070837067,17.206711988225443,865,1,146082,23489,1206,0,2276,1652
1875,1,0,0,0,40,0,124,0,1,42381,312732,12.36931687685298,45,538,430,153,33984,482384,294336,1936,2197,2152,2321,2582,16.64331697709324,10.89017689082249,261,1,22032,24516,277,0,1891,1767
1876,1,0,0,0,40,0,5,0,1,75344,556784,16.492422502470642,56,765,549,272,39900,388930,429870,1831,2319,2263,2324,2812,16.64331697709324,14.921384110844198,488,1,57120,23544,277,0,1775,1770
1877,0,1,1,0,54,0,1109,0,0,166562,364212,11.575836902790225,10,1501,1377,134,40290,462060,644166,2594,2852,2842,3961,4219,35.25620512760839,11.932888170540295,258,1,31758,5332,1243,0,2584,1475
1878,0,1,1,0,54,0,1146,0,0,135432,291708,10.392304845413264,13,1457,1362,108,38631,440263,640137,2606,2809,2796,3955,4158,35.41186241925155,10.429965964842806,203,1,25596,3230,1254,0,2593,1447
1879,0,0,1,0,58,1,910,0,0,4115216,4737208,40.29888335921977,1289,4493,4158,1624,39715,685495,492973,2582,4541,3252,5451,7410,50.33885179461288,18.81991538154454,1959,1,274456,68675,2534,0,1293,383
1880,0,0,1,0,50,1,792,0,0,1418209,2154372,29.30870177950569,859,2510,2510,859,38592,481536,504108,2508,3367,2508,4159,5018,40.63249930782009,0.0,859,0,172659,0,1651,0,1649,857
1881,0,0,1,0,48,1,458,0,0,1450635,2429689,31.575306807693888,967,2482,2452,997,43560,536140,482526,2407,3434,2467,3892,4919,38.144462245521304,5.501408174353464,1027,0,197406,4830,1455,0,1440,982
1882,1,0,0,0,41,0,12,0,1,91773,608850,17.233687939614086,96,807,606,297,43014,438700,412050,1849,2347,2251,2359,2857,17.578395831246947,14.426620007868419,498,1,59697,29949,309,0,1753,1741
1883,0,1,0,1,66,0,4243,0,0,4454294,17106330,71.5122367151245,5114,5985,5985,5114,52320,802800,729210,3345,8459,3345,4216,9330,29.512709126747414,0.0,5114,1,1114852,0,871,0,1769,2474
1884,0,1,0,1,65,0,3219,0,0,3777562,13605836,64.28841264178172,4006,5174,5047,4133,52425,740700,767036,3165,7425,3419,4206,8466,30.23243291566195,11.308525934296243,4260,1,962989,15748,914,0,841,2378
1885,0,1,1,0,64,0,0,0,0,7349521,8723998,52.06726418777925,2651,5482,5422,2711,47705,653254,756230,3158,5929,3278,5929,8700,52.06726418777925,7.994134176674909,2771,1,637085,5640,2711,0,507,507
1886,0,1,1,0,63,0,86,0,0,6577376,8225632,51.068581339214816,2541,5197,5130,2608,52890,678110,775884,3087,5762,3221,5676,8351,50.21951811795888,8.230562448445415,2675,1,641568,6097,2522,0,546,632
1887,0,1,1,0,54,0,959,0,0,270636,625632,15.0996688705415,133,1510,1415,228,50429,655816,578984,2649,2972,2839,3931,4254,34.45286635390443,9.756499634156611,323,1,48108,15770,1187,0,2516,1557
1888,0,0,1,0,50,1,516,0,0,303100,2177990,29.427877939124322,824,1258,1216,866,31616,523120,382280,2473,3381,2557,2865,3773,18.708286933869708,6.678188844436455,908,1,131632,8022,350,0,1649,2165
1889,0,0,1,0,50,1,505,0,0,267444,2097324,28.77498913987632,743,1236,1151,828,26398,499001,339422,2448,3361,2618,2856,3769,17.97220075561143,9.607770959340817,913,1,110952,16660,323,0,1705,2210
1890,1,0,0,0,41,0,175,0,1,100914,872364,20.42057785666214,108,968,659,417,43296,514632,368192,1783,2509,2401,2334,3060,15.556349186104045,17.8945240492672,726,1,73392,64272,242,0,1675,1850
1891,1,0,0,0,43,0,275,0,1,229596,1373760,25.219040425836983,104,1529,997,636,43143,473040,425520,1628,2796,2692,2521,3689,19.0,23.5577304863097,1168,1,125292,85120,361,0,1524,1799
1892,0,0,1,0,58,1,1261,0,0,1869000,2556750,29.58039891549808,76,3810,3011,875,28413,674982,359406,2123,3797,3721,5058,6732,46.216880033165374,31.1175615792988,1674,1,107625,190162,2136,0,2047,786
1893,0,0,1,0,60,1,795,0,0,3928456,4876872,40.29888335921977,1216,4451,4043,1624,39600,660660,540540,2595,4627,3411,5422,7454,49.18333050943175,20.45641836451952,2032,1,292320,73032,2419,0,1379,584
1894,0,0,1,0,49,1,306,0,0,458227,1338975,23.259406699226016,541,1388,1388,541,40301,522225,472725,2475,3016,2475,3322,3863,29.103264421710495,0.0,541,0,103331,0,847,0,1934,1628
1895,0,0,0,0,49,1,402,0,1,1795624,2833070,33.97057550292606,1154,2710,2710,1154,55304,547465,608840,2455,3609,2455,4011,5165,39.44616584663204,0.0,1154,1,286192,0,1556,0,1301,899
1896,0,0,1,0,48,1,442,0,0,1683015,2679465,33.090784215548595,1095,2632,2632,1095,47025,550575,511423,2447,3542,2447,3984,5079,39.20459156782532,0.0,1095,0,228855,0,1537,0,1352,910
1897,0,1,1,0,61,0,66,0,0,3537072,5923830,43.749285708454714,1787,3889,3762,1914,44377,690185,615905,2968,5009,3222,4943,6984,42.988370520409354,11.33196341945808,2041,1,380886,20701,1848,0,1181,1247
1898,0,1,1,0,54,0,889,0,0,270960,658320,15.491933384829668,113,1496,1369,240,51408,652834,592488,2616,2983,2870,3872,4239,33.60059523282288,11.270126310527191,367,1,51840,20320,1129,0,2503,1614
1899,0,1,1,0,54,0,1009,0,0,173850,408600,12.24744871391589,30,1429,1309,150,48000,523008,681000,2604,2874,2844,3883,4153,34.044089061098404,11.82974410020298,270,1,37500,6480,1159,0,2574,1565
1900,0,0,1,0,50,1,499,0,0,427050,2396225,30.805843601498726,919,1429,1399,949,38340,537825,454500,2495,3474,2555,2975,3954,21.213203435596427,5.5965095842615735,979,0,170820,5160,450,0,1576,2075
1901,0,0,1,0,51,1,501,0,0,347490,2272941,29.8496231131986,783,1389,1281,891,28059,507649,359691,2443,3442,2659,2941,3940,19.748417658131498,10.89017689082249,999,1,125631,20736,390,0,1660,2161
1902,0,0,1,0,51,1,445,0,0,290966,2093182,28.39013913315678,614,1359,1167,806,27064,516803,353192,2405,3403,2789,2958,3956,19.0,14.793091451689286,998,1,109616,37632,361,0,1791,2236
1903,0,0,1,0,52,1,324,0,0,266437,1830612,26.514147167125703,384,1401,1082,703,39900,494760,546840,2285,3307,2923,2983,4005,19.467922333931785,18.509900150377497,1022,1,147630,34771,379,0,1901,2225
1904,0,0,1,0,50,1,630,0,0,1508599,2412996,30.870698080866262,923,2566,2536,953,41580,478548,557040,2502,3485,2562,4115,5098,39.786932528155525,5.572104574801163,983,0,209660,2850,1583,0,1579,949
1905,0,0,1,0,50,1,632,0,0,1616244,2514820,31.52776554086889,934,2680,2620,994,36064,566720,407330,2470,3524,2590,4156,5210,40.32369030731191,7.822290851349969,1054,1,160034,12060,1626,0,1536,904
1906,0,0,1,0,51,1,632,0,0,1832244,2790252,32.77193921634788,864,2990,2780,1074,35700,618324,389700,2388,3672,2808,4304,5588,41.30375285612676,14.990732154983036,1284,1,161100,47040,1706,0,1524,892
1907,1,0,0,0,41,0,119,0,1,58710,645810,17.578395831246947,108,700,499,309,28545,361570,344850,1889,2399,2291,2280,2790,13.784048752090222,14.733734538837195,510,1,50985,26934,190,0,1781,1900
1908,1,0,0,0,41,0,153,0,1,60970,700820,18.303005217723125,107,745,517,335,30012,382836,343088,1864,2427,2320,2274,2837,13.490737563232042,15.587863252408876,563,1,54940,34200,182,0,1757,1910
1909,1,0,0,0,43,0,289,0,1,176700,1276363,24.269322199023193,101,1377,889,589,39872,485408,385726,1679,2756,2655,2467,3544,17.320508075688775,22.696691099233277,1077,1,104842,90280,300,0,1578,1867
1910,1,0,0,0,42,0,265,0,1,207594,1289875,24.63736998950984,64,1492,949,607,40309,367625,495125,1582,2732,2668,2467,3617,18.49324200890693,23.816500679910355,1150,1,141431,29865,342,0,1518,1783
1911,1,0,0,0,43,0,340,0,0,117024,460676,14.560219778561036,88,888,764,212,36573,362891,475887,2049,2385,2297,2725,3061,23.49468024894146,12.621349452967342,336,1,46428,7936,552,0,1961,1621
1912,0,1,0,1,66,0,807,0,0,6475540,9911480,54.589376255824725,2950,5183,5153,2980,42966,768306,618636,3296,6306,3356,5499,8509,46.61544808322666,5.5503012171862105,3010,1,554280,5550,2173,0,346,1153
1913,0,1,0,1,66,0,593,0,0,6700718,9698484,53.87021440462252,2812,5301,5211,2902,50076,715188,782028,3252,6244,3432,5651,8643,48.05205510693585,9.590813010750445,2992,1,679068,9900,2309,0,440,1033
1914,0,1,0,1,66,0,509,0,0,6791772,9561344,53.600373133029585,2843,5267,5237,2873,50794,725504,775424,3298,6201,3358,5692,8595,48.620983124572874,5.514871952411144,2903,1,669409,3450,2364,0,455,964
1915,0,1,1,0,61,0,138,0,0,4132395,6515094,45.858477951192405,2073,4098,4068,2103,51736,690854,718736,3068,5201,3128,5063,7196,44.328320518603,5.5503012171862105,2133,0,487896,3690,1965,1,995,1133
1916,0,1,1,0,54,0,995,0,0,133800,324720,10.954451150103322,12,1343,1235,120,44213,484374,668382,2598,2826,2814,3821,4049,33.391615714128,10.98852450445412,228,1,29640,4320,1115,0,2586,1591
1917,0,0,1,0,56,1,85,0,0,2566200,4402320,39.496835316262995,1332,3433,3205,1560,32760,550290,474096,2594,4382,3050,4467,6255,40.55859958134649,15.278026045538596,1788,1,262080,36480,1645,0,1262,1177
1918,0,0,1,0,51,1,475,0,0,398544,2353872,30.199337741083,742,1519,1349,912,30530,554915,366502,2411,3493,2751,3018,4100,20.904544960366874,13.64605912284091,1082,1,129504,35360,437,0,1669,2144
1919,0,0,1,0,49,1,260,0,0,554636,1561244,25.019992006393608,626,1512,1512,626,43200,561150,478848,2494,3120,2494,3380,4006,29.765752132274432,0.0,626,0,120192,0,886,0,1868,1608
1920,1,0,0,0,41,0,353,1,0,75450,313800,12.24744871391589,60,743,653,150,40940,372376,481160,2002,2242,2182,2595,2835,22.427661492005804,9.70850005632103,240,1,34500,5940,503,0,1942,1589
1921,1,0,0,0,40,0,187,0,1,31860,216864,10.392304845413264,78,433,403,108,40250,502000,323288,1978,2116,2038,2303,2441,17.175564037317667,5.684275577662207,138,1,17388,6300,295,0,1900,1713
1922,1,0,0,0,42,0,165,0,1,146466,1004406,21.77154105707724,37,1220,783,474,25883,303017,383539,1682,2593,2556,2428,3339,17.578395831246947,21.556574761103807,911,1,85794,33212,309,0,1645,1810
1923,0,1,0,1,67,0,1245,0,0,5970456,10598424,56.07138307550475,2904,5283,5043,3144,33600,505650,755104,3131,6515,3611,5270,8654,43.57751713900185,15.556149959855471,3384,1,704256,7680,1899,0,227,1472
1924,0,1,0,1,66,0,1027,0,0,6195540,10167040,55.27205442174191,2965,5173,5083,3055,48160,745472,715520,3238,6383,3418,5356,8501,45.033320996790806,9.497356383238309,3145,1,656825,13140,2028,0,273,1300
1925,0,0,1,0,57,1,301,0,0,3087282,4643827,40.162171256046406,1395,3745,3527,1613,39928,529736,624743,2661,4492,3097,4793,6624,43.749285708454714,15.446888696741146,1831,1,350021,19838,1914,0,1266,965
1926,0,0,0,0,51,1,456,1,0,733012,2886374,33.37663853655727,1029,1857,1772,1114,53130,544110,655523,2506,3705,2676,3249,4448,25.65151067676132,9.759997214798725,1199,1,281842,5695,658,0,1477,1933
1927,0,0,1,0,50,1,227,0,0,567000,1621944,25.45584412271571,618,1553,1523,648,43460,513115,530636,2473,3151,2533,3378,4056,29.58039891549808,5.5965095842615735,678,0,137376,3810,875,0,1855,1628
1928,0,0,1,0,51,1,482,0,0,1783368,2889324,33.406586176980134,966,2864,2714,1116,31682,561813,377994,2439,3705,2739,4187,5453,39.97499218261337,12.882345016608866,1266,1,162936,31050,1598,0,1473,991
1929,0,0,1,0,52,1,483,0,0,1828180,2943200,33.645207682521445,952,2927,2747,1132,32487,574600,382200,2420,3732,2780,4215,5527,40.18706259482024,14.064063304453542,1312,1,166404,37980,1615,0,1468,985
1930,1,0,0,0,42,0,120,0,1,31369,521911,15.716233645501712,97,524,374,247,31571,509233,276803,1963,2360,2263,2240,2637,11.269427669584644,13.531383308295037,397,1,32357,35250,127,0,1866,1986
1931,1,0,0,0,41,0,50,0,1,105651,732888,18.734993995195193,38,965,652,351,36036,325728,482328,1775,2439,2401,2389,3053,17.349351572897472,18.420318117800456,664,1,81081,9703,301,0,1737,1787
1932,0,1,0,1,68,0,1294,0,0,5886512,10749832,56.19608527290847,2873,5307,5022,3158,42200,718244,680800,3119,6562,3689,5268,8711,43.174066289845804,17.090862659123662,3443,1,631600,41895,1864,0,246,1540
1933,0,1,0,1,66,0,473,0,0,6696270,9457560,53.24471804789655,2750,5282,5197,2835,50976,720576,787296,3251,6171,3421,5698,8618,48.60041152089147,9.2729914971827,2920,1,669060,9265,2362,0,501,974
1934,0,1,1,0,61,0,60,0,0,1757376,4137156,36.823905279043935,831,3177,2652,1356,54516,704781,720036,2526,4407,3576,4347,6228,36.0,22.916389936385,1881,1,320016,66150,1296,0,1695,1755
1935,0,1,1,0,54,0,898,0,0,157200,408750,12.24744871391589,0,1348,1198,150,45254,509575,659450,2575,2875,2875,3773,4073,32.37282811247729,12.950100320556757,300,1,36300,9300,1048,0,2575,1677
1936,0,0,1,0,51,1,417,0,0,1603900,2743400,32.78719262151,1075,2567,2567,1075,42021,528264,518056,2552,3627,2552,4044,5119,38.62641583165593,0.0,1075,0,218225,0,1492,0,1477,1060
1937,0,0,0,0,49,1,532,1,0,1957020,2886894,34.02939905434711,1098,2908,2848,1158,28520,458712,386415,2433,3651,2553,4183,5401,41.10960958218893,7.914659756013729,1218,1,179490,9660,1690,0,1335,803
1938,1,0,0,0,43,0,319,0,1,77922,1043770,21.93171219946131,102,1022,643,481,29988,425320,332010,1791,2651,2549,2332,3192,12.727922061357855,20.360894827222403,860,1,73593,67083,162,0,1689,2008
1939,0,1,0,1,67,0,604,0,0,6513696,9647048,53.59104402789705,2745,5267,5140,2872,39790,772570,581107,3232,6231,3486,5627,8626,47.62352359916263,11.489290135793457,2999,1,496856,25019,2268,0,487,1091
1940,0,1,1,0,54,0,826,0,0,183456,498680,13.490737563232042,0,1372,1190,182,46492,539780,646640,2558,2922,2922,3748,4112,31.74901573277509,14.249103215689319,364,1,42952,15288,1008,0,2558,1732
1941,0,1,1,0,54,0,867,0,0,156060,417537,12.36931687685298,0,1326,1173,153,43845,504865,646773,2576,2882,2882,3749,4055,31.937438845342623,13.122185548803433,306,1,36261,10098,1020,0,2576,1709
1942,0,1,1,0,54,0,952,0,0,99465,256690,9.746794344808963,0,1237,1142,95,39044,464744,613354,2607,2797,2797,3749,3939,32.357379374726875,10.808743440944937,190,1,21565,5795,1047,0,2607,1655
1943,0,0,1,0,56,1,123,0,0,2522728,4670679,40.63249930782009,1275,3555,3179,1651,39856,531852,599748,2453,4480,3205,4357,6384,39.08964057138413,19.58078380332937,2027,1,350012,38728,1528,0,1178,1301
1944,0,0,1,0,50,1,496,0,0,698880,2848160,33.46640106136302,1090,1774,1744,1120,46056,579804,513686,2513,3663,2573,3167,4317,24.979991993593593,5.483301264452448,1150,0,226240,4950,624,0,1423,1919
1945,0,0,1,0,52,1,385,0,0,456450,2367275,29.916550603303182,576,1724,1405,895,38700,595125,454940,2326,3540,2964,3155,4369,22.58317958127243,18.697204839375203,1214,1,153940,61248,510,0,1750,2135
1946,0,0,1,0,53,1,365,0,0,447636,2322276,29.597297173897484,537,1726,1387,876,40848,588522,487784,2312,3527,2990,3162,4377,22.60530911091463,19.2641934262698,1215,1,161184,60003,511,0,1775,2140
1947,0,0,1,0,50,1,182,0,0,617400,1765400,26.457513110645905,640,1642,1582,700,44265,491790,572494,2462,3222,2582,3404,4164,29.698484809834994,7.994134176674909,760,0,158900,5580,882,0,1822,1640
1948,1,0,0,0,43,0,325,0,1,39900,912240,20.493901531919196,107,828,515,420,35738,464808,362724,1859,2592,2485,2267,3000,9.746794344808963,18.872910447806458,733,1,70140,57905,95,0,1752,2077
1949,0,1,1,0,66,0,312,0,0,6725268,9173574,52.478567053607705,2634,5316,5196,2754,49728,739482,746144,3211,6085,3451,5773,8647,49.416596402423345,10.966602528904897,2874,1,616896,15840,2442,0,577,889
1950,1,0,0,0,40,0,30,0,1,27000,304050,12.24744871391589,90,390,330,150,22200,449994,202700,1967,2177,2087,2207,2417,13.416407864998739,8.086478275311649,210,1,15000,14760,180,0,1877,1847
1951,1,0,0,0,43,0,134,0,0,204360,1132364,22.891046284519195,66,1372,914,524,47752,406268,548894,1703,2685,2619,2551,3533,19.748417658131498,21.89767296464683,982,1,133096,15572,390,0,1637,1771
1952,0,1,0,1,66,0,356,0,0,6624716,9222752,52.51666402200353,2596,5322,5160,2758,47355,685520,772464,3182,6102,3506,5746,8666,49.01020301937138,12.781057885822433,2920,1,637098,16524,2402,0,586,942
1953,0,1,1,0,65,0,134,0,0,7065792,8452512,50.91168824543142,2400,5510,5318,2592,51792,678288,811989,3069,5853,3453,5987,8771,52.21110992882645,14.059477767970847,2784,1,645408,14976,2726,0,669,535
1954,0,0,1,0,56,1,945,0,0,1754986,2659098,30.56141357987225,191,3556,2813,934,21109,595023,287547,2104,3781,3590,4726,6403,43.347433603386484,28.688357759068584,1677,1,94334,175348,1879,0,1913,968
1955,0,0,1,0,52,1,463,0,0,634478,2770271,32.57299494980466,879,1841,1659,1061,30885,556143,378595,2429,3672,2793,3209,4452,24.454038521274967,14.143284532236633,1243,1,153845,37128,598,0,1550,2013
1956,0,0,1,0,52,1,451,0,0,612560,2725840,32.2490309931942,828,1841,1629,1040,30636,542547,387908,2409,3661,2833,3210,4462,24.269322199023193,15.28251067977674,1252,1,153920,41340,589,0,1581,2032
1957,0,0,1,0,53,1,153,0,0,513268,2116832,28.231188426986208,347,1891,1441,797,38986,512608,536512,2206,3453,3106,3300,4547,25.37715508089904,21.636196137747532,1247,1,160994,54450,644,0,1859,2012
1958,0,0,1,0,50,1,177,0,0,720630,1933155,27.65863337187866,765,1707,1707,765,44051,512981,548359,2527,3292,2527,3469,4234,30.692018506445613,0.0,765,0,166005,0,942,0,1762,1585
1959,1,0,0,0,44,0,403,0,1,55188,240084,10.392304845413264,104,831,619,108,35880,511290,346788,2011,2331,2435,2734,3054,22.60530911091463,16.133155202402655,320,1,16848,44944,511,0,2115,1712
1960,0,1,0,1,66,0,1611,0,0,5513976,11001648,57.3410847473258,2775,5478,4965,3288,45410,799694,635740,2833,6634,3859,5023,8824,40.95119045888654,22.779287594782836,3801,1,624720,96957,1677,0,58,1669
1961,0,1,0,1,67,0,1002,0,0,6034048,10179072,54.84523680320835,2828,5194,5014,3008,43920,619272,812160,3204,6392,3564,5390,8578,44.78839135311738,13.612485340686598,3188,1,721920,10620,2006,0,376,1378
1962,0,1,1,0,60,0,196,0,0,1644192,4215664,37.20215047547655,766,3190,2572,1384,52425,685350,709718,2428,4430,3664,4234,6236,34.46737587922817,24.865478121535222,2002,1,322472,77250,1188,0,1662,1858
1963,0,1,1,0,57,0,55,0,0,715806,2350530,28.61817604250837,513,1999,1693,819,51660,602700,706020,2564,3689,3176,3744,4869,29.563490998188964,17.743184151249086,1125,1,201474,26316,874,0,2051,1996
1964,0,1,1,0,54,0,904,0,0,94905,256880,9.746794344808963,10,1179,1094,95,43338,502944,630032,2619,2799,2789,3703,3883,31.606961258558215,9.855393472241717,180,1,22135,6205,999,0,2609,1705
1965,0,0,1,0,60,1,465,0,0,5494324,6407214,46.07602413403309,1412,5422,4711,2123,53628,742428,657924,2307,5141,3729,5606,8440,50.872389367907616,26.777910357809137,2834,1,462814,115893,2588,0,895,430
1966,0,0,0,0,57,1,274,1,0,2981055,4609550,39.93745109543172,1253,3806,3464,1595,47034,676260,580890,2548,4485,3232,4759,6696,43.23193264243457,18.812222178836137,1937,1,320595,58824,1869,0,1295,1021
1967,1,0,0,0,41,0,185,0,1,22950,564840,16.431676725154983,120,505,355,270,30654,489528,274052,1942,2362,2242,2177,2597,9.219544457292887,13.226055982240474,420,1,35370,35250,85,0,1822,2007
1968,1,0,0,0,42,0,76,0,0,181740,822900,19.748417658131498,48,1198,856,390,39825,373470,474750,1768,2500,2452,2576,3308,21.587033144922902,19.32482319894002,732,1,87750,24282,466,0,1720,1644
1969,0,1,1,0,64,0,192,0,0,6498385,7875640,49.54795656734998,2425,5132,5102,2455,53703,708968,779544,3178,5663,3238,5855,8340,51.44900387762624,5.514871952411144,2485,1,596565,3120,2647,0,753,561
1970,0,1,1,0,58,0,73,0,0,873828,2834352,31.176914536239792,521,2322,1871,972,53037,621108,726084,2465,3888,3367,3815,5238,29.9833287011299,21.603044853811753,1423,1,242028,37884,899,0,1944,2017
1971,0,1,1,0,54,0,865,0,0,105084,292572,10.392304845413264,0,1189,1081,108,45696,520128,644742,2601,2817,2817,3682,3898,31.192947920964443,10.948360265819424,216,1,25704,7992,973,0,2601,1736
1972,0,0,1,0,60,1,716,0,0,5347436,5967802,44.51965857910413,1409,5253,4680,1982,54412,734684,671453,2438,4993,3584,5709,8264,51.94227565288221,24.090219887171386,2555,1,441986,89388,2698,0,1029,313
1973,0,0,1,0,59,1,1152,0,0,4866624,5050656,41.27953488110059,1343,4921,4560,1704,52998,649116,717288,2603,4668,3325,5820,7885,53.44155686354955,19.26401857715617,2065,1,412368,37544,2856,0,1260,108
1974,0,0,0,0,56,1,174,1,0,2565247,4756783,41.12177038990418,1352,3547,3208,1691,42039,486649,683559,2474,4504,3152,4330,6360,38.948684188300895,19.2747804077037,2030,1,410913,12882,1517,0,1122,1296
1975,0,0,1,0,52,1,436,0,0,702432,2862844,32.92415526630866,874,1942,1732,1084,29962,557251,375022,2431,3725,2851,3289,4583,25.45584412271571,15.014719061487286,1294,1,153928,43050,648,0,1557,1993
1976,0,0,1,0,53,1,324,0,0,605781,2578158,30.93541659651604,537,2010,1590,957,33532,544188,447204,2274,3651,3114,3327,4704,25.15949125081825,21.413472472281857,1377,1,158862,71820,633,0,1737,2061
1977,0,0,1,0,50,1,155,0,0,806696,2096256,28.705400188814647,824,1803,1803,824,43382,506256,554592,2544,3368,2544,3523,4347,31.28897569432403,0.0,824,0,179632,0,979,0,1720,1565
1978,0,0,0,0,51,1,202,0,1,2089400,3496712,36.71511950137164,1080,3166,2898,1348,48682,523988,625154,2326,3942,2862,4144,5760,39.370039370059054,16.658425890078547,1616,1,324868,22512,1550,0,1246,1044
1979,1,0,0,0,44,0,160,0,0,72561,443406,14.177446878757825,9,772,562,201,35495,341930,505174,1996,2407,2416,2567,2978,19.0,15.957103185950617,411,1,46029,6510,361,0,2005,1845
1980,1,0,0,0,43,0,283,0,1,42228,850425,19.77371993328519,121,769,499,391,24960,452400,261000,1905,2566,2445,2283,2944,10.392304845413264,17.90725026088836,661,1,46920,59400,108,0,1784,2067
1981,1,0,0,0,43,0,306,0,1,84175,1055314,21.93171219946131,181,956,656,481,55418,530948,502426,1894,2675,2494,2369,3150,13.228756555322953,18.636284493864252,781,1,110149,39000,175,0,1713,2019
1982,1,0,0,0,42,0,80,0,0,199104,869856,20.199009876724155,43,1261,896,408,42781,381628,509548,1767,2540,2497,2620,3393,22.090722034374522,20.087209181925694,773,1,97512,19345,488,0,1724,1644
1983,0,1,1,0,53,0,858,0,0,104328,291492,10.392304845413264,0,1182,1074,108,44826,502014,650459,2591,2807,2807,3665,3881,31.080540535840107,10.909289819896376,216,1,26028,6588,966,0,2591,1733
1984,0,0,1,0,52,1,465,0,0,819234,3047037,34.161381705077446,1047,1989,1869,1167,28340,569198,339430,2491,3778,2731,3313,4600,26.49528259898354,11.436007248781129,1287,1,151710,26640,702,0,1444,1909
1985,0,0,1,0,52,1,442,0,0,770184,2971514,33.555923471125034,946,1990,1810,1126,28968,562107,358904,2459,3765,2819,3323,4629,26.153393661244042,14.034855041500148,1306,1,153136,38160,684,0,1513,1955
1986,0,0,1,0,53,1,402,0,0,711288,2852628,32.68026927673638,798,2004,1734,1068,29725,547555,387295,2401,3739,2941,3337,4675,25.80697580112788,17.09701894132234,1338,1,154860,52920,666,0,1603,2005
1987,0,0,1,0,51,1,128,0,0,829473,2170893,29.13760456866693,807,1868,1826,849,43200,490944,575325,2515,3406,2599,3534,4425,31.25699921617557,6.63067838716079,891,0,191025,3906,977,0,1708,1580
1988,1,0,0,0,40,0,160,0,0,28944,216000,10.392304845413264,78,406,376,108,47034,468000,402000,1970,2108,2030,2268,2406,16.3707055437449,5.501408174353464,138,0,21708,5160,268,0,1892,1732
1989,1,0,0,0,43,0,301,0,0,131406,1173966,23.302360395462088,266,1062,785,543,51980,497260,488612,1885,2705,2439,2404,3224,15.556349186104045,17.655986544208815,820,1,122718,29639,242,0,1619,1920
1990,0,1,0,1,67,0,535,0,0,6291450,9352080,52.820450584977024,2748,5087,5045,2790,46920,770960,683808,3310,6142,3394,5607,8439,47.486840282335066,6.488991180673202,2832,1,569160,6888,2255,0,562,1097
1991,0,1,1,0,54,0,659,0,0,189000,593136,14.696938456699069,4,1303,1091,216,44226,518994,642564,2534,2962,2958,3621,4049,29.58039891549808,15.163241752806078,428,1,50544,16112,875,0,2530,1871
1992,0,1,1,0,54,0,774,0,0,138600,407100,12.24744871391589,0,1224,1074,150,47432,531944,656788,2564,2864,2864,3638,3938,30.397368307141328,12.785844799727476,300,1,36300,11250,924,0,2564,1790
1993,0,0,1,0,59,1,366,0,0,3629907,5191269,41.60528812542944,1095,4464,3828,1731,55430,722759,689770,2363,4730,3635,5096,7463,45.79301256742124,25.415753483021124,2367,1,398130,91584,2097,0,1268,902
1994,0,0,1,0,60,1,595,0,0,5171636,6003968,44.67661580737735,1405,5178,4587,1996,53628,739968,655744,2417,5004,3599,5599,8186,50.90186637049765,24.42948626000105,2587,1,435128,96333,2591,0,1012,417
1995,0,0,1,0,52,1,447,0,0,842128,3075344,34.17601498127012,1015,2042,1889,1168,31831,602957,365987,2480,3801,2786,3354,4675,26.851443164195103,13.036712646478286,1321,1,162352,34578,721,0,1465,1912
1996,0,0,0,0,50,1,298,1,0,2547408,3649540,38.13135192987524,1424,3236,3206,1454,34882,537140,409130,2480,3964,2540,4262,5746,41.8568990729127,5.684275577662207,1484,1,237002,5640,1752,0,1056,758
1997,1,0,0,0,40,0,156,0,0,35941,254381,11.269427669584644,127,410,410,127,48530,460690,422633,2003,2130,2003,2286,2413,16.822603841260722,0.0,127,0,26797,0,283,0,1876,1720
1998,1,0,0,0,42,0,289,0,0,141126,1172221,23.388031127053,300,1052,805,547,52182,501462,477889,1896,2690,2390,2401,3195,16.06237840420901,16.6246312392797,794,1,121981,28652,258,0,1596,1885
1999,0,1,0,1,67,0,580,0,0,6226044,9403512,52.933921071464184,2802,5024,5024,2802,48160,751744,721540,3356,6158,3356,5578,8380,47.138094997570704,0.0,2802,1,602430,0,2222,0,554,1134
2000,0,1,0,1,67,0,366,0,0,6367411,9153662,52.08646657242167,2579,5194,5060,2713,42008,796264,600572,3240,6087,3508,5721,8568,48.4458460551573,11.737458020983768,2847,1,482914,26398,2347,0,661,1027
2001,0,1,0,1,67,0,197,0,0,6480054,8887914,51.43928459844674,2399,5342,5095,2646,53165,728903,822955,3112,6005,3606,5808,8701,49.48737212663449,15.770117384119807,2893,1,648270,23465,2449,0,713,910
2002,0,1,0,1,67,0,155,0,0,6509250,8815760,51.28352561983234,2353,5382,5105,2630,53502,744144,807832,3075,5982,3629,5827,8734,49.749371855331,16.679854339417524,2907,1,633830,30470,2475,0,722,877
2003,0,1,1,0,56,0,75,0,0,465766,1823012,25.41653005427767,556,1457,1367,646,53072,603908,699856,2732,3468,2912,3543,4279,26.851443164195103,9.678858787534972,736,0,160208,7830,721,1,2176,2101
2004,0,1,1,0,55,0,576,0,0,215172,713112,16.06237840420901,3,1347,1092,258,42273,505812,638484,2509,3022,3019,3598,4111,28.879058156387302,16.62947167306628,513,1,59598,18360,834,0,2506,1930
2005,0,1,1,0,55,0,615,0,0,198666,643968,15.297058540778355,0,1317,1083,234,42639,503616,641216,2518,2986,2986,3601,4069,29.13760456866693,15.891790495269438,468,1,54522,16146,849,0,2518,1903
2006,0,0,1,0,51,1,481,0,0,1008216,3289432,35.679125549822544,1213,2125,2065,1273,36288,578816,418608,2524,3857,2644,3376,4709,28.142494558940577,7.880145860644973,1333,1,206226,12060,792,0,1311,1792
2007,0,0,1,0,51,1,472,0,0,976560,3248940,35.38361202590826,1167,2117,2032,1252,32256,581280,373680,2510,3847,2680,3375,4712,27.92848008753788,9.460074866898333,1337,1,180288,18360,780,0,1343,1815
2008,0,0,1,0,55,1,24,0,0,1218672,3085740,33.406586176980134,714,2610,2208,1116,30652,536410,436870,2363,3881,3167,3857,5375,33.04542328371661,20.204498347212244,1518,1,176328,68340,1092,0,1649,1673
2009,0,0,0,0,50,1,320,1,0,2528004,3636702,37.92097045171708,1378,3256,3196,1438,30222,523503,369234,2469,3967,2589,4287,5785,41.92851058647326,8.217978828131171,1498,1,209948,11760,1758,0,1091,771
2010,0,0,0,0,50,1,372,1,0,2512620,3578580,37.54996671103717,1325,3277,3192,1410,28560,517752,355320,2453,3948,2623,4320,5815,42.21374183841087,9.628282789709404,1495,1,197400,16915,1782,0,1128,756
2011,1,0,0,0,44,0,331,0,1,10830,66690,5.477225575051661,271,692,391,30,48480,533520,449046,1922,2253,2524,2584,2915,19.0,17.38162353615016,331,1,6060,53277,361,0,2193,1862
2012,1,0,0,0,40,0,150,0,0,45000,300600,12.24744871391589,150,450,450,150,49729,446892,446892,2004,2154,2004,2304,2454,17.320508075688775,0.0,150,0,33450,0,300,0,1854,1704
2013,1,0,0,0,42,0,274,0,0,193752,1273142,24.454038521274967,356,1164,922,598,46795,521605,406639,1887,2727,2371,2453,3293,18.0,16.304202262578826,840,1,114218,39688,324,0,1531,1805
2014,1,0,0,0,43,0,51,0,0,206830,1034631,21.93171219946131,186,1206,911,481,54880,526995,481824,1856,2632,2446,2581,3357,20.73644135332772,18.0002143308769,776,1,107744,41300,430,0,1670,1721
2015,1,0,0,0,41,0,187,0,0,171458,687487,18.193405398660254,46,1134,849,331,48888,402938,523404,1792,2408,2362,2595,3211,22.759613353482084,17.552240829551245,616,1,83412,15390,518,0,1746,1559
2016,0,1,0,1,67,0,284,0,0,6380736,9028688,51.69139193328034,2497,5235,5060,2672,52122,804202,740001,3204,6051,3554,5767,8614,48.86716689148246,13.3741791114057,2847,1,585168,27475,2388,0,707,991
2017,0,1,1,0,55,0,454,0,0,252072,902664,18.0,39,1387,1102,324,48174,604562,618492,2501,3110,3071,3564,4173,27.892651361962706,16.88448850132384,609,1,71928,36765,778,0,2462,2008
2018,0,0,1,0,59,1,418,0,0,2655768,4290528,37.86819245752297,827,3893,3286,1434,49335,756976,583440,2385,4426,3599,4844,6885,43.034869582700026,24.823091036128194,2041,1,279630,116544,1852,0,1558,1140
2019,0,0,1,0,53,1,398,0,0,880080,3106914,34.02939905434711,902,2174,1918,1158,28689,587577,351473,2427,3841,2939,3443,4857,27.568097504180443,16.865655847341852,1414,1,151698,56832,760,0,1525,1923
2020,0,0,1,0,54,1,356,0,0,831357,3017682,33.27160951922825,765,2200,1858,1107,29044,577912,373462,2384,3833,3068,3477,4926,27.40437921208944,19.508859164271403,1449,1,151659,71820,751,0,1619,1975
2021,0,0,1,0,55,1,309,0,0,797872,2918811,32.57299494980466,631,2243,1813,1061,33170,588714,426405,2321,3812,3181,3503,4994,27.422618401604176,21.7006509563456,1491,1,164455,84280,752,0,1690,1999
2022,0,0,0,0,50,1,187,1,0,2546460,3791095,38.79432948254165,1475,3227,3197,1505,33598,539066,395483,2489,4024,2549,4211,5746,41.13392760240627,5.652706486041966,1535,1,236285,5820,1692,0,1014,827
2023,0,0,0,0,51,1,445,1,0,2483366,3521068,37.0,1245,3307,3183,1369,27537,516972,352364,2448,3941,2696,4386,5879,42.59107887809371,11.41455123074134,1493,1,187553,24428,1814,0,1203,758
2024,0,0,0,0,51,1,652,1,0,2415468,3266056,35.52463933666322,1232,3206,3176,1262,45126,535716,564184,2558,3850,2618,4502,5794,43.749285708454714,5.623413251903491,1292,1,275116,3630,1914,0,1326,674
2025,1,0,0,0,40,0,283,0,0,42228,218808,10.392304845413264,66,541,499,108,30720,388992,324160,1984,2134,2068,2417,2567,19.77371993328519,6.78953034358522,150,0,17280,6930,391,0,1918,1635
2026,1,0,0,0,40,0,149,0,0,54230,341020,13.038404810405298,170,489,489,170,50794,437308,467398,2006,2176,2006,2325,2495,17.86057109949175,0.0,170,0,39610,0,319,0,1836,1687
2027,1,0,0,0,40,0,65,0,0,58724,429512,14.560219778561036,152,549,489,212,25992,461928,230964,1966,2238,2086,2303,2575,16.64331697709324,8.016064826688304,272,0,24168,14520,277,0,1814,1749
2028,0,1,0,1,67,0,1145,0,0,5835050,10322845,55.27205442174191,2647,5373,4965,3055,46031,814339,645389,2971,6434,3787,5289,8752,43.70354676682432,20.199282889812956,3463,1,583505,77520,1910,0,324,1469
2029,0,1,0,1,67,0,455,0,0,6240816,9203904,52.306787322488084,2706,5047,5017,2736,48319,770356,709804,3334,6100,3394,5645,8411,47.75981574503821,5.501408174353464,2766,1,577296,4680,2281,0,628,1083
2030,0,1,0,1,67,0,370,0,0,6291000,9088200,51.96152422706632,2610,5120,5030,2700,45590,791010,653004,3276,6066,3456,5696,8486,48.27007354458868,9.535934250532243,2790,1,523800,16290,2330,0,666,1036
2031,0,1,0,1,67,0,158,0,0,6414915,8792745,51.11751167652823,2373,5308,5068,2613,52398,716745,827790,3125,5978,3605,5820,8673,49.54795656734998,15.537188462367766,2853,1,642798,21600,2455,0,752,910
2032,0,1,0,1,66,0,32,0,0,6486953,8570672,50.62608023538856,2240,5417,5094,2563,53788,755744,795872,3021,5907,3667,5875,8761,50.309044912421065,18.203526446137644,2886,1,609994,38114,2531,0,781,813
2033,0,1,0,1,66,0,52,0,0,6537573,8428230,50.309044912421065,2248,5397,5114,2531,52364,705960,822510,3047,5861,3613,5913,8727,50.82322303829225,17.040209244575763,2814,1,625157,24621,2583,0,799,747
2034,0,1,1,0,54,0,722,0,0,130800,406050,12.24744871391589,16,1156,1022,150,48165,527865,668629,2573,2857,2841,3579,3863,29.5296461204668,12.31452873038128,284,1,37050,8576,872,0,2557,1835
2035,0,0,1,0,55,1,288,0,0,842305,2972210,32.7566787083184,607,2324,1858,1073,31724,570620,426580,2304,3843,3236,3555,5094,28.0178514522438,22.61733277864947,1539,1,165242,88074,785,0,1697,1985
2036,0,0,1,0,51,1,40,0,0,983664,2509704,31.176914536239792,930,2026,1984,972,41356,506072,544802,2540,3554,2624,3594,4608,31.811947441173732,6.653712290320142,1014,0,205092,4830,1012,0,1610,1570
2037,0,0,0,0,51,1,726,1,0,2386800,3168936,34.9857113690718,1194,3204,3174,1224,42370,577347,491910,2559,3813,2619,4539,5793,44.15880433163923,5.514871952411144,1254,1,232560,5160,1950,0,1365,639
2038,1,0,0,0,40,0,373,0,0,38930,172040,9.219544457292887,55,573,543,85,24130,384560,257048,1994,2109,2054,2482,2597,21.400934559032695,6.099356562415133,115,0,10795,5820,458,0,1939,1566
2039,1,0,0,0,40,0,147,0,0,65088,385152,13.856406460551018,192,531,531,192,50160,419254,481440,2006,2198,2006,2345,2537,18.411952639521967,0.0,192,0,46080,0,339,0,1814,1667
2040,0,1,0,1,67,0,415,0,0,6234474,9131958,52.08646657242167,2683,5041,5011,2713,48741,777546,710226,3336,6079,3396,5664,8407,47.93745925682754,5.483301264452448,2743,1,572443,4740,2298,0,653,1068
2041,0,1,0,1,67,0,244,0,0,6325440,8915280,51.38093031466052,2490,5186,5036,2640,50544,820611,702416,3227,6017,3527,5773,8563,48.948953002081666,12.345470001201512,2790,1,549120,25950,2396,0,737,981
2042,0,1,0,1,67,0,159,0,0,6371830,8789270,51.03920062069938,2395,5261,5051,2605,52779,738906,813134,3164,5979,3584,5820,8635,49.457052075512955,14.55997679978325,2815,1,627805,22260,2446,0,769,928
2043,0,1,0,1,65,0,216,0,0,6582960,8100780,49.59838707054898,2270,5326,5136,2460,53172,694823,829836,3103,5753,3483,5969,8619,51.73006862551025,13.927000263998286,2650,1,619920,13870,2676,0,833,617
2044,0,1,1,0,55,0,327,0,0,273024,1072512,19.595917942265423,112,1367,1095,384,50621,634011,622839,2521,3177,3065,3504,4160,26.664583251946766,16.49381556828984,656,1,85632,37808,711,0,2409,2082
2045,0,1,1,0,55,0,366,0,0,261360,1004760,18.973665961010276,59,1387,1086,360,51754,630766,639139,2490,3151,3092,3517,4178,26.94438717061496,17.35107474265597,661,1,82440,39130,726,0,2431,2065
2046,0,0,1,0,59,1,1113,0,0,4436170,4815718,40.27406113120453,1394,4585,4357,1622,56364,724436,685839,2741,4591,3197,5704,7554,52.29722745997153,15.415592261291158,1850,1,374682,32604,2735,0,1347,234
2047,0,0,1,0,52,1,434,0,0,1080755,3372723,35.76310948449533,1129,2274,2124,1279,29025,566955,355995,2487,3916,2787,3482,4911,29.068883707497267,12.849476832533073,1429,1,172665,32400,845,0,1358,1792
2048,0,0,1,0,53,1,423,0,0,1054620,3340260,35.4964786985977,1080,2277,2097,1260,24265,559361,304865,2471,3911,2831,3488,4928,28.930952282978865,14.093805174152301,1440,1,144900,40860,837,0,1391,1814
2049,0,0,1,0,53,1,400,0,0,1008576,3286440,34.9857113690718,984,2288,2048,1224,27520,577275,343680,2445,3909,2925,3509,4973,28.705400188814647,16.46403862829034,1464,1,156672,53040,824,0,1461,1861
2050,0,0,0,0,52,1,540,1,0,2445669,3433419,36.29049462324811,1287,3204,3174,1317,44702,537042,565719,2577,3924,2637,4464,5811,43.09292285283048,5.753771868478424,1347,1,285789,3630,1857,0,1290,750
2051,1,0,0,0,40,0,366,1,0,51192,220428,10.392304845413264,48,642,582,108,22204,371462,249002,1981,2149,2101,2515,2683,21.77154105707724,8.591701934764863,168,1,13176,11340,474,0,1933,1567
2052,1,0,0,0,40,0,149,1,0,76532,426120,14.560219778561036,212,573,573,212,44744,377880,478380,2010,2222,2010,2371,2583,19.0,0.0,212,1,50456,0,361,0,1798,1649
2053,1,0,0,0,42,0,185,0,0,133950,990290,21.6794833886788,350,875,755,470,46945,431935,482503,1987,2577,2227,2392,2982,16.881943016134134,12.198713124830267,590,1,107630,7560,285,0,1637,1822
2054,1,0,0,0,41,0,237,0,0,198018,1198530,24.06241883103193,445,1055,921,579,52704,505080,447120,1936,2649,2204,2412,3125,18.49324200890693,11.974018752834446,713,1,125064,19028,342,0,1491,1728
2055,1,0,0,0,41,0,192,0,0,95760,467628,15.0996688705415,48,828,648,228,51156,416353,516852,1871,2279,2231,2471,2879,20.493901531919196,14.201947569596928,408,1,57456,11520,420,0,1823,1631
2056,0,1,0,1,66,0,1358,0,0,5729103,10580947,56.27610505356603,2743,5400,4976,3167,44896,815204,614744,2917,6508,3765,5150,8741,42.532340636273474,20.742186626737265,3591,1,582728,84376,1809,0,174,1532
2057,0,1,0,1,65,0,420,0,0,6638125,7721125,48.73397172404482,2308,5237,5170,2375,53815,744479,763985,3184,5626,3318,6046,8488,52.86775955154521,8.2143728690235,2442,1,558125,8375,2795,0,876,456
2058,0,1,1,0,56,0,145,0,0,456464,2121392,27.422618401604176,590,1521,1359,752,54720,643188,677040,2659,3573,2983,3428,4342,24.63736998950984,12.803033322522062,914,0,180480,18954,607,1,2069,2214
2059,0,1,1,0,55,0,480,0,0,202500,746280,16.431676725154983,2,1288,1020,270,48659,544508,682708,2496,3034,3032,3514,4052,27.386127875258307,17.172010390461228,538,1,66690,17688,750,0,2494,2014
2060,0,1,1,0,55,0,528,0,0,184320,660000,15.491933384829668,0,1248,1008,240,47177,525250,679250,2510,2990,2990,3518,3998,27.712812921102035,16.353584097457986,480,1,59280,13920,768,0,2510,1982
2061,0,0,1,0,55,1,298,0,0,959880,3177180,33.76388603226827,690,2432,1982,1140,29638,565761,406902,2337,3927,3237,3629,5219,29.017236257093817,22.460277648787812,1590,1,166440,86400,842,0,1647,1945
2062,0,0,1,0,51,1,89,0,0,981092,2689456,32.18695387886216,1006,2013,1983,1036,37440,467280,539968,2566,3632,2626,3543,4609,30.773365106858236,5.830951894845301,1066,1,215488,2910,947,0,1560,1649
2063,0,0,0,0,52,1,406,1,0,2477360,3620544,37.20215047547655,1324,3234,3174,1384,35292,533664,452568,2556,4000,2676,4406,5850,42.30839160261236,7.750803389552748,1444,1,239432,9960,1790,0,1232,826
2064,0,0,0,0,52,1,458,1,0,2466128,3553886,36.851051545376556,1328,3204,3174,1358,41607,541719,526017,2587,3975,2647,4433,5821,42.61455150532503,5.501408174353464,1388,1,272958,4230,1816,0,1259,801
2065,0,0,0,0,52,1,766,1,0,2381411,3164754,34.741905532080416,1099,3288,3180,1207,29400,513912,393300,2514,3829,2730,4595,5910,44.41846462902562,10.700008142562027,1315,1,181050,19440,1973,0,1415,649
2066,1,0,0,0,40,0,604,0,0,44957,134603,8.18535277187245,37,768,738,67,42924,439971,393764,1979,2076,2039,2680,2777,25.903667693977237,5.5503012171862105,97,0,13132,4830,671,0,1942,1338
2067,1,0,0,0,40,0,111,0,0,93330,511530,15.968719422671311,255,621,621,255,48805,431290,455362,2006,2261,2006,2372,2627,19.131126469708992,0.0,255,0,57885,0,366,0,1751,1640
2068,1,0,0,0,40,0,199,0,0,58482,326592,12.727922061357855,42,643,523,162,50800,403200,512064,1896,2178,2136,2377,2659,19.0,11.507543736956848,282,1,41148,6360,361,0,1854,1655
2069,0,1,0,1,67,0,417,0,0,6184048,9117888,52.0,2704,4991,4991,2704,50140,775560,735096,3372,6076,3372,5659,8363,47.82258880487337,0.0,2704,1,589472,0,2287,0,668,1085
2070,0,1,0,1,67,0,34,0,0,6360195,8531040,50.38849074937649,2292,5291,5044,2539,53320,722400,833280,3113,5899,3607,5865,8651,50.049975024968795,15.724020412848395,2786,1,629672,21736,2505,0,821,855
2071,0,1,1,0,56,0,10,0,0,344544,1664704,24.331050121192877,484,1282,1174,592,47502,658008,570836,2704,3404,2920,3394,4094,24.124676163629637,10.435690064413366,700,0,120176,18360,582,1,2220,2230
2072,0,1,1,0,56,0,181,0,0,283950,1261350,21.213203435596427,222,1309,1081,450,51290,644690,625069,2575,3253,3031,3434,4112,25.11971337416094,15.103225841862386,678,1,100350,32604,631,0,2353,2172
2073,0,1,1,0,55,0,314,0,0,242640,1005480,18.973665961010276,47,1347,1034,360,51012,608874,653562,2480,3153,3106,3467,4140,25.96150997149434,17.69221231691028,673,1,84240,35995,674,0,2433,2119
2074,0,1,1,0,55,0,456,0,0,196020,746280,16.431676725154983,0,1266,996,270,48216,541744,679944,2494,3034,3034,3490,4030,26.94438717061496,17.336075532623774,540,1,66420,18090,726,0,2494,2038
2075,0,1,1,0,53,0,708,0,0,99360,323400,10.954451150103322,0,1068,948,120,47000,506660,673750,2575,2815,2815,3523,3763,28.77498913987632,11.661903789690601,240,1,30000,5760,828,0,2575,1867
2076,0,0,1,0,59,1,109,0,0,4716786,6311640,46.021733996015406,1593,4870,4345,2118,53724,721160,661560,2455,5098,3505,5207,7850,47.19110085598767,22.984882776406234,2643,1,470196,81375,2227,0,862,753
2077,0,0,1,0,53,1,424,0,0,1196052,3519204,36.41428291206625,1173,2381,2228,1326,27690,565302,345020,2501,3980,2807,3556,5035,30.033314835362415,13.036712646478286,1479,1,172380,33201,902,0,1328,1752
2078,0,0,1,0,54,1,307,0,0,1424850,3697825,36.837480912787726,1233,2531,2407,1357,45045,531375,629475,2601,4082,2849,3775,5256,32.4037034920393,11.305585981900606,1481,1,313467,10912,1050,0,1368,1675
2079,0,0,0,0,52,1,324,1,0,2492325,3736350,37.749172176353746,1335,3264,3174,1425,31310,529644,406410,2532,4047,2712,4371,5886,41.82104733265297,9.510461639168101,1515,1,220875,16380,1749,0,1197,873
2080,1,0,0,0,40,0,79,0,0,111672,595485,17.233687939614086,297,673,673,297,49268,453130,437090,2005,2302,2005,2381,2678,19.390719429665317,0.0,297,0,64746,0,376,0,1708,1629
2081,1,0,0,0,40,0,212,0,0,89888,429936,14.560219778561036,37,811,636,212,53000,429936,507000,1853,2240,2203,2452,2839,20.591260281974,13.812692024999391,387,1,53000,11725,424,0,1816,1604
2082,0,1,0,1,67,0,35,0,0,6322404,8525244,50.3189825016365,2304,5257,5029,2532,54858,750841,828282,3139,5899,3595,5864,8624,49.969990994595946,15.113881704305674,2760,1,622872,22800,2497,0,835,870
2083,0,1,0,1,65,0,299,0,0,6467406,7911002,48.96937818678118,2236,5257,5095,2398,47000,620212,824750,3137,5697,3461,5996,8556,51.93264869039514,12.828687024400846,2560,1,599500,7938,2697,0,901,602
2084,0,1,0,1,65,0,421,0,0,6522096,7669872,48.49742261192856,2257,5220,5125,2352,50880,691332,782640,3166,5613,3356,6034,8481,52.65928218272634,9.759997214798725,2447,1,564480,9310,2773,0,909,488
2085,0,1,1,0,55,0,289,0,0,233640,1006200,18.973665961010276,37,1332,1009,360,51666,609310,662415,2472,3155,3118,3444,4127,25.475478405713993,17.972889774666918,683,1,85320,35530,649,0,2435,2146
2086,0,1,1,0,53,0,687,0,0,96840,323160,10.954451150103322,0,1047,927,120,47124,503591,678636,2573,2813,2813,3500,3740,28.407745422683583,11.621977114038057,240,1,30240,4920,807,0,2573,1886
2087,0,0,1,0,55,1,335,0,0,1111500,3418480,35.14256678161116,870,2500,2135,1235,26164,584048,343232,2403,4003,3133,3668,5268,30.0,20.508582339871694,1600,1,153140,80665,900,0,1533,1868
2088,0,0,1,0,56,1,292,0,0,1076988,3352752,34.55430508634199,740,2550,2096,1194,28980,589680,387504,2354,4002,3262,3710,5358,30.033314835362415,22.755222576362197,1648,1,164772,93978,902,0,1614,1906
2089,0,0,0,0,52,1,396,1,0,2482540,3662650,37.282703764614496,1360,3206,3176,1390,38352,495380,537540,2605,4025,2665,4421,5841,42.261093218230876,5.830951894845301,1420,1,283560,3390,1786,0,1245,849
2090,1,0,0,0,40,0,83,0,0,128238,642147,17.86057109949175,319,721,721,319,42780,374418,462990,2013,2332,2013,2415,2734,20.049937655763422,0.0,319,0,73370,0,402,0,1694,1611
2091,1,0,0,0,40,0,190,0,0,237984,1199984,24.331050121192877,550,1036,994,592,53172,510804,427697,1985,2619,2069,2429,3063,20.049937655763422,6.570697549716149,634,1,124912,7014,402,0,1435,1625
2092,1,0,0,0,41,0,28,0,0,233093,1024814,22.293496809607955,402,1061,966,497,41002,509314,342292,1967,2559,2157,2531,3123,21.656407827707714,10.06192246325636,592,1,82502,20520,469,0,1565,1593
2093,1,0,0,0,40,0,231,0,0,104652,463296,15.0996688705415,38,877,687,228,49022,392176,516128,1842,2260,2222,2491,2909,21.42428528562855,14.344660619261914,418,1,57912,7220,459,0,1804,1573
2094,0,1,0,1,67,0,377,0,0,6162078,9046284,51.749396131742444,2678,4979,4979,2678,50380,773562,743160,3378,6056,3378,5679,8357,47.968739820845826,0.0,2678,1,589160,0,2301,0,700,1077
2095,0,1,0,1,67,0,6,0,0,6305112,8429388,50.07993610219566,2266,5264,5022,2508,55328,752864,830167,3119,5869,3603,5875,8625,50.1398045468867,15.558009107250758,2750,1,619476,23958,2514,0,853,847
2096,0,1,0,1,66,0,258,0,0,6404515,7984600,49.040799340956916,2235,5238,5068,2405,53655,727080,813400,3150,5725,3490,5983,8558,51.60426338976267,13.19014343722849,2575,1,589225,16830,2663,0,915,657
2097,0,1,0,1,66,0,300,0,0,6418944,7909056,48.86716689148246,2238,5226,5076,2388,51584,688896,821376,3162,5700,3462,6000,8538,51.84592558726288,12.360324274125283,2538,1,592224,12000,2688,0,924,624
2098,0,1,1,0,64,0,277,0,0,4942574,6762093,45.70557952810576,1965,4579,4455,2089,47908,657111,763932,3113,5326,3361,5603,7816,48.641546028061235,11.515574071079046,2213,1,493004,11408,2366,0,1148,871
2099,0,1,1,0,63,0,144,0,0,4119777,6213948,44.26059195266146,1929,4092,4062,1959,46620,666120,704184,3142,5131,3202,5275,7264,45.858477951192405,5.514871952411144,1989,1,434898,3570,2103,0,1213,1069
2100,0,1,1,0,56,0,172,0,0,248640,1178520,20.493901531919196,137,1295,1012,420,51076,634156,634156,2523,3226,3089,3398,4101,24.331050121192877,16.82785260599149,703,1,94920,37922,592,0,2386,2214
2101,0,1,1,0,54,0,615,0,0,114750,406050,12.24744871391589,0,1065,915,150,47311,506209,684871,2557,2857,2857,3472,3772,27.65863337187866,12.967447346601379,300,1,37950,6000,765,0,2557,1942
2102,0,0,1,0,52,1,433,0,0,1377570,3723810,37.54996671103717,1286,2511,2387,1410,29526,586302,351253,2517,4051,2765,3618,5152,31.25699921617557,11.485331950731227,1534,1,187530,27776,977,0,1231,1664
2103,0,0,1,0,55,1,332,0,0,1173660,3505836,35.52463933666322,891,2563,2192,1262,26164,586158,344472,2407,4040,3149,3708,5341,30.495901363953813,20.756095628904642,1633,1,156488,81991,930,0,1516,1848
2104,0,0,1,0,53,1,242,0,0,975384,2958516,33.406586176980134,996,2110,1990,1116,31265,448019,490435,2531,3767,2771,3525,4761,29.563490998188964,11.621977114038057,1236,1,206460,12960,874,0,1535,1777
2105,0,0,1,0,52,1,254,0,0,969920,2962400,33.46640106136302,1030,2076,1986,1120,31914,428490,521065,2555,3765,2735,3511,4721,29.427877939124322,10.295630140987,1210,1,220640,7560,866,0,1525,1779
2106,0,0,0,0,52,1,366,1,0,2491432,3720276,37.49666651850535,1376,3208,3178,1406,38688,492156,550368,2616,4052,2676,4418,5854,42.09513035969837,5.8721273231371045,1436,1,292448,3150,1772,0,1240,874
2107,0,0,0,0,53,1,722,1,0,2423283,3301553,35.17101079013795,1062,3371,3196,1237,29204,523124,397681,2494,3906,2844,4628,6040,44.26059195266146,13.812692024999391,1412,1,184313,31500,1959,0,1432,710
2108,1,0,0,0,40,0,566,1,0,107400,305250,12.24744871391589,55,961,866,150,32186,425315,313390,1940,2185,2130,2751,2996,26.758176320519304,10.012227554748348,245,1,23100,18145,716,0,1885,1319
2109,1,0,0,0,40,0,57,0,0,150898,724888,19.0,361,779,779,361,51246,469872,439752,2008,2369,2008,2426,2787,20.445048300260872,0.0,361,0,79059,0,418,0,1647,1590
2110,1,0,0,0,41,0,150,0,0,221904,841386,20.049937655763422,275,1081,954,402,41000,523250,343252,1966,2495,2220,2645,3174,23.49468024894146,11.92537741680652,529,1,65928,27686,552,0,1691,1541
2111,0,1,0,1,67,0,6,0,0,6275016,8419230,50.0199960015992,2284,5228,5010,2502,53410,733570,824425,3147,5867,3583,5873,8593,50.07993610219566,14.764900729971618,2720,1,612990,21364,2508,0,863,857
2112,0,1,0,1,65,0,505,0,0,6451500,7511800,47.958315233127195,2233,5172,5105,2300,49163,689126,760978,3199,5566,3333,6071,8438,52.96225070746144,8.185808589931957,2367,1,535900,7169,2805,0,966,461
2113,0,1,1,0,56,0,240,0,0,345600,2021040,26.832815729997478,530,1390,1200,720,46631,620347,592277,2617,3527,2997,3287,4197,21.908902300206645,13.791774304255147,910,0,151920,27930,480,1,2087,2327
2114,0,1,1,0,56,0,101,0,0,247950,1264050,21.213203435596427,173,1278,1001,450,50838,643261,623598,2532,3259,3086,3360,4087,23.473389188611005,16.649874639545555,727,1,99900,39334,551,0,2359,2258
2115,0,1,1,0,55,0,240,0,0,216000,1005840,18.973665961010276,18,1302,960,360,52920,603504,684530,2452,3154,3136,3394,4096,24.49489742783178,19.453234403289226,702,1,88200,32832,600,0,2434,2194
2116,0,1,1,0,55,0,288,0,0,203940,918720,18.16590212458495,17,1261,948,330,52500,584640,696000,2471,3114,3097,3402,4045,24.859605789312106,18.653564188095974,643,1,82500,24727,618,0,2454,2166
2117,0,1,1,0,55,0,388,0,0,177660,745200,16.431676725154983,14,1184,928,270,52164,571320,695520,2504,3030,3016,3418,3944,25.65151067676132,16.917940215049025,526,1,68040,18176,658,0,2490,2102
2118,0,1,1,0,54,0,439,0,0,162960,659520,15.491933384829668,12,1147,919,240,51156,557844,692496,2520,2988,2976,3427,3895,26.057628441590765,15.994137403596097,468,1,60480,14592,679,0,2508,2069
2119,0,0,1,0,58,1,1140,0,0,3493216,4013600,37.20215047547655,1354,3938,3908,1384,55448,672800,693100,2870,4284,2930,5424,6838,50.23942674832188,5.478746393072713,1414,1,330776,3660,2524,0,1516,376
2120,0,0,1,0,54,1,366,0,0,1289011,3655086,36.51027252705737,1038,2595,2300,1333,27432,592272,348234,2447,4075,3037,3709,5337,31.096623610932426,18.42507614943896,1628,1,169291,65785,967,0,1409,1775
2121,0,0,1,0,55,1,328,0,0,1236480,3588368,35.888716889852724,909,2627,2248,1288,27648,601776,356608,2407,4074,3165,3746,5413,30.983866769659336,20.957869280723678,1667,1,164864,84138,960,0,1498,1826
2122,0,0,1,0,56,1,315,0,0,1224000,3570000,35.70714214271425,867,2643,2235,1275,29648,610400,380800,2392,4075,3208,3760,5443,30.983866769659336,21.76836682430315,1683,1,173400,88536,960,0,1525,1840
2123,0,0,1,0,50,1,232,0,0,2511465,4332405,41.291645644125154,1705,3178,3178,1705,43618,574266,490413,2541,4246,2541,4014,5719,38.379682124790975,0.0,1705,0,329065,0,1473,0,836,1068
2124,0,0,0,0,52,1,437,1,0,2488314,3636978,37.067505985701274,1344,3215,3185,1374,33400,529400,442049,2617,4021,2677,4458,5862,42.555845661906424,5.5965095842615735,1404,1,229458,5040,1811,0,1273,836
2125,0,0,0,0,54,1,938,1,0,2388264,3112536,33.85262175962151,827,3549,3230,1146,32186,567644,418264,2397,3862,3035,4800,6265,45.65084884205331,18.653910833091263,1465,1,176484,61248,2084,0,1570,632
2126,1,0,0,0,40,0,562,1,0,124440,347650,13.038404810405298,46,1026,902,170,32832,441720,310840,1921,2215,2169,2777,3071,27.055498516937366,11.41455123074134,294,1,25840,24924,732,0,1875,1313
2127,1,0,0,0,40,0,96,1,0,164977,730303,19.0,331,848,818,361,43120,356048,495635,1993,2384,2053,2480,2871,21.37755832643195,5.791460926441345,391,1,88445,0,457,0,1662,1566
2128,1,0,0,0,40,0,64,0,0,170372,768202,19.544820285692065,382,828,828,382,50394,446442,456497,2011,2393,2011,2457,2839,21.118712081942874,0.0,382,0,86714,0,446,0,1629,1565
2129,1,0,0,0,40,0,33,0,0,176548,813252,20.09975124224178,404,841,841,404,44888,499224,364353,2013,2417,2013,2450,2854,20.904544960366874,0.0,404,0,73124,0,437,0,1609,1576
2130,1,0,0,0,40,0,139,0,0,251712,1164096,24.0,546,1043,1013,576,39590,432494,373885,1991,2597,2051,2458,3064,20.904544960366874,5.483301264452448,606,0,106560,5010,437,0,1445,1584
2131,1,0,0,0,39,0,266,0,0,48360,244776,11.135528725660043,39,599,514,124,54750,432306,493500,1889,2098,2059,2364,2573,19.748417658131498,9.357120099656203,209,1,31000,7310,390,0,1850,1584
2132,0,1,0,1,67,0,379,0,0,6136830,9062186,51.710733895391584,2589,5054,4969,2674,49648,725246,786248,3304,6063,3474,5684,8443,47.90615826801394,9.257905235465769,2759,1,620368,9520,2295,0,715,1094
2133,0,1,0,1,66,0,341,0,0,6349080,7811535,48.52834223420371,2228,5178,5051,2355,53482,733057,802714,3190,5672,3444,6013,8495,51.92301994298868,11.368721298642535,2482,1,569910,13462,2696,0,962,621
2134,0,1,1,0,65,0,425,0,0,5465600,6987855,46.20606020859169,1945,4885,4695,2135,45732,726606,674238,3083,5408,3463,5833,8158,50.59644256269407,13.912911596993856,2325,1,439810,29260,2560,0,1138,713
2135,0,1,1,0,55,0,216,0,0,207360,1005120,18.973665961010276,25,1271,936,360,53072,597488,692416,2457,3152,3127,3368,4063,24.0,19.26779425925374,695,1,89280,29480,576,0,2432,2216
2136,0,1,1,0,53,0,630,0,0,90000,321720,10.954451150103322,12,978,870,120,47124,501347,675612,2573,2801,2789,3431,3659,27.386127875258307,10.89017689082249,228,1,30240,4536,750,0,2561,1931
2137,0,0,1,0,56,1,1125,0,0,2685150,3313440,34.20526275297414,1085,3550,3465,1170,43800,566400,620208,2747,4002,2917,5127,6382,47.90615826801394,9.265143265380413,1255,1,256230,9350,2295,0,1662,537
2138,0,0,0,0,50,1,263,1,0,2502864,4380012,41.46082488325576,1719,3175,3175,1719,37349,563108,430612,2548,4267,2548,4004,5723,38.157568056677825,0.0,1719,1,290511,0,1456,0,829,1092
2139,0,0,0,0,53,1,609,1,0,2475286,3489024,36.02776706930364,1148,3355,3205,1298,29944,529536,408576,2538,3986,2838,4595,6043,43.669211121796096,12.950100320556757,1448,1,197296,26850,1907,0,1390,781
2140,0,0,0,0,54,1,808,1,0,2438553,3281226,34.77067730142742,939,3496,3226,1209,30200,542800,409814,2444,3923,2984,4731,6210,44.91102314577124,17.27360060772727,1479,1,182559,49410,2017,0,1505,697
2141,0,0,0,0,54,1,857,1,0,2429460,3232548,34.46737587922817,888,3533,3233,1188,30600,544200,416313,2421,3909,3021,4766,6254,45.221676218380054,18.160436542779482,1488,1,181764,54300,2045,0,1533,676
2142,0,0,0,0,54,1,905,1,0,2418024,3183576,34.161381705077446,844,3562,3239,1167,32232,556512,431024,2405,3895,3051,4800,6290,45.51922670696417,17.996955674948754,1490,1,184386,58786,2072,0,1561,656
2143,1,0,0,0,40,0,97,1,0,282270,1185534,24.124676163629637,582,1067,1067,582,37128,370734,415548,2037,2619,2037,2522,3104,22.02271554554524,0.0,582,1,118728,0,485,0,1455,1552
2144,1,0,0,0,41,0,168,0,0,235008,840888,20.199009876724155,341,1051,984,408,31089,496701,265869,1994,2469,2128,2637,3112,24.0,8.616819548034314,475,1,52632,15544,576,0,1653,1485
2145,0,1,0,1,66,0,342,0,0,6311083,7796734,48.4458460551573,2220,5163,5036,2347,53312,744128,790636,3195,5669,3449,6011,8485,51.85556864985669,11.353036033505358,2474,1,558586,14605,2689,0,975,633
2146,0,1,0,1,65,0,507,0,0,6354360,7498920,47.74934554525329,2238,5109,5067,2280,49887,680823,792649,3247,5569,3331,6076,8398,52.79204485526205,6.5135556243263055,2322,1,549480,3780,2787,0,1009,502
2147,0,1,1,0,55,0,143,0,0,208794,1094018,19.77371993328519,30,1286,925,391,55350,629550,688308,2437,3189,3159,3332,4084,23.108440016582687,19.0,752,1,96186,37183,534,0,2407,2264
2148,0,0,1,0,53,1,491,0,0,2072790,4575492,41.30375285612676,1582,3045,2921,1706,43616,504216,622224,2558,4388,2806,3897,5727,34.85685011586675,11.41455123074134,1830,1,395792,9548,1215,0,976,1467
2149,0,0,1,0,52,1,474,0,0,1839960,4254504,40.17461885320133,1614,2754,2754,1614,42000,553560,527200,2636,4250,2636,3776,5390,33.76388603226827,0.0,1614,0,322800,0,1140,0,1022,1496
2150,0,0,0,0,56,1,308,1,0,1354560,3734336,36.4417343165772,898,2778,2348,1328,34164,658008,410552,2382,4140,3242,3832,5590,31.937438845342623,22.246325080578696,1758,1,193888,96320,1020,0,1484,1792
2151,0,0,1,0,53,1,393,0,0,970408,3234293,34.655446902326915,1000,2210,2009,1201,33345,525135,460503,2492,3894,2894,3501,4903,28.42534080710379,15.0436608546514,1402,1,205371,31758,808,0,1492,1885
2152,0,0,1,0,53,1,475,0,0,928650,3260730,35.07135583350036,1188,2027,1985,1230,31980,434764,516945,2609,3881,2693,3406,4678,27.477263328068172,6.852548980306203,1272,1,239850,3780,755,0,1421,1896
2153,0,0,0,0,51,1,190,1,0,2509544,4344606,41.012193308819754,1615,3241,3174,1682,24898,545013,304794,2516,4265,2650,4075,5824,38.62641583165593,8.892463825840219,1749,1,198476,15075,1492,0,901,1091
2154,0,0,0,0,52,1,139,1,0,2515326,4309857,40.70626487409524,1562,3270,3175,1657,25228,551412,309519,2506,4258,2696,4119,5871,38.961519477556315,10.72886966703452,1752,1,197183,21375,1518,0,944,1083
2155,0,0,0,0,52,1,35,1,0,2523026,4223780,40.07492981902776,1453,3330,3177,1606,27178,562820,334010,2477,4236,2783,4201,5960,39.63584236521283,13.419926217395696,1759,1,203962,33813,1571,0,1024,1059
2156,0,0,0,0,53,1,119,1,0,2526150,4089301,39.1279950930277,1411,3301,3181,1531,30033,568923,376611,2551,4202,2791,4321,5972,40.620192023179804,11.275536377596524,1651,1,215871,24960,1650,0,1140,1021
2157,1,0,0,0,42,0,343,0,0,188210,626580,17.175564037317667,53,1175,933,295,39435,507636,350460,1882,2419,2366,2762,3299,25.25866188063018,16.46246988824629,537,1,48675,51304,638,0,1829,1486
2158,1,0,0,0,40,0,79,1,0,213272,858600,20.591260281974,382,969,927,424,41535,394875,431325,1983,2449,2067,2528,2994,22.427661492005804,6.553889165207866,466,1,90312,4662,503,0,1601,1522
2159,1,0,0,0,40,0,49,1,0,220770,901812,21.118712081942874,416,971,941,446,43890,424620,422598,1992,2468,2052,2517,2993,22.24859546128699,5.531194905403055,476,1,93214,4080,495,0,1576,1527
2160,1,0,0,0,40,0,21,1,0,227896,942406,21.61018278497431,467,955,955,467,47957,445978,437906,2018,2485,2018,2506,2973,22.090722034374522,0.0,467,1,101339,0,488,0,1551,1530
2161,1,0,0,0,40,0,4,0,0,236192,982832,22.090722034374522,488,972,972,488,51513,465234,449122,2014,2502,2014,2498,2986,22.0,0.0,488,0,108824,0,484,0,1526,1530
2162,1,0,0,0,40,0,23,1,0,286628,1112598,23.388031127053,517,1101,1071,547,42864,382392,463752,2004,2581,2064,2558,3135,22.891046284519195,5.483301264452448,577,1,124716,2490,524,0,1487,1510
2163,1,0,0,0,40,0,19,1,0,278166,1048950,22.759613353482084,488,1085,1055,518,49500,445500,455625,1995,2543,2055,2562,3110,23.173260452512935,5.478746393072713,548,1,116550,3840,537,0,1507,1488
2164,1,0,0,0,40,0,63,0,0,268888,987224,22.090722034374522,488,1039,1039,488,51972,493612,430899,2023,2511,2023,2574,3062,23.473389188611005,0.0,488,0,103944,0,551,0,1535,1472
2165,0,1,0,1,67,0,253,0,0,6151770,8847900,51.088159097779204,2486,5091,4967,2610,49932,742410,772920,3266,6000,3514,5747,8481,48.54894437575342,11.161509396993736,2734,1,595080,15376,2357,0,780,1033
2166,0,1,0,1,67,0,82,0,0,6188463,8555607,50.28916384272063,2379,5126,4976,2529,48510,781473,710430,3233,5912,3533,5830,8509,49.467160824126545,12.250849366392371,2679,1,531090,23850,2447,0,854,936
2167,0,1,0,1,65,0,549,0,0,6323020,7421205,47.486840282335066,2225,5089,5059,2255,50456,697692,783258,3261,5546,3321,6095,8380,52.952809179494906,5.572104574801163,2285,1,536690,3060,2804,0,1036,487
2168,0,1,1,0,56,0,24,0,0,213300,1260450,21.213203435596427,108,1266,924,450,56160,672240,655434,2459,3251,3143,3275,4067,21.77154105707724,18.4935977473728,792,1,105300,46170,474,0,2351,2327
2169,0,1,1,0,55,0,273,0,0,171900,828600,17.320508075688775,30,1143,873,300,52208,574496,693262,2492,3062,3032,3335,3905,23.93741840717165,17.310877542037954,570,1,75300,19980,573,0,2462,2189
2170,0,1,1,0,55,0,325,0,0,160650,742770,16.431676725154983,30,1105,865,270,51500,566706,687750,2511,3021,2991,3346,3856,24.392621835300936,16.367114495260488,510,1,67500,17520,595,0,2481,2156
2171,0,0,1,0,58,1,1182,0,0,2776543,3433309,34.307433596816885,1027,3686,3536,1177,53562,691329,659242,2767,4094,3067,5276,6603,48.569537778323564,12.410850817228189,1327,1,266002,21750,2359,0,1740,558
2172,0,0,0,0,55,1,296,1,0,1199121,3497123,35.397740040855716,729,2734,2210,1253,47058,519126,706123,2267,4044,3315,3748,5525,30.93541659651604,24.068589234435763,1777,1,317009,19388,957,0,1538,1834
2173,0,0,1,0,52,1,552,0,0,917833,3372177,35.679125549822544,1273,1994,1994,1273,35136,484767,508608,2649,3922,2649,3370,4643,26.851443164195103,0.0,1273,0,244416,0,721,0,1376,1928
2174,0,0,0,0,52,1,118,1,0,2521440,4321056,40.59556626036888,1514,3312,3178,1648,31692,597816,364458,2488,4270,2756,4152,5934,39.11521443121589,12.618364153088987,1782,1,229072,30016,1530,0,974,1092
2175,0,0,0,0,53,1,242,1,0,2535768,3963060,38.41874542459709,1446,3224,3194,1476,40572,526260,555795,2655,4161,2715,4403,5909,41.44876355212541,5.791460926441345,1506,1,305532,3600,1718,0,1209,967
2176,1,0,0,0,40,0,695,0,0,66300,171870,9.219544457292887,55,895,865,85,27477,430686,260838,1992,2107,2052,2802,2917,27.92848008753788,5.8721273231371045,115,0,10965,6540,780,0,1937,1242
2177,1,0,0,0,40,0,661,0,0,83052,219996,10.392304845413264,48,937,877,108,26910,421659,264810,1977,2145,2097,2806,2974,27.730849247724095,8.304442100362111,168,0,14040,12660,769,0,1929,1268
2178,1,0,0,0,42,0,338,0,0,213503,686698,17.97220075561143,55,1252,984,323,39078,497484,355042,1858,2449,2394,2787,3378,25.709920264364882,17.12401793006818,591,1,53941,55208,661,0,1803,1465
2179,1,0,0,0,40,0,86,1,0,237272,907164,21.118712081942874,379,1045,978,446,40257,384426,433242,1967,2480,2101,2566,3079,23.065125189341593,8.329212945039274,513,1,94998,6968,532,0,1588,1502
2180,1,0,0,0,40,0,57,1,0,244708,948010,21.61018278497431,425,1033,991,467,40397,403970,412090,1988,2497,2072,2554,3063,22.891046284519195,6.609134537568676,509,1,94801,5376,524,0,1563,1506
2181,1,0,0,0,40,0,20,1,0,271341,1072620,23.043437243605826,531,1042,1042,531,32364,375720,351480,2020,2551,2020,2531,3062,22.60530911091463,0.0,531,1,92394,0,511,0,1489,1509
2182,1,0,0,0,40,0,93,1,0,279268,981552,22.0,454,1091,1061,484,45368,433992,429936,1998,2512,2058,2605,3119,24.020824298928627,5.514871952411144,514,1,102608,4110,577,0,1544,1451
2183,1,0,0,0,40,0,138,0,0,268768,920258,21.307275752662516,454,1046,1046,454,49629,472291,431751,2027,2481,2027,2619,3073,24.331050121192877,0.0,454,0,96702,0,592,0,1573,1435
2184,1,0,0,0,40,0,183,0,0,257368,859872,20.591260281974,424,1031,1031,424,44888,502944,367068,2028,2452,2028,2635,3059,24.63736998950984,0.0,424,0,76744,0,607,0,1604,1421
2185,1,0,0,0,41,0,277,0,0,234330,755185,19.1049731745428,305,1067,1007,365,24150,475870,217245,2009,2434,2129,2711,3136,25.337718918639855,8.52469877450791,425,1,38325,14700,642,0,1704,1427
2186,1,0,0,0,37,0,533,0,1,40200,126563,8.18535277187245,28,762,667,67,26316,324908,289017,1794,1956,1984,2489,2651,24.49489742783178,10.133790967822552,162,1,10251,13870,600,0,1822,1289
2187,0,1,0,1,68,0,382,0,0,6123843,9128295,51.70106381884226,2461,5176,4964,2673,51754,782035,771790,3203,6088,3627,5706,8591,47.86439177509728,14.669851868889596,2885,1,604098,29044,2291,0,742,1124
2188,0,1,1,0,55,0,201,0,0,175230,913770,18.16590212458495,30,1161,861,330,53750,595335,692250,2469,3099,3069,3300,3930,23.043437243605826,18.160436542779482,630,1,82500,24900,531,0,2439,2238
2189,0,0,1,0,55,1,6,0,0,1923760,3873816,37.20215047547655,1054,3104,2774,1384,44678,702549,498222,2469,4183,3129,4189,5903,37.282703764614496,18.601075237738275,1714,1,246352,63690,1390,0,1415,1409
2190,0,0,1,0,58,1,142,0,0,3166920,5396728,43.034869582700026,1612,3802,3562,1852,51500,728500,600284,2674,4766,3154,4624,6716,41.352146256270665,15.544382038814643,2092,0,381512,43200,1710,1,1062,1204
2191,0,0,1,0,53,1,571,0,0,901562,3437684,35.73513677041127,1153,2107,1983,1277,35754,476484,543784,2568,3969,2816,3398,4799,26.570660511172846,11.774388077729856,1401,1,257954,12400,706,0,1415,1986
2192,0,0,1,0,53,1,583,0,0,898100,3446138,35.81898937714463,1188,2078,1983,1283,34320,472736,523770,2591,3969,2781,3386,4764,26.457513110645905,10.50128202411823,1378,1,250185,10165,700,0,1403,1986
2193,0,0,1,0,53,1,611,0,0,899682,3468528,36.08323710533743,1272,2023,1993,1302,32088,447552,508824,2634,3966,2694,3355,4687,26.28687885618983,5.791460926441345,1332,0,248682,3000,691,0,1362,1973
2194,0,0,1,0,55,1,573,0,0,1565290,4347330,39.6232255123179,1408,2729,2567,1570,44280,598104,567645,2607,4339,2931,3766,5498,31.575306807693888,13.170380740752039,1732,1,321850,23976,997,0,1199,1772
2195,0,0,0,0,53,1,160,1,0,2547204,4097082,38.961519477556315,1458,3256,3196,1518,42210,566790,542499,2639,4217,2759,4377,5955,40.963398296528084,8.16338338718601,1578,1,305118,8700,1678,0,1181,1021
2196,0,0,0,0,55,1,711,1,0,2525632,3504569,35.679125549822544,1057,3473,3257,1273,28906,534082,410197,2537,4026,2969,4737,6226,44.54211490264017,14.722387796083261,1489,1,189677,38448,1984,0,1480,769
2197,1,0,0,0,41,0,581,1,0,109650,308850,12.24744871391589,55,976,881,150,37380,432390,366502,1964,2209,2154,2790,3035,27.03701166919155,10.50128202411823,245,1,26700,16055,731,0,1909,1328
2198,1,0,0,0,40,0,38,1,0,278423,1038360,22.561028345356956,449,1116,1056,509,33088,383520,359040,1980,2549,2100,2587,3156,23.388031127053,7.994134176674909,569,1,89584,8640,547,0,1531,1493
2199,1,0,0,0,40,0,123,1,0,290524,979316,21.93171219946131,439,1127,1085,481,44457,413308,445884,1994,2517,2078,2640,3163,24.576411454889016,6.553889165207866,523,1,105339,4788,604,0,1555,1432
2200,1,0,0,0,40,0,167,0,0,278718,916432,21.236760581595302,421,1099,1069,451,47524,442976,442976,2002,2483,2062,2650,3131,24.859605789312106,5.514871952411144,481,0,98318,4050,618,0,1581,1414
2201,1,0,0,0,38,0,516,0,1,76320,228600,10.954451150103322,14,890,756,120,32148,325755,358140,1771,2025,2039,2541,2795,25.219040425836983,12.08361278705801,254,1,22560,14472,636,0,1785,1269
2202,0,1,0,1,66,0,510,0,0,6240096,7471872,47.49736834815167,2196,5082,5022,2256,51863,718704,791568,3252,5568,3372,6078,8394,52.592775169218825,7.822290851349969,2316,1,539184,6420,2766,0,1056,546
2203,0,1,1,0,62,0,263,0,0,2037630,4851500,39.56008088970496,1242,3190,2867,1565,51968,694400,719200,2777,4665,3423,4402,6290,36.08323710533743,18.2550309577016,1888,1,363080,40375,1302,0,1535,1798
2204,0,1,1,0,55,0,76,0,0,182597,1087762,19.77371993328519,49,1200,858,391,54900,625950,678808,2440,3173,3124,3249,3982,21.61018278497431,18.72917466344535,733,1,95404,36252,467,0,2391,2315
2205,0,1,1,0,54,0,395,0,0,128684,576852,14.560219778561036,30,1001,819,212,50400,544200,685692,2539,2933,2903,3328,3722,24.63736998950984,14.23361009791196,394,1,53424,11102,607,0,2509,2114
2206,0,0,1,0,58,1,184,0,0,3156377,5448352,43.255057507764334,1661,3768,3558,1871,48659,719264,573664,2702,4783,3122,4599,6680,41.0731055558257,14.546594193114244,2081,0,368587,39480,1687,1,1041,1225
2207,0,0,1,0,57,1,1192,0,0,2494128,3161340,33.04542328371661,942,3526,3376,1092,55404,660060,703485,2745,3987,3045,5179,6421,47.791212581394085,12.25234475675418,1242,1,265356,16500,2284,0,1803,611
2208,0,0,1,0,54,1,566,0,0,935975,3529594,35.93048844644336,1036,2271,2016,1291,32757,500322,489386,2479,4025,2989,3459,5005,26.92582403567252,16.76241769183441,1546,1,231089,34170,725,0,1443,2009
2209,0,0,1,0,53,1,661,0,0,877812,3560236,36.38681079732051,1264,2047,1987,1324,35119,465197,545867,2629,4013,2749,3352,4736,25.748786379167466,8.491821094987799,1384,1,268772,5580,663,0,1365,2026
2210,0,0,0,0,54,1,482,1,0,2566319,3779839,37.134889255254286,1229,3390,3240,1379,29550,539977,411150,2591,4120,2891,4602,6131,43.139309220245984,12.247584794411392,1529,1,206850,27300,1861,0,1362,880
2211,1,0,0,0,40,0,151,1,0,302880,979680,21.908902300206645,450,1141,1111,480,47328,416364,473512,2011,2521,2071,2672,3182,25.11971337416094,5.514871952411144,510,1,111360,3000,631,0,1561,1410
2212,1,0,0,0,40,0,194,0,0,289800,916200,21.213203435596427,450,1094,1094,450,49280,447920,456064,2036,2486,2036,2680,3130,25.37715508089904,0.0,450,0,100800,0,644,0,1586,1392
2213,1,0,0,0,41,0,283,0,0,149310,561870,16.431676725154983,120,973,823,270,49276,403714,528574,1931,2351,2231,2634,3054,23.515952032609693,12.613010185831968,420,1,68580,6300,553,0,1811,1528
2214,1,0,0,0,37,0,683,0,1,73910,178505,9.746794344808963,65,903,873,95,40964,368284,392711,1849,1974,1909,2657,2782,27.892651361962706,5.684275577662207,125,1,19855,3510,778,0,1784,1101
2215,1,0,0,0,37,0,703,0,1,71370,168660,9.486832980505138,90,883,883,90,43472,391666,389792,1874,1964,1874,2667,2757,28.160255680657446,0.0,90,1,18720,0,793,0,1784,1081
2216,0,1,0,1,67,0,172,0,0,6182748,8111554,49.01020301937138,2134,5244,4976,2402,54492,769956,807103,3109,5779,3645,5951,8621,50.73460357586329,16.475063179409663,2670,1,574078,31624,2574,0,975,803
2217,0,1,0,1,66,0,635,0,0,6221904,7256691,46.87216658103186,2197,5029,5029,2197,49713,723357,749781,3303,5500,3303,6135,8332,53.21653878260028,0.0,2197,1,498719,0,2832,0,1106,471
2218,0,1,0,1,65,0,661,0,0,5871240,6958350,45.98912915026767,2020,4986,4891,2115,44690,717220,674450,3195,5405,3385,6066,8276,52.687759489277965,9.759997214798725,2210,1,433575,14155,2776,0,1175,514
2219,0,1,1,0,54,0,264,0,0,149857,759257,16.64331697709324,30,1065,818,277,53286,586574,682509,2494,3018,2988,3282,3806,23.259406699226016,16.43111319559244,524,1,68973,20995,541,0,2464,2200
2220,0,1,1,0,54,0,374,0,0,129056,592524,14.7648230602334,28,1000,810,218,49949,540882,682218,2528,2936,2908,3310,3718,24.331050121192877,14.441500845121997,408,1,54718,11590,592,0,2500,2126
2221,0,0,1,0,54,1,659,0,0,878472,3617082,36.373066958946424,1122,2188,1987,1323,34272,459312,557736,2533,4057,2935,3398,4922,25.768197453450252,15.0436608546514,1524,1,269892,17085,664,0,1411,2070
2222,0,0,1,0,54,1,666,0,0,865255,3598404,36.345563690772494,1146,2151,1976,1321,34235,454908,558420,2549,4045,2899,3379,4875,25.592967784139454,14.094251656799676,1496,1,270805,14175,655,0,1403,2069
2223,0,0,1,0,51,1,453,0,0,2206204,4434885,41.58124577258358,1729,3005,3005,1729,46864,518130,595080,2565,4294,2565,3841,5570,35.7211421989835,0.0,1729,0,401128,0,1276,0,836,1289
2224,0,0,0,0,52,1,363,1,0,2496748,4617832,42.09513035969837,1664,3289,3181,1772,14872,440414,229328,2498,4378,2714,4015,5895,37.53664875824692,10.96830808063325,1880,1,155936,21816,1409,0,834,1197
2225,0,0,0,0,53,1,106,1,0,2547600,4389000,40.620192023179804,1470,3374,3194,1650,18258,476140,271320,2480,4310,2840,4204,6034,39.293765408777,13.431290203866302,1830,1,168300,36540,1544,0,1010,1116
2226,0,0,0,0,55,1,549,1,0,2589706,3757586,36.851051545376556,1224,3399,3265,1358,31871,561701,434419,2633,4125,2901,4674,6166,43.669211121796096,11.5784147532791,1492,1,213206,24254,1907,0,1409,860
2227,1,0,0,0,41,0,474,1,0,126160,393680,13.784048752090222,40,1004,854,190,37467,428904,375032,1922,2262,2222,2736,3076,25.768197453450252,12.81730439318685,340,1,34390,24450,664,0,1882,1408
2228,1,0,0,0,40,0,178,0,0,315840,981120,21.908902300206645,450,1168,1138,480,52030,439460,494648,2014,2524,2074,2702,3212,25.65151067676132,5.572104574801163,510,1,116160,2940,658,0,1564,1386
2229,1,0,0,0,38,0,575,0,0,108750,285750,12.24744871391589,60,965,875,150,34884,325755,388620,1815,2055,1995,2630,2870,26.92582403567252,10.053568030701648,240,1,30600,8010,725,0,1755,1180
2230,1,0,0,0,38,0,645,0,1,91800,228960,10.954451150103322,30,1035,885,120,23750,362520,238500,1758,2028,2058,2673,2943,27.65863337187866,12.5999078163187,270,1,15000,29400,765,0,1788,1143
2231,1,0,0,0,38,0,556,0,1,105900,287850,12.24744871391589,12,1018,856,150,37368,331987,414504,1757,2069,2081,2625,2937,26.570660511172846,13.254920366232327,312,1,32400,12474,706,0,1769,1213
2232,1,0,0,0,38,0,606,0,1,87120,228720,10.954451150103322,30,996,846,120,36984,383106,350704,1756,2026,2056,2632,2902,26.94438717061496,12.639835959643802,270,1,22080,22650,726,0,1786,1180
2233,1,0,0,0,37,0,627,0,1,79380,203904,10.392304845413264,42,993,843,108,38665,349280,394592,1738,1996,2038,2623,2881,27.110883423451916,12.525768210359056,258,1,22572,15450,735,0,1780,1153
2234,1,0,0,0,37,0,679,0,1,69210,167670,9.486832980505138,30,979,859,90,43834,376326,404271,1743,1953,1983,2632,2842,27.730849247724095,11.015556749295067,210,1,19530,13800,769,0,1773,1094
2235,0,1,0,1,65,0,711,0,0,6011626,6998356,46.06517122512408,2037,5040,4955,2122,45570,715666,692580,3213,5420,3383,6131,8338,53.225933528685054,9.220820253968727,2207,1,445620,12155,2833,0,1176,465
2236,0,1,0,1,65,0,684,0,0,5792797,6885344,45.70557952810576,1965,4986,4862,2089,44268,715232,672384,3172,5385,3420,6069,8282,52.65928218272634,11.15359010904883,2213,1,426156,18600,2773,0,1207,523
2237,0,1,1,0,61,0,299,0,0,1801500,4636500,38.72983346207417,1100,3101,2701,1500,49932,704748,676929,2691,4591,3491,4292,6192,34.655446902326915,20.211890097700834,1900,1,328500,58000,1201,0,1591,1890
2238,0,1,1,0,59,0,659,0,0,762852,3758688,35.53871128783372,710,2420,1867,1263,43992,559488,696384,2423,4239,3529,3580,5396,24.576411454889016,23.93160196984752,1816,1,295542,40922,604,0,1713,2372
2239,0,1,1,0,54,0,349,0,0,131556,619248,15.0996688705415,36,997,805,228,49250,535052,679000,2524,2944,2908,3293,3713,24.020824298928627,14.204303443252225,420,1,57000,12096,577,0,2488,2139
2240,0,0,1,0,57,1,265,0,0,2990934,5408699,43.2087954009366,1717,3619,3469,1867,50922,712662,599679,2747,4764,3047,4499,6516,40.024992192379,12.263881625621906,2017,0,386469,26550,1602,1,1030,1295
2241,0,0,0,0,52,1,393,1,0,2497444,4683602,42.2965719651132,1665,3309,3185,1789,0,411026,0,2494,4407,2742,4014,5927,37.36308338453881,11.718395466430005,1913,1,0,28644,1396,0,829,1222
2242,0,0,0,0,54,1,68,1,0,2587725,4288725,39.68626966596886,1515,3278,3218,1575,37558,574553,484694,2663,4298,2783,4366,6001,40.53393639902249,7.9730082341141015,1635,1,280350,10200,1643,0,1148,1080
2243,0,0,0,0,54,1,320,1,0,2611776,4018680,38.262252939417984,1397,3315,3248,1464,30429,568215,403515,2678,4209,2812,4529,6060,42.23742416388575,8.187175587434018,1531,1,215208,13065,1784,0,1281,961
2244,0,0,0,0,55,1,370,1,0,2612904,3972710,37.97367509209505,1357,3339,3254,1442,30932,575795,407740,2670,4197,2840,4567,6094,42.567593307585526,9.220820253968727,1527,1,213416,16745,1812,0,1313,943
2245,0,0,0,0,55,1,468,1,0,2618469,3882171,37.429934544425805,1306,3365,3270,1401,34230,581910,451673,2676,4172,2866,4640,6136,43.23193264243457,9.746794344808963,1496,1,228363,17480,1869,0,1370,902
2246,0,0,0,0,55,1,662,1,0,2619543,3688232,36.345563690772494,1171,3454,3304,1321,37524,591904,494184,2642,4113,2942,4775,6246,44.53088815642464,12.25845656828046,1471,1,233817,25950,1983,0,1471,809
2247,1,0,0,0,44,0,192,0,1,23545,187680,9.219544457292887,35,482,362,85,55696,521088,521088,2088,2293,2328,2485,2690,16.64331697709324,10.981735174982626,205,1,20060,15600,277,0,2123,1931
2248,1,0,0,0,43,0,149,0,1,118002,609123,16.64331697709324,217,763,703,277,52118,556347,452994,2139,2476,2259,2625,2962,20.639767440550294,7.864259938752337,337,1,57062,10260,426,0,1922,1773
2249,1,0,0,0,40,0,194,0,0,323520,978720,21.908902300206645,480,1154,1154,480,55902,471009,493438,2039,2519,2039,2713,3193,25.96150997149434,0.0,480,1,116160,0,674,0,1559,1365
2250,1,0,0,0,38,0,312,0,0,36180,175320,9.486832980505138,90,492,492,90,49815,399340,473364,1948,2038,1948,2350,2440,20.049937655763422,0.0,90,1,21870,0,402,0,1858,1546
2251,1,0,0,0,38,0,549,0,0,115182,308448,12.727922061357855,95,940,873,162,38850,333200,422688,1837,2066,1971,2615,2844,26.664583251946766,8.567952416355485,229,1,35964,4824,711,0,1742,1193
2252,1,0,0,0,39,0,531,0,1,136990,374680,13.784048752090222,26,1127,911,190,25840,299744,335240,1756,2162,2188,2693,3099,26.851443164195103,15.765972429182042,406,1,32300,21816,721,0,1782,1251
2253,1,0,0,0,38,0,560,0,0,128625,337225,13.228756555322953,15,1100,910,175,39825,341079,433575,1737,2102,2117,2662,3027,27.110883423451916,14.305113165267556,365,1,39375,13490,735,0,1752,1192
2254,1,0,0,0,37,0,631,0,1,102510,254332,11.575836902790225,41,1074,899,134,38640,349232,398580,1723,2032,2073,2663,2972,27.65863337187866,13.555134321639665,309,1,28140,17325,765,0,1764,1133
2255,0,1,1,0,55,0,105,0,0,168226,1300140,21.587033144922902,171,1122,827,466,54635,622170,683550,2495,3256,3085,3151,3912,19.0,17.32824900086334,761,1,114170,30090,361,0,2324,2429
2256,0,1,1,0,53,0,524,0,0,101100,399300,12.24744871391589,55,919,824,150,46795,508442,652190,2567,2812,2757,3336,3581,25.96150997149434,9.764028217990806,245,1,36750,5985,674,0,2512,1988
2257,0,0,1,0,57,1,314,0,0,3122427,5596038,43.94314508543966,1811,3668,3548,1931,53816,718704,628866,2778,4829,3018,4515,6566,40.2119385257662,10.981735174982626,2051,0,419027,19800,1617,1,967,1281
2258,0,0,1,0,58,1,74,0,0,3907160,5939286,44.87761134463375,1798,4170,3954,2014,48144,695964,601596,2733,4963,3165,4889,7119,44.04543109109048,14.734906844635344,2230,1,410856,36936,1940,0,935,1009
2259,0,0,1,0,55,1,598,0,0,890699,3582131,35.90264614203248,907,2362,1980,1289,32490,528010,475209,2397,4068,3161,3470,5141,26.28687885618983,20.379469228875777,1671,1,220419,57682,691,0,1490,2088
2260,0,0,1,0,55,1,656,0,0,766641,3487143,35.53871128783372,1035,2098,1870,1263,32562,447282,554961,2533,4024,2989,3368,4859,24.63736998950984,16.110184702855936,1491,1,253863,18240,607,0,1498,2154
2261,0,0,1,0,54,1,693,0,0,719910,3410100,35.53871128783372,1221,1875,1833,1263,37758,548100,502200,2658,3963,2742,3270,4575,23.874672772626646,6.503581472166948,1305,1,234918,6384,570,0,1437,2130
2262,0,0,0,0,51,1,427,1,0,2170050,4392862,41.255302689472536,1672,3007,2977,1702,31820,554915,381988,2551,4283,2611,3856,5588,35.70714214271425,5.623413251903491,1732,1,251896,6120,1275,0,879,1306
2263,0,0,0,0,54,1,166,1,0,2565927,4566709,41.0731055558257,1507,3388,3208,1687,33495,549521,446655,2527,4394,2887,4228,6095,39.0,13.555937255793266,1867,1,278355,31500,1521,0,1020,1186
2264,0,0,0,0,55,1,485,1,0,2648864,3907355,37.456641600656084,1318,3376,3291,1403,36890,604345,473450,2700,4188,2870,4673,6161,43.45112196480086,9.219544457292887,1488,1,238510,15725,1888,0,1382,897
2265,0,0,0,0,56,1,816,1,0,2659297,3565673,35.679125549822544,1045,3590,3362,1273,42845,585409,574205,2573,4074,3029,4890,6391,45.70557952810576,15.101483965871344,1501,1,260965,31464,2089,0,1528,712
2266,1,0,0,0,41,0,494,1,0,96600,311700,12.24744871391589,55,889,794,150,22655,409366,238970,1983,2228,2173,2722,2967,25.37715508089904,10.94569230433746,245,1,17250,20235,644,0,1928,1434
2267,1,0,0,0,42,0,321,1,0,157852,565212,16.3707055437449,40,1085,857,268,28314,417582,301587,1881,2377,2337,2698,3194,24.269322199023193,15.830327909517015,496,1,38324,43092,589,0,1841,1520
2268,1,0,0,0,42,0,138,1,0,247243,928785,20.808652046684813,51,1386,1004,433,31030,459030,311025,1763,2578,2527,2716,3531,23.895606290697042,20.111962565091382,815,1,62785,78692,571,0,1712,1574
2269,1,0,0,0,40,0,175,0,0,349350,1040910,22.58317958127243,480,1225,1195,510,51359,414323,516373,2011,2551,2071,2726,3266,26.1725046566048,5.483301264452448,540,1,129030,1860,685,0,1531,1356
2270,1,0,0,0,37,0,557,0,1,128100,331800,13.228756555322953,145,937,907,175,43680,424704,369720,1866,2071,1926,2628,2833,27.055498516937366,5.531194905403055,205,1,34125,5040,732,0,1721,1164
2271,1,0,0,0,39,0,757,0,1,136050,292650,12.24744871391589,0,1207,1057,150,25756,267287,366788,1801,2101,2101,2858,3158,30.116440692751194,13.345031470771058,300,1,28200,9000,907,0,1801,1044
2272,1,0,0,0,38,0,670,0,1,134784,310392,12.727922061357855,28,1184,994,162,31710,402360,289316,1726,2078,2106,2748,3100,28.844410203711913,14.115544213798941,352,1,24462,37050,832,0,1754,1084
2273,1,0,0,0,39,0,599,0,1,140220,356940,13.416407864998739,30,1169,959,180,22656,350991,253824,1773,2163,2193,2762,3152,27.910571473905726,15.783232155841432,390,1,23040,37170,779,0,1803,1204
2274,1,0,0,0,39,0,538,0,1,159000,422304,14.560219778561036,16,1190,962,212,24160,318720,300792,1764,2204,2220,2742,3182,27.386127875258307,16.4052977943864,440,1,32012,30096,750,0,1780,1242
2275,1,0,0,0,39,0,524,0,1,171456,450756,15.0996688705415,28,1236,980,228,30545,294573,405285,1721,2205,2233,2729,3213,27.422618401604176,16.917940215049025,484,1,46740,14080,752,0,1749,1225
2276,1,0,0,0,38,0,614,0,1,138075,335300,13.228756555322953,37,1176,964,175,34869,339132,377452,1704,2091,2128,2705,3092,28.089143810376278,14.984791701209256,387,1,34475,22260,789,0,1741,1127
2277,0,1,1,0,55,0,27,0,0,162630,1077960,19.748417658131498,162,1035,807,390,53436,605316,674416,2536,3154,2992,3181,3799,20.42057785666214,15.354562593986909,618,1,95160,22800,417,0,2374,2347
2278,0,1,1,0,54,0,188,0,0,153573,846351,17.578395831246947,134,981,806,309,52117,577929,676533,2564,3048,2914,3236,3720,22.293496809607955,13.359104871799886,484,1,76323,15050,497,0,2430,2242
2279,0,1,1,0,53,0,444,0,0,122112,513984,13.856406460551018,107,913,828,192,47580,522015,653188,2592,2869,2762,3313,3590,25.219040425836983,9.383858473517451,277,1,46848,5950,636,0,2485,2041
2280,0,1,1,0,53,0,494,0,0,112880,453050,13.038404810405298,103,901,834,170,46656,511680,647595,2598,2835,2732,3329,3566,25.768197453450252,8.239962426314323,237,1,41310,4489,664,0,2495,2001
2281,0,0,1,0,57,1,344,0,0,2706132,5249750,42.731721238442994,1676,3458,3308,1826,53424,724500,609500,2725,4701,3025,4357,6333,38.49675310984031,12.261034368426225,1976,1,387112,25800,1482,0,1049,1393
2282,0,0,1,0,57,1,351,0,0,2901856,5452544,43.45112196480086,1793,3520,3425,1888,49698,724888,571824,2793,4776,2983,4425,6408,39.20459156782532,9.747874142570481,1983,0,373824,17955,1537,1,1000,1351
2283,0,0,1,0,58,1,361,0,0,3263460,5792392,44.67661580737735,1901,3726,3631,1996,49000,725500,568792,2807,4898,2997,4537,6628,40.43513323831146,9.842833472037558,2091,0,391216,18145,1635,1,906,1267
2284,0,0,1,0,58,1,1164,0,0,2269501,3025657,32.14031735997639,843,3420,3230,1033,51700,644380,688315,2739,3962,3119,5126,6349,46.87216658103186,13.808421129276201,1223,1,242755,21850,2197,0,1896,732
2285,0,0,1,0,55,1,635,0,0,748356,3460527,35.199431813596085,944,2138,1843,1239,34176,497154,536256,2498,4032,3088,3397,4931,24.576411454889016,18.358569931971438,1534,1,237888,33335,604,0,1554,2189
2286,0,0,1,0,54,1,683,0,0,672810,3365280,35.07135583350036,1096,1911,1777,1230,39150,476064,615600,2602,3966,2870,3283,4647,23.388031127053,12.168439873279091,1364,1,276750,8844,547,0,1506,2189
2287,0,0,1,0,54,1,687,0,0,667890,3350520,35.07135583350036,1122,1881,1773,1230,40860,490320,618348,2616,3954,2832,3267,4605,23.302360395462088,10.781717396486519,1338,1,279210,7776,543,0,1494,2181
2288,0,0,0,0,55,1,259,1,0,2658090,4158066,38.80721582386451,1476,3301,3271,1506,35860,607420,450043,2731,4267,2791,4526,6062,42.01190307520001,5.572104574801163,1536,1,245478,5850,1765,0,1255,996
2289,1,0,0,0,40,0,160,0,0,342881,1041929,22.60530911091463,481,1212,1182,511,46872,385371,505672,2009,2550,2069,2710,3251,25.903667693977237,5.531194905403055,541,1,126728,0,671,0,1528,1368
2290,1,0,0,0,40,0,163,0,0,309764,976430,21.93171219946131,481,1125,1125,481,53572,479080,460810,2030,2511,2030,2674,3155,25.37715508089904,0.0,481,0,109187,0,644,0,1549,1386
2291,1,0,0,0,41,0,175,1,0,221306,811716,19.77371993328519,301,1047,957,391,23940,435960,236664,1986,2467,2166,2642,3123,23.790754506740637,9.903872795307445,481,1,44574,20430,566,0,1685,1510
2292,1,0,0,0,39,0,231,0,0,58752,305847,12.36931687685298,86,604,537,153,27540,269865,407796,1932,2152,2066,2383,2603,19.595917942265423,9.176172281517143,220,1,31212,2412,384,0,1846,1615
2293,1,0,0,0,38,0,454,0,0,122360,367840,13.784048752090222,63,961,834,190,36456,325248,420112,1809,2126,2063,2580,2897,25.37715508089904,11.798511981252409,317,1,41230,8636,644,0,1746,1292
2294,1,0,0,0,38,0,507,0,0,142308,382503,14.177446878757825,159,951,909,201,43442,407242,386309,1861,2104,1945,2611,2854,26.60826939130014,6.495386533491135,243,1,40803,6216,708,0,1702,1195
2295,1,0,0,0,38,0,536,0,0,137940,361190,13.784048752090222,160,946,916,190,45630,444834,370695,1871,2091,1931,2627,2847,26.94438717061496,5.483301264452448,220,1,37050,5370,726,0,1711,1175
2296,1,0,0,0,38,0,585,0,0,137700,347040,13.416407864998739,150,975,945,180,33534,468504,266064,1898,2108,1958,2693,2903,27.65863337187866,5.753771868478424,210,1,24840,6990,765,0,1748,1163
2297,1,0,0,0,39,0,738,0,1,165240,354060,13.416407864998739,0,1278,1098,180,28457,281281,391433,1787,2147,2147,2885,3245,30.298514815086232,14.560219778561036,360,1,35820,9720,918,0,1787,1049
2298,1,0,0,0,38,0,669,0,1,163210,366130,13.784048752090222,28,1267,1049,190,29055,375765,287123,1709,2117,2145,2786,3194,29.30870177950569,15.151971135051772,408,1,28310,39240,859,0,1737,1068
2299,1,0,0,0,38,0,605,0,1,171150,408240,14.491376746189438,30,1265,1025,210,25702,351864,276048,1704,2154,2184,2759,3209,28.548204847240395,16.043341638998395,450,1,29820,40560,815,0,1734,1129
2300,0,1,1,0,58,0,697,0,0,527378,3382374,33.97057550292606,750,2015,1611,1154,46222,559821,709302,2527,4085,3335,3388,4946,21.37755832643195,20.42477484803742,1558,1,279268,26664,457,0,1777,2474
2301,0,1,1,0,57,0,682,0,0,325944,2896274,31.71750305430741,697,1639,1330,1006,47142,558526,699597,2570,3885,3188,3203,4518,18.0,17.70154959160601,1315,1,244458,21321,324,0,1873,2555
2302,0,1,1,0,56,0,410,0,0,135216,1762816,25.019992006393608,384,1084,842,626,53820,647680,658944,2574,3442,3058,3032,3900,14.696938456699069,15.611899613675368,868,1,146484,30976,216,0,2190,2600
2303,0,1,1,0,56,0,264,0,0,149857,1514800,23.259406699226016,301,1058,818,541,54656,627200,683200,2560,3341,3040,3077,3858,16.64331697709324,15.503284344161868,781,1,132004,25440,277,0,2259,2523
2304,0,1,1,0,55,0,213,0,0,153900,1432296,22.64950330581225,273,1053,813,513,53900,614240,684040,2552,3305,3032,3092,3845,17.320508075688775,15.493614093656653,753,1,125685,23760,300,0,2279,2492
2305,0,1,1,0,55,0,107,0,0,159950,1268632,21.37755832643195,229,1035,807,457,53040,613496,666240,2548,3233,3004,3126,3811,18.708286933869708,15.22616659032535,685,1,109680,25080,350,0,2319,2426
2306,0,0,1,0,53,1,106,0,0,1492920,3396712,35.7211421989835,1096,2626,2446,1276,42408,660176,455202,2482,3938,2842,3832,5288,34.20526275297414,13.424785270182428,1456,1,218196,38340,1170,0,1386,1492
2307,0,0,1,0,53,1,126,0,0,1521256,3469554,36.02776706930364,1118,2650,2470,1298,43400,662904,467775,2493,3971,2853,3845,5323,34.23448553724738,13.45762619345434,1478,1,227150,37620,1172,0,1375,1501
2308,0,0,1,0,55,1,346,0,0,2006400,4438400,40.0,1447,3007,2854,1600,43848,699048,482676,2621,4374,2927,4028,5781,35.41186241925155,12.407318298018154,1753,1,278400,32130,1254,0,1174,1520
2309,0,0,1,0,57,1,393,0,0,2758644,5367768,43.23193264243457,1761,3453,3345,1869,48576,726616,551424,2764,4741,2980,4348,6325,38.41874542459709,10.429745618880121,1977,0,358848,21060,1476,1,1003,1396
2310,0,0,1,0,59,1,68,0,0,3762444,5636042,43.657759905886145,1629,4157,3880,1906,48616,697852,609142,2680,4863,3234,4931,7114,44.429719783046124,16.691908598119873,2183,1,392636,46813,1974,0,1051,983
2311,0,0,1,0,56,1,528,0,0,944353,3594388,35.651086939951774,737,2548,2014,1271,29488,429856,548632,2294,4099,3362,3571,5376,27.258026340878022,24.187691968360163,1805,1,246574,40050,743,0,1557,2085
2312,0,0,1,0,56,1,632,0,0,697593,3391245,34.77067730142742,900,2095,1786,1209,36764,510510,566610,2496,4014,3114,3382,4900,24.020824298928627,18.754125305015645,1518,1,244218,33063,577,0,1596,2228
2313,0,0,1,0,55,1,642,0,0,680184,3371976,34.72751070837067,923,2053,1770,1206,37450,489300,598344,2513,4002,3079,3360,4849,23.748684174075834,17.85780609790561,1489,1,258084,23206,564,0,1590,2232
2314,0,0,0,0,51,1,415,1,0,2000414,4241467,40.45985664828782,1607,2889,2859,1637,30672,551883,373104,2561,4228,2621,3813,5480,34.95711658589707,5.7180036243905645,1667,1,235728,6150,1222,0,954,1369
2315,0,0,0,0,54,1,277,1,0,2571308,4745820,41.80908992073375,1530,3437,3219,1748,43659,627165,513135,2497,4463,2933,4186,6152,38.353617821530214,14.848688813420488,1966,1,330372,39676,1471,0,967,1244
2316,0,0,0,0,55,1,326,1,0,2695931,4142782,38.561638969317684,1487,3300,3300,1487,35098,607348,448546,2786,4273,2786,4599,6086,42.579337712087536,0.0,1487,1,239407,0,1813,0,1299,973
2317,1,0,0,0,42,0,365,1,0,122324,448592,14.560219778561036,62,939,789,212,28826,429548,300472,1966,2328,2266,2693,3055,24.020824298928627,13.616943205730175,362,1,30104,29400,577,0,1904,1539
2318,1,0,0,0,42,0,330,1,0,131976,496548,15.297058540778355,59,973,798,234,32670,420156,350130,1947,2356,2297,2686,3095,23.748684174075834,14.508925086820515,409,1,38610,29400,564,0,1888,1558
2319,1,0,0,0,43,0,29,1,0,249290,1055360,22.02271554554524,61,1423,999,485,30315,467840,306816,1752,2661,2600,2690,3599,22.67156809750927,21.330110773486886,909,1,68385,89040,514,0,1691,1662
2320,1,0,0,0,40,0,144,0,0,338212,1049588,22.67156809750927,484,1202,1172,514,42768,359392,496206,2012,2556,2072,2700,3244,25.65151067676132,5.684275577662207,544,1,124902,0,658,0,1528,1384
2321,1,0,0,0,39,0,216,0,0,34992,214056,10.392304845413264,66,474,432,108,26130,257660,398382,1940,2090,2024,2306,2456,18.0,7.144172493767167,150,1,21708,1344,324,0,1874,1658
2322,0,1,1,0,62,0,256,0,0,1541120,4280736,37.094473981982816,926,2946,2496,1376,44928,647088,671976,2661,4487,3561,4231,6057,33.46640106136302,21.316392757901514,1826,1,297216,56250,1120,0,1735,1991
2323,0,1,1,0,56,0,626,0,0,119187,2210802,27.910571473905726,523,1188,932,779,54707,683958,644226,2582,3617,3094,2991,4026,12.36931687685298,16.007380146096207,1035,1,176833,37888,153,0,2059,2685
2324,0,1,1,0,54,0,202,0,0,151403,819623,17.349351572897472,193,912,804,301,51414,569107,669858,2615,3024,2831,3226,3635,22.427661492005804,10.471798365004291,409,1,74046,9072,503,0,2422,2220
2325,0,1,1,0,53,0,377,0,0,124868,570280,14.560219778561036,145,868,801,212,49446,540690,661740,2623,2902,2757,3279,3558,24.269322199023193,8.416522024785497,279,1,52152,4958,589,0,2478,2101
2326,0,0,1,0,53,1,218,0,0,1563144,3663704,36.932370625238775,1230,2644,2510,1364,46128,666128,499596,2552,4050,2820,3832,5330,33.85262175962151,11.586137991427458,1498,0,253704,26800,1146,1,1322,1540
2327,0,0,1,0,53,1,237,0,0,1595050,3736578,37.242448899072144,1263,2661,2537,1387,47559,670806,514554,2570,4081,2818,3844,5355,33.91164991562634,11.135528725660043,1511,1,264917,24180,1150,0,1307,1544
2328,0,0,1,0,54,1,275,0,0,1662006,3878970,37.86819245752297,1314,2713,2593,1434,49000,676250,530180,2585,4139,2825,3864,5418,34.044089061098404,10.973419967718494,1554,1,281064,22920,1159,0,1271,1546
2329,0,0,1,0,57,1,440,0,0,2811081,5499858,43.71498598878879,1844,3449,3382,1911,42558,707988,497894,2811,4789,2945,4349,6327,38.353617821530214,8.20759886765899,1978,0,330603,14070,1471,1,967,1407
2330,0,0,1,0,57,1,444,0,0,3090700,5766648,44.654227123532216,1964,3574,3544,1994,51204,725892,589968,2862,4886,2922,4442,6466,39.370039370059054,5.5965095842615735,2024,0,406776,5490,1550,1,898,1342
2331,0,0,1,0,54,1,691,0,0,563732,3198388,34.23448553724738,1038,1787,1653,1172,39123,564903,515781,2595,3901,2863,3210,4516,21.93171219946131,11.757812605679836,1306,1,221508,20636,481,0,1557,2248
2332,0,0,0,0,55,1,197,1,0,2707850,4312100,39.370039370059054,1520,3327,3297,1550,34485,581438,459030,2752,4332,2812,4529,6109,41.79712908801273,5.830951894845301,1580,1,255750,5430,1747,0,1232,1035
2333,0,0,0,0,55,1,246,1,0,2717280,4265640,39.11521443121589,1500,3336,3306,1530,34768,591056,457232,2758,4318,2818,4564,6124,42.14261501141095,5.830951894845301,1560,1,250920,5580,1776,0,1258,1012
2334,0,0,0,0,56,1,344,1,0,2732660,4174980,38.600518131237564,1490,3324,3324,1490,36842,610836,473538,2802,4292,2802,4636,6126,42.82522621072771,0.0,1490,1,251810,0,1834,0,1312,968
2335,1,0,0,0,44,0,245,0,1,28050,189295,9.219544457292887,173,673,415,85,56105,545615,509983,1969,2312,2485,2557,2900,18.16590212458495,16.540197773961598,343,1,19465,37668,330,0,2142,1897
2336,1,0,0,0,40,0,128,0,0,334628,1059828,22.759613353482084,488,1194,1164,518,43542,362142,503316,2016,2564,2076,2692,3240,25.41653005427767,5.830951894845301,548,1,127428,1170,646,0,1528,1400
2337,1,0,0,0,40,0,130,0,0,301584,991616,22.090722034374522,488,1106,1106,488,51948,451104,475488,2032,2520,2032,2650,3138,24.859605789312106,0.0,488,0,114192,0,618,0,1544,1414
2338,1,0,0,0,42,0,139,1,0,189210,780955,19.261360284258224,251,1001,881,371,35574,509410,309435,1985,2476,2225,2615,3106,22.58317958127243,11.702672623215602,491,1,54537,27360,510,0,1734,1595
2339,1,0,0,0,41,0,156,1,0,87552,470364,15.0996688705415,78,762,612,228,23408,274379,363088,1913,2291,2213,2447,2825,19.595917942265423,13.74811193271127,378,1,40128,9900,384,0,1835,1679
2340,1,0,0,0,38,0,405,0,0,169216,491264,16.0,189,984,917,256,39104,360772,399152,1852,2175,1986,2580,2903,25.709920264364882,8.222029866439447,323,1,53248,7169,661,0,1663,1258
2341,1,0,0,0,39,0,547,0,0,188880,471360,15.491933384829668,150,1117,1027,240,38097,489036,300492,1874,2204,2054,2751,3081,28.053520278211074,9.965825211365143,330,1,36720,19620,787,0,1724,1177
2342,1,0,0,0,40,0,596,0,1,233820,542700,16.431676725154983,30,1436,1136,270,26250,422100,251250,1710,2280,2310,2876,3446,29.427877939124322,18.45187609899152,570,1,33750,65400,866,0,1740,1144
2343,1,0,0,0,41,0,573,0,1,229840,560864,16.492422502470642,28,1417,1117,272,27702,352602,334044,1762,2334,2362,2907,3479,29.068883707497267,19.18137805659978,572,1,44064,40500,845,0,1790,1217
2344,1,0,0,0,39,0,601,0,1,235170,535410,16.431676725154983,30,1441,1141,270,23976,293484,321246,1683,2253,2283,2854,3424,29.512709126747414,18.104032888004372,570,1,43740,30900,871,0,1713,1112
2345,0,1,1,0,56,0,476,0,0,109820,1815906,25.41653005427767,464,998,816,646,54264,640908,669018,2629,3457,2993,2981,3809,13.038404810405298,13.54900725170882,828,1,153748,21840,170,0,2165,2641
2346,0,1,1,0,55,0,322,0,0,136488,1576380,23.748684174075834,384,986,806,564,53325,628875,662415,2615,3359,2975,3037,3781,15.556349186104045,13.423028349552247,744,1,133668,21420,242,0,2231,2553
2347,0,1,1,0,55,0,215,0,0,150450,1419840,22.58317958127243,330,985,805,510,52360,612480,662592,2604,3294,2964,3079,3769,17.175564037317667,13.41682193249194,690,1,121380,20160,295,0,2274,2489
2348,0,1,1,0,54,0,77,0,0,157320,987480,18.973665961010276,236,921,797,360,50301,567801,666549,2619,3103,2867,3180,3664,20.904544960366874,11.284767849177381,484,1,87480,10788,437,0,2383,2306
2349,0,1,1,0,54,0,254,0,0,141480,732510,16.431676725154983,203,861,794,270,49776,553452,661972,2646,2983,2780,3237,3574,22.891046284519195,8.222029866439447,337,1,65880,5360,524,0,2443,2189
2350,0,0,1,0,52,1,184,0,0,1436340,3425218,35.9722114972099,1170,2528,2404,1294,38955,648515,420873,2523,3941,2771,3757,5175,33.31666249791537,11.140052311785754,1418,1,205746,27404,1110,0,1353,1537
2351,0,0,1,0,53,1,226,0,0,1487856,3569784,36.578682316343766,1218,2570,2450,1338,42731,658996,461564,2548,4006,2788,3780,5238,33.34666400106613,10.996993508431213,1458,0,231474,25200,1112,1,1330,1556
2352,0,0,1,0,54,1,322,0,0,1640760,3924756,38.1051177665153,1362,2672,2582,1452,49104,670344,535194,2613,4155,2793,3833,5375,33.61547262794322,9.505517133991825,1542,0,287496,16920,1130,1,1251,1573
2353,0,0,1,0,54,1,358,0,0,1713000,4069500,38.72983346207417,1410,2732,2642,1500,49196,680963,531748,2623,4213,2803,3855,5445,33.793490497431605,9.580310602724222,1590,0,294000,17190,1142,1,1213,1571
2354,0,0,1,0,56,1,481,0,0,2548770,5264490,43.069710934716056,1765,3319,3229,1855,50200,712338,567600,2748,4693,2928,4212,6157,37.067505985701274,9.65116822864259,1945,0,371000,16830,1374,1,983,1464
2355,0,0,1,0,54,1,686,0,0,517560,3122460,33.76388603226827,965,1769,1594,1140,43860,558756,588885,2564,3879,2914,3193,4508,21.307275752662516,13.43304388518588,1315,1,245100,21350,454,0,1599,2285
2356,0,0,1,0,56,1,629,0,0,728280,3438216,34.9857113690718,889,2154,1819,1224,53808,662924,640452,2474,4033,3144,3404,4963,24.392621835300936,18.597383942831776,1559,1,279072,47570,595,0,1585,2214
2357,1,0,0,0,44,0,215,0,1,54750,333000,12.24744871391589,51,716,515,150,55350,546120,499500,2019,2370,2421,2585,2936,19.1049731745428,14.759616393239527,351,1,33750,30753,365,0,2070,1855
2358,1,0,0,0,44,0,187,0,1,72768,425664,13.856406460551018,10,753,571,192,53820,518778,509910,2035,2409,2399,2596,2970,19.467922333931785,14.114210692578558,374,1,44160,24934,379,0,2025,1838
2359,1,0,0,0,43,0,78,1,0,246483,1180863,23.173260452512935,161,1372,996,537,43357,499173,420009,1823,2736,2575,2658,3571,21.42428528562855,20.065675792984692,913,1,102567,66176,459,0,1662,1740
2360,1,0,0,0,39,0,128,1,0,19620,178200,9.486832980505138,60,338,308,90,21714,279180,304920,1950,2070,2010,2198,2318,14.7648230602334,5.791460926441345,120,1,13860,3090,218,0,1890,1762
2361,1,0,0,0,39,0,672,0,0,254340,531900,16.431676725154983,15,1497,1212,270,34040,362480,364450,1685,2240,2255,2912,3467,30.692018506445613,17.530749761849496,555,1,49950,36480,942,0,1700,1028
2362,1,0,0,0,39,0,646,0,1,249696,535296,16.492422502470642,5,1467,1190,272,29252,279456,405408,1691,2240,2245,2886,3435,30.298514815086232,17.351840431116628,549,1,56032,12188,918,0,1696,1050
2363,1,0,0,0,38,0,849,0,1,116280,228360,10.954451150103322,12,1197,1089,120,48438,393921,445302,1795,2023,2011,2872,3100,31.12876483254676,10.669676460233537,228,1,28080,10800,969,0,1783,934
2364,0,1,1,0,59,0,695,0,0,628334,3615953,34.828149534535996,783,2161,1731,1213,50750,605143,745250,2551,4194,3411,3499,5142,22.759613353482084,21.371593423190188,1643,1,303250,30100,518,0,1768,2463
2365,0,1,1,0,58,0,742,0,0,503960,3446852,34.23448553724738,822,1952,1602,1172,47970,573495,723486,2591,4113,3291,3371,4893,20.73644135332772,19.185875353701523,1522,1,288312,22750,430,0,1769,2511
2366,0,1,1,0,56,0,508,0,0,98700,1848980,25.65151067676132,505,961,808,658,52628,626630,663160,2657,3468,2963,2960,3771,12.24744871391589,12.438613279124889,811,1,155288,17901,150,0,2152,2660
2367,0,1,1,0,55,0,108,0,0,153900,1246500,21.213203435596427,316,926,792,450,53680,609400,675880,2636,3220,2904,3112,3696,18.49324200890693,11.727705886231366,584,1,109800,13534,342,0,2320,2428
2368,0,1,1,0,55,0,49,0,0,155820,1159620,20.493901531919196,296,915,791,420,53165,599137,676445,2637,3181,2885,3132,3676,19.261360284258224,11.265233092802442,544,1,102900,12028,371,0,2341,2390
2369,0,1,1,0,53,0,367,0,0,121170,565110,14.491376746189438,180,817,787,210,49200,538200,661986,2661,2901,2721,3268,3508,24.020824298928627,5.684275577662207,240,1,51660,2160,577,0,2481,2114
2370,0,0,1,0,53,1,335,0,0,1553250,3833250,37.749172176353746,1358,2582,2515,1425,46986,661740,513790,2623,4115,2757,3780,5272,33.015148038438355,8.19263674150144,1492,0,272175,12998,1090,1,1265,1600
2371,0,0,1,0,56,1,527,0,0,2422230,5201808,42.91852746774987,1782,3217,3157,1842,47188,708824,530912,2764,4666,2884,4139,6041,36.26292872893749,7.896951773353783,1902,0,346296,11940,1315,1,982,1509
2372,0,0,1,0,56,1,529,0,0,2536650,5332602,43.347433603386484,1819,3289,3229,1879,46494,698148,536382,2778,4717,2898,4188,6127,36.742346141747674,7.864259938752337,1939,0,355131,11760,1350,1,959,1488
2373,0,0,1,0,56,1,530,0,0,2596464,5401708,43.56604182158393,1831,3333,3266,1898,43432,694424,506588,2779,4744,2913,4214,6179,36.98648401781386,8.286047041568583,1965,0,337844,13668,1368,1,948,1478
2374,0,0,1,0,57,1,531,0,0,2924140,5752472,44.67661580737735,1996,3461,3461,1996,52974,700326,628276,2882,4878,2882,4347,6343,38.27531841800928,0.0,1996,0,435128,0,1465,1,886,1417
2375,0,0,1,0,55,1,673,0,0,485070,3065820,33.31666249791537,876,1781,1547,1110,46295,544114,649070,2528,3872,2996,3199,4543,20.904544960366874,15.601376800644807,1344,1,260850,19890,437,0,1652,2325
2376,0,0,0,0,55,1,110,1,0,2693139,4712569,41.19465984809196,1547,3434,3284,1697,32913,574839,441543,2627,4474,2927,4364,6211,39.83716857408418,12.35277120656332,1847,1,269823,27600,1587,0,1080,1190
2377,0,0,0,0,56,1,282,1,0,2795803,4332803,39.20459156782532,1477,3416,3356,1537,37022,603266,487687,2759,4356,2879,4638,6235,42.649736224272246,8.038779614196052,1597,1,265901,10740,1819,0,1282,1000
2378,1,0,0,0,42,0,241,1,0,128742,545928,16.06237840420901,66,949,757,258,36844,516304,319516,1924,2374,2308,2615,3065,22.338307903688676,14.744899158146904,450,1,38958,43392,499,0,1858,1617
2379,1,0,0,0,39,0,627,0,0,278100,594000,17.320508075688775,0,1527,1227,300,35705,382140,366300,1680,2280,2280,2907,3507,30.44667469527666,18.027756377319946,600,1,55500,42000,927,0,1680,1053
2380,1,0,0,0,41,0,588,0,1,302940,678150,18.16590212458495,30,1608,1248,330,18576,353460,221940,1695,2385,2415,2973,3663,30.298514815086232,20.365957543159126,690,1,35640,68040,918,0,1725,1137
2381,1,0,0,0,41,0,567,0,1,302170,701490,18.303005217723125,26,1598,1237,335,34532,372732,406236,1733,2429,2455,2996,3692,30.033314835362415,20.88747478870912,696,1,64990,39710,902,0,1759,1192
2382,1,0,0,0,40,0,538,0,0,325800,741376,19.026297590440446,17,1641,1262,362,35639,321536,464896,1669,2410,2427,2948,3689,30.0,20.689798250511352,741,1,82174,14402,900,0,1686,1148
2383,1,0,0,0,40,0,593,0,1,305844,666303,18.193405398660254,29,1615,1255,331,20412,326106,253638,1653,2344,2373,2937,3628,30.397368307141328,19.868840418864497,691,1,41706,57600,924,0,1682,1089
2384,1,0,0,0,40,0,600,0,1,306900,668910,18.16590212458495,30,1620,1260,330,19182,279726,281753,1667,2357,2387,2957,3647,30.495901363953813,20.017975750904043,690,1,45870,41040,930,0,1697,1097
2385,0,1,1,0,56,0,720,0,0,46800,2208180,27.92848008753788,588,1032,840,780,52200,656792,636975,2639,3611,3023,2891,3863,7.745966692414834,13.857909732226029,972,1,175500,27264,60,0,2051,2771
2386,0,1,1,0,56,0,683,0,0,50250,2121000,27.386127875258307,580,987,817,750,52440,644784,650440,2658,3578,2998,2895,3815,8.18535277187245,13.224002439779724,920,1,172500,22100,67,0,2078,2761
2387,0,1,1,0,55,0,352,0,0,124260,1591440,23.874672772626646,450,908,788,570,55189,639368,672872,2672,3362,2912,3010,3700,14.7648230602334,10.95920259392275,690,1,137370,14040,218,0,2222,2574
2388,0,1,1,0,55,0,293,0,0,133380,1504440,23.2379000772445,420,907,787,540,55189,637994,671426,2666,3326,2906,3033,3693,15.716233645501712,10.954451150103322,660,1,130140,13800,247,0,2246,2539
2389,0,1,1,0,53,0,483,0,0,94950,399750,12.24744871391589,120,813,783,150,45880,493025,660920,2635,2815,2695,3298,3478,25.15949125081825,5.7180036243905645,180,1,37200,1440,633,0,2515,2032
2390,0,0,1,0,52,1,266,0,0,1381800,3461080,36.27671429443411,1231,2451,2366,1316,38151,639090,412910,2545,3946,2715,3680,5081,32.4037034920393,9.412769291411893,1401,0,206612,18785,1050,1,1314,1580
2391,0,0,1,0,52,1,287,0,0,1403850,3533691,36.565010597564445,1270,2454,2387,1337,38552,644892,417594,2576,3980,2710,3693,5097,32.4037034920393,8.222029866439447,1404,0,211246,14807,1050,1,1306,1593
2392,0,0,1,0,53,1,308,0,0,1425900,3605490,36.851051545376556,1298,2468,2408,1358,39772,647820,432765,2595,4013,2715,3705,5123,32.4037034920393,7.748117453886108,1418,0,221354,13080,1050,1,1297,1605
2393,0,0,1,0,53,1,403,0,0,1563420,3956260,38.31448812133603,1438,2563,2533,1468,47336,657580,522830,2665,4163,2725,3760,5258,32.63433774416144,5.477225575051661,1498,0,284792,5670,1065,1,1227,1630
2394,0,0,1,0,54,1,436,0,0,1629501,4092665,38.897300677553446,1483,2620,2590,1513,47871,657315,532885,2675,4218,2735,3782,5325,32.817678162843876,5.490867587491313,1543,0,298061,5550,1077,1,1192,1628
2395,0,0,1,0,54,1,498,0,0,1784880,4386624,40.099875311526844,1578,2748,2718,1608,46189,673816,510136,2698,4336,2758,3838,5476,33.31666249791537,5.5503012171862105,1638,0,300696,5970,1110,1,1120,1618
2396,0,0,1,0,55,1,539,0,0,1919702,4624431,41.0,1639,2865,2823,1681,45933,690501,503433,2709,4432,2793,3893,5616,33.793490497431605,6.503581472166948,1723,0,307623,8568,1142,1,1070,1609
2397,0,0,1,0,56,1,576,0,0,2464272,5333604,43.40506882842141,1854,3222,3192,1884,44652,690764,518073,2801,4715,2861,4139,6053,36.16628264005025,5.572104574801163,1914,0,344772,5970,1308,1,947,1523
2398,0,0,1,0,57,1,574,0,0,2983632,5885744,45.14421336118285,2008,3532,3502,2038,45901,672904,568936,2858,4926,2918,4352,6420,38.262252939417984,5.531194905403055,2068,0,401486,5250,1464,1,850,1424
2399,0,0,1,0,55,1,685,0,0,426600,2978640,32.863353450309965,852,1703,1475,1080,37515,565390,504714,2530,3838,2986,3153,4461,19.87460691435179,15.379982602521288,1308,1,197640,36024,395,0,1678,2363
2400,0,0,0,0,56,1,108,1,0,2789325,4547004,40.2119385257662,1509,3450,3342,1617,35190,582084,478040,2704,4429,2920,4537,6262,41.53311931459037,10.45608800483739,1725,1,274890,18792,1725,0,1195,1087
2401,0,0,0,0,56,1,252,1,0,2826720,4411680,39.496835316262995,1470,3462,3372,1560,37100,599536,494900,2738,4388,2918,4640,6290,42.567593307585526,9.79077483409882,1650,1,273000,15750,1812,0,1268,1016
2402,1,0,0,0,41,0,492,1,0,96300,312450,12.24744871391589,90,852,792,150,20651,402019,222881,2023,2233,2143,2725,2935,25.337718918639855,9.211558703193814,210,1,16050,12900,642,0,1933,1441
2403,1,0,0,0,40,0,77,0,0,334338,1106345,23.259406699226016,511,1189,1159,541,51912,421270,515340,2015,2586,2075,2663,3234,24.859605789312106,5.623413251903491,571,1,136332,2040,618,0,1504,1427
2404,1,0,0,0,38,0,378,0,0,233640,643170,18.16590212458495,270,1098,1038,330,34427,387851,337177,1889,2279,2009,2657,3047,26.60826939130014,8.137062211202972,390,1,57090,9660,708,0,1619,1241
2405,1,0,0,0,39,0,556,0,0,292380,659670,18.16590212458495,60,1486,1216,330,44091,413793,425787,1729,2329,2269,2885,3485,29.765752132274432,16.756044470937617,600,1,70290,34290,886,0,1669,1113
2406,1,0,0,0,42,0,567,0,1,340180,768325,19.1049731745428,4,1658,1297,365,36490,374690,431525,1744,2470,2466,3037,3763,30.528675044947494,19.060975706681074,726,1,74825,35017,932,0,1740,1173
2407,1,0,0,0,40,0,532,0,0,372800,816800,20.0,29,1703,1332,400,31724,314468,420652,1671,2442,2413,2974,3745,30.528675044947494,19.276770069688435,771,1,82400,23002,932,0,1642,1110
2408,0,1,1,0,58,0,770,0,0,364431,3199506,33.18132004607411,859,1674,1432,1101,53072,621884,720688,2664,4007,3148,3237,4580,18.193405398660254,15.95519545368323,1343,1,273048,21054,331,0,1805,2575
2409,0,1,1,0,57,0,771,0,0,322672,3104512,32.7414110874898,856,1589,1373,1072,51957,599472,726896,2680,3968,3112,3197,4485,17.349351572897472,15.058325596438765,1288,1,269072,15552,301,0,1824,2595
2410,0,1,1,0,56,0,536,0,0,81840,1853940,25.69046515733026,565,879,784,660,55388,637643,685396,2714,3469,2904,2933,3688,11.135528725660043,9.874922862703322,755,1,161040,10355,124,0,2149,2685
2411,0,1,1,0,55,0,298,0,0,130680,1502820,23.2379000772445,450,872,782,540,55189,637307,670703,2693,3323,2873,3025,3655,15.556349186104045,9.489467114586667,630,1,130140,10440,242,0,2243,2541
2412,0,1,1,0,52,0,541,0,0,79320,317880,10.954451150103322,53,848,781,120,47500,503310,662250,2582,2769,2716,3310,3497,25.709920264364882,8.544404542961196,187,1,30000,3417,661,0,2529,1988
2413,0,0,1,0,53,1,451,0,0,1540532,4007465,38.561638969317684,1487,2523,2523,1487,46222,652190,514745,2695,4182,2695,3731,5218,32.18695387886216,0.0,1487,0,284017,0,1036,1,1208,1659
2414,0,0,1,0,54,1,469,0,0,1571910,4080020,38.8587184554509,1510,2551,2551,1510,46272,651182,518784,2702,4212,2702,3743,5253,32.264531609803356,0.0,1510,0,289920,0,1041,1,1192,1661
2415,0,0,1,0,54,1,516,0,0,1678477,4286985,39.736632972611055,1579,2642,2642,1579,46127,648885,523995,2715,4294,2715,3778,5357,32.60368077380221,0.0,1579,0,304747,0,1063,1,1136,1652
2416,0,0,1,0,54,1,530,0,0,1717344,4359042,40.024992192379,1602,2674,2674,1602,45790,655761,516990,2721,4323,2721,3793,5395,32.7414110874898,0.0,1602,0,304380,0,1072,1,1119,1649
2417,0,0,1,0,54,1,544,0,0,1759332,4434102,40.32369030731191,1626,2708,2708,1626,45198,662661,507222,2727,4353,2727,3809,5435,32.89376840679705,0.0,1626,0,302436,0,1082,1,1101,1645
2418,0,0,1,0,54,1,558,0,0,1801800,4511100,40.620192023179804,1650,2742,2742,1650,45140,667096,505790,2734,4384,2734,3826,5476,33.04542328371661,0.0,1650,0,305250,0,1092,1,1084,1642
2419,0,0,1,0,57,1,622,0,0,2695520,5670502,44.51965857910413,1952,3372,3342,1982,43076,692362,509258,2831,4843,2891,4221,6233,36.87817782917155,5.483301264452448,2012,0,352796,6090,1360,1,879,1501
2420,0,0,1,0,58,1,613,0,0,3278790,6218986,46.292547996410825,2143,3673,3673,2143,48068,708088,571694,2902,5045,2902,4432,6575,39.11521443121589,0.0,2143,0,422171,0,1530,1,759,1372
2421,0,0,1,0,57,1,1182,0,0,1527619,2233393,27.910571473905726,659,2860,2740,779,36022,622139,475922,2747,3646,2987,4828,5727,44.28317965096906,11.418751370995183,899,1,129314,22560,1961,0,2088,906
2422,1,0,0,0,43,0,184,0,0,155561,677019,17.69180601295413,223,900,810,313,54675,486675,525609,2073,2476,2253,2660,3063,22.293496809607955,9.69343894498722,403,1,76059,8100,497,0,1850,1666
2423,1,0,0,0,44,0,72,0,1,164353,978587,21.047565179849187,67,1190,814,443,36110,508070,346813,1833,2652,2585,2580,3399,19.261360284258224,20.68273778130717,819,1,69551,79336,371,0,1766,1838
2424,1,0,0,0,44,0,102,0,1,170455,1035806,21.61018278497431,85,1214,832,467,41701,494614,414766,1836,2685,2600,2583,3432,19.1049731745428,20.341319017469967,849,1,87329,66850,365,0,1751,1853
2425,1,0,0,0,40,0,60,0,0,337824,1124424,23.49468024894146,552,1164,1164,552,55596,460362,501102,2037,2589,2037,2649,3201,24.73863375370596,0.0,552,0,135792,0,612,0,1485,1425
2426,1,0,0,0,42,0,37,0,0,129618,728118,18.49324200890693,132,931,721,342,46930,525863,404510,1919,2471,2339,2508,3060,19.467922333931785,15.195478829531048,552,1,64980,40950,379,0,1787,1750
2427,1,0,0,0,38,0,265,0,0,196350,642180,18.16590212458495,300,955,925,330,45450,393092,437850,1916,2276,1976,2541,2901,24.392621835300936,5.501408174353464,360,1,74250,3150,595,0,1616,1351
2428,1,0,0,0,38,0,282,0,0,231120,700560,18.973665961010276,360,1002,1002,360,38850,432012,340550,1946,2306,1946,2588,2948,25.337718918639855,0.0,360,1,63000,0,642,0,1586,1304
2429,1,0,0,0,39,0,331,0,0,248760,707040,18.973665961010276,300,1111,1051,360,35496,400656,341736,1904,2324,2024,2655,3075,26.28687885618983,8.334399795261145,420,1,62640,9960,691,0,1604,1273
2430,1,0,0,0,41,0,532,0,1,413660,884940,20.73644135332772,88,1734,1392,430,29605,318990,393078,1716,2488,2400,3020,3792,31.016124838541646,18.49423012062866,772,1,82130,28044,962,0,1628,1096
2431,1,0,0,0,41,0,602,0,1,386880,807690,19.748417658131498,0,1772,1382,390,35571,345857,441123,1681,2461,2461,3063,3843,31.496031496047245,20.979318350276287,780,1,83070,28470,992,0,1681,1079
2432,0,1,1,0,58,0,750,0,0,399600,3231210,33.31666249791537,854,1726,1470,1110,54780,640420,724839,2655,4021,3167,3271,4637,18.973665961010276,16.414293341620972,1366,1,276390,23296,360,0,1801,2551
2433,0,1,1,0,57,0,780,0,0,283500,3019800,32.4037034920393,875,1495,1320,1050,50546,572324,730504,2701,3926,3051,3146,4371,16.431676725154983,13.480748117239651,1225,1,266700,9450,270,0,1826,2606
2434,0,1,1,0,55,0,480,0,0,94500,1761480,25.099800796022265,570,840,780,630,55876,640284,682224,2736,3426,2856,2946,3636,12.24744871391589,7.789174875971784,690,1,153720,6540,150,0,2166,2646
2435,0,0,0,0,54,1,301,1,0,1022856,2390152,29.5296461204668,414,2503,2045,872,48265,539977,671545,2283,3613,3199,3914,5244,34.249087579087416,21.501457270676152,1330,1,213640,32060,1173,0,1869,1568
2436,0,0,1,0,53,1,411,0,0,1386990,3716853,37.429934544425805,1401,2391,2391,1401,39123,644679,427133,2653,4054,2653,3643,5044,31.464265445104548,0.0,1401,0,225561,0,990,1,1252,1663
2437,0,0,1,0,53,1,467,0,0,1459608,3927912,38.262252939417984,1464,2461,2461,1464,44164,654652,485623,2683,4147,2683,3680,5144,31.575306807693888,0.0,1464,0,264984,0,997,1,1219,1686
2438,0,0,1,0,55,1,674,0,0,2121456,5102120,42.80186911806539,1802,3020,2990,1832,38468,657260,453955,2755,4617,2815,3943,5805,34.02939905434711,5.7180036243905645,1862,0,298616,6330,1158,1,953,1627
2439,0,0,1,0,56,1,673,0,0,2321928,5349540,43.55456348076513,1867,3151,3121,1897,39044,640140,485040,2790,4717,2850,4044,5971,34.9857113690718,5.7180036243905645,1927,0,326284,5850,1224,1,923,1596
2440,0,0,1,0,57,1,663,0,0,2888200,5949692,45.42025979670306,2063,3463,3463,2063,48755,706580,573916,2884,4947,2884,4284,6347,37.416573867739416,0.0,2063,0,410537,0,1400,1,821,1484
2441,0,0,1,0,57,1,660,0,0,3034629,6086082,45.858477951192405,2073,3576,3546,2103,51088,717712,596164,2864,4997,2924,4337,6470,37.986839826445156,5.490867587491313,2133,0,433218,5400,1443,1,791,1451
2442,0,0,1,0,57,1,658,0,0,3110195,6148208,46.07602413403309,2093,3618,3588,2123,50996,706624,605264,2866,5019,2926,4361,6514,38.27531841800928,5.490867587491313,2153,0,443707,5190,1465,1,773,1431
2443,0,0,1,0,57,1,1199,0,0,1384320,2059176,26.851443164195103,661,2701,2641,721,46535,585480,648312,2796,3577,2916,4776,5557,43.81780460041329,7.9730082341141015,781,1,163667,6420,1920,0,2135,936
2444,0,0,1,0,58,1,380,0,0,981981,3503478,34.62657938636157,541,2676,2018,1199,40200,584400,587322,2264,4121,3580,3741,5598,28.61817604250837,25.70291503635199,1857,1,240999,87514,819,0,1723,2103
2445,0,0,1,0,55,1,633,0,0,400384,2865152,32.0,663,1776,1415,1024,46800,559600,654732,2437,3822,3159,3189,4574,19.77371993328519,19.375408289937102,1385,1,239616,32490,391,0,1774,2407
2446,0,0,0,0,56,1,49,1,0,2847056,4709616,40.779897008207364,1501,3537,3375,1663,36400,589056,495600,2670,4495,2994,4544,6369,41.376321731154405,12.890756302658941,1825,1,291025,27540,1712,0,1169,1120
2447,1,0,0,0,42,0,33,0,0,193768,965641,21.37755832643195,427,911,881,457,56595,488103,517685,2083,2570,2143,2537,3024,20.591260281974,5.483301264452448,487,1,111965,3180,424,0,1656,1689
2448,1,0,0,0,42,0,269,1,0,123662,511104,15.556349186104045,67,928,753,242,20881,280896,331584,1937,2354,2287,2623,3040,22.60530911091463,14.214585752227697,417,1,37994,15225,511,0,1870,1601
2449,1,0,0,0,42,0,190,1,0,129359,582254,16.64331697709324,65,956,744,277,26970,365748,325810,1890,2379,2314,2569,3058,21.61018278497431,15.029763150103136,489,1,42935,30952,467,0,1825,1635
2450,1,0,0,0,42,0,69,1,0,138312,720375,18.411952639521967,62,1024,747,339,34121,486625,316625,1848,2464,2402,2533,3149,20.199009876724155,17.30726194448455,616,1,50511,60109,408,0,1786,1717
2451,1,0,0,0,44,0,149,0,1,162140,1076416,22.0,123,1180,819,484,41216,498176,409216,1863,2708,2585,2559,3404,18.303005217723125,19.922867438730606,845,1,89056,64619,335,0,1740,1889
2452,1,0,0,0,40,0,45,0,0,375876,1204458,24.310491562286437,561,1257,1227,591,56334,466702,501348,2008,2629,2068,2674,3295,25.219040425836983,5.478746393072713,621,1,145386,3120,636,0,1447,1402
2453,1,0,0,0,39,0,97,0,0,3810,58500,5.477225575051661,30,157,157,30,49735,395850,477750,1950,1980,1950,2077,2107,11.269427669584644,0.0,30,1,7350,0,127,0,1920,1823
2454,1,0,0,0,39,0,300,0,0,67500,297450,12.24744871391589,12,762,600,150,40140,442209,356940,1821,2133,2145,2433,2745,21.213203435596427,12.728043305644134,312,1,27000,29484,450,0,1833,1533
2455,1,0,0,0,39,0,253,0,0,165900,588600,17.320508075688775,258,895,853,300,45030,372780,464994,1920,2262,2004,2515,2857,23.515952032609693,6.484411467763075,342,1,71100,3024,553,0,1662,1409
2456,1,0,0,0,41,0,569,0,0,387600,820400,20.0,9,1760,1369,400,31584,459424,289191,1660,2451,2442,3020,3811,31.12876483254676,20.913515367716318,791,1,56400,85629,969,0,1651,1082
2457,1,0,0,0,41,0,589,0,1,406776,841704,20.199009876724155,4,1809,1405,408,33369,468301,303261,1659,2471,2467,3060,3872,31.575306807693888,20.09975124224178,812,1,59976,87668,997,0,1655,1066
2458,1,0,0,0,41,0,599,0,1,427980,875280,20.493901531919196,16,1843,1439,420,18093,339692,231324,1680,2504,2488,3103,3927,31.921779399024736,20.112054757449005,824,1,46620,70700,1019,0,1664,1065
2459,1,0,0,0,42,0,600,0,1,428400,882420,20.493901531919196,26,1886,1440,420,26400,346665,336160,1655,2521,2547,3121,3987,31.937438845342623,21.154955016548037,866,1,67200,57980,1020,0,1681,1081
2460,0,1,1,0,58,0,691,0,0,423062,3152948,32.89376840679705,805,1750,1473,1082,54216,629424,731414,2637,3996,3191,3305,4664,19.77371993328519,17.039400770443176,1359,1,271582,22437,391,0,1832,2523
2461,0,1,1,0,57,0,749,0,0,357480,3127680,32.863353450309965,862,1629,1411,1080,55029,640016,721104,2678,3976,3114,3227,4525,18.193405398660254,15.121479258279154,1298,1,268920,19402,331,0,1816,2565
2462,0,1,1,0,55,0,120,0,0,149281,1241603,21.236760581595302,409,824,782,451,56105,630437,674485,2711,3204,2795,3084,3577,18.193405398660254,6.48074069840786,493,1,110495,4452,331,0,2302,2422
2463,0,1,1,0,54,0,60,0,0,151981,1156066,20.518284528683193,391,812,782,421,56595,634326,672770,2716,3167,2776,3107,3558,19.0,5.5503012171862105,451,1,103145,3210,361,0,2325,2385
2464,0,0,1,0,52,1,376,0,0,1291760,3493380,36.60601043544625,1340,2304,2304,1340,37996,615252,419727,2607,3947,2607,3571,4911,31.04834939252005,0.0,1340,1,215740,0,964,0,1267,1643
2465,0,0,1,0,52,1,402,0,0,1312168,3570952,36.932370625238775,1364,2326,2326,1364,38001,625702,416262,2618,3982,2618,3580,4944,31.016124838541646,0.0,1364,0,216876,0,962,1,1254,1656
2466,0,0,1,0,53,1,463,0,0,1366080,3775219,37.72267222772003,1423,2383,2383,1423,39366,644679,429786,2653,4076,2653,3613,5036,30.983866769659336,0.0,1423,0,230526,0,960,1,1230,1693
2467,0,0,1,0,54,1,611,0,0,1626702,4396623,40.2119385257662,1557,2683,2623,1617,46127,649841,524767,2659,4336,2779,3725,5402,31.71750305430741,7.849311256600636,1677,0,312081,11160,1006,1,1102,1713
2468,0,0,1,0,55,1,725,0,0,2150204,5240654,43.278170016764804,1813,3081,3021,1873,40414,677116,467266,2738,4671,2858,3946,5879,33.88214869219483,8.086478275311649,1933,0,312791,12720,1148,1,925,1650
2469,0,0,1,0,56,1,723,0,0,2251710,5370195,43.64630568559039,1845,3147,3087,1905,41624,682198,484868,2759,4724,2879,4001,5966,34.38022687534217,8.1903625881272,1965,0,327660,12480,1182,1,914,1637
2470,0,0,1,0,56,1,719,0,0,2419572,5547216,44.22668877499196,1914,3235,3193,1956,47580,691984,553020,2794,4792,2878,4073,6071,35.17101079013795,6.5252844928085345,1998,0,381420,7896,1237,1,880,1599
2471,0,0,1,0,56,1,716,0,0,2541792,5675208,44.63182720884279,1962,3298,3268,1992,44322,709401,507122,2819,4841,2879,4125,6147,35.7211421989835,5.514871952411144,2022,0,354576,6240,1276,1,857,1573
2472,0,0,1,0,57,1,704,0,0,2949105,6064505,45.880278987817846,2063,3548,3506,2105,52890,708726,619415,2839,4986,2923,4282,6429,37.429934544425805,6.484411467763075,2147,0,452575,7014,1401,1,776,1480
2473,0,0,1,0,52,1,367,0,0,1448634,3652407,37.429934544425805,1401,2435,2435,1401,47957,565719,576147,2607,4008,2607,3641,5042,32.155870381627054,0.0,1401,0,309621,0,1034,0,1206,1573
2474,0,0,0,0,56,1,77,1,0,2842800,4892100,41.53311931459037,1513,3585,3373,1725,36668,584216,504808,2624,4561,3048,4484,6421,40.59556626036888,14.694496548602537,1937,1,307050,34980,1648,0,1111,1188
2475,0,0,1,0,57,1,210,0,0,2947375,4610825,40.18706259482024,1435,3620,3440,1615,41664,619535,548160,2675,4470,3035,4680,6475,42.720018726587654,13.774493079968597,1795,1,310080,29340,1825,0,1240,1030
2476,1,0,0,0,44,0,424,0,0,46260,198900,9.486832980505138,37,731,604,90,52208,459680,554710,2083,2300,2337,2724,2941,22.67156809750927,11.86971052873884,217,1,22590,9271,514,0,2120,1696
2477,1,0,0,0,42,0,27,1,0,162630,876951,20.42057785666214,417,807,807,417,43228,450042,424806,2103,2520,2103,2493,2910,19.748417658131498,0.0,417,1,84234,0,390,0,1686,1713
2478,1,0,0,0,41,0,58,1,0,136800,715806,18.49324200890693,312,772,742,342,47936,447902,468832,2063,2435,2123,2493,2865,20.0,5.531194905403055,372,1,76608,3660,400,0,1751,1693
2479,1,0,0,0,41,0,258,1,0,102384,452304,14.696938456699069,174,732,690,216,34740,404142,376920,2052,2310,2136,2568,2826,21.77154105707724,6.7040592262067955,258,1,38880,6132,474,0,1878,1620
2480,1,0,0,0,41,0,291,1,0,98892,420291,14.177446878757825,141,753,693,201,35552,368016,422382,2031,2292,2151,2583,2844,22.181073012818835,7.7992067098508295,261,1,40602,5940,492,0,1890,1599
2481,1,0,0,0,41,0,35,0,0,455994,1350216,25.65151067676132,616,1393,1351,658,51562,416556,521208,2010,2710,2094,2745,3445,26.324893162176366,6.7040592262067955,700,1,167132,2352,693,0,1394,1359
2482,1,0,0,0,41,0,4,1,0,204300,942750,21.213203435596427,316,1038,904,450,26208,435760,263970,1961,2545,2229,2549,3133,21.307275752662516,12.11691450897726,584,1,56700,28810,454,0,1645,1641
2483,1,0,0,0,42,0,26,0,0,120935,765681,19.0,114,943,696,361,47724,411474,521766,1874,2482,2368,2456,3064,18.303005217723125,16.22436246843356,608,1,88806,16302,335,0,1760,1786
2484,1,0,0,0,39,0,399,0,0,343980,836640,20.493901531919196,173,1486,1239,420,39884,470112,336648,1745,2412,2239,2811,3478,28.61817604250837,16.02271768373319,667,1,70980,50882,819,0,1572,1173
2485,1,0,0,0,41,0,594,0,0,469800,940050,21.213203435596427,108,1836,1494,450,34365,495093,302905,1747,2539,2431,3133,3925,32.31098884280702,18.517897431643927,792,1,65250,77634,1044,0,1639,1045
2486,1,0,0,0,41,0,550,0,1,485376,993504,21.77154105707724,179,1793,1498,474,20328,322784,276672,1801,2570,2391,3120,3889,32.0,17.225867684193634,769,1,62568,42185,1024,0,1622,1072
2487,1,0,0,0,40,0,632,0,1,357120,730440,18.973665961010276,30,1682,1352,360,45212,361162,515366,1699,2389,2359,3021,3711,31.496031496047245,19.173402628875486,690,1,91440,7590,992,0,1669,1037
2488,0,1,1,0,57,0,685,0,0,383250,3041850,32.4037034920393,808,1657,1415,1050,55278,643134,721353,2655,3947,3139,3262,4554,19.1049731745428,15.872007510678884,1292,1,261450,22022,365,0,1847,2532
2489,0,1,1,0,55,0,237,0,0,142378,1419154,22.67156809750927,514,791,791,514,55144,623986,673684,2761,3275,2761,3038,3552,16.64331697709324,0.0,514,1,125416,0,277,0,2247,2484
2490,0,1,1,0,54,0,119,0,0,152090,1247138,21.307275752662516,424,819,789,454,55350,618075,675762,2717,3201,2777,3082,3566,18.303005217723125,5.531194905403055,484,1,111684,3090,335,0,2293,2412
2491,0,1,1,0,53,0,296,0,0,134121,664183,15.716233645501712,180,857,790,247,51816,548556,683006,2622,2936,2756,3232,3546,23.302360395462088,8.642106768569302,314,1,62738,4020,543,0,2442,2146
2492,0,0,1,0,54,1,698,0,0,1719648,4671028,41.30375285612676,1646,2774,2714,1706,44826,659858,509268,2678,4444,2798,3746,5512,31.74901573277509,7.750803389552748,1766,1,317316,11700,1008,0,1032,1730
2493,0,0,1,0,54,1,709,0,0,1763580,4744376,41.58124577258358,1669,2809,2749,1729,44103,661304,502152,2684,4473,2804,3764,5553,31.937438845342623,7.789174875971784,1789,1,316407,11820,1020,0,1015,1724
2494,0,0,1,0,55,1,774,0,0,2130331,5304012,43.55456348076513,1807,3110,3020,1897,43719,690612,494892,2706,4693,2886,3919,5906,33.51119216023208,9.69343894498722,1987,1,335769,18630,1123,0,899,1673
2495,0,0,1,0,56,1,767,0,0,2404934,5618116,44.50842616853577,1914,3262,3195,1981,47628,689148,555856,2769,4817,2903,4050,6098,34.84250278036869,8.20759886765899,2048,1,388276,12462,1214,0,855,1622
2496,0,0,1,0,57,1,742,0,0,3087975,6264797,46.551047249229526,2077,3682,3592,2167,46170,702513,549290,2801,5058,2981,4316,6573,37.749172176353746,9.501147918471748,2257,0,411730,17280,1425,1,724,1466
2497,0,0,1,0,57,1,740,0,0,3168224,6336448,46.776062254106,2098,3726,3636,2188,47236,697936,567616,2806,5084,2986,4344,6622,38.05259518088089,9.494144610579708,2278,0,428848,16560,1448,1,708,1448
2498,0,0,0,0,56,1,235,1,0,2780106,5068237,42.2965719651132,1521,3611,3343,1789,36166,606262,478777,2565,4622,3101,4387,6444,39.42080668885405,16.45237440656764,2057,1,302341,49044,1554,0,1044,1279
2499,0,0,1,0,57,1,273,0,0,3017674,4606008,40.07492981902776,1388,3703,3485,1606,39928,622356,527712,2650,4474,3086,4747,6571,43.347433603386484,15.162381191036106,1824,1,295504,37278,1879,0,1262,989
2500,1,0,0,0,42,0,40,1,0,128481,713256,18.411952639521967,279,778,718,339,32400,378720,378720,2044,2443,2164,2483,2882,19.467922333931785,7.754559014766193,399,1,61020,7740,379,0,1765,1725
2501,1,0,0,0,43,0,179,1,0,139830,638380,17.175564037317667,115,949,769,295,21714,305124,333256,1984,2459,2344,2638,3113,21.77154105707724,15.121190037410903,475,1,45430,18360,474,0,1869,1690
2502,1,0,0,0,43,0,141,1,0,139050,664968,17.578395831246947,99,969,759,309,20412,271152,348624,1942,2461,2362,2602,3121,21.213203435596427,15.64928048133532,519,1,50058,14910,450,0,1843,1702
2503,1,0,0,0,41,0,5,0,0,323186,1163130,23.790754506740637,524,1179,1137,566,27738,425385,275370,2013,2621,2097,2626,3234,23.895606290697042,6.78953034358522,608,0,75844,8694,571,0,1489,1484
2504,1,0,0,0,42,0,60,0,0,108661,761710,19.0,76,947,662,361,38915,381910,453650,1825,2471,2395,2411,3057,17.349351572897472,17.205092336640153,646,1,77615,25365,301,0,1749,1809
2505,1,0,0,0,39,0,222,0,0,115843,491036,15.716233645501712,187,776,716,247,49164,405552,479108,1928,2235,2048,2457,2764,21.656407827707714,7.952707287670506,307,1,59527,5220,469,0,1741,1519
2506,0,1,1,0,62,0,119,0,0,1106322,3484803,33.36165463522455,540,2680,2107,1113,48380,641855,738916,2558,4244,3704,4125,5811,31.52776554086889,23.97104863958354,1686,1,262668,55008,994,0,2018,2137
2507,0,1,1,0,59,0,448,0,0,640385,3151285,32.48076353782343,575,2142,1662,1055,44275,522725,755711,2507,4042,3467,3594,5129,24.63736998950984,22.493653007613965,1535,1,266915,9120,607,0,1932,2380
2508,0,1,1,0,55,0,508,0,0,98700,1837136,25.65151067676132,658,808,808,658,52200,628200,647744,2792,3450,2792,2942,3600,12.24744871391589,0.0,658,1,152656,0,150,0,2134,2642
2509,0,1,1,0,55,0,403,0,0,121404,1680328,24.576411454889016,574,835,805,604,50995,603694,653770,2752,3386,2812,2983,3617,14.177446878757825,5.501408174353464,634,1,141940,3360,201,0,2178,2581
2510,0,1,1,0,54,0,59,0,0,159530,1010604,19.261360284258224,329,843,801,371,55161,618348,661932,2682,3095,2766,3154,3567,20.73644135332772,6.538739683827756,413,1,90153,4662,430,0,2353,2294
2511,0,0,1,0,57,1,803,0,0,2642748,5937360,45.56314299957807,1986,3439,3349,2076,47690,717860,543400,2770,4936,2950,4133,6299,35.679125549822544,9.560918316574591,2166,0,394440,17730,1273,1,784,1587
2512,0,0,1,0,59,1,1125,0,0,1518264,2342736,28.142494558940577,658,2843,2709,792,45024,594558,662592,2824,3750,3092,4875,5801,43.78355855797927,11.747494334573807,926,1,177408,14070,1917,0,2166,1041
2513,0,0,1,0,57,1,105,0,0,3002266,4822789,41.0,1441,3707,3467,1681,42460,631180,553717,2629,4550,3109,4655,6576,42.261093218230876,15.847692511927205,1921,1,324433,39840,1786,0,1188,1083
2514,1,0,0,0,42,0,22,1,0,189104,903968,20.591260281974,394,900,870,424,34020,383760,402948,2102,2556,2162,2578,3032,21.118712081942874,5.531194905403055,454,1,80136,3570,446,0,1708,1686
2515,1,0,0,0,41,0,301,1,0,180300,629100,17.320508075688775,300,901,901,300,38352,394236,427788,2097,2397,2097,2698,2998,24.515301344262525,0.0,300,1,61200,0,601,0,1797,1496
2516,1,0,0,0,43,0,171,1,0,151492,681088,17.69180601295413,163,947,797,313,22770,430848,250240,2026,2489,2326,2660,3123,22.0,14.04244506670108,463,1,35995,31950,484,0,1863,1692
2517,1,0,0,0,42,0,125,1,0,70350,710200,18.303005217723125,67,813,545,335,24948,326480,343440,1852,2455,2388,2330,2933,14.491376746189438,17.59530893729249,603,1,54270,30016,210,0,1785,1910
2518,1,0,0,0,40,0,203,1,0,81204,403206,14.177446878757825,106,700,605,201,44099,419254,423266,1911,2207,2101,2410,2706,20.09975124224178,9.863740202967753,296,1,42411,12540,404,0,1805,1602
2519,1,0,0,0,39,0,233,0,0,342240,949920,21.908902300206645,290,1383,1193,480,39879,374031,417569,1789,2459,2169,2692,3362,26.70205984563738,13.941784393794311,670,1,101280,19950,713,0,1499,1266
2520,1,0,0,0,41,0,494,0,0,501491,1043725,22.427661492005804,184,1819,1500,503,30418,471025,278050,1756,2578,2394,3072,3894,31.575306807693888,17.86587805925116,822,1,67402,72413,997,0,1572,1078
2521,0,1,1,0,55,0,426,0,0,118656,1724220,24.859605789312106,588,840,810,618,51504,619380,647280,2760,3408,2820,2982,3630,13.856406460551018,5.478746393072713,648,1,143376,3660,192,0,2172,2598
2522,0,1,1,0,55,0,322,0,0,136488,1566228,23.748684174075834,504,866,806,564,51360,594278,666480,2717,3341,2837,3019,3643,15.556349186104045,7.789174875971784,624,1,135360,6000,242,0,2213,2535
2523,0,1,1,0,54,0,107,0,0,160758,1256752,21.400934559032695,428,839,809,458,52430,587216,672280,2714,3202,2774,3095,3583,18.734993995195193,5.5503012171862105,488,1,112210,2760,351,0,2286,2393
2524,0,1,1,0,54,0,54,0,0,164107,1184255,20.808652046684813,403,842,812,433,53165,593495,670075,2705,3168,2765,3114,3577,19.467922333931785,5.572104574801163,463,1,106085,2880,379,0,2302,2356
2525,0,1,1,0,54,0,58,0,0,165623,1030880,19.467922333931785,312,883,816,379,55370,614720,666400,2653,3099,2787,3157,3603,20.904544960366874,8.329212945039274,446,1,92855,7035,437,0,2341,2283
2526,0,0,1,0,59,1,356,0,0,3186752,4810832,40.19950248448356,1531,3673,3588,1616,46800,580515,714480,2892,4593,3062,4949,6650,44.40720662234904,9.251281740554573,1701,1,387840,6375,1972,0,1361,1005
2527,0,0,0,0,56,1,158,1,0,1576323,3324780,34.336569426778794,1055,2640,2516,1179,25056,609120,327120,2696,3999,2944,4157,5460,36.565010597564445,11.932888170540295,1303,1,136764,28768,1337,0,1641,1483
2528,0,0,1,0,57,1,17,0,0,2998020,4995540,41.71330722922842,1468,3735,3463,1740,41748,611523,562716,2599,4611,3143,4594,6606,41.50903516103452,16.80530064383442,2012,1,341040,41888,1723,0,1131,1148
2529,1,0,0,0,42,0,118,1,0,129744,906512,20.591260281974,316,838,730,424,33855,391254,395530,2030,2562,2246,2444,2976,17.4928556845359,10.613247510664669,532,1,78440,13716,306,0,1714,1832
2530,1,0,0,0,43,0,162,1,0,166495,724270,18.303005217723125,215,952,832,335,20691,451858,214038,2042,2497,2282,2659,3114,22.293496809607955,12.346399965104396,455,1,33165,28440,497,0,1827,1665
2531,1,0,0,0,42,0,95,0,0,141006,911214,20.639767440550294,143,1040,757,426,34056,367908,423522,1856,2565,2422,2470,3179,18.193405398660254,17.38390821205725,709,1,84348,27451,331,0,1713,1808
2532,1,0,0,0,40,0,60,0,0,8509,255905,11.269427669584644,42,279,194,127,33901,336505,409045,1930,2142,2100,2082,2294,8.18535277187245,9.930529422773999,212,1,25781,7225,67,0,1888,1948
2533,1,0,0,0,39,0,221,0,0,372810,1011330,22.58317958127243,282,1469,1241,510,37430,376770,390651,1755,2493,2211,2714,3452,27.03701166919155,15.244617570879624,738,1,100470,28044,731,0,1473,1252
2534,1,0,0,0,40,0,306,0,0,416160,1020510,22.58317958127243,201,1635,1326,510,43676,488244,358179,1692,2511,2310,2817,3636,28.5657137141714,17.872888273489416,819,1,91290,63036,816,0,1491,1185
2535,1,0,0,0,41,0,413,0,0,482258,1063972,22.759613353482084,176,1791,1449,518,34104,476528,301938,1712,2572,2396,2985,3845,30.512292604784715,18.4935977473728,860,1,76146,75582,931,0,1536,1123
2536,1,0,0,0,42,0,525,0,0,575100,1140480,23.2379000772445,306,1839,1605,540,42084,532224,352704,1878,2652,2346,3177,3951,32.63433774416144,15.455495813746403,774,1,90180,50076,1065,0,1572,1047
2537,0,1,1,0,61,0,174,0,0,876031,3143647,32.046840717924134,415,2492,1880,1027,51480,673420,716274,2449,4088,3673,3914,5553,29.206163733020468,25.974701379175084,1639,1,240318,52632,853,0,2034,2208
2538,0,1,1,0,56,0,646,0,0,130896,2274520,28.42534080710379,778,1000,970,808,53110,636190,661525,2785,3623,2845,2977,3815,12.727922061357855,5.514871952411144,838,1,189880,3660,162,0,2007,2653
2539,0,1,1,0,56,0,568,0,0,110313,2020963,26.851443164195103,721,874,874,721,50398,633478,625069,2803,3524,2803,2956,3677,12.36931687685298,0.0,721,1,160783,0,153,0,2082,2650
2540,0,1,1,0,56,0,531,0,0,112266,1941786,26.324893162176366,693,855,855,693,50400,630450,627648,2802,3495,2802,2964,3657,12.727922061357855,0.0,693,1,155232,0,162,0,2109,2640
2541,0,1,1,0,55,0,489,0,0,116200,1858536,25.768197453450252,664,839,839,664,51754,632574,640971,2799,3463,2799,2974,3638,13.228756555322953,0.0,664,1,152056,0,175,0,2135,2624
2542,0,1,1,0,55,0,294,0,0,142416,1532352,23.49468024894146,467,895,810,552,53900,610720,680120,2691,3328,2861,3034,3671,16.06237840420901,9.251281740554573,637,1,135240,8415,258,0,2224,2518
2543,0,1,1,0,55,0,241,0,0,148292,1450432,22.891046284519195,439,892,807,524,53900,608960,678160,2683,3292,2853,3051,3660,16.822603841260722,9.300149152818726,609,1,128380,8330,283,0,2244,2485
2544,0,1,1,0,55,0,188,0,0,153573,1371720,22.293496809607955,430,873,806,497,54120,607200,678960,2693,3257,2827,3069,3633,17.578395831246947,8.2143728690235,564,1,122262,6499,309,0,2263,2451
2545,0,1,1,0,54,0,27,0,0,162630,1139244,20.42057785666214,357,867,807,417,54282,595576,680268,2672,3149,2792,3122,3599,19.748417658131498,7.9332512824338455,477,1,103833,5340,390,0,2315,2342
2546,0,0,1,0,53,1,663,0,0,1264864,3991616,38.781438859330635,1474,2375,2345,1504,42525,644922,464450,2624,4158,2684,3495,5029,29.0,5.478746393072713,1534,1,263200,6180,841,0,1150,1813
2547,0,0,1,0,58,1,655,0,0,3105800,6179800,46.04345773288535,1930,3775,3585,2120,42834,705430,515955,2725,5035,3105,4380,6690,38.27531841800928,13.838706257176828,2310,1,375240,38760,1465,0,795,1450
2548,0,0,1,0,57,1,46,0,0,3034035,5077905,42.01190307520001,1464,3785,3484,1765,44036,627186,581154,2576,4642,3178,4596,6662,41.46082488325576,17.662659759960558,2066,1,356530,46053,1719,0,1112,1158
2549,0,0,1,0,57,1,141,0,0,3122622,4895334,41.20679555607303,1397,3838,3537,1698,39990,619845,536238,2582,4581,3184,4722,6721,42.883563284783136,17.70875669762007,1999,1,315828,50267,1839,0,1185,1044
2550,1,0,0,0,42,0,257,1,0,174894,1213504,23.790754506740637,446,995,875,566,34104,373056,420224,2024,2710,2264,2453,3139,17.578395831246947,11.002816348706927,686,1,110936,12360,309,0,1578,1835
2551,1,0,0,0,42,0,59,1,0,123386,686698,17.97220075561143,170,858,705,323,38613,448586,389058,1973,2449,2279,2508,2984,19.544820285692065,12.486530243515826,476,1,59109,25092,382,0,1803,1744
2552,1,0,0,0,40,0,32,0,0,489744,1460640,26.758176320519304,686,1430,1400,716,48240,489600,410040,2010,2756,2070,2724,3470,26.153393661244042,5.490867587491313,746,0,143916,5340,684,0,1324,1356
2553,1,0,0,0,41,0,28,0,0,458133,1416550,26.28687885618983,649,1396,1354,691,37206,479700,325950,2008,2741,2092,2713,3446,25.748786379167466,6.609134537568676,733,0,109869,8988,663,0,1359,1387
2554,1,0,0,0,38,0,247,1,0,8310,58320,5.477225575051661,30,307,307,30,39270,363528,408240,1944,1974,1944,2221,2251,16.64331697709324,0.0,30,1,6300,0,277,0,1914,1667
2555,1,0,0,0,40,0,127,1,0,50490,344250,13.038404810405298,5,642,467,170,27566,362475,311850,1850,2195,2200,2322,2667,17.233687939614086,13.229728356877892,345,1,26180,26950,297,0,1855,1728
2556,1,0,0,0,40,0,130,1,0,72504,429300,14.560219778561036,92,674,554,212,39006,398925,400950,1905,2237,2145,2367,2699,18.49324200890693,10.95616238207774,332,1,41976,15840,342,0,1813,1683
2557,1,0,0,0,40,0,134,1,0,230736,837254,20.445048300260872,323,1065,970,418,35640,360540,396594,1908,2421,2098,2555,3068,23.49468024894146,10.06192246325636,513,1,82764,10355,552,0,1585,1451
2558,1,0,0,0,39,0,133,1,0,287718,942312,21.77154105707724,324,1231,1081,474,38728,409528,373744,1838,2462,2138,2595,3219,24.63736998950984,12.35277120656332,624,1,89112,23100,607,0,1514,1381
2559,1,0,0,0,40,0,325,0,0,468506,1093902,23.259406699226016,165,1783,1407,541,35332,489324,295212,1646,2563,2398,2888,3805,29.427877939124322,19.724874845353288,917,1,78986,86104,866,0,1481,1156
2560,1,0,0,0,41,0,443,0,0,575828,1185227,23.853720883753127,314,1836,1581,569,45212,529082,370774,1828,2652,2338,3095,3919,31.811947441173732,16.006953473611997,824,1,101282,51765,1012,0,1514,1071
2561,0,1,0,1,65,0,841,0,0,3419892,4811760,38.41874542459709,876,4393,3793,1476,56350,798700,749800,2660,4736,3860,5577,7653,48.13522618623496,24.582606838508408,2076,1,339480,84000,2317,0,1784,943
2562,0,1,1,0,57,0,653,0,0,257610,2656080,30.495901363953813,835,1302,1207,930,44732,602616,605472,2761,3786,2951,3133,4158,16.64331697709324,9.96633033441658,1025,1,197160,12730,277,0,1926,2579
2563,0,1,1,0,57,0,663,0,0,234090,2617218,30.298514815086232,851,1240,1173,918,44377,567349,635773,2784,3769,2918,3106,4091,15.968719422671311,8.436161057888377,985,1,204714,6968,255,0,1933,2596
2564,0,1,1,0,56,0,654,0,0,207792,2523696,29.79932885150268,846,1164,1122,888,44850,554190,653660,2800,3730,2884,3076,4006,15.297058540778355,6.63067838716079,930,1,204240,3738,234,0,1954,2608
2565,0,1,1,0,56,0,610,0,0,152000,2252800,28.284271247461902,800,990,990,800,49235,605440,644864,2816,3616,2816,3006,3806,13.784048752090222,0.0,800,1,183200,0,190,0,2016,2626
2566,0,1,1,0,54,0,54,0,0,161680,1176480,20.73644135332772,340,896,806,430,54467,593712,686736,2646,3166,2826,3112,3632,19.390719429665317,9.552038418812673,520,1,107930,7380,376,0,2306,2360
2567,0,0,1,0,53,1,732,0,0,1253728,4111672,39.293765408777,1514,2386,2356,1544,43254,647109,474014,2633,4207,2693,3475,5049,28.495613697550013,5.478746393072713,1574,1,274832,6090,812,0,1119,1851
2568,0,0,1,0,53,1,756,0,0,1280365,4194570,39.63584236521283,1571,2386,2386,1571,44408,651480,485940,2670,4241,2670,3485,5056,28.548204847240395,0.0,1571,1,285922,0,815,0,1099,1855
2569,0,0,1,0,52,1,256,0,0,1616900,3686532,37.49666651850535,1406,2556,2556,1406,42731,647634,453606,2622,4028,2622,3772,5178,33.91164991562634,0.0,1406,0,243238,0,1150,0,1216,1472
2570,0,0,1,0,57,1,72,0,0,3071713,5157687,42.2965719651132,1458,3837,3506,1789,45854,654441,582366,2552,4672,3214,4600,6720,41.43669871020132,18.506706221735417,2120,1,361378,53953,1717,0,1094,1166
2571,1,0,0,0,43,0,213,1,0,169708,1159760,23.065125189341593,398,985,851,532,30535,337900,429460,2046,2712,2314,2499,3165,17.86057109949175,12.019627717482168,666,1,104804,10184,319,0,1648,1861
2572,1,0,0,0,42,0,165,1,0,116044,567088,16.3707055437449,76,893,701,268,36000,338560,476100,1924,2384,2308,2549,3009,20.808652046684813,14.307589169369836,460,1,60300,8832,433,0,1848,1683
2573,1,0,0,0,41,0,541,0,0,293460,1810692,29.597297173897484,846,1241,1211,876,52948,504348,448539,2037,2943,2097,2402,3308,18.303005217723125,5.684275577662207,906,1,190092,4260,335,0,1191,1732
2574,1,0,0,0,40,0,164,0,0,483276,1599972,27.964262908219126,782,1400,1400,782,52644,437844,503316,2046,2828,2046,2664,3446,24.859605789312106,0.0,782,1,192372,0,618,0,1264,1428
2575,1,0,0,0,40,0,109,0,0,490536,1545037,27.51363298439521,757,1405,1405,757,51300,465348,459225,2041,2798,2041,2689,3446,25.45584412271571,0.0,757,0,170325,0,648,0,1284,1393
2576,1,0,0,0,40,0,201,0,0,439470,1142850,23.874672772626646,261,1650,1341,570,41516,429070,388970,1696,2575,2314,2776,3655,27.76688675382964,17.78146024076311,879,1,110580,48822,771,0,1435,1234
2577,1,0,0,0,41,0,388,0,0,575453,1215107,24.269322199023193,331,1824,1566,589,46736,524002,379592,1805,2652,2321,3040,3887,31.25699921617557,16.063886362399987,847,1,108376,50826,977,0,1474,1086
2578,0,1,1,0,62,0,139,0,0,1182180,3194640,31.937438845342623,563,2636,2179,1020,56400,751680,736020,2675,4152,3589,4291,5768,34.044089061098404,21.42255633550467,1477,1,239700,61238,1159,0,2112,1973
2579,0,1,1,0,57,0,388,0,0,477888,2632944,30.199337741083,547,1801,1436,912,55056,640914,715976,2522,3799,3252,3411,4688,22.891046284519195,19.232749017330665,1277,1,226176,31755,524,0,1975,2363
2580,0,1,1,0,56,0,596,0,0,187872,2330272,28.705400188814647,794,1082,1052,824,46864,571256,656096,2798,3652,2858,3056,3910,15.0996688705415,5.514871952411144,854,1,191168,2880,228,0,2004,2600
2581,0,1,1,0,56,0,525,0,0,154350,2070495,27.110883423451916,693,987,945,735,47085,616923,605655,2775,3552,2859,3027,3804,14.491376746189438,6.503581472166948,777,1,158025,5880,210,0,2082,2607
2582,0,1,1,0,56,0,494,0,0,149672,1986684,26.570660511172846,646,978,918,706,48832,613452,630336,2754,3520,2874,3026,3792,14.560219778561036,7.750803389552748,766,1,158144,7620,212,0,2108,2602
2583,0,1,1,0,56,0,459,0,0,147586,1901693,26.019223662515376,617,955,895,677,50544,606744,657306,2749,3486,2869,3027,3764,14.7648230602334,7.750803389552748,737,1,158418,6720,218,0,2132,2591
2584,0,1,1,0,56,0,420,0,0,147744,1815048,25.45584412271571,588,936,876,648,52080,607817,672240,2741,3449,2861,3029,3737,15.0996688705415,7.746504550744806,708,1,155520,6240,228,0,2153,2573
2585,0,1,1,0,55,0,283,0,0,155120,1554560,23.664319132398465,452,945,837,560,54808,613496,688448,2668,3336,2884,3053,3721,16.64331697709324,10.480278705357403,668,1,138880,10044,277,0,2216,2499
2586,0,1,1,0,55,0,235,0,0,158004,1472044,23.065125189341593,405,956,829,532,55081,617041,683449,2640,3299,2894,3064,3723,17.233687939614086,11.385697187787974,659,1,131404,12319,297,0,2235,2470
2587,0,1,1,0,55,0,132,0,0,162108,1303500,21.77154105707724,350,940,816,474,54500,599500,687500,2626,3224,2874,3092,3690,18.49324200890693,11.135709774976435,598,1,118500,10788,342,0,2276,2408
2588,0,1,1,0,54,0,27,0,0,162630,1060020,19.748417658131498,270,927,807,390,54216,587088,682218,2598,3108,2838,3135,3645,20.42057785666214,11.15593165433301,510,1,97890,9120,417,0,2328,2301
2589,0,0,1,0,55,1,962,0,0,1765208,5236910,43.520110293977886,1719,3001,2826,1894,47817,699545,522585,2590,4659,2940,3697,5766,30.528675044947494,13.390035705542966,2069,1,357966,34650,932,0,871,1833
2590,0,0,1,0,59,1,406,0,0,3052872,4622876,39.44616584663204,1526,3548,3518,1556,52514,644707,718982,2941,4527,3001,4933,6519,44.294469180700204,5.501408174353464,1586,1,376552,3000,1962,0,1415,1009
2591,0,0,1,0,59,1,461,0,0,3039192,4525936,39.08964057138413,1528,3517,3517,1528,53361,684222,684222,2962,4490,2962,4951,6479,44.598206241955516,0.0,1528,1,352968,0,1989,0,1434,973
2592,0,0,1,0,59,1,110,0,0,983024,3119896,32.37282811247729,666,2368,1986,1048,44296,672802,583492,2595,4025,3359,3915,5345,30.62678566222711,19.852533269669806,1430,1,205408,64558,938,0,1929,2039
2593,1,0,0,0,43,0,197,1,0,149100,650700,17.320508075688775,210,887,797,300,40068,459828,409941,2079,2469,2259,2666,3056,22.293496809607955,9.601845894041878,390,1,56700,14400,497,0,1869,1672
2594,1,0,0,0,43,0,340,1,0,117024,1205016,23.49468024894146,372,944,764,552,30753,438783,333999,2003,2735,2363,2395,3127,14.560219778561036,13.751862506585848,732,1,84456,32760,212,0,1631,1971
2595,1,0,0,0,42,0,65,1,0,122496,824832,19.595917942265423,174,913,703,384,34953,410268,393084,1938,2532,2358,2467,3061,17.86057109949175,14.692526380756615,594,1,70272,29190,319,0,1764,1829
2596,1,0,0,0,41,0,572,0,0,289085,1838330,29.916550603303182,895,1218,1218,895,54656,501176,460096,2054,2949,2054,2377,3272,17.97220075561143,0.0,895,0,200480,0,323,0,1159,1731
2597,1,0,0,0,41,0,567,0,0,322218,1886490,30.298514815086232,918,1269,1269,918,54587,507585,454155,2055,2973,2055,2406,3324,18.734993995195193,0.0,918,0,202878,0,351,0,1137,1704
2598,1,0,0,0,41,0,558,0,0,394128,1991892,31.080540535840107,966,1374,1374,966,49250,515500,406214,2062,3028,2062,2470,3436,20.199009876724155,0.0,966,0,190302,0,408,0,1096,1654
2599,1,0,0,0,40,0,187,0,0,488988,1634754,28.26658805020514,799,1411,1411,799,53325,460350,484902,2046,2845,2046,2658,3457,24.73863375370596,0.0,799,1,189363,0,612,0,1247,1434
2600,1,0,0,0,40,0,133,0,0,496134,1583604,27.820855486487112,744,1445,1415,774,49434,472626,437844,2016,2820,2076,2687,3491,25.317977802344327,5.477225575051661,804,0,165636,4650,641,0,1272,1405
2601,1,0,0,0,40,0,79,0,0,503250,1534500,27.386127875258307,708,1463,1421,750,45202,476718,396924,2004,2796,2088,2717,3509,25.903667693977237,6.503581472166948,792,0,145500,7518,671,0,1296,1375
2602,1,0,0,0,43,0,99,1,0,294030,1278288,24.372115213907882,382,1301,1089,594,28072,499264,260392,1940,2746,2364,2647,3453,22.24859546128699,15.51474431382845,806,1,71874,50880,495,0,1558,1657
2603,1,0,0,0,44,0,126,1,0,217872,1179072,23.108440016582687,257,1219,942,534,31086,437184,346656,1931,2742,2485,2616,3427,20.199009876724155,18.086353621159986,811,1,83838,48752,408,0,1674,1800
2604,1,0,0,0,44,0,137,1,0,195564,1137780,22.715633383201094,216,1195,895,516,30369,350595,421155,1905,2721,2505,2584,3400,19.467922333931785,18.542846889446768,816,1,98556,26100,379,0,1689,1826
2605,1,0,0,0,41,0,46,1,0,54696,436508,14.560219778561036,59,623,470,212,28199,356207,335617,1906,2271,2212,2317,2682,16.06237840420901,12.546325833189906,365,1,34556,20808,258,0,1847,1801
2606,1,0,0,0,40,0,305,0,0,553584,1237066,24.63736998950984,312,1814,1519,607,45287,515614,364802,1743,2645,2333,2950,3852,30.199337741083,17.193348457482436,902,1,108653,60770,912,0,1431,1126
2607,1,0,0,0,42,0,311,0,1,493500,1186092,23.748684174075834,437,1566,1439,564,47752,534162,395364,1976,2667,2230,2978,3669,29.58039891549808,11.526200699097002,691,1,106032,25019,875,0,1539,1228
2608,1,0,0,0,40,0,533,0,1,224370,555385,16.64331697709324,0,1364,1087,277,50800,401000,509270,1728,2282,2282,2815,3369,28.460498941515414,17.180890375359095,554,1,70358,13850,810,0,1728,1195
2609,0,0,1,0,55,1,1001,0,0,1682990,5202141,43.485629810317796,1757,2915,2781,1891,47817,696003,519939,2617,4642,2885,3641,5666,29.832867780352597,11.675279088410905,2025,1,357399,26532,890,0,860,1861
2610,0,0,1,0,55,1,1012,0,0,1788864,5354976,44.0,1786,3010,2860,1936,51000,691500,564264,2616,4702,2916,3690,5776,30.397368307141328,12.36812780528175,2086,1,394944,27300,924,0,830,1842
2611,0,0,1,0,59,1,404,0,0,3014700,4596258,39.319206502675,1516,3526,3496,1546,50694,633249,707574,2943,4519,3003,4923,6499,44.15880433163923,5.652706486041966,1576,1,367948,3060,1950,0,1427,1023
2612,0,0,1,0,57,1,694,0,0,74955,2255751,28.089143810376278,512,1161,884,789,39204,566082,566082,2582,3648,3136,2954,4020,9.746794344808963,16.645268827181116,1066,1,156222,36841,95,0,2070,2764
2613,1,0,0,0,44,0,264,1,0,149857,1195610,23.259406699226016,351,1008,818,541,37062,384540,470730,2020,2751,2400,2487,3218,16.64331697709324,14.318161748821744,731,1,115233,15580,277,0,1669,1933
2614,1,0,0,0,43,0,415,1,0,136296,1372425,25.11971337416094,421,1057,847,631,36200,435000,393675,1965,2806,2385,2391,3232,14.696938456699069,14.70857985441067,841,1,114211,32340,216,0,1544,1959
2615,1,0,0,0,43,0,224,0,1,107172,992944,21.400934559032695,218,932,692,458,40548,403248,472624,1928,2626,2408,2402,3100,15.297058540778355,15.736288429356065,698,1,99844,22080,234,0,1710,1934
2616,1,0,0,0,42,0,53,1,0,121448,693481,17.97220075561143,68,954,699,323,40140,386460,478781,1892,2470,2402,2523,3101,19.390719429665317,16.561207264006544,578,1,72029,19890,376,0,1824,1771
2617,1,0,0,0,41,0,613,0,0,191748,1731619,29.0,841,1069,1069,841,55000,452980,514750,2059,2900,2059,2287,3128,15.0996688705415,0.0,841,1,210250,0,228,0,1218,1831
2618,1,0,0,0,41,0,609,0,0,221440,1777575,29.410882339705484,865,1121,1121,865,52377,487035,454155,2055,2920,2055,2311,3176,16.0,0.0,865,1,191165,0,256,0,1190,1799
2619,1,0,0,0,41,0,605,0,0,253650,1831620,29.832867780352597,890,1175,1175,890,40766,448644,384846,2058,2948,2058,2343,3233,16.881943016134134,0.0,890,0,166430,0,285,0,1168,1773
2620,1,0,0,0,41,0,601,0,0,286082,1884668,30.23243291566195,884,1257,1227,914,36616,410338,379408,2032,2976,2092,2375,3319,17.69180601295413,5.5503012171862105,944,0,168176,4470,313,0,1148,1749
2621,1,0,0,0,41,0,589,0,0,356160,1973760,30.983866769659336,930,1361,1331,960,46221,446152,437928,2026,3016,2086,2427,3417,19.261360284258224,5.478746393072713,990,0,204480,4170,371,0,1096,1685
2622,1,0,0,0,41,0,584,0,0,393600,2020152,31.368774282716245,984,1384,1384,984,52836,488614,455766,2053,3037,2053,2453,3437,20.0,0.0,984,0,218448,0,400,0,1069,1653
2623,1,0,0,0,41,0,537,0,0,415810,1987185,31.096623610932426,967,1397,1397,967,53928,517860,439770,2055,3022,2055,2485,3452,20.73644135332772,0.0,967,0,206938,0,430,0,1088,1625
2624,1,0,0,0,41,0,264,0,0,485257,1724891,29.0,811,1448,1418,841,55842,465577,504546,2021,2892,2081,2628,3499,24.020824298928627,5.514871952411144,871,1,206886,3060,577,0,1210,1474
2625,1,0,0,0,40,0,209,0,0,495312,1667904,28.5657137141714,816,1423,1423,816,54264,486472,466032,2044,2860,2044,2651,3467,24.63736998950984,0.0,816,0,186048,0,607,0,1228,1437
2626,1,0,0,0,40,0,156,0,0,503712,1622016,28.142494558940577,762,1458,1428,792,50160,491520,428032,2018,2840,2078,2684,3506,25.219040425836983,5.483301264452448,822,0,165528,5070,636,0,1256,1412
2627,1,0,0,0,40,0,102,0,0,511488,1572864,27.712812921102035,708,1494,1434,768,45741,485376,395264,1988,2816,2108,2714,3542,25.80697580112788,7.748117453886108,828,0,148224,11040,666,0,1280,1382
2628,1,0,0,0,41,0,82,1,0,432600,1454600,26.457513110645905,573,1445,1318,700,33512,490408,295076,1951,2778,2205,2696,3523,24.859605789312106,11.30350933966113,827,1,99400,28956,618,0,1378,1460
2629,1,0,0,0,42,0,98,1,0,368480,1389038,25.65151067676132,488,1388,1218,658,30550,496085,274430,1941,2769,2281,2671,3499,23.664319132398465,13.152397064008891,828,1,85540,40120,560,0,1453,1551
2630,1,0,0,0,40,0,32,0,0,111969,649484,17.86057109949175,289,700,670,319,38472,342048,466244,2006,2355,2066,2387,2736,18.734993995195193,5.753771868478424,349,1,73051,1560,351,0,1717,1685
2631,1,0,0,0,40,0,72,1,0,296820,1030200,22.58317958127243,330,1272,1092,510,36278,377740,391880,1840,2530,2200,2602,3292,24.124676163629637,13.612485340686598,690,1,98940,22140,582,0,1510,1438
2632,1,0,0,0,40,0,218,0,0,535719,1275882,25.11971337416094,289,1822,1480,631,40796,438774,380136,1680,2653,2364,2871,3844,29.13760456866693,18.541474343042776,973,1,118628,57456,849,0,1391,1173
2633,1,0,0,0,42,0,289,0,0,626340,1395240,25.69046515733026,533,1736,1609,660,49800,526386,422800,1987,2774,2241,3063,3850,30.805843601498726,11.781273911446958,787,1,132000,23622,949,0,1454,1165
2634,1,0,0,0,42,0,255,0,1,605476,1388100,25.709920264364882,576,1662,1577,661,54858,468300,516600,2015,2761,2185,3016,3762,30.265491900843113,9.607770959340817,746,1,162606,7310,916,0,1439,1184
2635,1,0,0,0,38,0,647,0,1,122400,296667,12.36931687685298,19,1087,953,153,56882,461482,463421,1805,2092,2073,2739,3026,28.284271247461902,11.825513470936757,287,1,36567,16348,800,0,1786,1139
2636,1,0,0,0,38,0,689,0,1,103632,245872,11.269427669584644,7,1063,943,127,56376,470448,449152,1816,2063,2056,2752,2999,28.5657137141714,11.206010841342998,247,1,29464,16800,816,0,1809,1120
2637,0,1,1,0,56,0,530,0,0,232275,2308895,28.548204847240395,725,1190,1100,815,53946,628926,688419,2743,3648,2923,3118,4023,16.881943016134134,9.515978740065268,905,1,198045,9540,285,0,2018,2548
2638,0,0,1,0,53,1,932,0,0,1225245,4480896,40.82891132518721,1637,2432,2402,1667,44400,645120,497280,2658,4355,2718,3423,5120,27.110883423451916,5.483301264452448,1697,1,308395,5850,735,0,1021,1953
2639,0,0,1,0,53,1,951,0,0,1256206,4559249,41.14608122288197,1693,2435,2435,1693,45120,646320,506284,2693,4386,2693,3435,5128,27.23967694375247,0.0,1693,1,318284,0,742,0,1000,1951
2640,0,0,1,0,54,1,1046,0,0,1653015,5241873,43.71498598878879,1803,2884,2776,1911,50200,688493,548600,2635,4654,2851,3608,5627,29.410882339705484,10.419152549993726,2019,1,382200,20196,865,0,832,1878
2641,0,0,0,0,53,1,182,0,1,1901643,3918180,38.379682124790975,1431,2806,2764,1473,40913,667660,433580,2618,4133,2702,3951,5466,35.93048844644336,6.609134537568676,1515,1,240099,9114,1291,0,1187,1369
2642,1,0,0,0,43,0,111,1,0,149410,731640,18.303005217723125,182,934,781,335,37050,425880,414960,2031,2519,2337,2630,3118,21.118712081942874,12.555809127227581,488,1,63650,20961,446,0,1849,1738
2643,1,0,0,0,42,0,90,0,1,117000,642300,17.320508075688775,60,930,690,300,45448,393944,528827,1901,2441,2381,2531,3071,19.748417658131498,16.02101568709642,540,1,74100,11760,390,0,1841,1751
2644,1,0,0,0,41,0,264,1,0,99540,437850,14.491376746189438,60,834,684,210,39360,341940,500400,1935,2295,2235,2559,2919,21.77154105707724,12.410850817228189,360,1,50400,4350,474,0,1875,1611
2645,1,0,0,0,43,0,140,1,0,136476,664020,17.4928556845359,306,752,752,306,46990,551180,401450,2170,2476,2170,2616,2922,21.118712081942874,0.0,306,1,56610,0,446,0,1864,1724
2646,1,0,0,0,41,0,640,0,0,187044,1764048,29.29163703175362,858,1076,1076,858,50850,464656,462600,2056,2914,2056,2274,3132,14.7648230602334,0.0,858,1,193050,0,218,0,1198,1838
2647,1,0,0,0,41,0,635,0,0,217854,1818684,29.698484809834994,852,1159,1129,882,34668,441268,334044,2032,2944,2092,2309,3221,15.716233645501712,5.490867587491313,912,0,142884,5670,247,0,1180,1815
2648,1,0,0,0,41,0,559,0,0,416792,2018099,31.352830813181765,953,1437,1407,983,48160,441395,459872,2023,3036,2083,2477,3490,20.591260281974,5.477225575051661,1013,0,220192,3690,424,0,1070,1629
2649,1,0,0,0,40,0,503,0,0,434478,1960893,30.93541659651604,957,1411,1411,957,54412,499956,456927,2049,3006,2049,2503,3460,21.307275752662516,0.0,957,0,213411,0,454,0,1092,1595
2650,1,0,0,0,41,0,393,0,0,466198,1863885,30.116440692751194,877,1451,1421,907,56628,497310,480870,2025,2962,2085,2569,3506,22.67156809750927,5.478746393072713,937,0,212238,3930,514,0,1148,1541
2651,1,0,0,0,40,0,231,0,0,502902,1704696,28.879058156387302,834,1437,1437,834,51146,488516,437416,2044,2878,2044,2647,3481,24.55605831561735,0.0,834,0,178476,0,603,0,1210,1441
2652,1,0,0,0,41,0,124,0,0,521781,1614924,28.053520278211074,745,1492,1450,787,41580,474012,369360,2010,2839,2094,2715,3544,25.748786379167466,6.48074069840786,829,0,141660,7980,663,0,1265,1389
2653,1,0,0,0,40,0,68,1,0,477708,1339688,25.65151067676132,327,1715,1384,658,41109,392948,433668,1705,2694,2367,2762,3751,26.94438717061496,18.416597087756077,989,1,140154,36079,726,0,1378,1310
2654,1,0,0,0,40,0,155,1,0,537900,1343100,25.69046515733026,295,1840,1475,660,36200,407000,368335,1670,2695,2400,2850,3875,28.548204847240395,19.12230144663005,1025,1,119460,56210,815,0,1375,1220
2655,1,0,0,0,38,0,679,0,1,84996,208332,10.392304845413264,18,985,895,108,56334,474534,441741,1839,2037,2019,2716,2914,28.053520278211074,9.740037464252968,198,1,24732,12870,787,0,1821,1142
2656,0,1,1,0,60,0,61,0,0,842712,2672880,29.79932885150268,403,2322,1837,888,52877,629090,761530,2525,3898,3495,3959,5332,30.805843601498726,23.196229258852345,1373,1,224664,31525,949,0,2122,2061
2657,0,1,1,0,57,0,426,0,0,311040,2314980,28.460498941515414,618,1386,1194,810,55350,703068,643050,2666,3668,3050,3242,4244,19.595917942265423,13.93476779920133,1002,1,182250,29376,384,0,2048,2474
2658,0,1,1,0,56,0,392,0,0,208593,1942479,26.324893162176366,559,1128,994,693,56069,636281,692341,2669,3496,2937,3104,3931,17.349351572897472,11.633585509503979,827,1,171171,12864,301,0,2110,2502
2659,0,1,1,0,55,0,280,0,0,194769,1673325,24.55605831561735,450,1079,926,603,54750,607725,693750,2622,3378,2928,3098,3854,17.97220075561143,12.52805739248939,756,1,150750,12393,323,0,2172,2452
2660,0,1,1,0,53,0,104,0,0,171185,980025,19.1049731745428,257,942,834,365,54500,585330,671250,2577,3050,2793,3154,3627,21.656407827707714,10.684669642126707,473,1,91250,8532,469,0,2320,2216
2661,0,0,1,0,53,1,633,0,0,997084,3628240,36.932370625238775,1364,2095,2095,1364,50244,563920,630420,2660,4024,2660,3391,4755,27.03701166919155,0.0,1364,1,323268,0,731,0,1296,1929
2662,0,0,1,0,54,1,1029,0,0,1286560,4762560,41.95235392680606,1760,2491,2491,1760,46320,649440,522258,2706,4466,2706,3437,5197,27.03701166919155,0.0,1760,1,339680,0,731,0,946,1975
2663,0,0,1,0,54,1,1086,0,0,1573840,5233400,43.70354676682432,1843,2801,2734,1910,49044,668560,550740,2673,4650,2807,3564,5541,28.705400188814647,8.2143728690235,1977,1,383910,12194,824,0,830,1916
2664,0,0,1,0,57,1,647,0,0,70490,2130282,27.23967694375247,550,1029,837,742,47475,605781,645975,2679,3613,3063,2966,3900,9.746794344808963,13.886752829940423,934,1,166950,22656,95,0,2129,2776
2665,1,0,0,0,44,0,502,1,0,85224,1408740,25.219040425836983,366,1040,770,636,29353,436355,330035,1945,2851,2485,2349,3255,11.575836902790225,16.889160885292643,906,1,94764,49140,134,0,1579,2081
2666,1,0,0,0,43,0,355,1,0,89250,1148700,22.9128784747792,230,990,695,525,43460,448540,463856,1893,2713,2483,2358,3178,13.038404810405298,17.392895378462356,820,1,111300,37170,170,0,1663,2018
2667,1,0,0,0,41,0,315,1,0,89100,372600,13.416407864998739,60,795,675,180,46930,393300,511290,1950,2250,2190,2565,2865,22.24859546128699,11.029743904822288,300,1,44460,6840,495,0,1890,1575
2668,1,0,0,0,41,0,671,0,0,155246,1763151,29.206163733020468,853,1035,1035,853,52000,429936,516750,2067,2920,2067,2249,3102,13.490737563232042,0.0,853,1,213250,0,182,0,1214,1885
2669,1,0,0,0,41,0,664,0,0,185712,1806312,29.597297173897484,876,1088,1088,876,47637,488694,414462,2062,2938,2062,2274,3150,14.560219778561036,0.0,876,0,176076,0,212,0,1186,1850
2670,1,0,0,0,41,0,522,0,0,438823,1998542,31.192947920964443,943,1454,1424,973,41664,394368,445718,2024,3027,2084,2505,3508,21.236760581595302,5.514871952411144,1003,0,211141,3030,451,0,1081,1603
2671,1,0,0,0,40,0,468,0,0,456469,1942603,30.805843601498726,949,1430,1430,949,49952,456481,458528,2047,2996,2047,2528,3477,21.93171219946131,0.0,949,0,212576,0,481,0,1098,1566
2672,1,0,0,0,40,0,359,0,0,486900,1842300,30.0,870,1471,1441,900,53124,476951,466716,2017,2947,2077,2588,3518,23.259406699226016,5.478746393072713,930,0,205200,4170,541,0,1147,1506
2673,1,0,0,0,40,0,305,0,0,500196,1791420,29.597297173897484,846,1477,1447,876,51480,478530,449900,2015,2921,2075,2616,3522,23.895606290697042,5.478746393072713,906,0,192720,4530,571,0,1169,1474
2674,1,0,0,0,40,0,252,0,0,512653,1744385,29.206163733020468,853,1454,1454,853,46295,480575,402865,2045,2898,2045,2646,3499,24.515301344262525,0.0,853,0,168041,0,601,0,1192,1444
2675,1,0,0,0,41,0,199,0,0,523730,1703160,28.809720581775867,830,1461,1461,830,40940,471960,365256,2052,2882,2052,2683,3513,25.11971337416094,0.0,830,0,147740,0,631,0,1222,1421
2676,1,0,0,0,41,0,146,0,0,533427,1661613,28.407745422683583,777,1498,1468,807,38250,463275,350030,2029,2866,2089,2720,3557,25.709920264364882,5.5503012171862105,837,0,137190,5820,661,0,1252,1398
2677,1,0,0,0,41,0,122,0,0,51975,360325,13.228756555322953,25,622,472,175,33180,288260,487983,1909,2234,2209,2356,2681,17.233687939614086,13.83729107805355,325,1,41475,0,297,0,1884,1762
2678,1,0,0,0,41,0,9,1,0,159580,830220,20.09975124224178,374,829,799,404,23436,388395,254820,2025,2459,2085,2450,2884,19.87460691435179,6.148342568763683,434,1,50096,5880,395,0,1651,1660
2679,1,0,0,0,41,0,41,1,0,374736,1217744,24.331050121192877,345,1472,1225,592,27985,397001,298265,1810,2649,2304,2690,3529,25.15949125081825,16.122726236282535,839,1,85840,44707,633,0,1465,1424
2680,1,0,0,0,39,0,547,0,1,126350,343875,13.228756555322953,5,1067,897,175,46706,379245,475530,1795,2140,2135,2687,3032,26.870057685088806,13.42674807141325,345,1,42350,11900,722,0,1790,1243
2681,0,1,1,0,57,0,293,0,0,381128,2229755,27.94637722496424,481,1569,1269,781,54145,699475,630955,2555,3636,3155,3343,4424,22.090722034374522,17.358105696309828,1081,1,172601,47700,488,0,2074,2367
2682,0,1,1,0,56,0,420,0,0,248581,2109559,27.40437921208944,601,1232,1082,751,56334,643261,691014,2659,3560,2959,3140,4041,18.193405398660254,12.270382205646603,901,1,184746,15300,331,0,2058,2478
2683,0,0,1,0,54,1,1132,0,0,1542869,5289009,43.94314508543966,1889,2772,2730,1931,47871,665577,539583,2697,4670,2781,3538,5511,28.26658805020514,6.488991180673202,1973,1,380407,7770,799,0,808,1940
2684,0,0,1,0,60,1,1057,0,0,1090758,1944618,25.337718918639855,307,2676,2341,642,45136,657293,630032,2694,3671,3364,4728,5705,41.2189276910499,18.667722384469624,977,1,133536,48575,1699,0,2387,1330
2685,0,0,1,0,54,1,251,0,0,859410,2909262,32.57299494980466,806,2126,1871,1061,39528,501786,592272,2487,3803,2997,3552,4868,28.460498941515414,15.980739174365313,1316,1,229176,23205,810,0,1681,1932
2686,0,0,1,0,53,1,151,0,0,1858890,3825855,37.960505792204614,1441,2731,2731,1441,46284,605340,538965,2655,4096,2655,3945,5386,35.91656999213594,0.0,1441,0,292523,0,1290,0,1214,1365
2687,1,0,0,0,41,0,249,1,0,96390,437220,14.491376746189438,60,819,669,210,47500,395580,520500,1932,2292,2232,2541,2901,21.42428528562855,12.384480471957746,360,1,52500,7800,459,0,1872,1623
2688,1,0,0,0,45,0,30,0,1,275400,1218780,23.2379000772445,390,1200,1050,540,25137,426573,300181,2107,2797,2407,2767,3457,22.58317958127243,13.130475867068439,690,1,71820,28050,510,0,1717,1747
2689,1,0,0,0,41,0,685,0,0,187950,1843700,29.916550603303182,865,1135,1105,895,47864,510880,397580,2030,2955,2090,2270,3195,14.491376746189438,5.531194905403055,925,0,172735,5790,210,0,1165,1850
2690,1,0,0,0,41,0,672,1,0,254340,1974432,30.692018506445613,875,1279,1212,942,28167,479984,257808,2029,3038,2163,2366,3375,16.431676725154983,8.833574853908106,1009,1,115866,15879,270,0,1154,1826
2691,1,0,0,0,41,0,486,1,0,463680,1987062,31.080540535840107,936,1476,1446,966,37202,366146,429913,2027,3023,2087,2537,3533,21.908902300206645,5.623413251903491,996,1,201894,2790,480,0,1091,1577
2692,1,0,0,0,41,0,432,0,0,480420,1932984,30.692018506445613,942,1452,1452,942,43452,418608,437076,2052,2994,2052,2562,3504,22.58317958127243,0.0,942,0,200646,0,510,0,1110,1542
2693,1,0,0,0,40,0,378,0,0,495720,1879146,30.298514815086232,918,1458,1458,918,46440,442152,440105,2047,2965,2047,2587,3505,23.2379000772445,0.0,918,0,197370,0,540,0,1129,1507
2694,1,0,0,0,40,0,325,0,0,510150,1830275,29.916550603303182,895,1465,1465,895,44844,453990,413090,2045,2940,2045,2615,3510,23.874672772626646,0.0,895,0,180790,0,570,0,1150,1475
2695,1,0,0,0,41,0,220,0,0,535500,1748450,29.154759474226502,850,1480,1480,850,37518,456654,347633,2057,2907,2057,2687,3537,25.099800796022265,0.0,850,0,143650,0,630,0,1207,1427
2696,1,0,0,0,40,0,241,0,0,43320,240120,10.954451150103322,30,571,481,120,33672,276138,488244,1911,2121,2091,2362,2572,19.0,10.564395459581663,210,1,29280,0,361,0,1881,1640
2697,1,0,0,0,38,0,348,0,0,24480,116400,7.745966692414834,30,498,468,60,45034,345320,490820,1910,2000,1970,2348,2438,20.199009876724155,5.531194905403055,90,1,15180,0,408,0,1880,1532
2698,1,0,0,0,38,0,403,0,0,12990,57930,5.477225575051661,30,463,463,30,52611,476957,411303,1931,1961,1931,2364,2394,20.808652046684813,0.0,30,1,6390,0,433,0,1901,1498
2699,1,0,0,0,38,0,391,1,0,53892,210168,10.392304845413264,48,667,607,108,30690,385308,301630,1886,2054,2006,2445,2613,22.338307903688676,8.246211251235321,168,1,16740,10680,499,0,1838,1447
2700,1,0,0,0,39,0,258,1,0,47368,246512,11.135528725660043,29,601,506,124,25272,310128,322056,1893,2112,2083,2370,2589,19.544820285692065,11.144389776194219,219,1,20088,11020,382,0,1864,1606
2701,1,0,0,0,40,0,176,1,0,9156,446246,14.7648230602334,10,488,260,218,15219,350037,182183,1819,2265,2275,2089,2535,6.48074069840786,16.672307136013423,446,1,19402,46740,42,0,1829,2005
2702,1,0,0,0,42,0,88,1,0,63600,638400,17.320508075688775,150,662,512,300,26607,312816,385168,1978,2428,2278,2340,2790,14.560219778561036,13.552624232328649,450,1,54300,12300,212,0,1828,1916
2703,1,0,0,0,41,0,7,1,0,288894,1106982,23.108440016582687,372,1237,1075,534,28140,290220,416673,1911,2607,2235,2614,3310,23.259406699226016,12.82193224364006,696,1,107334,7776,541,0,1539,1532
2704,1,0,0,0,41,0,28,1,0,418413,1314108,25.15949125081825,356,1571,1294,633,35114,375756,402744,1799,2709,2353,2737,3647,25.709920264364882,17.201164008891322,910,1,122802,31578,661,0,1443,1415
2705,1,0,0,0,42,0,278,0,1,356448,999192,21.77154105707724,354,1346,1226,474,46872,531216,392088,1988,2582,2228,2860,3454,27.422618401604176,11.305412972083932,594,1,88164,24120,752,0,1634,1356
2706,1,0,0,0,41,0,377,0,1,226100,668610,17.97220075561143,81,1265,1023,323,44929,370530,519570,1828,2393,2312,2770,3335,26.457513110645905,15.790094819097714,565,1,81073,7744,700,0,1747,1370
2707,0,1,0,1,64,0,867,0,0,2496760,3860820,34.713109915419565,863,3619,3277,1205,52961,804204,676044,2862,4409,3546,5276,6823,45.51922670696417,18.591278770160216,1547,1,254255,59166,2072,0,1999,1132
2708,0,1,1,0,56,0,317,0,0,324750,2133750,27.386127875258307,516,1417,1183,750,56608,694180,660040,2611,3595,3079,3278,4262,20.808652046684813,15.33075055979848,984,1,174000,32526,433,0,2095,2412
2709,0,1,1,0,55,0,360,0,0,259200,2010240,26.832815729997478,538,1262,1080,720,55527,622616,695208,2610,3512,2974,3152,4054,18.973665961010276,13.581456357942667,902,1,179280,16562,360,0,2072,2432
2710,0,1,1,0,54,0,93,0,0,212670,1383630,22.58317958127243,318,1119,927,510,54000,586008,678250,2521,3223,2905,3130,3832,20.42057785666214,14.182970611648413,702,1,127500,14400,417,0,2203,2296
2711,0,0,1,0,53,1,660,0,0,947884,3632650,36.851051545376556,1358,2056,2056,1358,51302,604550,607225,2675,4033,2675,3373,4731,26.419689627245813,0.0,1358,1,308266,0,698,0,1317,1977
2712,0,0,1,0,54,1,1163,0,0,1371414,5153192,43.46262762420146,1889,2615,2615,1889,46172,649264,529232,2728,4617,2728,3454,5343,26.94438717061496,0.0,1889,1,366466,0,726,0,839,2002
2713,0,0,1,0,54,1,1178,0,0,1510848,5348480,44.181444068749045,1922,2756,2726,1952,47959,660340,545260,2710,4692,2770,3514,5496,27.820855486487112,5.501408174353464,1982,1,388448,5460,774,0,788,1966
2714,0,0,1,0,55,1,1186,0,0,1673280,5556096,44.8998886412873,1986,2876,2846,2016,48750,689000,537420,2726,4772,2786,3586,5632,28.809720581775867,5.5965095842615735,2046,1,393120,5760,830,0,740,1926
2715,0,0,1,0,57,1,1044,0,0,1220800,2023700,26.457513110645905,592,2552,2444,700,36192,601328,503034,2783,3591,2999,4635,5443,41.7612260356422,10.613247510664669,808,1,121800,18468,1744,0,2191,1147
2716,0,0,1,0,59,1,271,0,0,361712,2222160,27.422618401604176,176,1809,1233,752,42532,579180,641235,2379,3707,3531,3436,4764,21.93171219946131,24.002187924173185,1328,1,163184,62208,481,0,2203,2474
2717,1,0,0,0,43,0,113,0,1,108030,844350,19.748417658131498,60,997,667,390,45695,400525,534755,1835,2555,2495,2442,3162,16.64331697709324,18.69395290194482,720,1,96330,16500,277,0,1775,1888
2718,1,0,0,0,41,0,710,0,0,162344,1839304,29.866369046136157,892,1074,1074,892,50264,424772,503128,2062,2954,2062,2244,3136,13.490737563232042,0.0,892,1,217648,0,182,0,1170,1880
2719,1,0,0,0,41,0,702,0,0,193768,1881012,30.23243291566195,914,1126,1126,914,48165,508326,401310,2058,2972,2058,2270,3184,14.560219778561036,0.0,914,0,178230,0,212,0,1144,1846
2720,1,0,0,0,40,0,254,1,0,60600,300900,12.24744871391589,26,678,554,150,27435,355062,310930,1882,2156,2130,2410,2684,20.09975124224178,12.571818675157655,274,1,23250,18600,404,0,1856,1602
2721,1,0,0,0,39,0,258,1,0,39528,215244,10.392304845413264,23,559,474,108,17760,239160,294964,1908,2101,2078,2359,2552,19.131126469708992,10.554415716634443,193,1,15984,6630,366,0,1885,1627
2722,1,0,0,0,42,0,178,1,0,24120,566284,16.3707055437449,2,628,358,268,9558,342306,124667,1843,2381,2383,2203,2741,9.486832980505138,16.879656292731575,538,1,15812,58860,90,0,1845,2023
2723,1,0,0,0,41,0,74,0,0,133320,838300,20.09975124224178,374,764,734,404,31266,336150,400475,2045,2479,2105,2405,2839,18.16590212458495,5.791460926441345,434,1,77972,2670,330,0,1671,1745
2724,1,0,0,0,41,0,168,0,0,713745,1582785,27.65863337187866,555,1908,1698,765,42075,465525,386903,1859,2834,2279,3002,3977,30.54504869860253,14.50130676499154,975,1,143055,37380,933,0,1304,1136
2725,0,1,1,0,56,0,246,0,0,341280,2043360,26.832815729997478,443,1471,1194,720,56350,695310,652740,2561,3558,3115,3312,4309,21.77154105707724,16.655504792135552,997,1,165600,39057,474,0,2118,2364
2726,0,1,1,0,55,0,330,0,0,280800,2004480,26.832815729997478,508,1322,1110,720,55527,620832,693216,2572,3504,2996,3174,4106,19.748417658131498,14.675787412724949,932,1,179280,19504,390,0,2064,2394
2727,0,1,1,0,55,0,230,0,0,252000,1734390,25.099800796022265,390,1270,1030,630,53928,589142,693756,2513,3383,2993,3153,4023,20.0,15.802589827616266,870,1,158760,18000,400,0,2123,2353
2728,0,0,1,0,54,1,337,0,0,964620,3172295,34.132096331752024,1015,2143,1993,1165,51984,620844,620844,2573,3888,2873,3551,4866,28.77498913987632,12.254111330655777,1315,1,265620,20100,828,0,1558,1895
2729,0,0,1,0,54,1,472,0,0,952320,3365360,35.21363372331802,1173,2075,2008,1240,54707,616078,654074,2647,3954,2781,3482,4789,27.712812921102035,8.329212945039274,1307,1,298840,7638,768,0,1474,1946
2730,0,0,1,0,52,1,901,0,0,925956,4004911,38.897300677553446,1483,2155,2125,1513,50167,584987,600869,2617,4160,2677,3259,4802,24.73863375370596,5.514871952411144,1543,1,343451,3810,612,0,1134,2035
2731,0,0,1,0,54,1,1198,0,0,1289855,5133058,43.393547907494266,1841,2610,2568,1883,44415,640610,515214,2684,4609,2768,3411,5336,26.1725046566048,6.481658975540136,1925,1,355887,7812,685,0,843,2041
2732,0,0,1,0,54,1,1220,0,0,1428864,5344576,44.181444068749045,1952,2684,2684,1952,46256,646168,536648,2738,4690,2738,3470,5422,27.055498516937366,0.0,1952,1,382592,0,732,0,786,2006
2733,0,0,1,0,54,1,1228,0,0,1585805,5535205,44.88875137492688,2015,2802,2802,2015,47959,662027,546653,2747,4762,2747,3534,5549,28.053520278211074,0.0,2015,1,400985,0,787,0,732,1960
2734,0,0,1,0,55,1,1233,0,0,1829610,5848443,45.858477951192405,2036,3040,2973,2103,44856,700812,495018,2714,4884,2848,3651,5821,29.49576240750525,8.456490803821907,2170,1,374334,13936,870,0,678,1911
2735,0,0,1,0,59,1,1199,0,0,506430,979429,18.193405398660254,264,1928,1861,331,40400,597718,591800,2892,3290,3026,4489,4887,39.11521443121589,8.239962426314323,398,1,66200,9045,1530,0,2628,1429
2736,0,0,0,0,53,1,84,0,1,2023165,3920340,38.27531841800928,1435,2876,2846,1465,39930,647592,441540,2646,4141,2706,4057,5552,37.16180835212409,5.5965095842615735,1495,1,241725,6450,1381,0,1211,1295
2737,1,0,0,0,44,0,589,1,0,64980,1535580,26.153393661244042,324,1139,779,684,35728,455735,395120,1885,2929,2605,2340,3384,9.746794344808963,19.394318800716377,1044,1,120384,58680,95,0,1561,2150
2738,1,0,0,0,44,0,630,0,1,19800,1477080,25.69046515733026,300,1050,690,660,44390,431934,514740,1878,2898,2598,2268,3288,5.477225575051661,19.41700011264206,1020,1,151800,31320,30,0,1578,2208
2739,1,0,0,0,44,0,357,0,1,78030,1127100,22.58317958127243,120,1053,663,510,52836,490620,525980,1820,2720,2600,2363,3263,12.36931687685298,19.9788727966655,900,1,121380,43680,153,0,1700,2057
2740,1,0,0,0,44,0,298,0,1,87360,1056480,21.908902300206645,90,1052,662,480,53165,477617,539245,1811,2681,2591,2383,3253,13.490737563232042,19.95295929800609,870,1,117600,37830,182,0,1721,2019
2741,1,0,0,0,43,0,238,0,1,95400,985950,21.213203435596427,60,1052,662,450,50128,455728,528031,1801,2641,2581,2403,3243,14.560219778561036,19.905583516269473,840,1,108450,35490,212,0,1741,1979
2742,1,0,0,0,43,0,118,1,0,106080,846690,19.748417658131498,60,992,662,390,38700,373412,488475,1841,2561,2501,2443,3163,16.492422502470642,18.747906464209546,720,1,87750,21120,272,0,1781,1899
2743,1,0,0,0,41,0,729,0,0,144342,1851498,29.8496231131986,849,1095,1053,891,47311,388586,525734,2036,2969,2120,2240,3173,12.727922061357855,6.7040592262067955,933,1,225423,1638,162,0,1187,1916
2744,1,0,0,0,41,0,722,0,0,173280,1881456,30.199337741083,882,1132,1102,912,52364,437356,509561,2033,2975,2093,2253,3195,13.784048752090222,5.478746393072713,942,1,225264,2610,190,0,1151,1873
2745,1,0,0,0,41,0,716,0,0,203612,1921238,30.56141357987225,934,1152,1152,934,49245,503965,413457,2057,2991,2057,2275,3209,14.7648230602334,0.0,934,0,187734,0,218,0,1123,1839
2746,1,0,0,0,41,0,572,0,0,465804,2153574,32.03123475609393,941,1565,1480,1026,35496,321147,486968,2014,3125,2184,2553,3664,21.307275752662516,9.855393472241717,1111,1,238032,2125,454,0,1073,1645
2747,1,0,0,0,44,0,150,1,0,405256,1575200,26.758176320519304,592,1406,1282,716,17072,426800,193600,2076,2916,2324,2766,3606,23.790754506740637,11.700176052913939,840,1,63008,28520,566,0,1484,1634
2748,1,0,0,0,42,0,11,1,0,405102,1349484,25.337718918639855,414,1501,1273,642,30360,386768,346830,1874,2744,2330,2733,3603,25.11971337416094,15.523305947390151,870,1,105930,34428,631,0,1460,1471
2749,1,0,0,0,41,0,14,1,0,599027,1605331,27.694764848252458,405,1910,1548,767,25564,347438,322322,1731,2860,2455,2874,4003,27.94637722496424,19.29527580699211,1129,1,118118,49594,781,0,1326,1312
2750,1,0,0,0,41,0,60,1,0,656821,1627604,27.94637722496424,451,1952,1622,781,30668,341776,389708,1754,2865,2414,2925,4036,29.0,18.194028081620004,1111,1,146047,32340,841,0,1303,1243
2751,1,0,0,0,41,0,159,0,1,618570,1476036,26.664583251946766,561,1731,1581,711,55161,504468,471252,1926,2787,2226,2946,3807,29.49576240750525,12.291303419254204,861,1,161397,22500,870,0,1365,1206
2752,0,1,1,0,56,0,191,0,0,344310,1952010,26.267851073127396,390,1489,1189,690,56364,690276,653499,2529,3519,3129,3328,4318,22.338307903688676,17.322239866749324,990,1,159390,41400,499,0,2139,2330
2753,0,1,1,0,56,0,244,0,0,307740,1938210,26.267851073127396,443,1383,1136,690,56088,640452,691014,2562,3499,3056,3255,4192,21.118712081942874,15.727106176144607,937,1,169740,24453,446,0,2119,2363
2754,0,0,1,0,55,1,53,0,0,984354,2804288,31.921779399024736,866,2138,1985,1019,45472,616448,558656,2599,3771,2905,3718,4890,31.080540535840107,12.369845243052126,1172,1,206857,24327,966,0,1733,1786
2755,0,0,1,0,54,1,556,0,0,930732,3466528,35.805027579936315,1252,2038,2008,1282,54189,602992,657072,2674,3986,2734,3430,4742,26.94438717061496,5.572104574801163,1312,1,311526,3180,726,0,1422,1978
2756,0,0,1,0,53,1,599,0,0,925356,3523672,36.15245496505044,1307,2015,2015,1307,52836,598512,641648,2696,4003,2696,3404,4711,26.60826939130014,0.0,1307,1,311066,0,708,0,1389,1988
2757,0,0,1,0,54,1,1240,0,0,1251441,5182371,43.57751713900185,1832,2625,2558,1899,43338,635857,507594,2662,4628,2796,3388,5354,25.67099530598687,8.185808589931957,1966,1,353214,12462,659,0,830,2070
2758,0,0,1,0,54,1,1270,0,0,1501175,5537220,44.88875137492688,1985,2790,2760,2015,44655,629292,535860,2718,4763,2778,3493,5538,27.294688127912362,5.531194905403055,2045,1,392925,5190,745,0,733,2003
2759,0,0,1,0,55,1,164,0,0,965472,2957292,32.68026927673638,749,2291,1972,1068,35156,517803,520572,2450,3837,3088,3673,5060,30.066592756745816,18.832504361731505,1387,1,200784,41151,904,0,1701,1865
2760,0,0,1,0,53,1,60,0,0,1995669,3864354,37.986839826445156,1413,2856,2826,1443,43316,637364,487396,2648,4121,2708,4061,5534,37.1887079635741,5.652706486041966,1473,0,262626,5850,1383,0,1235,1295
2761,1,0,0,0,43,0,181,1,0,101040,922832,20.518284528683193,61,1021,661,421,38247,401136,458128,1832,2613,2552,2432,3213,15.491933384829668,19.672151382036557,781,1,87989,36360,240,0,1771,1952
2762,1,0,0,0,45,0,113,1,0,186468,855782,19.467922333931785,252,998,871,379,33708,478696,359022,2131,2637,2385,2750,3256,22.181073012818835,11.338657706151796,506,1,60261,24257,492,0,1879,1766
2763,1,0,0,0,41,0,737,0,0,159600,1888752,30.199337741083,882,1117,1087,912,52118,426626,523963,2041,2983,2101,2246,3188,13.228756555322953,5.501408174353464,942,1,230736,1890,175,0,1159,1896
2764,1,0,0,0,43,0,149,1,0,495006,1693812,27.964262908219126,722,1475,1415,782,20640,465690,207936,2106,2948,2226,2799,3641,25.15949125081825,8.660254037844387,842,1,75072,14640,633,0,1384,1533
2765,1,0,0,0,41,0,151,0,1,592602,1446954,26.419689627245813,548,1697,1547,698,53502,460206,499593,1923,2771,2223,2922,3770,29.13760456866693,12.27795318108085,848,1,168218,16350,849,0,1375,1224
2766,1,0,0,0,40,0,169,0,1,486366,1266282,24.859605789312106,558,1465,1405,618,55304,456927,508152,1989,2667,2109,2836,3514,28.053520278211074,7.745966692414834,678,1,153264,5640,787,0,1431,1262
2767,0,1,0,1,66,0,2932,0,0,7988700,15470550,68.19090848492928,3808,7210,6368,4650,53808,785172,758556,2485,7977,4169,5045,10537,41.44876355212541,29.119022112909082,5492,1,1060200,119564,1718,0,1323,1609
2768,0,1,0,1,66,0,2168,0,0,8255985,13848615,64.45928947793328,3434,6863,6142,4155,51865,843249,683265,2612,7488,4054,5320,10196,44.57577817604534,26.995375533069822,4876,1,851775,129059,1987,0,822,1346
2769,0,1,0,1,66,0,2073,0,0,8292328,13679883,64.00781202322104,3371,6847,6121,4097,52877,844767,697851,2613,7436,4065,5363,10186,44.98888751680797,27.103289838714982,4823,1,856273,126324,2024,0,758,1315
2770,0,1,1,0,56,0,150,0,0,336600,1858560,25.69046515733026,351,1479,1170,660,56400,675840,661760,2507,3476,3125,3326,4295,22.58317958127243,17.58005252942577,969,1,155100,38625,510,0,2156,2306
2771,0,1,1,0,56,0,175,0,0,320100,1852620,25.69046515733026,375,1430,1145,660,56386,654031,679294,2522,3467,3092,3292,4237,22.02271554554524,16.893621987501874,945,1,159720,31065,485,0,2147,2322
2772,0,1,1,0,55,0,204,0,0,304317,1848444,25.748786379167466,393,1392,1122,663,56870,655180,674696,2518,3451,3058,3247,4180,21.42428528562855,16.496433576864867,933,1,160446,31050,459,0,2125,2329
2773,0,0,1,0,53,1,639,0,0,904932,3568131,36.373066958946424,1323,2007,2007,1323,51980,609522,620310,2697,4020,2697,3381,4704,26.153393661244042,0.0,1323,1,304290,0,684,0,1374,2013
2774,0,0,1,0,55,1,1315,0,0,1470714,5607861,45.13313638558703,1977,2819,2759,2037,45080,633190,539588,2693,4790,2813,3475,5572,26.870057685088806,7.864259938752337,2097,1,399252,10380,722,0,716,2031
2775,0,0,1,0,55,1,1312,0,0,1846745,6012205,46.52956049652737,2135,3048,3018,2165,46624,688696,522076,2747,4942,2807,3630,5825,29.206163733020468,5.501408174353464,2195,1,407020,5940,853,0,612,1924
2776,0,0,1,0,55,1,112,0,0,1303313,3308041,34.62657938636157,987,2498,2286,1199,33820,491102,524210,2547,3958,2971,3846,5257,32.96968304366907,15.42479684557981,1411,1,227810,24380,1087,0,1560,1672
2777,0,0,1,0,53,1,46,0,0,1898355,3751878,37.429934544425805,1401,2756,2756,1401,44712,578448,554346,2678,4079,2678,4033,5434,36.810324638611924,0.0,1401,0,290007,0,1355,0,1277,1323
2778,1,0,0,0,45,0,365,1,0,122324,1309790,24.020824298928627,182,1184,789,577,37961,424490,460810,1875,2847,2665,2482,3454,14.560219778561036,20.32529007722004,972,1,117131,44240,212,0,1693,2058
2779,1,0,0,0,45,0,483,1,0,97308,1440540,25.219040425836983,228,1197,789,636,35838,448470,409965,1857,2901,2673,2418,3462,12.36931687685298,20.636127029016333,1044,1,115116,61608,153,0,1629,2112
2780,1,0,0,0,45,0,601,0,1,66120,1575048,26.38181191654584,276,1211,791,696,45576,488808,477493,1843,2959,2683,2358,3474,9.746794344808963,20.94710640380162,1116,1,146856,59220,95,0,1567,2168
2781,1,0,0,0,45,0,651,0,1,29106,1564101,26.324893162176366,273,1155,735,693,48108,476227,514596,1837,2950,2677,2299,3412,6.48074069840786,20.906515063476174,1113,1,158004,47880,42,0,1564,2215
2782,1,0,0,0,42,0,174,1,0,103987,528827,15.716233645501712,65,850,668,247,33325,331855,460315,1959,2388,2323,2562,2991,20.518284528683193,14.249103215689319,429,1,53105,9282,421,0,1894,1720
2783,1,0,0,0,42,0,519,1,0,136512,407424,13.856406460551018,72,1023,903,192,21522,447742,216444,2002,2314,2242,2833,3145,26.664583251946766,11.320779839735554,312,1,19584,28440,711,0,1930,1411
2784,1,0,0,0,43,0,375,1,0,163314,563730,16.06237840420901,124,1025,891,258,18304,454480,192280,2051,2443,2319,2818,3210,25.15949125081825,13.118865017421564,392,1,22704,32562,633,0,1927,1552
2785,1,0,0,0,47,0,456,1,0,260497,1858107,28.053520278211074,757,1148,1118,787,40656,545391,415536,2331,3148,2391,2692,3509,18.193405398660254,5.572104574801163,817,1,138512,5850,331,0,1574,2030
2786,1,0,0,0,45,0,78,0,1,384120,1508760,25.69046515733026,510,1392,1242,660,48697,532638,477774,2136,2946,2436,2868,3678,24.124676163629637,12.470060607585795,810,1,137940,24450,582,0,1626,1704
2787,1,0,0,0,41,0,739,0,0,206280,1970165,30.903074280724887,955,1171,1171,955,45248,462112,416726,2063,3018,2063,2279,3234,14.696938456699069,0.0,955,0,192910,0,216,0,1108,1847
2788,1,0,0,0,41,0,734,1,0,236192,2016416,31.240998703626616,976,1218,1218,976,33022,431794,326428,2066,3042,2066,2308,3284,15.556349186104045,0.0,976,1,154208,0,242,0,1090,1824
2789,1,0,0,0,42,0,4,0,0,131765,783655,19.1049731745428,23,1068,726,365,48260,407930,545338,1805,2512,2489,2508,3215,19.0,19.942660131436398,707,1,92710,13338,361,0,1782,1786
2790,1,0,0,0,39,0,104,1,0,28272,246388,11.135528725660043,29,447,352,124,15272,365608,164921,1892,2111,2082,2215,2434,15.0996688705415,11.560495330392458,219,1,10292,21280,228,0,1863,1759
2791,1,0,0,0,40,0,7,1,0,31850,369824,13.490737563232042,29,510,357,182,11375,355600,132080,1879,2214,2185,2207,2542,13.228756555322953,14.307589169369836,335,1,11830,34884,175,0,1850,1857
2792,1,0,0,0,38,0,465,0,1,61884,210492,10.392304845413264,0,789,681,108,48600,389800,473607,1841,2057,2057,2522,2738,23.93741840717165,10.684669642126707,216,1,26244,8316,573,0,1841,1376
2793,0,1,0,1,66,0,2641,0,0,8163036,14762272,66.84309986827361,3727,7036,6295,4468,55930,786352,776440,2563,7772,4045,5131,10340,42.74342054632502,27.294503710781903,5209,1,1049980,98553,1827,0,1164,1477
2794,0,1,1,0,56,0,64,0,0,356580,1769670,25.099800796022265,329,1497,1196,630,54808,696632,620789,2508,3439,3110,3375,4306,23.790754506740637,17.70875669762007,931,1,139230,44548,566,0,2179,2243
2795,0,1,1,0,55,0,136,0,0,312345,1757335,25.11971337416094,330,1427,1126,631,56628,651690,673970,2484,3416,3086,3280,4212,22.24859546128699,17.41452153216854,932,1,152702,33712,495,0,2154,2290
2796,0,0,1,0,55,1,1358,0,0,1498959,5735961,45.59605246071199,2012,2867,2800,2079,46367,642847,549041,2692,4838,2826,3480,5626,26.851443164195103,8.20171446926608,2146,1,413721,11591,721,0,680,2038
2797,0,0,1,0,55,1,1356,0,0,1686541,5933967,46.292547996410825,2143,2930,2930,2143,42504,639639,509496,2769,4912,2769,3556,5699,28.053520278211074,0.0,2143,1,394312,0,787,0,626,1982
2798,0,0,1,0,55,1,1353,0,0,1755004,6000772,46.51881339845203,2164,2975,2975,2164,44415,651655,524097,2773,4937,2773,3584,5748,28.478061731796284,0.0,2164,1,408996,0,811,0,609,1962
2799,0,0,1,0,59,1,433,0,0,2690498,4296744,37.92097045171708,1343,3404,3309,1438,39816,708156,501984,2893,4426,3083,4859,6392,43.255057507764334,9.82390283601982,1533,1,241584,19760,1871,0,1550,1117
2800,0,0,1,0,57,1,515,0,0,2818596,4164490,37.960505792204614,1229,3609,3397,1441,51728,705160,612680,2678,4331,3102,4846,6499,44.22668877499196,14.952366174434152,1653,1,305492,36040,1956,0,1449,934
2801,1,0,0,0,41,0,393,1,0,81450,313050,12.24744871391589,65,778,693,150,40002,369399,471662,2002,2237,2172,2630,2865,23.302360395462088,9.568061544601736,235,1,33900,5950,543,0,1937,1544
2802,1,0,0,0,42,0,560,1,0,144384,405312,13.856406460551018,42,1094,944,192,24304,413756,261764,1961,2303,2261,2863,3205,27.422618401604176,12.899034672654562,342,1,23808,30600,752,0,1919,1359
2803,1,0,0,0,45,0,16,1,0,227465,1104830,22.02271554554524,358,1081,954,485,38157,539886,366758,2151,2763,2405,2747,3359,21.656407827707714,11.33196341945808,612,1,78085,27178,469,0,1793,1809
2804,1,0,0,0,45,0,72,0,1,426420,1579410,26.267851073127396,556,1442,1308,690,45900,515025,466956,2155,2979,2423,2907,3731,24.859605789312106,11.691581880872027,824,1,140760,21440,618,0,1599,1671
2805,1,0,0,0,41,0,743,0,0,202460,1971120,30.903074280724887,925,1197,1167,955,41769,456144,390096,2034,3019,2094,2276,3261,14.560219778561036,5.652706486041966,985,0,180495,5130,212,0,1109,1852
2806,1,0,0,0,45,0,144,0,1,312912,1451988,25.219040425836983,402,1362,1128,636,31878,452034,367563,2049,2919,2517,2775,3645,22.181073012818835,15.436568313836048,870,1,102396,40248,492,0,1647,1791
2807,1,0,0,0,41,0,162,0,0,107008,531712,16.0,14,916,674,256,42140,357244,508865,1835,2333,2319,2495,2993,20.445048300260872,16.78101775240627,498,1,62720,8228,418,0,1821,1659
2808,1,0,0,0,40,0,584,1,0,87792,248496,11.135528725660043,16,940,832,124,18486,316632,234468,1896,2128,2112,2712,2944,26.60826939130014,11.516883551890645,232,1,14508,17604,708,0,1880,1296
2809,1,0,0,0,43,0,175,1,0,118724,967069,21.047565179849187,293,861,711,443,23368,277241,401672,2033,2626,2333,2451,3044,16.3707055437449,13.59540590085461,593,1,81512,7200,268,0,1740,1915
2810,1,0,0,0,43,0,83,1,0,351708,1376304,25.219040425836983,528,1297,1189,636,23895,292140,383028,2056,2800,2272,2717,3461,23.515952032609693,10.448863694758844,744,1,112572,7452,553,0,1528,1611
2811,1,0,0,0,42,0,51,1,0,484462,1545802,26.870057685088806,504,1611,1393,722,29666,348983,389662,1923,2863,2359,2812,3752,25.903667693977237,14.881567710587273,940,1,131404,22454,671,0,1419,1470
2812,1,0,0,0,42,0,22,1,0,688779,1800581,29.0,480,2021,1660,841,27633,323291,391803,1780,2982,2502,2960,4162,28.61817604250837,19.246264105905396,1202,1,153903,31046,819,0,1300,1322
2813,1,0,0,0,39,0,417,0,1,67084,243288,11.135528725660043,0,789,665,124,49735,398286,480690,1838,2086,2086,2503,2751,23.259406699226016,11.56292174611876,248,1,30380,9796,541,0,1838,1421
2814,0,1,1,0,55,0,23,0,0,375024,1679795,24.515301344262525,333,1493,1225,601,54656,681980,626080,2527,3396,3063,3419,4288,24.979991993593593,16.470309108515075,869,1,134624,36984,624,0,2194,2171
2815,0,1,1,0,55,0,23,0,0,346200,1678200,24.49489742783178,328,1449,1177,600,55370,685265,632122,2525,3397,3069,3374,4246,24.020824298928627,16.93572431587857,872,1,135600,37536,577,0,2197,2220
2816,0,0,1,0,55,1,1391,0,0,1800912,6135460,46.97871858618538,2207,3023,3023,2207,48175,653300,569900,2780,4987,2780,3596,5803,28.5657137141714,0.0,2207,1,452435,0,816,0,573,1964
2817,1,0,0,0,44,0,349,1,0,91700,1175856,22.891046284519195,103,1120,699,524,43472,468996,466752,1823,2768,2665,2419,3364,13.228756555322953,20.942780273870824,945,1,108992,56835,175,0,1720,2069
2818,1,0,0,0,44,0,238,0,1,106248,1041044,21.587033144922902,66,1094,694,466,41748,437864,475842,1834,2700,2634,2462,3328,15.0996688705415,20.983107800946563,866,1,99258,44800,228,0,1768,2006
2819,1,0,0,0,44,0,9,0,1,120042,774306,18.734993995195193,66,978,693,351,37410,383844,474290,1921,2557,2491,2548,3184,18.49324200890693,18.01173406283156,636,1,75465,22800,342,0,1855,1864
2820,1,0,0,0,43,0,48,0,1,119833,708016,17.97220075561143,67,950,694,323,34760,346336,482240,1936,2515,2448,2563,3142,19.261360284258224,17.095668131953637,579,1,71060,12800,371,0,1869,1821
2821,1,0,0,0,42,0,217,0,1,111078,518122,15.556349186104045,67,876,701,242,35266,329714,490289,1966,2383,2316,2600,3017,21.42428528562855,14.028067812123815,417,1,55418,5425,459,0,1899,1682
2822,1,0,0,0,44,0,182,0,0,224043,873103,19.77371993328519,175,1180,964,391,44781,564949,395241,2017,2624,2449,2806,3413,23.93741840717165,14.698198320279001,607,1,69207,44496,573,0,1842,1660
2823,1,0,0,0,45,0,50,1,0,248376,1204676,22.891046284519195,397,1125,998,524,28560,482790,312664,2172,2823,2426,2773,3424,21.77154105707724,11.298832705339896,651,1,71264,26543,474,0,1775,1825
2824,1,0,0,0,45,0,151,0,1,409680,1648800,26.832815729997478,519,1490,1289,720,47961,501510,501510,2089,3010,2491,2859,3780,23.853720883753127,14.277791876442175,921,1,157680,27135,569,0,1570,1721
2825,1,0,0,0,41,0,728,0,0,174420,1905768,30.298514815086232,888,1138,1108,918,53172,438036,523152,2046,2994,2106,2266,3214,13.784048752090222,5.684275577662207,948,1,231336,2220,190,0,1158,1886
2826,1,0,0,0,41,0,736,0,0,188337,1933968,30.610455730027933,937,1138,1138,937,53124,480912,470592,2064,3001,2064,2265,3202,14.177446878757825,0.0,937,0,213636,0,201,0,1127,1863
2827,1,0,0,0,45,0,132,0,1,298144,1412488,24.819347291981714,348,1368,1100,616,44730,481530,488409,2025,2909,2561,2777,3661,22.0,16.54041876222127,884,1,131208,34840,484,0,1677,1809
2828,1,0,0,0,42,0,73,0,0,148824,750087,18.734993995195193,16,1110,775,351,47690,406030,536387,1802,2488,2472,2561,3247,20.591260281974,19.70088779398469,686,1,88101,16415,424,0,1786,1713
2829,1,0,0,0,43,0,73,1,0,467208,1559523,26.851443164195103,539,1551,1369,721,29992,352569,397992,1981,2884,2345,2811,3714,25.45584412271571,13.520067743263182,903,1,132664,18382,648,0,1442,1515
2830,1,0,0,0,43,0,34,1,0,706992,1852422,29.29163703175362,497,2043,1682,858,27180,326009,388620,1798,3017,2520,2983,4202,28.705400188814647,19.016053414530607,1219,1,154440,32129,824,0,1301,1335
2831,1,0,0,0,40,0,276,0,1,136192,515328,16.0,171,873,788,256,55926,481107,471042,1928,2269,2098,2545,2886,23.065125189341593,9.412769291411893,341,1,59904,10370,532,0,1757,1481
2832,0,1,0,1,65,0,2443,0,0,8402108,14363063,66.08328079022712,3712,6946,6291,4367,53212,825539,697268,2634,7656,3944,5213,10235,43.86342439892262,25.650103461581985,5022,1,925804,113315,1924,0,1078,1365
2833,0,1,0,1,65,0,2398,0,0,8415720,14289372,65.86349520030045,3690,6926,6278,4338,51912,830088,678564,2646,7632,3942,5234,10220,44.04543109109048,25.523607237718004,4986,1,893628,116640,1940,0,1044,1354
2834,0,1,1,0,66,0,2168,0,0,8478393,13872210,64.73793323855806,3561,6844,6214,4191,53250,827500,705030,2680,7501,3940,5333,10154,44.97777228809804,25.208013394661382,4821,0,892683,107730,2023,1,881,1287
2835,0,1,0,1,68,0,937,0,0,8765514,11929972,58.872744118140105,2825,6636,5995,3466,53212,863942,729704,2801,6908,4083,5971,10078,50.28916384272063,25.32684624303497,4107,1,734792,104483,2529,0,24,913
2836,0,1,0,1,66,0,1291,0,0,3430812,4353328,36.27671429443411,529,4710,3923,1316,55822,747608,817076,2521,4624,4095,5915,8018,51.05878964487897,28.070727373825584,2103,1,325052,76339,2607,0,1992,701
2837,0,1,1,0,55,0,34,0,0,344280,1586880,23.874672772626646,328,1416,1174,570,55125,682080,626400,2542,3354,3026,3388,4200,24.576411454889016,15.945523188210656,812,1,128250,33880,604,0,2214,2180
2838,0,1,1,0,55,0,9,0,0,330030,1583460,23.874672772626646,330,1389,1149,570,56386,672276,647274,2538,3348,3018,3357,4167,24.06241883103193,15.829319512027459,810,1,132810,30960,579,0,2208,2199
2839,0,0,1,0,53,1,38,0,0,1895768,3665242,36.851051545376556,1328,2784,2754,1358,36349,601877,439937,2669,4057,2729,4095,5483,37.36308338453881,5.684275577662207,1388,0,221354,5940,1396,0,1341,1303
2840,1,0,0,0,44,0,178,0,1,119528,995026,21.118712081942874,67,1093,714,446,52580,490820,533209,1852,2677,2610,2499,3324,16.3707055437449,20.025015527605827,825,1,106594,41311,268,0,1785,1963
2841,1,0,0,0,44,0,11,0,1,127062,802192,19.026297590440446,67,1008,713,362,44850,432120,509680,1921,2578,2511,2567,3224,18.734993995195193,18.385017694392122,657,1,83260,26255,351,0,1854,1865
2842,1,0,0,0,44,0,140,1,0,248109,973384,20.808652046684813,205,1234,1006,433,26445,483320,276504,2020,2681,2476,2821,3482,23.93741840717165,15.14852031581832,661,1,53259,51300,573,0,1815,1675
2843,1,0,0,0,46,0,80,1,0,272976,1308480,23.748684174075834,430,1182,1048,564,30660,487200,338720,2186,2884,2454,2804,3502,22.0,11.583726138680884,698,1,82344,26800,484,0,1756,1836
2844,1,0,0,0,46,0,263,1,0,401964,1814291,27.910571473905726,779,1295,1295,779,40182,421549,517038,2329,3108,2329,2845,3624,22.715633383201094,0.0,779,1,172938,0,516,0,1550,1813
2845,1,0,0,0,43,0,150,1,0,564400,1817700,28.809720581775867,800,1540,1510,830,20909,444570,225570,2160,3020,2220,2870,3730,26.076809620810597,5.830951894845301,860,1,85490,6870,680,0,1360,1510
2846,1,0,0,0,44,0,149,1,0,499260,1753690,28.0178514522438,700,1506,1421,785,19475,457970,212230,2149,3019,2319,2870,3740,25.219040425836983,9.412769291411893,870,1,74575,20060,636,0,1449,1598
2847,1,0,0,0,42,0,92,0,0,164348,770336,19.026297590440446,12,1166,816,362,51912,438368,536256,1778,2490,2478,2582,3294,21.307275752662516,19.992151631441793,712,1,91224,19950,454,0,1766,1674
2848,1,0,0,0,39,0,398,1,0,71288,267062,11.575836902790225,74,726,666,134,33598,312901,426502,1933,2127,2053,2525,2719,23.065125189341593,9.02186804273364,194,1,28676,3360,532,0,1859,1461
2849,1,0,0,0,38,0,317,1,0,34170,163030,9.219544457292887,43,529,487,85,27939,385518,266602,1876,2003,1960,2320,2447,20.049937655763422,6.73127350780198,127,1,11815,8232,402,0,1833,1516
2850,1,0,0,0,44,0,223,1,0,106938,1016825,21.37755832643195,210,938,691,457,30173,469475,318175,1978,2682,2472,2459,3163,15.297058540778355,17.234908893302006,704,1,65351,50388,234,0,1768,1991
2851,1,0,0,0,43,0,88,1,0,710400,1730400,28.284271247461902,487,2001,1688,800,29294,326613,419622,1850,2963,2476,3051,4164,29.79932885150268,18.169820954575776,1113,1,155200,22536,888,0,1363,1275
2852,0,1,1,0,66,0,1562,0,0,8710848,12774888,61.91930232165088,3149,6791,6106,3834,51957,836332,689724,2647,7166,4017,5604,10123,47.66550115125194,26.32490686593869,4519,0,793638,113710,2272,1,502,1060
2853,0,1,1,0,55,0,119,0,0,355860,1494720,23.2379000772445,330,1409,1199,540,54531,689232,606192,2558,3308,2978,3427,4177,25.67099530598687,14.692526380756615,750,1,118260,32130,659,0,2228,2109
2854,0,0,1,0,54,1,521,0,0,917196,3421943,35.397740040855716,1253,1985,1985,1253,51968,611744,633592,2731,3984,2731,3463,4716,27.055498516937366,0.0,1253,1,290696,0,732,0,1478,1999
2855,0,0,1,0,58,1,525,0,0,2460784,5427437,43.04648650006177,1823,3211,3181,1853,48800,714676,585800,2899,4782,2959,4257,6140,36.4417343165772,5.478746393072713,1883,1,370600,5460,1328,0,1076,1601
2856,0,0,1,0,59,1,144,0,0,2558017,4948734,40.90232267243512,1643,3232,3202,1673,52576,733584,627096,2928,4631,2988,4487,6190,39.102429592034305,5.501408174353464,1703,1,354676,5190,1529,0,1285,1429
2857,0,0,1,0,57,1,128,0,0,325380,1833612,25.25866188063018,426,1360,1148,638,38200,574800,548934,2662,3512,3086,3384,4234,22.58317958127243,14.743339197993663,850,1,121858,30316,510,0,2236,2364
2858,1,0,0,0,42,0,348,1,0,118720,450712,14.560219778561036,62,922,772,212,28086,321026,395436,1976,2338,2276,2686,3048,23.664319132398465,12.967447346601379,362,1,39432,12450,560,0,1914,1566
2859,1,0,0,0,43,0,637,1,0,179988,457496,14.560219778561036,42,1231,1061,212,20414,373334,254644,1988,2370,2328,3007,3389,29.13760456866693,14.229707211083644,382,1,25016,30940,849,0,1946,1309
2860,1,0,0,0,46,0,162,0,1,482040,1797120,27.92848008753788,568,1610,1398,780,44935,495360,481536,2092,3084,2516,2922,3914,24.859605789312106,14.64762860497819,992,1,163020,30104,618,0,1524,1686
2861,1,0,0,0,41,0,728,0,0,251904,2039832,31.368774282716245,984,1240,1240,984,48800,505812,414600,2073,3057,2073,2329,3313,16.0,0.0,984,0,196800,0,256,0,1089,1817
2862,1,0,0,0,41,0,735,0,0,268804,2090252,31.670175244226233,973,1301,1271,1003,40344,512664,341776,2054,3087,2114,2352,3385,16.3707055437449,5.753771868478424,1033,0,164492,6510,268,0,1081,1816
2863,1,0,0,0,43,0,150,1,0,629584,1906192,29.5296461204668,872,1594,1594,872,27406,421898,310412,2186,3058,2186,2908,3780,26.870057685088806,0.0,872,1,123824,0,722,0,1314,1464
2864,1,0,0,0,42,0,79,0,0,193362,853848,20.049937655763422,11,1274,883,402,52371,439668,537372,1733,2526,2515,2605,3398,21.93171219946131,20.839465388117805,793,1,101706,25024,481,0,1722,1643
2865,1,0,0,0,39,0,387,0,1,80550,298350,12.24744871391589,150,687,687,150,38243,455481,332163,1989,2139,1989,2526,2676,23.173260452512935,0.0,150,1,25050,0,537,0,1839,1452
2866,1,0,0,0,40,0,334,0,0,99560,382090,13.784048752090222,37,867,714,190,32148,283551,458508,1858,2201,2164,2535,2878,22.891046284519195,13.58085755909821,343,1,43320,1836,524,0,1821,1487
2867,1,0,0,0,42,0,55,1,0,64524,601375,16.822603841260722,25,769,511,283,24416,476000,231625,1867,2408,2383,2353,2894,15.0996688705415,18.62712375313323,541,1,30847,62694,228,0,1842,1897
2868,1,0,0,0,44,0,195,1,0,183654,1203417,23.173260452512935,387,1029,879,537,26520,304776,436995,2091,2778,2391,2583,3270,18.49324200890693,13.770282276639803,687,1,104715,7350,342,0,1704,1899
2869,1,0,0,0,43,0,157,1,0,265800,1312800,24.49489742783178,558,1085,1043,600,24939,334764,356644,2146,2788,2230,2631,3273,21.047565179849187,6.7597809605921,642,1,97800,4620,443,0,1588,1745
2870,1,0,0,0,44,0,134,1,0,344792,1453522,25.65151067676132,628,1212,1182,658,17664,406456,212064,2179,2867,2239,2733,3421,22.891046284519195,6.405979164606015,688,1,63168,6390,524,0,1551,1685
2871,1,0,0,0,44,0,114,1,0,437647,1599178,26.851443164195103,601,1448,1328,721,25756,303866,416984,2098,2939,2338,2825,3666,24.63736998950984,11.206010841342998,841,1,135548,6960,607,0,1497,1611
2872,1,0,0,0,44,0,107,1,0,472548,1639058,27.258026340878022,593,1529,1379,743,26460,308840,416934,2056,2949,2356,2842,3735,25.219040425836983,12.331628572798303,893,1,140427,9150,636,0,1463,1570
2873,1,0,0,0,40,0,142,0,1,291984,962220,21.77154105707724,407,1157,1090,474,46995,395850,489230,1963,2504,2097,2646,3187,24.819347291981714,8.222029866439447,541,1,114234,4958,616,0,1556,1414
2874,0,1,1,0,65,0,2198,0,0,8639243,13948204,65.09224224129939,3664,6849,6276,4237,52710,826292,691320,2719,7529,3865,5331,10141,45.155287619502545,24.014057378354998,4810,0,889770,100275,2039,1,945,1253
2875,0,1,1,0,54,0,93,0,0,311998,1409388,22.67156809750927,298,1337,1121,514,56644,652596,652596,2526,3256,2958,3349,4079,24.63736998950984,14.797954287357964,730,1,122332,25920,607,0,2228,2135
2876,0,0,1,0,56,1,1396,0,0,1977696,6368544,47.62352359916263,2268,3140,3140,2268,41860,645840,511056,2808,5076,2808,3680,5948,29.5296461204668,0.0,2268,1,412776,0,872,0,540,1936
2877,0,0,1,0,58,1,575,0,0,2405850,5460720,43.18564576337837,1835,3185,3155,1865,48158,708576,582672,2898,4793,2958,4218,6113,35.91656999213594,5.483301264452448,1895,1,371135,5460,1290,0,1063,1638
2878,0,0,1,0,58,1,520,0,0,2425641,5390109,42.883563284783136,1839,3158,3158,1839,47083,700509,577407,2931,4770,2931,4250,6089,36.318039594669756,0.0,1839,1,362283,0,1319,0,1092,1612
2879,0,0,1,0,58,1,464,0,0,2442576,5318220,42.567593307585526,1812,3160,3160,1812,47718,707335,581130,2935,4747,2935,4283,6095,36.71511950137164,0.0,1812,1,358776,0,1348,0,1123,1587
2880,0,0,1,0,58,1,355,0,0,2472800,5181440,41.95235392680606,1760,3165,3165,1760,49200,724224,588800,2944,4704,2944,4349,6109,37.48332962798263,0.0,1760,0,352000,0,1405,0,1184,1539
2881,0,0,1,0,58,1,300,0,0,2486556,5110098,41.641325627314025,1734,3168,3168,1734,49446,724962,592347,2947,4681,2947,4381,6115,37.86819245752297,0.0,1734,0,348534,0,1434,0,1213,1513
2882,0,0,1,0,59,1,188,0,0,2554365,4484832,38.82009788756334,1507,3202,3202,1507,51129,735072,616032,2976,4483,2976,4671,6178,41.1703777004778,0.0,1507,1,311949,0,1695,0,1469,1281
2883,1,0,0,0,43,0,449,1,0,244992,699886,17.86057109949175,49,1357,1087,319,21970,370786,285220,1924,2513,2464,2962,3551,27.712812921102035,17.616381969411314,589,1,41470,44550,768,0,1875,1426
2884,1,0,0,0,47,0,131,1,0,330372,1521128,25.37715508089904,482,1319,1157,644,27720,467676,330680,2200,3006,2524,2875,3681,22.64950330581225,12.850301615905524,806,1,90160,30942,513,0,1718,1849
2885,1,0,0,0,46,0,154,1,0,534296,1891960,28.495613697550013,685,1597,1470,812,35552,410080,470660,2203,3142,2457,2988,3927,25.65151067676132,11.368721298642535,939,1,164024,12573,658,0,1518,1672
2886,1,0,0,0,41,0,713,1,0,274230,2052270,31.464265445104548,960,1297,1267,990,50032,439476,489228,2043,3063,2103,2350,3370,16.64331697709324,5.477225575051661,1020,1,233640,3120,277,0,1083,1796
2887,1,0,0,0,41,0,723,0,0,287280,2085552,31.74901573277509,1008,1293,1293,1008,52779,498629,453111,2069,3077,2069,2354,3362,16.881943016134134,0.0,1008,0,220752,0,285,0,1061,1784
2888,1,0,0,0,41,0,731,0,0,302670,2128950,32.03123475609393,1026,1321,1321,1026,47498,527050,388025,2075,3101,2075,2370,3396,17.175564037317667,0.0,1026,0,191862,0,295,0,1049,1780
2889,1,0,0,0,43,0,741,0,0,497142,2519553,34.161381705077446,1014,1746,1593,1167,36260,528955,319532,2006,3326,2312,2585,3905,20.639767440550294,13.053492324047044,1320,1,172716,34884,426,0,992,1733
2890,1,0,0,0,42,0,54,0,0,220171,946691,21.047565179849187,26,1357,940,443,41452,367564,515017,1720,2580,2554,2634,3494,22.293496809607955,20.634334556251584,860,1,106763,0,497,0,1694,1640
2891,1,0,0,0,39,0,330,1,0,91800,358380,13.416407864998739,180,690,690,180,39528,430056,364353,1991,2171,1991,2501,2681,22.58317958127243,0.0,180,1,32940,0,510,0,1811,1481
2892,1,0,0,0,41,0,282,0,0,182619,640866,17.578395831246947,32,1177,900,309,47760,412726,497760,1797,2383,2351,2665,3251,24.310491562286437,17.816220302588206,586,1,74160,22437,591,0,1765,1483
2893,1,0,0,0,40,0,332,0,0,127680,464664,15.0996688705415,38,978,788,228,36000,326080,458550,1848,2266,2228,2598,3016,23.664319132398465,15.17291299205353,418,1,51300,8550,560,0,1810,1478
2894,1,0,0,0,39,0,258,1,0,61200,294300,12.24744871391589,60,648,558,150,21090,362970,223668,1872,2112,2052,2370,2610,20.199009876724155,10.564395459581663,240,1,17100,18000,408,0,1812,1554
2895,1,0,0,0,45,0,224,0,1,157200,1179000,22.891046284519195,282,1066,824,524,38700,506250,387000,2008,2774,2492,2550,3316,17.320508075688775,17.01646294184693,766,1,90128,46464,300,0,1726,1950
2896,1,0,0,0,44,0,55,1,0,715806,1809171,28.61817604250837,457,2055,1693,819,29172,344604,413083,1847,3028,2571,3083,4264,29.563490998188964,19.804817580644276,1181,1,153153,31494,874,0,1390,1335
2897,0,1,1,0,65,0,1383,0,0,3381088,4193262,35.679125549822544,432,4770,3929,1273,53676,701622,830088,2453,4567,4135,5950,8064,51.536394906900505,29.028750934202186,2114,1,320796,59711,2656,0,2021,638
2898,0,1,1,0,54,0,175,0,0,314400,1315680,21.908902300206645,327,1288,1135,480,56144,663322,635912,2588,3221,2894,3396,4029,25.592967784139454,12.52805739248939,633,1,111360,20196,655,0,2261,2086
2899,0,0,1,0,56,1,1231,0,0,2046966,6180012,46.61544808322666,2143,3145,3115,2173,35266,651276,437976,2814,5017,2874,3786,5989,30.692018506445613,5.490867587491313,2203,0,334642,6390,942,0,671,1902
2900,0,0,1,0,57,1,902,0,0,2233320,5830776,44.85532298401161,1982,3152,3122,2012,46376,718704,541926,2868,4910,2928,4008,6050,33.31666249791537,5.684275577662207,2042,0,376244,5970,1110,0,886,1788
2901,0,0,1,0,58,1,792,0,0,2286153,5694813,44.26059195266146,1959,3126,3126,1959,47142,706401,563958,2907,4866,2907,4074,6033,34.161381705077446,0.0,1959,0,380046,0,1167,0,948,1740
2902,0,0,1,0,58,1,515,0,0,2390750,5354550,42.720018726587654,1825,3135,3135,1825,46948,710028,569196,2934,4759,2934,4244,6069,36.193922141707716,0.0,1825,0,354050,0,1310,0,1109,1624
2903,0,0,1,0,59,1,146,0,0,2513240,4499608,38.91015291668744,1484,3204,3174,1514,51360,713280,636008,2942,4486,3002,4632,6176,40.74309757492672,5.483301264452448,1544,0,323996,4920,1660,0,1458,1312
2904,0,0,1,0,55,1,138,0,0,2129760,3847488,37.30951621235526,1325,2989,2922,1392,32860,585968,428420,2697,4156,2831,4294,5753,39.11521443121589,8.239962426314323,1459,1,215760,12931,1530,0,1372,1234
2905,1,0,0,0,43,0,337,1,0,140118,522720,15.556349186104045,92,971,821,242,33901,360720,438480,2010,2402,2310,2739,3131,24.06241883103193,12.785844799727476,392,1,49126,12450,579,0,1918,1581
2906,1,0,0,0,41,0,715,0,0,129750,313500,12.24744871391589,0,1165,1015,150,40424,518320,340670,1940,2240,2240,2955,3255,29.410882339705484,12.470060607585795,300,1,24450,32850,865,0,1940,1225
2907,1,0,0,0,48,0,384,0,1,467236,2176526,30.033314835362415,778,1544,1420,902,49504,533273,540512,2289,3315,2537,2931,3957,22.759613353482084,11.442020048593916,1026,1,202048,16244,518,0,1511,1895
2908,1,0,0,0,41,0,719,0,0,323016,2138304,32.12475680841802,1002,1375,1345,1032,46830,435120,462056,2042,3104,2102,2385,3447,17.69180601295413,5.490867587491313,1062,0,230136,3540,313,0,1040,1759
2909,1,0,0,0,41,0,727,0,0,339150,2171400,32.4037034920393,1020,1403,1373,1050,52974,502524,450824,2038,3118,2098,2391,3471,17.97220075561143,5.477225575051661,1080,0,228900,4830,323,0,1018,1745
2910,1,0,0,0,41,0,733,0,0,357780,2215032,32.68026927673638,1068,1403,1403,1068,49276,526796,402356,2074,3142,2074,2409,3477,18.303005217723125,0.0,1068,0,207192,0,335,0,1006,1739
2911,1,0,0,0,41,0,281,0,0,220850,731850,18.708286933869708,44,1287,981,350,41216,384744,468384,1785,2441,2397,2722,3378,25.11971337416094,17.603930539450378,656,1,78400,25092,631,0,1741,1460
2912,1,0,0,0,40,0,385,0,0,110784,388224,13.856406460551018,58,903,769,192,34960,307344,465060,1888,2214,2156,2599,2925,24.020824298928627,11.813552510959783,326,1,44160,3350,577,0,1830,1445
2913,1,0,0,0,39,0,340,1,0,63516,262372,11.575836902790225,104,638,608,134,26058,395516,252582,1928,2092,1988,2432,2596,21.77154105707724,6.249099805534655,164,1,17286,6180,474,0,1824,1484
2914,1,0,0,0,42,0,65,1,0,94734,734958,18.49324200890693,23,938,619,342,26061,470631,255731,1830,2491,2468,2426,3087,16.64331697709324,20.101259637482983,661,1,40698,74008,277,0,1807,1872
2915,1,0,0,0,45,0,222,0,1,192888,1274640,23.748684174075834,336,1134,906,564,41860,519800,411320,2032,2824,2488,2602,3394,18.49324200890693,16.277893278954082,792,1,102648,42636,342,0,1696,1918
2916,0,1,1,0,65,0,2270,0,0,8811459,14138014,65.67343450741707,3781,6888,6356,4313,53984,789998,734272,2746,7591,3810,5321,10166,45.19955751995809,23.11793585424094,4845,0,966112,80864,2043,1,1035,1235
2917,0,1,1,0,66,0,1619,0,0,8902082,12912310,62.457985878508765,3337,6747,6183,3901,52948,807640,718270,2746,7211,3874,5592,10057,47.77028364998475,23.87623413621749,4465,0,846517,91932,2282,1,591,1028
2918,0,1,1,0,54,0,227,0,0,304650,1227600,21.213203435596427,316,1261,1127,450,56619,662904,635624,2594,3178,2862,3405,3989,26.019223662515376,11.65306661673843,584,1,104850,17822,677,0,2278,2051
2919,0,0,1,0,56,1,1339,0,0,1937250,6270048,47.05316142407437,2214,3089,3089,2214,34503,614544,450288,2832,5046,2832,3707,5921,29.58039891549808,0.0,2214,1,352026,0,875,0,618,1957
2920,0,0,1,0,57,1,1174,0,0,2045547,6098247,46.184412955021955,2133,3092,3092,2133,38280,663288,471735,2859,4992,2859,3818,5951,30.967725134404045,0.0,2133,0,351945,0,959,0,726,1900
2921,0,0,1,0,57,1,1065,0,0,2111200,5984160,45.60701700396552,2050,3125,3095,2080,43737,687603,526491,2847,4957,2907,3892,6002,31.85906464414798,5.490867587491313,2110,0,380640,5850,1015,0,797,1862
2922,0,0,1,0,57,1,954,0,0,2171872,5847036,45.0111097397076,2026,3098,3098,2026,44469,701298,528138,2886,4912,2886,3958,5984,32.7414110874898,0.0,2026,0,370758,0,1072,0,860,1814
2923,0,0,1,0,58,1,787,0,0,2252310,5656060,44.10215414239989,1945,3103,3103,1945,45496,703736,546704,2908,4853,2908,4066,6011,34.02939905434711,0.0,1945,0,365660,0,1158,0,963,1750
2924,1,0,0,0,41,0,734,0,0,417360,2299920,33.31666249791537,1110,1486,1486,1110,45540,524216,372960,2072,3182,2072,2448,3558,19.390719429665317,0.0,1110,0,199800,0,376,0,962,1696
2925,1,0,0,0,41,0,171,1,0,103246,510796,15.716233645501712,180,732,665,247,39245,345356,485980,2001,2315,2135,2486,2800,20.445048300260872,8.804782210438667,314,1,58045,2881,418,0,1821,1650
2926,1,0,0,0,40,0,203,0,1,106320,486960,15.491933384829668,210,713,683,240,39790,351017,466670,1999,2269,2059,2472,2742,21.047565179849187,6.300703649796459,270,1,55200,1740,443,0,1789,1586
2927,1,0,0,0,40,0,218,0,1,109920,483840,15.491933384829668,240,698,698,240,35904,387072,376992,2016,2256,2016,2474,2714,21.400934559032695,0.0,240,1,44880,0,458,0,1776,1558
2928,1,0,0,0,41,0,284,1,0,131157,512525,15.716233645501712,152,873,778,247,30457,475175,275975,1980,2322,2170,2606,2948,23.043437243605826,10.890370454394295,342,1,32851,21850,531,0,1828,1544
2929,1,0,0,0,45,0,190,1,0,309071,1486045,25.67099530598687,532,1255,1128,659,25330,335995,383350,2128,2914,2382,2724,3510,21.656407827707714,11.83366848156067,786,1,112030,12319,469,0,1596,1786
2930,1,0,0,0,45,0,160,1,0,410916,1637856,26.94438717061496,631,1387,1292,726,25414,437664,295536,2161,2982,2351,2822,3643,23.790754506740637,10.60004836173973,821,1,95106,18525,566,0,1530,1690
2931,1,0,0,0,44,0,124,1,0,615525,1906005,29.13760456866693,621,1802,1574,849,25256,345730,368180,2017,3094,2473,2970,4047,26.92582403567252,15.388702409555231,1077,1,139236,25308,725,0,1396,1520
2932,1,0,0,0,44,0,22,1,0,727488,1891132,29.017236257093817,471,2077,1706,842,31920,377328,426740,1875,3088,2617,3110,4323,29.393876913398138,19.407499378433613,1213,1,159980,37842,864,0,1404,1382
2933,1,0,0,0,41,0,92,0,1,278784,993168,22.0,334,1210,1060,484,38080,348840,459648,1902,2536,2202,2628,3262,24.0,12.429640165330436,634,1,108416,9300,576,0,1568,1476
2934,0,1,1,0,65,0,2103,0,0,8921070,13835040,64.94613152451807,3734,6817,6333,4218,51706,823280,675680,2796,7498,3764,5395,10097,45.98912915026767,22.065656847491287,4702,0,868908,87120,2115,1,938,1165
2935,0,0,1,0,57,1,1060,0,0,2078396,5943882,45.45327270945405,2066,3072,3072,2066,44770,696234,532245,2877,4943,2877,3883,5949,31.71750305430741,0.0,2066,0,382210,0,1006,0,811,1871
2936,0,0,1,0,60,1,426,0,0,569287,1716997,23.895606290697042,486,1653,1568,571,36888,697624,478113,2922,3578,3092,4004,4660,31.575306807693888,9.265143265380413,656,1,90789,17935,997,0,2436,2010
2937,0,0,1,0,54,1,148,0,0,1594749,3222846,34.51086785347479,1191,2530,2530,1191,42180,616968,500610,2706,3897,2706,4045,5236,36.59234892706397,0.0,1191,0,220335,0,1339,0,1515,1367
2938,1,0,0,0,41,0,504,0,0,123120,374940,13.416407864998739,180,864,864,180,38304,466592,356193,2083,2263,2083,2767,2947,26.153393661244042,0.0,180,0,30780,0,684,0,1903,1399
2939,1,0,0,0,44,0,489,0,0,306850,796727,19.0,42,1530,1211,361,42330,549543,375190,1888,2568,2526,3057,3737,29.154759474226502,18.9270116117719,680,1,61370,68266,850,0,1846,1357
2940,1,0,0,0,45,0,160,1,0,366921,1220769,23.043437243605826,189,1564,1222,531,30315,494285,324159,1957,2830,2641,2990,3863,26.28687885618983,18.49991856302218,873,1,74871,71820,691,0,1768,1608
2941,1,0,0,0,41,0,726,0,0,435240,2306772,33.406586176980134,1086,1536,1506,1116,46830,434070,460941,2037,3183,2097,2457,3603,19.748417658131498,5.501408174353464,1146,0,248868,3540,390,0,951,1677
2942,1,0,0,0,41,0,732,0,0,455868,2346246,33.67491648096547,1134,1536,1536,1134,45496,500698,388972,2069,3203,2069,2471,3605,20.049937655763422,0.0,1134,0,213192,0,402,0,935,1667
2943,1,0,0,0,46,0,134,0,1,544592,1868904,28.42534080710379,700,1590,1482,808,26750,494982,289125,2205,3121,2421,2987,3903,25.96150997149434,10.508183387917892,916,1,101000,23976,674,0,1505,1639
2944,1,0,0,0,42,0,56,1,0,112785,652917,17.578395831246947,175,808,674,309,35903,340193,471199,1979,2422,2247,2478,2921,19.1049731745428,12.276872470465587,443,1,68907,6700,365,0,1804,1748
2945,1,0,0,0,40,0,130,0,1,109344,554880,16.492422502470642,242,704,674,272,49022,393720,518160,2010,2312,2070,2442,2744,20.049937655763422,5.652706486041966,302,1,69088,1440,402,0,1768,1638
2946,1,0,0,0,38,0,378,1,0,100440,350640,13.416407864998739,180,738,738,180,42292,424664,377912,1948,2128,1948,2506,2686,23.62202362203543,0.0,180,1,34920,0,558,0,1768,1390
2947,1,0,0,0,40,0,171,1,0,108630,518925,15.968719422671311,93,843,681,255,16652,368335,187220,1873,2290,2197,2461,2878,20.639767440550294,14.39051556633979,417,1,23460,34506,426,0,1780,1609
2948,1,0,0,0,45,0,223,0,1,257448,1439311,25.11971337416094,397,1273,1039,631,37107,494977,390051,2047,2912,2515,2689,3554,20.199009876724155,16.331589874630957,865,1,107901,43056,408,0,1650,1873
2949,1,0,0,0,45,0,204,0,1,313357,1527867,25.903667693977237,501,1308,1138,671,28014,366597,396198,2107,2948,2447,2744,3585,21.61018278497431,13.722642351958527,841,1,116754,18530,467,0,1606,1810
2950,0,1,1,0,65,0,1936,0,0,9023312,13547340,64.21837743200929,3674,6762,6312,4124,53250,821250,699705,2835,7409,3735,5473,10047,46.776062254106,21.30076012915067,4574,0,878412,76950,2188,1,839,1097
2951,0,1,1,0,65,0,1844,0,0,9034652,13389338,63.76519426771944,3612,6742,6288,4066,51957,826543,681651,2839,7359,3747,5515,10035,47.138094997570704,21.418969972050128,4520,0,841662,81266,2222,1,773,1071
2952,0,0,1,0,57,1,1166,0,0,1979640,6035796,45.89117562233506,2076,3076,3046,2106,43848,664912,541674,2836,4972,2896,3806,5942,30.659419433511783,5.483301264452448,2136,1,398034,5490,940,0,760,1926
2953,0,0,1,0,57,1,1112,0,0,2013440,5969600,45.60701700396552,2050,3078,3048,2080,43845,680190,530950,2840,4950,2900,3838,5948,31.11269837220809,5.531194905403055,2110,1,384800,5760,968,0,790,1902
2954,0,0,1,0,60,1,1072,0,0,239780,571140,13.784048752090222,40,1602,1452,190,38024,583164,589176,2856,3196,3156,4268,4608,35.52463933666322,12.312788037888811,340,1,37240,19500,1262,0,2816,1744
2955,0,0,1,0,59,1,1042,0,0,402600,893100,17.320508075688775,3,1939,1642,300,40704,571584,631124,2680,3277,3274,4319,4916,36.6333181680284,17.274619134080364,597,1,63600,32373,1342,0,2677,1635
2956,1,0,0,0,41,0,445,1,0,137550,439320,14.491376746189438,180,895,865,210,27178,447688,265684,2062,2302,2122,2747,2987,25.592967784139454,5.572104574801163,240,1,26670,6600,655,0,1882,1437
2957,1,0,0,0,48,0,262,1,0,648695,2288899,30.773365106858236,797,1782,1632,947,45548,466481,570412,2267,3364,2567,3102,4199,26.1725046566048,12.439392632724381,1097,1,223492,11850,685,0,1470,1732
2958,1,0,0,0,46,0,288,0,1,597060,2142720,30.495901363953813,569,1933,1572,930,55615,523008,564480,1943,3234,2665,2946,4237,25.337718918639855,19.009323940636236,1291,1,227850,38627,642,0,1374,1662
2959,1,0,0,0,44,0,510,0,1,783216,2633064,34.292856398964496,881,2137,1842,1176,38979,476907,409737,1944,3415,2534,2905,4376,25.80697580112788,17.686024435274142,1471,1,215208,49560,666,0,1063,1573
2960,1,0,0,0,43,0,95,1,0,156546,968266,21.118712081942874,161,1082,797,446,23408,288743,382096,1886,2617,2456,2522,3253,18.734993995195193,17.58501981577856,731,1,78496,18810,351,0,1725,1820
2961,1,0,0,0,42,0,19,1,0,115850,749000,18.708286933869708,200,831,681,350,34050,321000,485780,1990,2490,2290,2471,2971,18.193405398660254,13.206671381360312,500,1,79450,4350,331,0,1790,1809
2962,1,0,0,0,42,0,0,1,0,112225,709865,18.303005217723125,211,794,670,335,39284,341159,517036,1995,2454,2243,2454,2913,18.303005217723125,11.892071150027212,459,1,81740,2232,335,0,1784,1784
2963,1,0,0,0,41,0,38,0,1,109863,650727,17.69180601295413,246,731,664,313,42840,353430,523908,2012,2392,2146,2430,2810,18.734993995195193,8.694308756644029,380,1,78876,938,351,0,1766,1728
2964,1,0,0,0,41,0,56,0,1,110772,628524,17.4928556845359,264,710,668,306,43172,353288,515554,2012,2360,2096,2416,2764,19.026297590440446,6.570697549716149,348,1,76806,0,362,0,1748,1692
2965,1,0,0,0,41,0,198,1,0,159943,656048,17.69180601295413,163,974,824,313,38060,461120,362608,1946,2409,2246,2607,3070,22.60530911091463,13.265214125244757,463,1,54149,27750,511,0,1783,1585
2966,1,0,0,0,40,0,421,0,0,160446,491744,15.556349186104045,157,990,905,242,29898,306832,402336,1947,2274,2117,2695,3022,25.748786379167466,9.265143265380413,327,1,47916,5695,663,0,1790,1369
2967,1,0,0,0,39,0,313,1,0,115758,431422,14.7648230602334,158,809,749,218,27060,435380,243417,1919,2197,2039,2510,2788,23.043437243605826,8.39589984422804,278,1,26814,13800,531,0,1761,1448
2968,1,0,0,0,45,0,176,0,1,220740,1281990,23.790754506740637,242,1280,956,566,36186,502830,369195,1941,2831,2589,2655,3545,19.748417658131498,18.684416857933613,890,1,92258,64152,390,0,1699,1875
2969,1,0,0,0,45,0,150,0,1,595000,1948200,29.154759474226502,638,1762,1550,850,30394,382764,417144,2080,3142,2504,2992,4054,26.457513110645905,15.255261758639925,1062,1,154700,23108,700,0,1442,1592
2970,0,0,0,0,55,1,175,1,0,1263600,2862080,32.2490309931942,890,2405,2255,1040,44888,498112,682496,2602,3792,2902,3967,5157,34.85685011586675,12.639835959643802,1190,1,257920,6300,1215,0,1712,1537
2971,1,0,0,0,42,0,490,1,0,177144,517396,15.556349186104045,50,1166,974,242,34454,344218,457532,1946,2380,2330,2870,3304,27.055498516937366,14.307589169369836,434,1,51788,12096,732,0,1896,1406
2972,1,0,0,0,42,0,535,0,0,291450,715895,18.303005217723125,40,1500,1205,335,47752,542798,401756,1842,2472,2432,3007,3637,29.49576240750525,17.570335756864036,630,1,62980,56935,870,0,1802,1267
2973,1,0,0,0,45,0,363,0,0,387610,1051684,21.61018278497431,43,1721,1297,467,34506,547236,319784,1828,2719,2676,3082,3973,28.809720581775867,21.691544738471443,891,1,66314,97944,830,0,1785,1422
2974,1,0,0,0,48,0,266,0,1,694647,2360432,31.25699921617557,802,1863,1688,977,53724,536352,584672,2241,3393,2591,3127,4279,26.664583251946766,13.3741791114057,1152,1,236434,18725,711,0,1439,1705
2975,1,0,0,0,47,0,178,1,0,750720,2265600,30.983866769659336,683,2019,1742,960,45504,453120,559320,2083,3320,2637,3142,4379,27.964262908219126,16.695186711087423,1237,1,227520,21052,782,0,1400,1578
2976,1,0,0,0,41,0,725,0,0,540174,2456196,34.38022687534217,1182,1639,1639,1182,46398,461316,434302,2078,3260,2078,2535,3717,21.37755832643195,0.0,1182,0,247038,0,457,0,896,1621
2977,1,0,0,0,41,0,730,0,0,564000,2500800,34.64101615137755,1170,1700,1670,1200,41300,491824,364700,2054,3284,2114,2554,3784,21.6794833886788,5.652706486041966,1230,0,210000,6000,470,0,884,1614
2978,1,0,0,0,45,0,417,0,1,841068,2594442,33.896902513356586,891,2139,1881,1149,35185,512566,349990,2000,3407,2516,2990,4397,27.055498516937366,16.550298932473556,1407,1,178095,54180,732,0,1109,1526
2979,1,0,0,0,43,0,120,1,0,130356,929958,20.639767440550294,208,950,732,426,31132,375476,395123,1965,2609,2401,2489,3133,17.4928556845359,15.96398994252774,644,1,77106,25506,306,0,1757,1877
2980,1,0,0,0,43,0,91,1,0,117300,847688,19.77371993328519,229,853,691,391,39674,359888,518152,2006,2559,2330,2468,3021,17.320508075688775,14.13620988103143,553,1,93449,5670,300,0,1777,1868
2981,1,0,0,0,42,0,75,0,1,113176,806520,19.390719429665317,242,811,677,376,37392,326040,527670,2011,2521,2279,2446,2956,17.349351572897472,12.793850855972996,510,1,92496,0,301,0,1769,1844
2982,1,0,0,0,42,0,56,0,1,110772,766354,19.026297590440446,254,776,668,362,39093,332369,527133,2009,2479,2225,2423,2893,17.4928556845359,11.25033949080533,470,1,90138,0,306,0,1755,1811
2983,1,0,0,0,41,0,38,0,1,109863,734994,18.734993995195193,266,749,664,351,41164,343416,525594,2009,2445,2179,2407,2843,17.69180601295413,9.759997214798725,436,1,88101,0,313,0,1743,1781
2984,1,0,0,0,41,0,0,0,1,112225,688425,18.303005217723125,305,700,670,335,47120,390450,509640,2025,2390,2085,2390,2755,18.303005217723125,5.652706486041966,365,1,83080,1620,335,0,1720,1720
2985,1,0,0,0,40,0,19,0,1,115850,676564,18.193405398660254,331,681,681,331,42845,427196,419020,2044,2375,2044,2394,2725,18.708286933869708,0.0,331,1,67855,0,350,0,1713,1694
2986,1,0,0,0,42,0,179,1,0,195842,763820,19.026297590440446,146,1119,903,362,36503,445210,365030,1894,2472,2326,2651,3229,23.259406699226016,15.511530043917954,578,1,62626,38016,541,0,1748,1569
2987,1,0,0,0,40,0,435,0,0,176896,519936,16.0,214,989,947,256,33227,302619,452913,1989,2287,2073,2722,3020,26.28687885618983,6.589126398255297,298,1,57088,1386,691,0,1775,1340
2988,1,0,0,0,40,0,243,1,0,136948,543772,16.3707055437449,148,899,779,268,15840,401742,162320,1909,2297,2149,2540,2928,22.60530911091463,12.346399965104396,388,1,21440,28800,511,0,1761,1518
2989,1,0,0,0,46,0,151,0,1,660972,2055168,29.866369046136157,637,1888,1633,892,31110,391680,421632,2049,3196,2559,3045,4192,27.2213151776324,16.64114744906307,1147,1,163236,28560,741,0,1412,1563
2990,1,0,0,0,46,0,145,1,0,699504,2097600,30.199337741083,635,1956,1679,912,31820,395600,425500,2023,3212,2577,3067,4256,27.694764848252458,17.363170339092083,1189,1,168720,31024,767,0,1388,1533
2991,1,0,0,0,45,0,14,0,1,717360,1916880,28.982753492378876,505,2029,1694,840,43392,438144,515732,1947,3122,2617,3136,4311,29.223278392404914,18.584154950164088,1175,1,189840,30820,854,0,1442,1428
2992,1,0,0,0,40,0,60,0,1,175500,793650,19.748417658131498,180,1050,840,390,39162,372405,435490,1825,2425,2245,2485,3085,21.213203435596427,14.742402984169178,600,1,83460,19530,450,0,1645,1585
2993,0,1,1,0,65,0,1783,0,0,9206634,13301174,63.671029518926424,3659,6720,6325,4054,50600,830093,656200,2886,7335,3676,5552,10001,47.65501022977542,19.966823791691695,4449,0,810800,73865,2271,1,773,1010
2994,0,0,1,0,57,1,1043,0,0,1991558,5853114,45.0111097397076,1936,3099,3009,2026,41184,676026,508464,2799,4915,2979,3872,5988,31.352830813181765,9.664766342822109,2116,1,356576,17730,983,0,863,1906
2995,0,0,1,0,59,1,253,0,0,2344830,4211670,37.54996671103717,1276,3207,3073,1410,49020,681036,642205,2853,4397,3121,4650,6194,40.779897008207364,11.59192030070629,1544,1,303150,20100,1663,0,1577,1324
2996,0,0,1,0,59,1,769,0,0,657666,1529253,22.64950330581225,351,1957,1795,513,38218,587257,578314,2819,3494,3143,4263,4938,35.805027579936315,12.803033322522062,675,1,99522,22032,1282,0,2468,1699
2997,1,0,0,0,47,0,193,1,0,792608,2369888,31.496031496047245,724,2059,1791,992,47824,468244,582916,2121,3381,2657,3188,4448,28.26658805020514,16.412088255480956,1260,1,242048,18760,799,0,1397,1590
2998,1,0,0,0,46,0,240,1,0,742500,2314620,31.464265445104548,651,2079,1740,990,50148,465262,589176,1999,3328,2677,3088,4417,27.386127875258307,18.423517200609112,1329,1,249480,20001,750,0,1348,1588
2999,1,0,0,0,41,0,722,0,0,585395,2511767,34.741905532080416,1207,1692,1692,1207,52170,489035,461982,2081,3288,2081,2566,3773,22.02271554554524,0.0,1207,0,267954,0,485,0,874,1596
3000,1,0,0,0,44,0,648,1,0,816624,2858184,35.832945734337834,1014,2190,1920,1284,25863,518658,247086,1956,3510,2496,2862,4416,25.219040425836983,17.466079346167888,1554,1,142524,65610,636,0,942,1590
3001,1,0,0,0,46,0,214,0,1,533195,1971385,29.068883707497267,755,1566,1476,845,32804,550588,324287,2243,3178,2423,2964,3899,25.11971337416094,9.987225542826152,935,1,117455,20700,631,0,1488,1702
3002,1,0,0,0,46,0,216,0,1,389025,1733199,27.2213151776324,531,1476,1266,741,48768,449088,594106,2129,3080,2549,2864,3815,22.9128784747792,14.684716722173809,951,1,188214,9450,525,0,1598,1814
3003,1,0,0,0,42,0,130,0,1,109344,859074,20.049937655763422,278,798,674,402,36900,320550,525702,2013,2539,2261,2409,2935,16.492422502470642,12.28429660001341,526,1,98892,0,272,0,1735,1865
3004,1,0,0,0,42,0,113,0,1,108030,824460,19.748417658131498,295,762,667,390,37884,325556,520044,2019,2504,2209,2391,2876,16.64331697709324,10.67666744507216,485,1,95940,0,277,0,1724,1837
3005,1,0,0,0,41,0,76,0,1,109445,766857,19.261360284258224,329,708,666,371,42000,347256,516750,2025,2438,2109,2362,2775,17.175564037317667,6.7040592262067955,413,1,92750,0,295,0,1696,1772
3006,1,0,0,0,40,0,268,1,0,157605,573705,16.881943016134134,190,933,838,285,20907,416691,203313,1918,2298,2108,2566,2946,23.515952032609693,10.72886966703452,380,1,28785,22230,553,0,1728,1460
3007,1,0,0,0,46,0,201,0,1,349300,1619800,26.457513110645905,423,1476,1199,700,34719,492882,377182,2037,3014,2591,2813,3790,22.338307903688676,17.351840431116628,977,1,114100,51799,499,0,1614,1815
3008,1,0,0,0,46,0,180,0,1,555901,1945233,29.0,623,1720,1502,841,31416,432531,388584,2095,3154,2531,2974,4033,25.709920264364882,15.72935506734506,1059,1,141288,32700,661,0,1472,1652
3009,0,1,0,1,65,0,2492,0,0,9383733,14874651,67.47592163134935,4000,7167,6614,4553,55000,718740,816750,2714,7820,3820,5328,10434,45.39823785126467,23.546650872519187,5106,1,1138250,48111,2061,0,1286,1206
3010,0,1,1,0,65,0,1660,0,0,9296700,13111140,63.166446789415026,3611,6699,6320,3990,52290,818214,690060,2907,7276,3665,5616,9985,48.27007354458868,19.58481191175014,4369,0,837900,66325,2330,1,704,956
3011,0,1,1,0,66,0,1134,0,0,9282312,12105132,60.54750201288241,3093,6771,6198,3666,52290,822198,693420,2729,6968,3875,5834,10073,50.3189825016365,24.053226175114784,4239,0,769860,100275,2532,1,364,770
3012,0,1,0,1,67,0,482,0,0,9195683,11112955,57.29746940310715,2609,6758,6084,3283,44022,856405,588990,2711,6668,4059,6186,10143,52.92447448959697,26.891115195474878,3957,1,571242,136148,2801,0,102,584
3013,0,1,1,0,55,0,660,0,0,367200,993600,18.973665961010276,300,1440,1380,360,52896,640320,629280,2700,3120,2820,3780,4200,31.937438845342623,7.880145860644973,420,1,82080,8280,1020,0,2400,1740
3014,0,0,1,0,55,1,745,0,0,917000,3876600,37.416573867739416,1160,2295,2055,1400,45732,614718,570414,2529,4169,3009,3424,5064,25.592967784139454,15.505095502968933,1640,1,288400,36960,655,0,1369,2114
3015,0,0,1,0,60,1,989,0,0,780626,1556590,22.759613353482084,348,2195,2025,518,54858,670115,739230,2835,3523,3175,4512,5200,38.82009788756334,13.28071670500598,688,1,127428,17000,1507,0,2487,1498
3016,0,0,1,0,59,1,252,0,0,109440,679668,15.0996688705415,138,798,708,228,45760,620048,655820,2891,3209,3071,3461,3779,21.908902300206645,9.543708938032719,318,1,50160,10710,480,0,2753,2501
3017,0,0,1,0,54,1,256,0,0,1472016,2969148,33.04542328371661,1062,2470,2440,1092,44946,538362,617213,2689,3811,2749,4067,5189,36.71511950137164,5.652706486041966,1122,0,247884,2940,1348,1,1627,1371
3018,0,0,1,0,58,1,1085,0,0,2147100,2964120,31.937438845342623,858,3287,3125,1020,45704,674192,572482,2744,3926,3068,5011,6193,45.880278987817846,12.803033322522062,1182,1,200940,28350,2105,0,1886,801
3019,1,0,0,0,41,0,190,0,0,189000,730800,18.708286933869708,350,890,890,350,51700,490680,459360,2088,2438,2088,2628,2978,23.2379000772445,0.0,350,0,77000,0,540,0,1738,1548
3020,1,0,0,0,42,0,429,1,0,255940,715225,18.303005217723125,16,1418,1099,335,27318,335195,371490,1816,2470,2454,2899,3553,27.640549922170507,18.115229658601585,654,1,58290,33176,764,0,1800,1371
3021,1,0,0,0,42,0,435,1,0,274750,745850,18.708286933869708,15,1470,1135,350,32399,385711,381449,1796,2481,2466,2916,3601,28.0178514522438,18.516519329174788,685,1,62650,43885,785,0,1781,1346
3022,1,0,0,0,46,0,142,0,0,494808,1471704,25.219040425836983,206,1844,1414,636,47752,587756,435032,1884,2950,2744,3092,4158,27.892651361962706,20.742746885678333,1066,1,119568,82990,778,0,1678,1536
3023,1,0,0,0,46,0,73,0,0,510608,1591576,26.057628441590765,277,1833,1431,679,28203,555528,278936,1942,3023,2746,3096,4177,27.422618401604176,20.05601424068041,1081,1,80801,95676,752,0,1665,1592
3024,1,0,0,0,47,0,10,0,0,527051,1717422,26.851443164195103,342,1831,1452,721,39750,595500,378738,2003,3103,2761,3113,4213,27.03701166919155,19.558902071467248,1100,1,114639,80727,731,0,1661,1651
3025,1,0,0,0,41,0,712,0,0,611145,2533275,34.85685011586675,1215,1718,1718,1215,52668,435765,525420,2085,3300,2085,2588,3803,22.427661492005804,0.0,1215,0,306180,0,503,0,870,1582
3026,1,0,0,0,41,0,718,0,0,631503,2559249,35.08560958569767,1231,1744,1744,1231,51385,496881,446985,2079,3310,2079,2592,3823,22.64950330581225,0.0,1231,0,264665,0,513,0,848,1566
3027,1,0,0,0,41,0,729,1,0,679842,2657334,35.58089374931439,1206,1863,1803,1266,33350,482770,304355,2039,3365,2159,2636,3962,23.173260452512935,7.9730082341141015,1326,1,183570,13260,537,0,833,1562
3028,1,0,0,0,44,0,644,1,0,856716,2890440,36.08323710533743,1032,2230,1960,1302,22422,492840,224220,1950,3522,2490,2878,4450,25.65151067676132,17.387285977754626,1572,1,131502,66420,658,0,918,1562
3029,1,0,0,0,45,0,466,0,1,902195,2748970,34.79942528261063,905,2262,1956,1211,35931,460810,401790,1964,3481,2576,3015,4532,27.294688127912362,17.813478821730932,1517,1,214347,49266,745,0,1059,1525
3030,1,0,0,0,45,0,254,1,0,244992,1455916,25.25866188063018,277,1383,1022,638,19370,296660,340018,1921,2920,2643,2666,3665,19.595917942265423,19.00178572286824,999,1,95062,33934,384,0,1644,1898
3031,1,0,0,0,44,0,252,1,0,165600,1240896,23.49468024894146,222,1182,852,552,28762,328208,442856,1918,2800,2578,2548,3430,17.320508075688775,19.604318042193523,882,1,108744,20130,300,0,1696,1948
3032,1,0,0,0,44,0,236,1,0,125952,1088304,22.181073012818835,252,988,748,492,39672,384888,504336,1972,2704,2452,2468,3200,16.0,17.0,732,1,112176,15120,256,0,1720,1956
3033,1,0,0,0,43,0,216,0,1,110836,1000272,21.400934559032695,278,880,700,458,44571,390936,543816,2004,2642,2364,2426,3064,15.556349186104045,14.960137677148381,638,1,114042,6660,242,0,1726,1942
3034,1,0,0,0,42,0,188,0,1,104060,919770,20.73644135332772,310,792,672,430,36542,322989,517638,2019,2569,2259,2381,2931,15.556349186104045,12.198713124830267,550,1,104060,0,242,0,1709,1897
3035,1,0,0,0,41,0,152,0,1,104448,855168,20.199009876724155,348,724,664,408,32880,287152,503040,2036,2504,2156,2352,2820,16.0,8.660254037844387,468,1,97920,0,256,0,1688,1840
3036,1,0,0,0,41,0,51,1,0,132210,815100,19.748417658131498,330,789,729,390,29606,472340,273790,2030,2480,2150,2429,2879,18.411952639521967,8.695069446861433,450,1,51090,13680,339,0,1700,1751
3037,1,0,0,0,41,0,399,0,0,279990,767868,19.131126469708992,271,1226,1131,366,31104,339876,402816,2003,2464,2193,2863,3324,27.65863337187866,9.785443037298442,461,1,70272,8550,765,0,1732,1333
3038,1,0,0,0,41,0,206,1,0,181235,692780,18.303005217723125,201,1010,876,335,20088,446688,192324,1934,2403,2202,2609,3078,23.259406699226016,12.276872470465587,469,1,31155,33098,541,0,1733,1527
3039,1,0,0,0,41,0,20,0,1,211500,936450,21.213203435596427,173,1197,920,450,29450,322555,395390,1804,2531,2358,2551,3278,21.6794833886788,17.180890375359095,727,1,85500,22714,470,0,1631,1611
3040,0,0,1,0,59,1,275,0,0,2289974,4139090,37.17526059088221,1192,3229,3039,1382,48620,661895,658900,2805,4377,3185,4652,6224,40.70626487409524,13.814873398238463,1572,0,304040,25840,1657,0,1613,1338
3041,0,0,1,0,60,1,1046,0,0,145080,378076,11.135528725660043,159,1577,1294,124,39964,591506,628094,2766,3173,3332,4219,4626,34.20526275297414,16.996538735441106,407,1,25544,33394,1170,0,2925,1879
3042,0,0,1,0,59,1,253,0,0,200688,1007508,18.411952639521967,30,1240,931,339,38808,588456,582512,2663,3311,3281,3564,4212,24.331050121192877,17.715999976822125,648,1,66444,41406,592,0,2633,2380
3043,1,0,0,0,43,0,330,1,0,218791,724228,18.193405398660254,63,1260,992,331,24566,310696,378524,1920,2519,2456,2849,3448,25.709920264364882,17.0316639184496,599,1,57263,22512,661,0,1857,1527
3044,1,0,0,0,43,0,345,1,0,227800,729630,18.303005217723125,52,1298,1015,335,23874,300564,376794,1895,2513,2461,2858,3476,26.076809620810597,17.277722103715632,618,1,57955,21791,680,0,1843,1498
3045,1,0,0,0,41,0,708,0,0,659680,2580440,35.21363372331802,1240,1772,1772,1240,56406,493197,495278,2081,3321,2081,2613,3853,23.065125189341593,0.0,1240,0,295120,0,532,0,841,1549
3046,1,0,0,0,41,0,715,0,0,679496,2617504,35.4400902933387,1226,1827,1797,1256,48158,504328,414716,2054,3340,2114,2625,3911,23.259406699226016,5.477225575051661,1286,0,249944,5460,541,0,828,1543
3047,1,0,0,0,42,0,731,1,0,754716,2772960,36.16628264005025,1213,1980,1885,1308,23650,455800,233200,2025,3428,2215,2697,4100,24.020824298928627,10.191668715015645,1403,1,143880,22230,577,0,812,1543
3048,1,0,0,0,43,0,740,1,0,851136,2962608,36.932370625238775,1182,2170,1988,1364,22686,432228,247608,1990,3536,2354,2796,4342,24.979991993593593,14.410523545032367,1546,1,155496,39312,624,0,808,1548
3049,1,0,0,0,46,0,250,0,1,909819,2521840,32.96968304366907,937,2074,1924,1087,48829,586960,447760,2170,3407,2470,3157,4394,28.930952282978865,12.537582169683825,1237,1,209791,29100,837,0,1233,1483
3050,1,0,0,0,46,0,263,0,1,615528,2145078,30.44667469527666,860,1658,1591,927,32705,488254,358670,2247,3241,2381,2978,3972,25.768197453450252,8.361900766312248,994,1,143685,12931,664,0,1387,1650
3051,1,0,0,0,45,0,297,1,0,196504,1413720,24.819347291981714,226,1325,935,616,25380,309825,431460,1905,2911,2685,2614,3620,17.86057109949175,21.125954389651604,1006,1,115808,21840,319,0,1679,1976
3052,1,0,0,0,43,0,281,0,1,108782,1096802,22.338307903688676,289,927,717,499,45682,400036,551698,1988,2697,2408,2416,3125,14.7648230602334,16.010548645515172,709,1,125249,7980,218,0,1699,1980
3053,1,0,0,0,43,0,272,0,1,102608,1056572,22.0,304,876,696,484,44856,388574,550116,2003,2667,2363,2395,3059,14.560219778561036,14.940311337213133,664,1,121968,4860,212,0,1699,1971
3054,1,0,0,0,43,0,260,0,1,98700,1015670,21.6794833886788,320,830,680,470,42840,367370,544572,2011,2631,2311,2371,2991,14.491376746189438,13.638575892569676,620,1,118440,2400,210,0,1691,1951
3055,1,0,0,0,42,0,245,0,1,96884,979808,21.37755832643195,337,789,669,457,42419,362336,538144,2024,2601,2264,2356,2933,14.560219778561036,12.321484129217549,577,1,114707,2040,212,0,1687,1932
3056,1,0,0,0,41,0,209,0,1,99636,915515,20.904544960366874,377,725,665,437,34749,299585,509085,2035,2532,2155,2323,2820,15.0996688705415,8.62579277231682,497,1,106191,0,228,0,1658,1867
3057,1,0,0,0,41,0,188,0,1,104060,889240,20.73644135332772,400,702,672,430,37994,324676,500456,2038,2498,2098,2310,2770,15.556349186104045,5.8721273231371045,460,1,104060,0,242,0,1638,1826
3058,1,0,0,0,45,0,14,0,1,725855,1941810,29.068883707497267,603,1946,1704,845,54366,507858,565308,2056,3143,2540,3157,4244,29.30870177950569,16.181695947463304,1087,1,207870,23716,859,0,1453,1439
3059,0,1,1,0,65,0,1692,0,0,9479533,13195413,63.55312738174259,3733,6692,6386,4039,47500,816750,620730,2961,7306,3573,5614,9959,48.4458460551573,17.56710861900198,4345,0,767410,60282,2347,1,772,920
3060,0,0,1,0,56,1,251,0,0,1284990,2851135,31.85906464414798,423,2873,2281,1015,29394,581463,398878,2217,3824,3401,4075,5682,35.58089374931439,24.381503975192235,1607,1,144130,118400,1266,0,1794,1543
3061,0,0,1,0,60,1,978,0,0,375535,892375,17.175564037317667,66,1929,1568,295,38372,641300,547525,2664,3320,3386,4298,4954,35.679125549822544,19.014562633801113,656,1,53395,60648,1273,0,2730,1752
3062,1,0,0,0,41,0,38,0,0,219600,941400,21.213203435596427,450,938,938,450,53072,447688,518816,2092,2542,2092,2580,3030,22.090722034374522,0.0,450,0,111600,0,488,0,1642,1604
3063,1,0,0,0,42,0,117,1,0,181048,789117,19.261360284258224,276,954,859,371,39990,457305,395622,2032,2498,2222,2615,3081,22.090722034374522,10.012227554748348,466,1,69006,15865,488,0,1756,1639
3064,1,0,0,0,43,0,401,0,0,509622,1183167,23.259406699226016,42,1982,1483,541,40411,548937,352107,1688,2728,2686,3129,4169,30.692018506445613,22.78951751891533,1040,1,87101,106287,942,0,1646,1245
3065,1,0,0,0,46,0,334,1,0,213192,1528534,25.65151067676132,258,1382,982,658,34362,385618,480861,1923,2981,2723,2647,3705,18.0,21.657982946590977,1058,1,136206,31200,324,0,1665,1999
3066,1,0,0,0,46,0,336,1,0,190800,1468524,25.219040425836983,260,1312,936,636,36093,367131,524143,1933,2945,2685,2609,3621,17.320508075688775,21.006907292134862,1012,1,144372,16168,300,0,1673,2009
3067,1,0,0,0,45,0,339,1,0,170632,1411256,24.819347291981714,266,1243,893,616,37440,366560,536094,1941,2907,2641,2568,3534,16.64331697709324,20.24149687738261,966,1,144144,11550,277,0,1675,2014
3068,1,0,0,0,45,0,340,0,1,151725,1353030,24.392621835300936,272,1173,850,595,40152,382032,543486,1951,2869,2597,2529,3447,15.968719422671311,19.51827996574125,918,1,142205,11951,255,0,1679,2019
3069,1,0,0,0,45,0,342,0,1,134784,1299456,24.0,281,1105,810,576,41820,383520,554976,1961,2832,2551,2490,3361,15.297058540778355,18.646164486794436,871,1,141696,8260,234,0,1680,2022
3070,1,0,0,0,44,0,342,0,1,120528,1247130,23.62202362203543,290,1042,774,558,42750,382185,558750,1967,2793,2503,2451,3277,14.696938456699069,17.710917114487437,826,1,139500,5896,216,0,1677,2019
3071,1,0,0,0,43,0,335,0,1,99750,1152900,22.9128784747792,313,927,715,525,44781,388692,555588,1984,2721,2408,2386,3123,13.784048752090222,15.736737497798764,737,1,132825,4876,190,0,1671,2006
3072,1,0,0,0,41,0,265,0,1,93666,975804,21.587033144922902,399,734,667,466,40424,341322,519312,2027,2560,2161,2295,2828,14.177446878757825,8.922530860130468,533,1,115568,804,201,0,1628,1893
3073,1,0,0,0,41,0,243,0,1,99144,951966,21.42428528562855,417,717,675,459,40656,348432,501908,2032,2533,2116,2290,2791,14.696938456699069,6.852548980306203,501,1,111078,1386,216,0,1615,1858
3074,1,0,0,0,41,0,220,0,1,106236,935240,21.307275752662516,424,718,688,454,45704,405820,477920,2030,2514,2090,2294,2778,15.297058540778355,5.5503012171862105,484,1,105328,2700,234,0,1606,1826
3075,1,0,0,0,41,0,196,0,1,115005,926354,21.236760581595302,451,706,706,451,45202,478582,398476,2054,2505,2054,2309,2760,15.968719422671311,0.0,451,1,87494,0,255,0,1603,1799
3076,1,0,0,0,42,0,3,0,1,197578,936502,21.047565179849187,175,1157,889,443,28518,310758,410116,1846,2557,2382,2560,3271,21.118712081942874,16.965701346880195,711,1,85942,17688,446,0,1671,1668
3077,0,1,0,1,64,0,2231,0,0,9681990,14359408,66.49060083951716,4017,7015,6611,4421,53743,782768,724304,2844,7669,3652,5438,10263,46.79743582719036,20.11331459262594,4825,1,985883,62216,2190,0,1173,1058
3078,0,1,1,0,65,0,1525,0,0,9553266,12934988,62.81719509815764,3637,6676,6367,3946,52858,809666,701492,2969,7224,3587,5699,9954,49.20365840057018,17.69690535547188,4255,0,844444,52221,2421,1,668,857
3079,0,1,1,0,54,0,499,0,0,150732,579396,14.560219778561036,117,1018,923,212,36503,576663,472809,2638,2945,2828,3444,3751,26.664583251946766,9.924396939761625,307,1,36676,16720,711,0,2521,2022
3080,0,0,1,0,54,1,347,0,0,1568858,2977339,33.03028912982749,1091,2529,2529,1091,43739,624941,521239,2729,3820,2729,4167,5258,37.92097045171708,0.0,1091,0,208381,0,1438,0,1638,1291
3081,1,0,0,0,46,0,632,1,0,64980,208260,9.486832980505138,92,994,812,90,42525,520650,437346,2132,2404,2496,3036,3308,26.870057685088806,13.500908052461922,272,1,17010,31850,722,0,2224,1592
3082,1,0,0,0,46,0,61,0,0,630300,1790052,27.640549922170507,290,2063,1589,764,29512,557634,290532,1869,3107,2817,3168,4406,28.722813232690143,21.775634009859967,1238,1,94736,112812,825,0,1579,1518
3083,1,0,0,0,41,0,694,0,0,742632,2645148,35.7211421989835,1246,1888,1858,1276,54970,476790,495447,2043,3349,2103,2655,3961,24.124676163629637,5.478746393072713,1306,0,304964,3600,582,0,797,1491
3084,1,0,0,0,41,0,702,0,0,760399,2680116,35.93048844644336,1291,1880,1880,1291,47628,504468,406896,2076,3367,2076,2665,3956,24.269322199023193,0.0,1291,0,253036,0,589,0,785,1487
3085,1,0,0,0,47,0,326,0,1,456456,2022306,29.29163703175362,666,1582,1390,858,49600,584536,471400,2165,3215,2549,2889,3939,23.065125189341593,14.26023739270955,1050,1,171600,35712,532,0,1499,1825
3086,1,0,0,0,47,0,331,0,1,419502,1970742,28.879058156387302,618,1553,1337,834,48555,588387,460785,2147,3197,2579,2866,3916,22.427661492005804,15.099741486923206,1050,1,162630,41256,503,0,1529,1860
3087,1,0,0,0,47,0,359,1,0,261002,1694350,26.851443164195103,370,1434,1083,721,30450,352500,477050,1999,3071,2701,2712,3784,19.026297590440446,18.8703810356977,1072,1,146363,21060,362,0,1629,1988
3088,1,0,0,0,46,0,365,1,0,234500,1638700,26.457513110645905,321,1414,1035,700,41811,423721,540771,1962,3041,2720,2676,3755,18.303005217723125,19.555459694141973,1079,1,161700,25772,335,0,1641,2006
3089,1,0,0,0,46,0,370,1,0,209811,1580712,26.057628441590765,289,1378,988,679,47500,442320,582000,1938,3007,2718,2637,3706,17.578395831246947,21.411562627486784,1069,1,169750,19890,309,0,1649,2019
3090,1,0,0,0,45,0,380,0,1,164604,1462296,25.25866188063018,303,1231,896,638,46228,417144,582168,1957,2930,2627,2550,3523,16.06237840420901,19.93786731388653,973,1,162052,10050,258,0,1654,2034
3091,1,0,0,0,45,0,388,0,1,127200,1352400,24.49489742783178,317,1095,812,600,43674,392196,565754,1971,2854,2537,2466,3349,14.560219778561036,18.343156639882896,883,1,150600,6792,212,0,1654,2042
3092,1,0,0,0,43,0,384,0,1,82161,1165290,23.173260452512935,362,865,690,537,44022,377580,549010,1995,2707,2345,2323,3035,12.36931687685298,14.232222772658718,712,1,135861,2625,153,0,1633,2017
3093,1,0,0,0,42,0,374,0,1,78600,1126076,22.891046284519195,374,824,674,524,44781,380373,543697,1999,2673,2299,2299,2973,12.24744871391589,13.056526021193557,674,1,132572,2700,150,0,1625,1999
3094,1,0,0,0,42,0,360,0,1,78489,1092690,22.64950330581225,386,793,666,513,45720,383400,541020,2003,2643,2257,2283,2923,12.36931687685298,11.888055542540647,640,1,130302,2794,153,0,1617,1977
3095,1,0,0,0,42,0,341,0,1,81486,1061330,22.427661492005804,395,773,665,503,46482,386130,535940,2002,2613,2218,2272,2883,12.727922061357855,11.093467603198212,611,1,127762,3240,162,0,1607,1948
3096,1,0,0,0,41,0,320,0,1,86625,1036530,22.24859546128699,410,755,670,495,46620,387390,527688,2009,2589,2179,2269,2849,13.228756555322953,9.714504923012402,580,1,124740,3400,175,0,1599,1919
3097,1,0,0,0,41,0,296,0,1,93696,1014064,22.090722034374522,421,747,680,488,46563,388586,517422,2011,2566,2145,2270,2825,13.856406460551018,8.456490803821907,555,1,121512,3350,192,0,1590,1886
3098,1,0,0,0,41,0,247,0,1,112554,990860,21.93171219946131,451,745,715,481,43700,473800,391400,2030,2541,2090,2294,2805,15.297058540778355,5.531194905403055,511,1,91390,5370,234,0,1579,1826
3099,1,0,0,0,41,0,222,0,1,123840,994080,21.908902300206645,480,738,738,480,31500,465975,289940,2071,2551,2071,2329,2809,16.06237840420901,0.0,480,1,67200,0,258,0,1591,1813
3100,1,0,0,0,43,0,49,1,0,220770,1064745,22.24859546128699,285,1151,941,495,38502,445257,400086,1941,2646,2361,2597,3302,21.118712081942874,15.076742382695786,705,1,92070,33180,446,0,1656,1705
3101,1,0,0,0,43,0,277,0,0,378348,1063704,22.181073012818835,407,1346,1261,492,41216,397808,484288,2077,2654,2247,2931,3508,27.730849247724095,9.692340849365527,577,1,110208,6970,769,0,1670,1393
3102,1,0,0,0,40,0,332,1,0,281580,792870,19.748417658131498,323,1179,1112,390,37740,345610,451326,1966,2423,2100,2755,3212,26.870057685088806,8.748575453901612,457,1,86580,4422,722,0,1643,1311
3103,1,0,0,0,40,0,249,1,0,259600,814400,20.0,358,1091,1049,400,28224,456064,256536,1994,2436,2078,2685,3127,25.475478405713993,6.63067838716079,442,1,50400,9702,649,0,1636,1387
3104,1,0,0,0,43,0,42,1,0,282583,1121645,22.60530911091463,283,1292,1064,511,18020,465340,186575,1967,2706,2423,2748,3487,23.515952032609693,15.8434824375548,739,1,43435,56544,553,0,1684,1642
3105,1,0,0,0,44,0,16,1,0,290457,1180944,23.043437243605826,289,1320,1078,531,20580,467040,217952,1982,2755,2466,2771,3544,23.388031127053,16.448836593433427,773,1,52038,57838,547,0,1693,1677
3106,1,0,0,0,46,0,183,0,1,516528,1909440,28.5657137141714,474,1791,1449,816,51865,592020,479700,1998,3156,2682,2973,4131,25.15949125081825,18.759732123942523,1158,1,167280,61560,633,0,1524,1707
3107,1,0,0,0,42,0,9,0,1,212962,978437,21.37755832643195,199,1181,923,457,32200,344701,428200,1883,2598,2399,2607,3322,21.587033144922902,17.02371381977504,715,1,91400,20640,466,0,1684,1675
3108,1,0,0,0,42,0,6,0,1,164016,851034,20.049937655763422,174,1038,810,402,31262,326018,429751,1889,2519,2345,2525,3155,20.199009876724155,15.883499378271265,630,1,81606,15048,408,0,1715,1709
3109,0,1,1,0,65,0,1449,0,0,9635256,12815712,62.545983084447556,3612,6675,6375,3912,52290,815724,687960,2976,7188,3576,5739,9951,49.628620774710235,17.434888240140808,4212,0,821520,52500,2463,1,636,813
3110,0,1,1,0,66,0,1458,0,0,6469875,6335685,43.78355855797927,1557,5652,5292,1917,44856,832860,588290,2945,5222,3665,6680,8957,58.09475019311125,19.226807410955796,2277,1,341226,74880,3375,0,1388,70
3111,0,0,1,0,54,1,1412,0,0,525708,4715910,41.44876355212541,1484,2258,2024,1718,49434,587430,634095,2511,4463,2979,3051,5003,17.4928556845359,15.424592478219187,1952,1,396858,26442,306,0,1027,2439
3112,0,0,0,0,57,1,679,1,0,1891212,3093144,32.817678162843876,792,3118,2833,1077,48768,729488,551424,2587,3949,3157,4628,5990,41.90465367951393,16.952631616932624,1362,1,206784,55290,1756,0,1795,1116
3113,0,0,0,0,57,1,780,1,0,1953301,3054619,32.57299494980466,805,3158,2902,1061,55000,719750,633380,2623,3940,3135,4720,6037,42.906875905849866,16.0350409690718,1317,1,233420,40704,1841,0,1818,1038
3114,1,0,0,0,42,0,110,0,1,287496,1258092,24.372115213907882,564,1108,1078,594,51865,535854,434190,2088,2712,2148,2602,3226,22.0,5.5503012171862105,624,1,121770,5160,484,0,1524,1634
3115,1,0,0,0,42,0,103,0,1,269310,1215333,23.93741840717165,543,1073,1043,573,54145,519645,468741,2091,2694,2151,2591,3194,21.6794833886788,5.490867587491313,603,1,126633,4230,470,0,1548,1651
3116,1,0,0,0,42,0,96,0,1,252721,1171254,23.515952032609693,553,1010,1010,553,56643,501966,506202,2118,2671,2118,2575,3128,21.37755832643195,0.0,553,1,132167,0,457,0,1565,1661
3117,1,0,0,0,44,0,153,1,0,240660,944580,20.493901531919196,101,1312,993,420,30625,393575,393575,1930,2669,2568,2822,3561,23.93741840717165,18.951153257280126,739,1,73500,40513,573,0,1829,1676
3118,1,0,0,0,44,0,173,1,0,250074,945566,20.518284528683193,82,1354,1015,421,26970,348130,390804,1907,2667,2585,2840,3600,24.372115213907882,19.394627225002203,760,1,73254,33900,594,0,1825,1652
3119,1,0,0,0,44,0,192,1,0,261184,948488,20.591260281974,63,1401,1040,424,27302,326602,418319,1876,2661,2598,2853,3638,24.819347291981714,19.871294182454566,785,1,79288,26353,616,0,1813,1621
3120,1,0,0,0,41,0,681,0,0,781816,2677752,35.888716889852724,1258,1925,1895,1288,55350,467775,511434,2049,3367,2109,2686,4004,24.63736998950984,5.531194905403055,1318,1,316848,3090,607,0,791,1472
3121,1,0,0,0,41,0,690,0,0,796824,2699046,36.08323710533743,1302,1914,1914,1302,51948,485082,460206,2073,3375,2073,2685,3987,24.73863375370596,0.0,1302,0,289044,0,612,0,771,1461
3122,1,0,0,0,44,0,734,1,0,1003800,3157668,37.86819245752297,1224,2344,2134,1434,26880,493248,264240,1992,3636,2412,2902,4546,26.457513110645905,15.616562303767314,1644,1,172080,49560,700,0,768,1502
3123,1,0,0,0,46,0,312,0,1,868689,2576340,33.18132004607411,909,2082,1890,1101,30816,500760,336960,2148,3441,2532,3129,4422,28.089143810376278,14.051104338071674,1293,1,158544,39744,789,0,1239,1551
3124,1,0,0,0,47,0,352,0,1,459024,2062104,29.597297173897484,664,1612,1400,876,52290,586146,494340,2142,3230,2566,2878,3966,22.891046284519195,14.843417048062975,1088,1,183960,37100,524,0,1478,1830
3125,1,0,0,0,47,0,358,0,1,422235,2011374,29.206163733020468,619,1582,1348,853,48888,594216,457452,2124,3211,2592,2853,3940,22.24859546128699,15.610256826450954,1087,1,165482,45396,495,0,1505,1863
3126,1,0,0,0,47,0,364,0,1,386780,1963780,28.809720581775867,572,1554,1296,830,43472,584402,416416,2108,3196,2624,2832,3920,21.587033144922902,16.40002938138678,1088,1,146080,53922,466,0,1536,1900
3127,1,0,0,0,47,0,385,1,0,289556,1818320,27.640549922170507,429,1478,1143,764,39963,411740,549780,2045,3144,2715,2759,3858,19.467922333931785,18.624686344179032,1099,1,176484,19430,379,0,1616,2001
3128,1,0,0,0,47,0,392,0,1,260793,1756452,27.258026340878022,381,1456,1094,743,41328,397152,581544,2002,3107,2726,2715,3820,18.734993995195193,19.222021996786484,1105,1,182778,9050,351,0,1621,2013
3129,1,0,0,0,45,0,419,0,1,159962,1507080,25.709920264364882,338,1226,903,661,48132,435480,574560,1957,2941,2603,2522,3506,15.556349186104045,19.51827996574125,984,1,166572,10982,242,0,1619,2038
3130,1,0,0,0,45,0,432,0,1,119808,1405248,24.979991993593593,356,1084,816,624,48768,432384,572008,1984,2876,2520,2444,3336,13.856406460551018,17.87542744029941,892,1,158496,10988,192,0,1628,2060
3131,1,0,0,0,44,0,442,0,1,88800,1308912,24.331050121192877,376,958,742,592,39591,351549,550539,1995,2803,2427,2361,3169,12.24744871391589,16.02684884758906,808,1,147408,216,150,0,1619,2061
3132,1,0,0,0,43,0,443,0,1,77318,1260168,24.020824298928627,387,901,711,577,39342,345072,543816,1994,2761,2374,2318,3085,11.575836902790225,14.85105546081279,767,1,143673,0,134,0,1607,2050
3133,1,0,0,0,43,0,440,0,1,69936,1218804,23.748684174075834,402,850,688,564,41832,358726,544572,1999,2725,2323,2285,3011,11.135528725660043,13.59550538610717,726,1,142128,0,124,0,1597,2037
3134,1,0,0,0,42,0,432,0,1,66240,1181280,23.49468024894146,418,806,672,552,43769,370220,541420,2006,2692,2274,2260,2946,10.954451150103322,12.333627810115374,686,1,139656,0,120,0,1588,2020
3135,1,0,0,0,42,0,398,0,1,71288,1118796,23.065125189341593,447,751,666,532,48514,401673,534162,2018,2635,2188,2237,2854,11.575836902790225,9.587694277262452,617,1,135128,3485,134,0,1571,1969
3136,1,0,0,0,41,0,348,0,1,88060,1074850,22.759613353482084,476,730,688,518,51156,421225,522900,2033,2593,2117,2245,2805,13.038404810405298,6.570697549716149,560,1,130536,2772,170,0,1557,1905
3137,1,0,0,0,41,0,322,0,1,98688,1060382,22.67156809750927,484,736,706,514,52200,464175,478616,2033,2577,2093,2255,2799,13.856406460551018,5.477225575051661,544,1,119248,3750,192,0,1549,1871
3138,1,0,0,0,41,0,295,0,1,110376,1054704,22.60530911091463,511,727,727,511,39846,472656,359136,2064,2575,2064,2280,2791,14.696938456699069,0.0,511,1,88914,0,216,0,1553,1848
3139,1,0,0,0,43,0,55,1,0,413336,1352736,24.819347291981714,441,1462,1287,616,34010,417240,393084,2021,2812,2371,2867,3658,25.903667693977237,13.359104871799886,791,1,110264,25025,671,0,1580,1525
3140,1,0,0,0,40,0,244,1,0,289820,875050,20.73644135332772,400,1134,1104,430,30590,468050,270655,2005,2465,2065,2709,3169,25.96150997149434,5.684275577662207,460,1,57190,6900,674,0,1605,1361
3141,1,0,0,0,43,0,73,1,0,303924,1123848,22.715633383201094,326,1295,1105,516,20592,453024,215622,1988,2694,2368,2767,3473,24.269322199023193,14.470300240284018,706,1,51084,44840,589,0,1662,1589
3142,1,0,0,0,42,0,10,0,1,156000,831480,19.748417658131498,189,991,790,390,36673,360308,462644,1931,2522,2333,2532,3123,20.0,15.350831985266003,591,1,84630,14070,400,0,1742,1732
3143,0,1,0,1,64,0,2250,0,0,9943479,14523831,66.88049042882386,4056,7113,6696,4473,50600,746810,714340,2830,7720,3664,5470,10360,47.148700936505136,20.432311195903043,4890,1,984060,61299,2223,0,1226,1024
3144,0,1,1,0,66,0,1537,0,0,6418664,6219490,43.347433603386484,1488,5686,5295,1879,48514,840740,632210,2919,5189,3701,6726,8996,58.44655678480983,20.025015527605827,2270,1,358889,76245,3416,0,1431,106
3145,0,0,1,0,59,1,19,0,0,2188830,4462533,38.58756276314948,1129,3319,2959,1489,45012,725274,557442,2637,4486,3357,4467,6316,38.34057902536163,19.220930703515467,1849,1,276954,70200,1470,0,1508,1527
3146,0,0,1,0,60,1,1039,0,0,620312,1287264,20.591260281974,118,2193,1887,424,40544,680064,549516,2730,3460,3342,4499,5229,38.24918299781056,17.63751634339106,730,1,76744,55692,1463,0,2612,1573
3147,0,0,1,0,54,1,401,0,0,1420272,2761920,31.74901573277509,948,2477,2417,1008,47760,545260,657600,2680,3748,2800,4149,5217,37.53664875824692,7.810249675906654,1068,0,241920,4920,1409,0,1732,1331
3148,0,0,0,0,57,1,718,1,0,1850768,3000424,32.37282811247729,751,3111,2814,1048,51054,727202,575463,2566,3911,3160,4629,5974,42.02380277890139,17.633003714773682,1345,1,210648,54054,1766,0,1815,1097
3149,0,0,1,0,58,1,989,0,0,2006970,2930478,31.71750305430741,778,3229,3001,1006,41769,643773,550557,2685,3919,3141,4908,6142,44.66542286825459,15.20892758594158,1234,1,190134,38760,1995,0,1907,918
3150,1,0,0,0,42,0,174,0,0,400752,1534764,26.94438717061496,726,1278,1278,726,51754,477764,484106,2114,2840,2114,2666,3392,23.49468024894146,0.0,726,0,166254,0,552,0,1388,1562
3151,1,0,0,0,41,0,688,0,0,851889,2759004,36.45545226711637,1329,1970,1970,1329,44197,475404,400668,2076,3405,2076,2717,4046,25.317977802344327,0.0,1329,0,256497,0,641,0,747,1435
3152,1,0,0,0,41,0,695,0,0,870264,2797469,36.64696440361739,1313,2021,1991,1343,32700,454094,312450,2053,3426,2113,2731,4104,25.45584412271571,5.623413251903491,1373,0,201450,6150,648,0,740,1435
3153,1,0,0,0,47,0,365,0,1,543534,2215584,30.692018506445613,741,1720,1519,942,49203,543312,500976,2151,3294,2553,2929,4072,24.020824298928627,14.463777529362124,1143,1,200646,31356,577,0,1410,1775
3154,1,0,0,0,46,0,377,0,1,463610,2101460,29.916550603303182,661,1647,1413,895,54560,582304,516560,2114,3243,2582,2866,3995,22.759613353482084,15.496772346339544,1129,1,196900,37908,518,0,1453,1830
3155,1,0,0,0,47,0,391,0,1,390150,2008550,29.154759474226502,573,1586,1309,850,39273,583661,375717,2086,3213,2640,2822,3949,21.42428528562855,16.925060583549502,1127,1,135150,61494,459,0,1513,1904
3156,1,0,0,0,47,0,398,0,1,356040,1971468,28.77498913987632,528,1558,1258,828,39928,590488,383341,2081,3209,2681,2811,3939,20.73644135332772,17.705874911261695,1128,1,133308,66000,430,0,1553,1951
3157,1,0,0,0,47,0,406,0,1,322400,1931982,28.39013913315678,482,1530,1206,806,56643,572883,568089,2073,3203,2721,2797,3927,20.0,18.471899695658166,1130,1,191022,40500,400,0,1591,1997
3158,1,0,0,0,47,0,414,0,1,291235,1865160,28.0178514522438,435,1506,1156,785,46314,441936,591624,2026,3161,2726,2747,3882,19.261360284258224,18.98449042348587,1135,1,195465,8750,371,0,1591,2005
3159,1,0,0,0,46,0,430,0,1,232559,1729704,27.258026340878022,377,1422,1056,743,41743,393432,575016,1962,3071,2694,2641,3750,17.69180601295413,20.765538919371746,1109,1,183521,0,313,0,1585,2015
3160,1,0,0,0,46,0,437,0,1,205770,1663488,26.870057685088806,372,1357,1007,722,44571,412416,573696,1954,3026,2654,2589,3661,16.881943016134134,20.24149687738261,1072,1,179778,5600,285,0,1582,2019
3161,1,0,0,0,45,0,447,0,1,179968,1606355,26.514147167125703,368,1294,959,703,46500,425010,571250,1950,2988,2620,2541,3579,16.0,19.726601144661004,1038,1,175750,8375,256,0,1582,2029
3162,1,0,0,0,45,0,456,0,1,155952,1549944,26.153393661244042,371,1225,912,684,48500,439604,566500,1953,2950,2579,2494,3491,15.0996688705415,18.988654370034546,997,1,171000,11894,228,0,1582,2038
3163,1,0,0,0,45,0,465,0,1,133866,1499832,25.80697580112788,381,1152,867,666,51543,466164,560748,1967,2918,2537,2453,3404,14.177446878757825,18.273413871518187,951,1,165834,16530,201,0,1586,2051
3164,1,0,0,0,44,0,474,0,1,113575,1453760,25.475478405713993,393,1080,824,649,51706,461440,562240,1984,2889,2496,2415,3320,13.228756555322953,17.405520429878383,905,1,162899,14848,175,0,1591,2065
3165,1,0,0,0,44,0,483,0,1,94950,1409058,25.15949125081825,405,1011,783,633,49022,429618,565404,1998,2859,2454,2376,3237,12.24744871391589,16.487069846655956,861,1,160782,8664,150,0,1593,2076
3166,1,0,0,0,43,0,496,0,1,65232,1318532,24.576411454889016,429,887,712,604,39342,344914,543567,2008,2787,2358,2291,3070,10.392304845413264,14.395630137896458,779,1,150396,0,108,0,1579,2075
3167,1,0,0,0,43,0,496,0,1,56145,1277151,24.310491562286437,441,836,686,591,40000,345760,540250,2011,2752,2311,2256,2997,9.746794344808963,13.206671381360312,741,1,147750,450,95,0,1570,2066
3168,1,0,0,0,42,0,474,0,1,54055,1204573,23.853720883753127,474,759,664,569,44781,374709,535601,2022,2686,2212,2212,2876,9.746794344808963,10.338881435266707,664,1,143957,2470,95,0,1548,2022
3169,1,0,0,0,41,0,452,0,1,60480,1175440,23.664319132398465,493,735,668,560,47817,396711,531047,2032,2659,2166,2207,2834,10.392304845413264,8.592096094735382,627,1,141680,2814,108,0,1539,1991
3170,1,0,0,0,41,0,426,0,1,70231,1152452,23.515952032609693,511,722,680,553,49841,410548,527252,2042,2637,2126,2211,2806,11.269427669584644,6.7040592262067955,595,1,139909,2268,127,0,1531,1957
3171,1,0,0,0,41,0,368,0,1,95025,1121295,23.302360395462088,543,718,718,543,46056,470820,417130,2065,2608,2065,2240,2783,13.228756555322953,0.0,543,1,109686,0,175,0,1522,1890
3172,1,0,0,0,41,0,340,0,1,108741,1121493,23.259406699226016,541,742,742,541,32250,445695,310950,2073,2614,2073,2274,2815,14.177446878757825,0.0,541,1,81150,0,201,0,1532,1872
3173,1,0,0,0,42,0,199,1,0,185022,1158281,23.259406699226016,417,1007,883,541,28951,473161,280471,2017,2682,2265,2483,3148,18.49324200890693,12.081486825133021,665,1,70871,27776,342,0,1600,1799
3174,1,0,0,0,43,0,101,1,0,257040,1218000,23.664319132398465,318,1261,1019,560,35776,452400,374100,1933,2735,2417,2634,3436,21.42428528562855,16.316935091576287,802,1,96320,41866,459,0,1615,1716
3175,1,0,0,0,43,0,44,1,0,323277,1295472,24.310491562286437,314,1415,1138,591,30600,438400,335376,1915,2783,2469,2739,3607,23.388031127053,16.695186711087423,868,1,90423,50137,547,0,1601,1645
3176,1,0,0,0,43,0,27,1,0,348508,1327592,24.576411454889016,357,1428,1181,604,31356,441798,342888,1951,2802,2445,2775,3626,24.020824298928627,15.803666688830278,851,1,94224,44213,577,0,1594,1621
3177,1,0,0,0,44,0,11,1,0,375126,1362690,24.859605789312106,400,1443,1225,618,32480,447615,352800,1987,2823,2423,2812,3648,24.63736998950984,14.912948840865376,836,1,98880,39022,607,0,1587,1598
3178,1,0,0,0,41,0,209,1,0,297660,942590,21.236760581595302,343,1219,1111,451,34776,351120,432630,1982,2541,2198,2750,3309,25.69046515733026,10.562698776726089,559,1,93357,8748,660,0,1639,1430
3179,1,0,0,0,42,0,16,0,1,149705,811439,19.467922333931785,204,949,774,379,55081,477443,528827,1966,2520,2316,2536,3090,19.87460691435179,14.805432150610974,554,1,93613,15225,395,0,1762,1746
3180,0,1,0,1,65,0,2177,0,0,10041018,14426750,66.6258208204597,4063,7077,6701,4439,48178,718250,708500,2874,7689,3626,5512,10327,47.56048780237646,19.40883305679919,4815,1,967702,51888,2262,0,1189,988
3181,0,1,0,1,65,0,2053,0,0,9991950,14146200,65.95452979136459,4050,6947,6647,4350,48256,754464,676416,2952,7602,3552,5549,10199,47.92702786528704,17.350500409780906,4650,1,904800,48600,2297,0,1098,955
3182,0,1,0,1,64,0,1926,0,0,9949435,13826945,65.27633568147036,4027,6830,6596,4261,51714,759330,717145,3011,7506,3479,5580,10075,48.321837713398274,15.319637286414302,4495,1,941681,35100,2335,0,1016,910
3183,0,0,1,0,59,1,408,0,0,355284,1258830,20.639767440550294,129,1557,1260,426,56882,706245,703290,2658,3381,3252,3789,4512,28.879058156387302,17.374382779324037,723,1,101388,36828,834,0,2529,2121
3184,0,0,0,0,56,1,426,1,0,1116715,2443625,29.410882339705484,675,2346,2156,865,46060,531100,692125,2635,3690,3015,4116,5171,35.93048844644336,14.344660619261914,1055,1,211925,10830,1291,0,1960,1534
3185,0,0,0,0,56,1,427,1,0,1172130,2500900,29.832867780352597,728,2369,2207,890,44820,505800,699690,2648,3700,2972,4127,5179,36.29049462324811,13.197871455595559,1052,1,221610,6156,1317,0,1920,1493
3186,0,0,0,0,55,1,427,1,0,1230188,2555640,30.265491900843113,782,2393,2259,916,43925,488250,700290,2656,3706,2924,4133,5183,36.64696440361739,11.974018752834446,1050,1,229916,3618,1343,0,1874,1447
3187,0,0,0,0,55,1,428,1,0,1290540,2610282,30.692018506445613,834,2420,2312,942,46435,512635,695521,2663,3713,2879,4141,5191,37.013511046643494,10.613247510664669,1050,1,236442,4428,1370,0,1829,1401
3188,0,0,0,0,56,1,723,1,0,1794474,2922048,32.03123475609393,771,3030,2775,1026,50800,723392,569600,2593,3874,3103,4597,5878,41.82104733265297,16.32090440024929,1281,1,205200,47175,1749,0,1822,1099
3189,0,0,0,0,57,1,793,1,0,1826660,2890272,31.811947441173732,712,3117,2817,1012,51156,719712,579768,2556,3868,3156,4661,5973,42.485291572496,17.65812098025657,1312,1,205436,54900,1805,0,1844,1051
3190,1,0,0,0,42,0,215,0,0,424704,1628928,27.712812921102035,768,1321,1321,768,45732,470862,436926,2121,2889,2121,2674,3442,23.515952032609693,0.0,768,0,158208,0,553,0,1353,1568
3191,1,0,0,0,42,0,201,0,0,257706,1313868,24.859605789312106,588,1065,1035,618,21462,312522,310396,2096,2744,2156,2543,3191,20.42057785666214,5.791460926441345,648,0,90228,3600,417,0,1508,1709
3192,1,0,0,0,43,0,172,1,0,196005,1160457,23.173260452512935,452,987,902,537,19890,367370,252837,2076,2698,2246,2526,3148,19.1049731745428,10.00848918394426,622,1,62829,15130,365,0,1624,1796
3193,1,0,0,0,44,0,129,1,0,308880,1100880,22.24859546128699,52,1562,1119,495,38472,373632,509296,1781,2719,2667,2848,3786,24.979991993593593,21.604458130986853,938,1,113355,23036,624,0,1729,1600
3194,1,0,0,0,43,0,212,1,0,440348,1239540,23.790754506740637,42,1868,1344,566,17689,291270,291270,1666,2756,2714,2968,4058,27.892651361962706,22.91370973579039,1090,1,75278,59212,778,0,1624,1412
3195,1,0,0,0,43,0,223,1,0,468510,1276326,24.124676163629637,64,1905,1387,582,17640,276318,307020,1675,2775,2711,2998,4098,28.372521918222215,22.787045845240925,1100,1,81480,50246,805,0,1611,1388
3196,1,0,0,0,41,0,676,0,0,893772,2788676,36.6333181680284,1342,2008,2008,1342,45540,477940,411444,2078,3420,2078,2744,4086,25.80697580112788,0.0,1342,0,265716,0,666,0,736,1412
3197,1,0,0,0,46,0,350,0,1,1150944,2927840,35.52463933666322,923,2513,2174,1262,44100,522000,454720,1981,3582,2659,3232,4833,30.199337741083,18.463643883096882,1601,1,247352,56952,912,0,1058,1408
3198,1,0,0,0,47,0,355,0,1,832464,2612520,33.27160951922825,879,2087,1859,1107,47671,582920,455480,2132,3467,2588,3112,4447,27.422618401604176,15.406507889143139,1335,1,213651,43776,752,0,1253,1608
3199,1,0,0,0,47,0,375,0,1,638064,2383920,31.74901573277509,796,1853,1641,1008,43739,451715,541585,2153,3373,2577,2998,4218,25.15949125081825,14.952366174434152,1220,1,230832,18232,633,0,1357,1732
3200,1,0,0,0,47,0,381,0,1,593352,2320272,31.368774282716245,766,1805,1587,984,50778,511686,551772,2140,3342,2576,2961,4163,24.55605831561735,15.073166625245115,1202,1,230256,24634,603,0,1374,1755
3201,1,0,0,0,46,0,394,0,1,508791,2200076,30.610455730027933,695,1722,1480,937,56160,549432,563520,2106,3285,2590,2891,4070,23.302360395462088,15.746479231304985,1179,1,224880,29282,543,0,1411,1805
3202,1,0,0,0,46,0,400,0,1,469796,2140588,30.23243291566195,656,1686,1428,914,55328,578474,524608,2084,3256,2600,2856,4028,22.67156809750927,16.199602857587234,1172,1,204736,39732,514,0,1428,1828
3203,1,0,0,0,47,0,425,0,1,359976,2013828,29.13760456866693,530,1592,1273,849,49784,602488,464912,2053,3221,2691,2796,3964,20.591260281974,18.148570520160238,1168,1,166404,59653,424,0,1523,1948
3204,1,0,0,0,46,0,441,0,1,294190,1892488,28.39013913315678,440,1537,1171,806,41174,406204,558824,1982,3154,2714,2713,3885,19.1049731745428,19.25012033518906,1172,1,191828,3294,365,0,1542,1983
3205,1,0,0,0,46,0,450,0,1,262975,1825125,28.0178514522438,424,1481,1120,785,41650,406875,553350,1964,3110,2686,2660,3806,18.303005217723125,20.624681316875876,1146,1,186830,4332,335,0,1540,1990
3206,1,0,0,0,45,0,479,0,1,179322,1648746,26.94438717061496,417,1282,973,726,47941,433761,570021,1962,2997,2580,2518,3553,15.716233645501712,18.910434425804382,1035,1,182226,10197,247,0,1545,2024
3207,1,0,0,0,45,0,490,0,1,154344,1594416,26.60826939130014,413,1221,926,708,49140,439140,567504,1957,2960,2547,2470,3473,14.7648230602334,18.385017694392122,1003,1,178416,11505,218,0,1544,2034
3208,1,0,0,0,44,0,501,0,1,131290,1546458,26.28687885618983,414,1158,881,691,51750,463266,559500,1961,2929,2515,2428,3396,13.784048752090222,17.7618623889712,968,1,172750,16066,190,0,1547,2048
3209,1,0,0,0,43,0,536,0,1,69552,1416156,25.37715508089904,454,942,752,644,48514,420009,558546,2009,2843,2389,2307,3141,10.392304845413264,15.008585219180986,834,1,163576,6650,108,0,1555,2091
3210,1,0,0,0,43,0,551,0,1,41406,1330554,24.859605789312106,484,819,685,618,40913,350939,540403,2019,2771,2287,2220,2972,8.18535277187245,12.5131552182536,752,1,155118,0,67,0,1535,2086
3211,1,0,0,0,42,0,531,0,1,40066,1263574,24.454038521274967,513,750,665,598,44781,374001,534589,2028,2711,2198,2180,2863,8.18535277187245,9.714504923012402,683,1,151294,2040,67,0,1515,2046
3212,1,0,0,0,41,0,504,0,1,50065,1233955,24.269322199023193,529,734,674,589,47498,391765,532130,2035,2684,2155,2180,2829,9.219544457292887,8.111420134500735,649,1,149606,2220,85,0,1506,2010
3213,1,0,0,0,41,0,474,0,1,62856,1210560,24.124676163629637,552,720,690,582,50904,420160,524160,2050,2662,2110,2188,2800,10.392304845413264,5.684275577662207,612,1,146664,1920,108,0,1498,1972
3214,1,0,0,0,41,0,443,0,1,77318,1193236,24.020824298928627,577,711,711,577,51984,471504,471504,2068,2645,2068,2202,2779,11.575836902790225,0.0,577,1,131556,0,134,0,1491,1934
3215,1,0,0,0,41,0,411,0,1,92826,1187829,23.93741840717165,573,735,735,573,37632,464352,348264,2073,2646,2073,2235,2808,12.727922061357855,0.0,573,1,96264,0,162,0,1500,1911
3216,1,0,0,0,45,0,174,0,1,870400,2344960,32.0,890,2008,1874,1024,48006,432810,581660,2156,3314,2424,3140,4298,29.154759474226502,12.133882760385626,1158,1,260096,4288,850,0,1266,1440
3217,1,0,0,0,45,0,73,0,1,858924,2172856,31.04834939252005,856,1963,1855,964,48514,430514,572516,2146,3218,2362,3145,4217,29.8496231131986,11.029743904822288,1072,1,244856,3780,891,0,1290,1363
3218,0,1,0,1,65,0,2105,0,0,10138206,14328312,66.37770710110436,4071,7042,6707,4406,47025,731700,679668,2917,7658,3587,5553,10294,47.968739820845826,18.32843530268791,4741,1,920854,51590,2301,0,1154,951
3219,0,1,1,0,64,0,449,0,0,8403156,8658041,51.79768334587948,2312,6186,5815,2683,48480,774480,651854,2856,5910,3598,6359,9413,55.96427431853289,19.629090169852294,3054,1,541966,53424,3132,0,544,95
3220,0,1,1,0,63,0,1048,0,0,7376180,7118350,47.34976240700686,2212,5562,5532,2242,55278,790575,704850,3145,5417,3205,6465,8737,57.358521598799946,5.684275577662207,2272,1,497724,4650,3290,0,933,115
3221,0,0,0,0,59,1,481,1,0,231066,880011,17.233687939614086,107,1265,1075,297,53410,725935,645934,2773,3260,3153,3741,4228,27.892651361962706,13.973411963356208,487,1,64746,27170,778,0,2666,2185
3222,0,0,0,0,59,1,469,1,0,273912,1002762,18.411952639521967,123,1363,1147,339,55926,692172,706962,2742,3297,3174,3766,4321,28.42534080710379,14.853878688691474,555,1,81021,23760,808,0,2619,2150
3223,0,0,1,0,58,1,450,0,0,350064,1201152,20.199009876724155,131,1543,1266,408,56628,712448,688896,2667,3352,3221,3802,4487,29.29163703175362,16.742690253690217,685,1,95472,36010,858,0,2536,2086
3224,0,0,1,0,58,1,443,0,0,379308,1274319,20.808652046684813,156,1586,1309,433,56595,721035,679833,2666,3376,3220,3819,4529,29.597297173897484,17.048237209539366,710,1,100023,38780,876,0,2510,2067
3225,0,0,1,0,58,1,439,0,0,556326,1633266,23.62202362203543,288,1825,1555,558,56160,702480,684918,2657,3485,3197,3924,4752,31.575306807693888,16.716313724403488,828,1,130572,36450,997,0,2369,1930
3226,0,0,1,0,58,1,448,0,0,655424,1796256,24.819347291981714,346,1950,1680,616,55695,685260,691092,2646,3532,3186,3980,4866,32.61901286060018,16.637457302852365,886,1,145992,34290,1064,0,2300,1852
3227,0,0,1,0,58,1,452,0,0,730380,1910832,25.65151067676132,386,2040,1768,658,54707,659208,699864,2632,3562,3176,4014,4944,33.31666249791537,16.6246312392797,930,1,158578,31008,1110,0,2246,1794
3228,0,0,1,0,54,1,456,0,0,1538137,2831453,32.14031735997639,1033,2522,2522,1033,46494,674286,518049,2741,3774,2741,4230,5263,38.58756276314948,0.0,1033,0,195237,0,1489,0,1708,1252
3229,0,0,0,0,56,1,653,1,0,1719950,2891525,32.01562118716424,855,2873,2703,1025,44856,710892,502138,2651,3846,2991,4499,5694,40.963398296528084,13.414440520665401,1195,1,182450,35190,1678,0,1796,1143
3230,0,0,0,0,56,1,798,1,0,1770120,2819520,31.464265445104548,732,3036,2778,990,46686,714848,529728,2590,3838,3106,4636,5884,42.28474902373195,16.408694078727795,1248,1,184140,51858,1788,0,1858,1060
3231,1,0,0,0,47,0,568,1,0,163380,497910,14.491376746189438,140,1338,988,210,35700,564298,355650,2021,2581,2721,3149,3709,27.892651361962706,18.788558083975534,560,1,31500,78400,778,0,2161,1593
3232,1,0,0,0,48,0,556,1,0,292380,802230,18.16590212458495,60,1606,1216,330,36972,576147,379236,2041,2761,2821,3317,4037,29.765752132274432,20.315129700937874,720,1,51480,85020,886,0,2101,1545
3233,1,0,0,0,42,0,354,0,0,577071,2038410,30.93541659651604,957,1560,1560,957,52212,487770,485640,2130,3087,2130,2733,3690,24.55605831561735,0.0,957,0,218196,0,603,0,1173,1527
3234,1,0,0,0,42,0,281,0,0,530082,1875132,29.698484809834994,882,1483,1483,882,47174,486854,437956,2126,3008,2126,2727,3609,24.515301344262525,0.0,882,0,181692,0,601,0,1244,1525
3235,1,0,0,0,42,0,255,0,0,517374,1825824,29.29163703175362,858,1461,1461,858,44895,466032,436240,2128,2986,2128,2731,3589,24.55605831561735,0.0,858,0,175890,0,603,0,1270,1525
3236,1,0,0,0,44,0,83,1,0,318068,1171140,22.891046284519195,57,1598,1131,524,34694,371010,467115,1768,2759,2702,2842,3833,24.63736998950984,22.161092926787695,991,1,109516,35025,607,0,1711,1628
3237,1,0,0,0,41,0,663,0,0,939708,2815056,36.823905279043935,1356,2049,2049,1356,50880,498240,440112,2076,3432,2076,2769,4125,26.324893162176366,0.0,1356,1,287472,0,693,0,720,1383
3238,1,0,0,0,43,0,721,1,0,1107696,3196410,38.379682124790975,1298,2400,2225,1473,31122,507780,288610,1995,3643,2345,2922,4570,27.422618401604176,14.11109767230738,1648,1,195909,40775,752,0,697,1418
3239,1,0,0,0,43,0,724,1,0,1139085,3259421,38.58756276314948,1288,2455,2254,1489,26564,501281,253924,1988,3678,2390,2954,4644,27.65863337187866,15.10554740609148,1690,1,172724,48441,765,0,700,1424
3240,1,0,0,0,46,0,479,0,1,1186980,3130050,36.810324638611924,955,2631,2231,1355,34875,519750,358050,1910,3665,2710,3186,4941,29.597297173897484,21.57429766140927,1755,1,210025,83600,876,0,955,1434
3241,1,0,0,0,46,0,362,0,1,951303,2748339,34.249087579087416,890,2267,1984,1173,50200,588093,468600,2060,3516,2626,3154,4610,28.478061731796284,16.94729252812277,1456,1,234600,52921,811,0,1170,1532
3242,1,0,0,0,46,0,367,0,1,896588,2696652,33.88214869219483,880,2197,1929,1148,49588,594297,460404,2081,3497,2617,3130,4546,27.94637722496424,16.54041876222127,1416,1,225008,51188,781,0,1201,1568
3243,1,0,0,0,47,0,372,0,1,843373,2642419,33.51119216023208,867,2130,1874,1123,48132,592956,449423,2097,3476,2609,3104,4483,27.40437921208944,16.20835795771336,1379,1,214493,50432,751,0,1230,1602
3244,1,0,0,0,47,0,378,0,1,792379,2595838,33.15116890850155,852,2067,1820,1099,40016,576328,387368,2115,3461,2609,3083,4429,26.851443164195103,16.005917126935234,1346,1,180236,53599,721,0,1263,1641
3245,1,0,0,0,47,0,383,0,1,742134,2553972,32.77193921634788,832,2007,1765,1074,40391,568342,401882,2136,3452,2620,3069,4385,26.28687885618983,16.00512449068634,1316,1,181506,50578,691,0,1304,1687
3246,1,0,0,0,47,0,389,0,1,694050,2503200,32.4037034920393,810,1951,1711,1050,51935,526864,560240,2144,3434,2624,3045,4335,25.709920264364882,16.010000385993933,1290,1,246750,28080,661,0,1334,1723
3247,1,0,0,0,47,0,395,0,1,647406,2429568,32.03123475609393,784,1899,1657,1026,49392,464128,596736,2126,3394,2610,2999,4267,25.11971337416094,15.907899214107001,1268,1,258552,13310,631,0,1342,1737
3248,1,0,0,0,47,0,402,0,1,602803,2361062,31.670175244226233,756,1851,1604,1003,54750,515526,588500,2107,3357,2601,2955,4205,24.515301344262525,15.94311779230633,1250,1,250750,20995,601,0,1351,1753
3249,1,0,0,0,46,0,408,0,1,559009,2297713,31.28897569432403,723,1806,1550,979,56608,544504,572668,2091,3326,2603,2918,4153,23.895606290697042,16.16875896871896,1235,1,238876,27648,571,0,1368,1776
3250,1,0,0,0,46,0,431,0,1,438672,2134992,30.199337741083,612,1693,1393,912,44022,592273,407334,2041,3253,2641,2822,4034,21.93171219946131,17.425824187477687,1212,1,158688,62700,481,0,1429,1860
3251,1,0,0,0,47,0,449,0,1,366270,2058420,29.49576240750525,531,1630,1291,870,55552,586768,529984,2027,3236,2705,2787,3996,20.518284528683193,18.616167243055138,1209,1,194880,50511,421,0,1496,1945
3252,1,0,0,0,47,0,458,0,1,331959,1998546,29.13760456866693,488,1601,1240,849,48945,459030,590854,1993,3203,2715,2745,3955,19.77371993328519,19.147564871653366,1210,1,213099,14440,391,0,1505,1963
3253,1,0,0,0,46,0,467,0,1,298908,1929240,28.77498913987632,467,1550,1189,828,43077,403090,580170,1969,3158,2691,2691,3880,19.0,20.6892054491381,1189,1,206172,0,361,0,1502,1969
3254,1,0,0,0,46,0,476,0,1,267117,1863363,28.407745422683583,468,1477,1138,807,44500,411002,577250,1970,3116,2648,2640,3786,18.193405398660254,19.956168621172907,1146,1,201750,5085,331,0,1502,1978
3255,1,0,0,0,45,0,486,0,1,236887,1799869,28.053520278211074,468,1407,1088,787,46065,423095,569463,1968,3074,2606,2588,3694,17.349351572897472,19.22940973892271,1106,1,195963,7337,301,0,1500,1986
3256,1,0,0,0,44,0,520,0,1,155184,1640412,27.055498516937366,464,1212,944,732,49644,441477,564732,1973,2973,2509,2453,3453,14.560219778561036,17.524900157951663,1000,1,184464,11256,212,0,1509,2029
3257,1,0,0,0,44,0,547,0,1,107100,1548400,26.457513110645905,458,1095,853,700,52000,460096,553000,1970,2912,2454,2365,3307,12.36931687685298,16.50383523772413,942,1,175000,14762,153,0,1512,2059
3258,1,0,0,0,43,0,576,0,1,63745,1468148,25.903667693977237,489,948,766,671,51156,444164,551376,2006,2859,2370,2283,3136,9.746794344808963,14.582844441888469,853,1,169092,9464,95,0,1517,2093
3259,1,0,0,0,43,0,591,0,1,44086,1429176,25.65151067676132,505,878,725,658,45287,388788,549516,2019,2830,2325,2239,3050,8.18535277187245,13.400333140258068,811,1,166474,3060,67,0,1514,2105
3260,1,0,0,0,42,0,604,0,1,27132,1388254,25.41653005427767,522,812,688,646,43010,365330,543697,2025,2795,2273,2191,2961,6.48074069840786,12.081486825133021,770,1,163438,1116,42,0,1503,2107
3261,1,0,0,0,41,0,551,0,1,41406,1291620,24.859605789312106,576,727,685,618,47244,388740,530860,2048,2708,2132,2157,2817,8.18535277187245,6.7597809605921,660,1,156972,1512,67,0,1472,2023
3262,1,0,0,0,41,0,517,0,1,58140,1268676,24.73863375370596,582,737,707,612,53105,445695,512031,2043,2685,2103,2168,2810,9.746794344808963,5.514871952411144,642,1,151164,2700,95,0,1461,1978
3263,1,0,0,0,41,0,483,0,1,75268,1256490,24.63736998950984,607,731,731,607,45472,480240,405720,2070,2677,2070,2194,2801,11.135528725660043,0.0,607,1,118972,0,124,0,1463,1946
3264,1,0,0,0,42,0,72,1,0,358704,1204704,23.748684174075834,534,1230,1200,564,34736,356712,444288,2106,2700,2166,2772,3366,25.219040425836983,5.490867587491313,594,1,117312,2340,636,0,1572,1500
3265,1,0,0,0,42,0,83,1,0,318068,1110356,22.891046284519195,416,1239,1131,524,36084,411086,394134,2011,2643,2227,2726,3358,24.63736998950984,10.392527581411793,632,1,97464,15228,607,0,1595,1512
3266,1,0,0,0,42,0,85,1,0,312354,1097124,22.759613353482084,394,1245,1121,518,38994,410892,425718,1994,2636,2242,2721,3363,24.55605831561735,11.157371872753709,642,1,104118,15376,603,0,1600,1515
3267,1,0,0,0,43,0,85,1,0,400784,1298256,24.331050121192877,484,1377,1269,592,25190,502197,241230,2085,2785,2301,2870,3570,26.019223662515376,11.466806094325776,700,1,65120,26352,677,0,1601,1516
3268,1,0,0,0,46,0,162,0,1,687328,2115910,30.23243291566195,680,1900,1666,914,53424,583380,490780,2081,3229,2549,3067,4215,27.422618401604176,15.526780068155361,1148,1,193768,40248,752,0,1401,1563
3269,1,0,0,0,41,0,25,0,1,142350,761755,19.1049731745428,238,882,755,365,51030,438270,507141,1960,2452,2214,2477,2969,19.748417658131498,12.208204741746746,492,1,88695,8128,390,0,1722,1697
3270,1,0,0,0,41,0,25,0,1,120600,695125,18.303005217723125,227,803,695,335,48090,435750,475175,1967,2410,2183,2435,2878,18.973665961010276,11.25033949080533,443,1,76715,7668,360,0,1740,1715
3271,0,0,1,0,55,1,1961,0,0,545376,6173568,46.98936049788292,1936,2727,2455,2208,40320,671040,469728,2524,5004,3068,3043,5523,15.716233645501712,17.253970932283497,2480,1,370944,57120,247,0,588,2549
3272,0,0,1,0,56,1,1950,0,0,690336,6352896,47.49736834815167,1937,2881,2562,2256,40824,684288,473088,2497,5072,3135,3122,5697,17.4928556845359,18.32583612366698,2575,1,379008,67947,306,0,560,2510
3273,0,0,0,0,58,1,537,1,0,201960,751485,15.968719422671311,105,1197,1047,255,53680,719068,648340,2797,3202,3097,3739,4144,28.142494558940577,12.360324274125283,405,1,56100,21000,792,0,2692,2155
3274,0,0,0,0,58,1,528,1,0,222985,816596,16.64331697709324,115,1244,1082,277,53410,722260,642664,2786,3225,3110,3753,4192,28.372521918222215,12.87391722223528,439,1,60386,23004,805,0,2671,2143
3275,0,0,0,0,58,1,515,1,0,266046,939774,17.86057109949175,127,1345,1153,319,55209,704094,680526,2754,3265,3138,3780,4291,28.879058156387302,13.990149959375703,511,1,73689,23808,834,0,2627,2112
3276,0,0,0,0,58,1,491,1,0,344862,1147194,19.77371993328519,136,1528,1273,391,56608,715896,680688,2679,3325,3189,3816,4462,29.698484809834994,16.075934767576697,646,1,90712,34680,882,0,2543,2052
3277,0,0,1,0,58,1,490,0,0,681296,1790096,24.819347291981714,376,1962,1722,616,55926,680004,694534,2666,3522,3146,4012,4868,33.25657829663178,15.663936949793563,856,1,147224,29520,1106,0,2290,1800
3278,0,0,1,0,54,1,484,0,0,1466661,2719827,31.51190251317746,993,2470,2470,993,52668,624492,632709,2739,3732,2739,4216,5209,38.43175770115127,0.0,993,0,229383,0,1477,1,1746,1262
3279,0,0,0,0,56,1,694,1,0,1685927,2805558,31.575306807693888,847,2838,2688,997,47498,714756,526218,2664,3811,2964,4505,5652,41.12177038990418,12.5999078163187,1147,1,186439,29700,1691,0,1817,1123
3280,0,0,0,0,57,1,973,1,0,1792518,2703316,30.62678566222711,588,3199,2849,938,40290,683034,489940,2532,3820,3232,4793,6081,43.71498598878879,18.96593854960265,1288,1,159460,72100,1911,0,1944,971
3281,1,0,0,0,44,0,134,1,0,464736,1384320,24.859605789312106,152,1836,1370,618,24180,349440,347200,1774,2858,2706,2992,4076,27.422618401604176,21.756238649808694,1084,1,95790,57318,752,0,1622,1488
3282,1,0,0,0,45,0,186,1,0,808567,1826372,28.478061731796284,368,2251,1808,811,39617,515708,389596,1809,3063,2695,3249,4503,31.575306807693888,21.36475195827169,1254,1,140303,86385,997,0,1441,1255
3283,1,0,0,0,41,0,661,0,0,998526,2869725,37.1887079635741,1383,2105,2105,1383,46844,495925,406700,2075,3458,2075,2797,4180,26.870057685088806,0.0,1383,0,271068,0,722,0,692,1353
3284,1,0,0,0,42,0,679,1,0,1028570,2974399,37.53664875824692,1349,2199,2139,1409,26076,447532,259653,2051,3520,2171,2841,4310,27.018512172212592,8.275039169881914,1469,1,173307,13320,730,0,702,1381
3285,1,0,0,0,46,0,370,0,1,1078800,2896640,35.21363372331802,898,2452,2110,1240,51450,572320,490560,1994,3576,2678,3206,4788,29.49576240750525,18.56257784815109,1582,1,260400,59166,870,0,1096,1466
3286,1,0,0,0,46,0,375,0,1,1020600,2838240,34.85685011586675,891,2379,2055,1215,53599,576992,506912,2012,3551,2660,3176,4715,28.982753492378876,18.07514540360568,1539,1,263655,53460,840,0,1121,1496
3287,1,0,0,0,46,0,380,0,1,963900,2779840,34.49637662132068,881,2309,2000,1190,53463,586336,497568,2027,3526,2645,3146,4645,28.460498941515414,17.65902901620333,1499,1,253470,52839,810,0,1146,1526
3288,1,0,0,0,47,0,390,0,1,855000,2679000,33.76388603226827,855,2175,1890,1140,42828,585150,404200,2065,3490,2635,3100,4525,27.386127875258307,17.042583472079173,1425,1,196080,60705,750,0,1210,1600
3289,1,0,0,0,47,0,402,0,1,753480,2595684,33.04542328371661,820,2054,1782,1092,45567,591873,434991,2105,3469,2649,3067,4431,26.267851073127396,16.86362314668256,1364,1,199836,55216,690,0,1285,1687
3290,1,0,0,0,46,0,429,0,1,569430,2332665,31.606961258558215,714,1854,1569,999,55660,537050,565070,2050,3334,2620,2905,4189,23.874672772626646,16.968618689213063,1284,1,241758,28500,570,0,1336,1765
3291,1,0,0,0,46,0,437,0,1,527580,2275433,31.25699921617557,682,1812,1517,977,56168,549644,554302,2034,3306,2624,2869,4141,23.2379000772445,17.235690167505883,1272,1,232526,33630,540,0,1352,1789
3292,1,0,0,0,46,0,445,0,1,487050,2220375,30.903074280724887,646,1774,1465,955,54467,583575,504525,2016,3280,2634,2835,4099,22.58317958127243,17.62246075341173,1264,1,207235,49131,510,0,1370,1815
3293,1,0,0,0,46,0,462,0,1,410400,2139552,30.199337741083,570,1704,1362,912,43092,591192,401166,2004,3258,2688,2796,4050,21.213203435596427,18.599210437109548,1254,1,155952,70110,450,0,1434,1896
3294,1,0,0,0,47,0,471,0,1,374220,2096523,29.8496231131986,530,1672,1311,891,55876,574132,538837,1992,3244,2714,2773,4025,20.493901531919196,19.125625662602012,1252,1,204039,49457,420,0,1462,1933
3295,1,0,0,0,46,0,480,0,1,339300,2036670,29.49576240750525,509,1621,1260,870,48768,449472,594614,1980,3211,2702,2731,3962,19.748417658131498,20.780877737897967,1231,1,220980,13357,390,0,1471,1951
3296,1,0,0,0,46,0,490,0,1,306000,1970300,29.154759474226502,511,1549,1210,850,43769,401014,586454,1979,3168,2657,2678,3867,18.973665961010276,20.02236869512215,1189,1,215050,3729,360,0,1468,1958
3297,1,0,0,0,45,0,500,0,1,273900,1907340,28.809720581775867,511,1479,1160,830,43769,397554,581394,1979,3128,2617,2628,3777,18.16590212458495,19.376611149766934,1149,1,209990,3828,330,0,1468,1968
3298,1,0,0,0,44,0,534,0,1,185760,1736082,27.820855486487112,516,1272,1014,774,50148,446357,565236,1985,3017,2501,2483,3515,15.491933384829668,17.17497191601075,1032,1,195048,11868,240,0,1469,2003
3299,1,0,0,0,44,0,547,0,1,158970,1686596,27.51363298439521,515,1209,967,757,50400,445600,561456,1986,2985,2470,2438,3437,14.491376746189438,16.545885401338353,999,1,190764,11374,210,0,1471,2018
3300,1,0,0,0,44,0,561,0,1,133380,1640574,27.2213151776324,513,1149,921,741,51912,456084,557928,1986,2955,2442,2394,3363,13.416407864998739,16.095395885040958,969,1,186732,12996,180,0,1473,2034
3301,1,0,0,0,44,0,576,0,1,108900,1597926,26.94438717061496,508,1094,876,726,52416,457808,554652,1983,2927,2419,2351,3295,12.24744871391589,15.684646312459815,944,1,182952,13298,150,0,1475,2051
3302,1,0,0,0,43,0,591,0,1,85320,1555668,26.664583251946766,510,1032,831,711,52961,461668,549188,1987,2899,2389,2308,3220,10.954451150103322,14.998296005958716,912,1,178461,13266,120,0,1477,2068
3303,1,0,0,0,43,0,625,0,1,41100,1480285,26.1725046566048,535,895,745,685,48514,412751,548894,2011,2846,2311,2221,3056,7.745966692414834,13.093212071241357,835,1,173990,5550,60,0,1476,2101
3304,1,0,0,0,42,0,625,0,1,19650,1377465,25.592967784139454,595,745,685,655,46736,386952,534162,2043,2758,2163,2133,2848,5.477225575051661,8.217978828131171,715,1,166370,1860,30,0,1448,2073
3305,1,0,0,0,41,0,551,0,1,57690,1328152,25.317977802344327,641,731,731,641,51300,466200,472416,2072,2713,2072,2162,2803,9.486832980505138,0.0,641,1,146148,0,90,0,1431,1982
3306,1,0,0,0,42,0,83,1,0,398334,1269468,24.310491562286437,531,1325,1265,591,33184,524112,292128,2088,2739,2208,2822,3473,25.96150997149434,8.660254037844387,651,1,80376,13740,674,0,1557,1474
3307,1,0,0,0,44,0,67,1,0,443100,1400196,25.15949125081825,525,1441,1333,633,26790,519820,252168,2104,2845,2320,2912,3653,26.457513110645905,11.644842629313263,741,1,72162,26028,700,0,1579,1512
3308,1,0,0,0,46,0,179,0,1,826472,2323951,31.670175244226233,853,1977,1827,1003,54312,574616,507423,2167,3320,2467,3141,4294,28.705400188814647,12.710426594494582,1153,1,219657,24300,824,0,1314,1493
3309,1,0,0,0,45,0,174,0,1,919800,2408700,32.4037034920393,942,2034,1926,1050,48006,433566,582676,2186,3344,2402,3170,4328,29.597297173897484,11.227269336102799,1158,1,266700,3888,876,0,1244,1418
3310,1,0,0,0,41,0,30,0,1,141151,748714,19.0,253,860,752,361,49698,410652,520574,1966,2435,2182,2465,2934,19.77371993328519,11.227269336102799,469,1,90611,4752,391,0,1713,1683
3311,0,1,1,0,64,0,1258,0,0,10063115,12547024,62.153036933041335,3651,6680,6468,3863,50853,821744,652848,3036,7111,3460,5853,9928,51.03920062069938,14.614663499292087,4075,0,776463,39432,2605,1,615,643
3312,0,1,1,0,65,0,444,0,0,9772672,10977476,57.93099343184095,2936,6688,6268,3356,55388,798124,742517,2851,6627,3691,6183,9959,53.96295025292817,20.751145327328377,3776,0,761812,62580,2912,1,85,359
3313,0,0,1,0,55,1,1309,0,0,747770,4822247,41.701318923986086,1471,2437,2169,1739,53360,637790,643336,2505,4512,3041,3203,5210,20.73644135332772,16.50583698321614,2007,1,403448,35108,430,0,1034,2343
3314,0,0,0,0,58,1,568,1,0,234065,812164,16.64331697709324,127,1272,1122,277,54168,715408,650904,2782,3209,3082,3777,4204,29.068883707497267,12.325090945468352,427,1,61494,20700,845,0,2655,2087
3315,0,0,0,0,58,1,540,1,0,311500,1025150,18.708286933869708,138,1452,1240,350,56144,708818,679528,2717,3279,3141,3819,4381,29.832867780352597,14.669851868889596,562,1,81200,27772,890,0,2579,2039
3316,0,0,0,0,58,1,529,1,0,531440,1488543,22.60530911091463,301,1761,1551,511,56088,716598,664164,2703,3424,3123,3953,4674,32.2490309931942,14.760160631183508,721,1,116508,30030,1040,0,2402,1873
3317,0,0,0,0,56,1,521,1,0,1097460,2298114,28.61817604250837,666,2312,2159,819,49022,541558,712724,2653,3625,2959,4146,5118,36.60601043544625,12.69945513274437,972,1,208026,6579,1340,0,1987,1466
3318,0,0,1,0,54,1,513,0,0,1397098,2616938,30.870698080866262,923,2449,2419,953,52800,604120,659040,2716,3699,2776,4212,5195,38.28837943815329,5.5503012171862105,983,0,228720,3240,1466,1,1793,1280
3319,0,0,0,0,55,1,696,1,0,1645137,2745819,31.32091952673165,873,2766,2658,981,46299,708147,512217,2691,3780,2907,4476,5565,40.95119045888654,10.684669642126707,1089,1,179523,21924,1677,0,1818,1122
3320,1,0,0,0,46,0,551,0,1,41406,156713,8.18535277187245,294,1046,685,67,52341,559021,512241,1978,2406,2700,2957,3385,24.859605789312106,19.086914556656602,428,1,14673,56677,618,0,2272,1721
3321,1,0,0,0,42,0,250,0,0,638856,2001562,30.56141357987225,934,1618,1618,934,53360,497176,492890,2143,3077,2143,2827,3761,26.153393661244042,0.0,934,0,214820,0,684,0,1209,1459
3322,1,0,0,0,42,0,278,0,0,646535,2047520,30.903074280724887,925,1662,1632,955,43400,465248,428800,2114,3099,2174,2821,3806,26.019223662515376,5.490867587491313,985,0,191000,4620,677,0,1189,1467
3323,1,0,0,0,42,0,311,1,0,594402,2023416,30.692018506445613,882,1633,1573,942,32725,401676,375900,2088,3090,2208,2779,3781,25.11971337416094,7.914659756013729,1002,1,164850,8580,631,0,1206,1517
3324,1,0,0,0,45,0,144,1,0,242820,1293900,23.874672772626646,168,1398,996,570,39964,467620,440380,1868,2840,2672,2696,3668,20.639767440550294,21.016501434072,972,1,110580,58692,426,0,1700,1844
3325,1,0,0,0,46,0,416,0,1,1279236,3161424,36.851051545376556,912,2746,2300,1358,44215,556392,430680,1882,3686,2774,3270,5074,30.692018506445613,21.169911386961495,1804,1,251230,86524,942,0,970,1386
3326,1,0,0,0,46,0,373,0,1,1279680,3107223,36.51027252705737,909,2717,2293,1333,52598,554778,515151,1907,3664,2755,3291,5048,30.983866769659336,20.6303496101567,1757,1,294593,64872,960,0,998,1371
3327,1,0,0,0,46,0,382,0,1,1153800,2985778,35.805027579936315,898,2566,2182,1282,54531,579921,510051,1945,3611,2713,3229,4895,30.0,19.636490343843082,1666,1,280758,62208,900,0,1047,1429
3328,1,0,0,0,46,0,390,0,1,1035271,2869461,35.08560958569767,881,2422,2072,1231,55278,580419,517482,1981,3562,2681,3172,4753,29.0,18.760337965492944,1581,1,273282,54600,841,0,1100,1490
3329,1,0,0,0,46,0,396,0,1,978877,2813517,34.741905532080416,872,2353,2018,1207,53965,585081,501165,1996,3538,2666,3142,4684,28.478061731796284,18.358569931971438,1542,1,259505,55945,811,0,1124,1520
3330,1,0,0,0,46,0,401,0,1,923142,2758788,34.38022687534217,859,2286,1963,1182,47058,590502,434124,2011,3516,2657,3115,4620,27.94637722496424,18.040713851564195,1505,1,219852,64600,781,0,1152,1553
3331,1,0,0,0,46,0,407,0,1,869658,2716668,34.02939905434711,845,2222,1909,1158,37884,577116,361284,2033,3504,2659,3097,4568,27.40437921208944,17.812638437069,1471,1,178332,70425,751,0,1188,1595
3332,1,0,0,0,47,0,413,0,1,817614,2678508,33.67491648096547,828,2161,1855,1134,36207,573966,351938,2056,3496,2668,3083,4523,26.851443164195103,17.704929018438854,1440,1,168966,69462,721,0,1228,1641
3333,1,0,0,0,47,0,426,0,1,718507,2574016,32.96968304366907,787,2048,1748,1087,51865,485440,599104,2068,3455,2668,3029,4416,25.709920264364882,17.578165697227664,1387,1,275011,17400,661,0,1281,1707
3334,1,0,0,0,46,0,440,0,1,625641,2426571,32.264531609803356,735,1948,1642,1041,52710,489510,585081,2025,3372,2637,2932,4279,24.515301344262525,17.55644642610752,1347,1,261291,19278,601,0,1290,1730
3335,1,0,0,0,46,0,448,0,1,581849,2366118,31.921779399024736,706,1903,1590,1019,55161,527094,564246,2009,3341,2635,2893,4225,23.895606290697042,17.7270950964016,1332,1,247617,29735,571,0,1303,1751
3336,1,0,0,0,46,0,456,0,1,539377,2308055,31.575306807693888,674,1861,1538,997,55926,553285,541710,1992,3312,2638,2856,4176,23.259406699226016,17.991162904425803,1320,1,233298,39406,541,0,1318,1774
3337,1,0,0,0,46,0,465,0,1,498736,2259440,31.240998703626616,641,1822,1487,976,52920,583380,486150,1980,3291,2650,2826,4137,22.60530911091463,18.320959680027343,1311,1,204960,56280,511,0,1339,1804
3338,1,0,0,0,46,0,482,0,1,420783,2176689,30.54504869860253,567,1750,1384,933,43263,590249,398943,1967,3266,2699,2784,4083,21.236760581595302,19.185202730889724,1299,1,159543,76128,451,0,1400,1882
3339,1,0,0,0,44,0,557,0,1,193358,1783368,28.26658805020514,565,1275,1041,799,49276,433008,566928,1998,3031,2466,2474,3507,15.556349186104045,16.390953545381592,1033,1,202946,9360,242,0,1433,1990
3340,1,0,0,0,44,0,570,0,1,165784,1732912,27.964262908219126,566,1210,994,782,50600,443200,560648,2000,2998,2432,2428,3426,14.560219778561036,15.658144421723517,998,1,197846,10368,212,0,1434,2004
3341,1,0,0,0,44,0,585,0,1,139594,1688934,27.694764848252458,566,1150,949,767,52164,455814,554904,2001,2969,2403,2384,3352,13.490737563232042,15.01331559233809,968,1,193284,11859,182,0,1435,2020
3342,1,0,0,0,42,0,660,0,1,29484,1501578,26.49528259898354,594,852,744,702,45540,385020,541167,2031,2841,2247,2181,2991,6.48074069840786,11.137157851700797,810,1,177606,3240,42,0,1437,2097
3343,1,0,0,0,42,0,29,1,0,308370,1206690,23.874672772626646,408,1273,1111,570,29946,340837,393762,1955,2687,2279,2658,3390,23.259406699226016,13.6673582272763,732,1,106020,15552,541,0,1547,1576
3344,1,0,0,0,46,0,186,0,1,941976,2457468,32.68026927673638,973,2045,1950,1068,53130,483210,582153,2206,3369,2396,3183,4346,29.698484809834994,10.232047425710157,1163,1,270204,6365,882,0,1233,1419
3345,0,1,1,0,64,0,1366,0,0,10200267,12767117,62.8410693734599,3822,6659,6532,3949,53037,805017,688629,3106,7182,3360,5816,9892,50.82322303829225,11.290504321766129,4076,0,841137,21717,2583,1,716,650
3346,0,1,1,0,64,0,1573,0,0,6760790,6243550,43.93176527297759,1600,5763,5433,1930,51156,815220,656705,2905,5165,3565,6738,8998,59.18614702783076,18.182560465906082,2260,1,391790,56430,3503,0,1305,268
3347,0,0,0,0,58,1,614,1,0,224976,752844,16.06237840420901,131,1257,1130,258,55056,723664,647796,2791,3176,3045,3790,4175,29.5296461204668,11.319573475552495,385,1,57276,19050,872,0,2660,2046
3348,0,0,0,0,58,1,559,1,0,370110,1134900,19.748417658131498,200,1529,1339,390,55671,701310,672210,2720,3300,3100,3859,4439,30.805843601498726,14.06415317210833,580,1,90090,24130,949,0,2520,1961
3349,0,0,0,0,58,1,572,1,0,488229,1361507,21.656407827707714,289,1690,1510,469,55615,711235,658981,2723,3372,3083,3944,4593,32.264531609803356,13.64881300169067,649,1,106463,24840,1041,0,2434,1862
3350,0,0,0,0,58,1,568,1,0,700800,1740000,24.49489742783178,418,1950,1768,600,55454,690200,675700,2718,3500,3082,4068,4850,34.17601498127012,13.810035044505925,782,1,139800,24934,1168,0,2300,1732
3351,0,0,0,0,55,1,549,1,0,1148992,2317120,28.844410203711913,712,2333,2213,832,51562,565355,707390,2665,3617,2905,4166,5118,37.16180835212409,11.12174306341096,952,1,211328,7200,1381,0,1953,1404
3352,0,0,1,0,55,1,545,0,0,1267866,2444474,29.765752132274432,826,2377,2317,886,53816,598703,684232,2699,3645,2819,4190,5136,37.82856063875548,7.83531632499182,946,0,219728,5400,1431,1,1873,1328
3353,0,0,1,0,55,1,542,0,0,1330784,2516242,30.23243291566195,884,2400,2370,914,53724,611166,666226,2723,3667,2783,4209,5153,38.157568056677825,5.5503012171862105,944,0,221188,3210,1456,1,1839,1297
3354,1,0,0,0,43,0,159,0,0,666900,1937700,30.0,900,1641,1641,900,55932,508108,510261,2153,3053,2153,2894,3794,27.2213151776324,0.0,900,0,213300,0,741,0,1253,1412
3355,1,0,0,0,42,0,216,0,0,675577,2007991,30.610455730027933,937,1658,1658,937,52836,510034,475746,2143,3080,2143,2864,3801,26.851443164195103,0.0,937,0,208014,0,721,0,1206,1422
3356,1,0,0,0,43,0,355,1,0,479004,1932072,29.866369046136157,802,1519,1429,892,29503,392046,353058,2076,3058,2256,2703,3685,23.173260452512935,9.924141172814958,982,1,145396,13410,537,0,1274,1629
3357,1,0,0,0,45,0,195,1,0,839656,1879544,28.705400188814647,416,2251,1843,824,30589,385489,412861,1873,3105,2689,3300,4532,31.921779399024736,20.650109346676764,1232,1,149144,45696,1019,0,1457,1262
3358,1,0,0,0,42,0,587,0,0,1085664,2901984,37.094473981982816,1346,2195,2165,1376,55696,497724,497724,2079,3485,2139,2898,4304,28.089143810376278,5.501408174353464,1406,1,324736,3420,789,0,733,1320
3359,1,0,0,0,42,0,600,0,0,1087225,2916810,37.21558813185679,1355,2200,2170,1385,52459,528606,440154,2076,3491,2136,2891,4306,28.0178514522438,5.5503012171862105,1415,1,289465,4950,785,0,721,1321
3360,1,0,0,0,42,0,674,1,0,1154307,3089856,38.24918299781056,1403,2312,2252,1463,26450,485760,242880,2052,3575,2172,2901,4424,28.089143810376278,8.39589984422804,1523,1,168245,14520,789,0,649,1323
3361,1,0,0,0,46,0,391,0,1,1233036,3070683,36.373066958946424,897,2681,2255,1323,56400,545435,557040,1895,3644,2747,3253,5002,30.528675044947494,20.66046408581588,1749,1,317520,51972,932,0,998,1389
3362,1,0,0,0,46,0,401,0,1,1110056,2952087,35.679125549822544,882,2536,2145,1273,55278,577431,514818,1928,3592,2710,3191,4855,29.5296461204668,19.793898493141363,1664,1,282606,59432,872,0,1046,1447
3363,1,0,0,0,46,0,418,0,1,938400,2793600,34.64101615137755,849,2333,1982,1200,43925,584328,407400,1977,3528,2679,3110,4661,27.964262908219126,18.778788002554194,1551,1,210000,73710,782,0,1128,1546
3364,1,0,0,0,46,0,424,0,1,884352,2754192,34.292856398964496,834,2270,1928,1176,35235,569106,339590,2000,3518,2684,3094,4612,27.422618401604176,18.583648574695868,1518,1,170520,78660,752,0,1166,1590
3365,1,0,0,0,47,0,431,0,1,832466,2721080,33.95585369269929,818,2210,1875,1153,39184,585280,372880,2025,3513,2695,3082,4570,26.870057685088806,18.478084298533762,1488,1,182174,74370,722,0,1207,1638
3366,1,0,0,0,47,0,443,0,1,733278,2605736,33.25657829663178,776,2099,1769,1106,49082,457064,596068,2026,3462,2686,3019,4455,25.748786379167466,18.324129811218587,1436,1,279818,12870,663,0,1250,1693
3367,1,0,0,0,46,0,467,0,1,595920,2401360,32.2490309931942,698,1955,1613,1040,55125,519525,565705,1967,3349,2651,2882,4264,23.93741840717165,18.502129318647302,1382,1,254800,31122,573,0,1269,1736
3368,1,0,0,0,46,0,483,0,1,512458,2297088,31.575306807693888,635,1873,1511,997,50546,585216,458496,1942,3301,2666,2818,4177,22.67156809750927,19.029926305868532,1359,1,198403,66246,514,0,1307,1790
3369,1,0,0,0,46,0,501,0,1,433570,2220375,30.903074280724887,589,1775,1409,955,41917,583575,388275,1959,3280,2691,2779,4100,21.307275752662516,20.566130400518517,1321,1,159485,79056,454,0,1370,1871
3370,1,0,0,0,46,0,510,0,1,396016,2182758,30.56141357987225,592,1700,1358,934,53250,584250,497781,1995,3271,2679,2761,4037,20.591260281974,20.24664966699213,1276,1,198942,58482,424,0,1403,1913
3371,1,0,0,0,46,0,530,0,1,326675,2071925,29.916550603303182,598,1557,1260,895,41832,384290,583380,2018,3210,2612,2680,3872,19.1049731745428,18.981895703114834,1192,1,225540,1782,365,0,1420,1950
3372,1,0,0,0,45,0,541,0,1,293460,2005164,29.597297173897484,599,1488,1211,876,39250,359373,572250,2012,3165,2566,2624,3777,18.303005217723125,18.25096116097859,1153,1,219000,0,335,0,1413,1954
3373,1,0,0,0,45,0,552,0,1,262548,1942512,29.29163703175362,603,1419,1164,858,42084,378088,570528,2009,3122,2519,2570,3683,17.4928556845359,17.350500409780906,1113,1,216216,0,306,0,1406,1958
3374,1,0,0,0,44,0,577,0,1,203528,1832576,28.705400188814647,612,1283,1071,824,48260,422560,564896,2012,3048,2436,2471,3507,15.716233645501712,15.671671988914904,1036,1,209296,7632,247,0,1400,1977
3375,1,0,0,0,43,0,616,0,1,126036,1695262,27.892651361962706,616,1102,940,778,52877,455411,551287,2017,2957,2341,2341,3281,12.727922061357855,13.425198563041231,940,1,196834,10530,162,0,1401,2017
3376,1,0,0,0,43,0,631,0,1,102510,1657755,27.65863337187866,612,1052,899,765,53928,463738,546084,2014,2932,2320,2301,3219,11.575836902790225,13.070431470999356,918,1,192780,11169,134,0,1402,2033
3377,1,0,0,0,42,0,656,0,1,62985,1590186,27.2213151776324,617,950,826,741,53928,459244,540792,2022,2887,2270,2231,3096,9.219544457292887,11.718395466430005,865,1,186732,9176,85,0,1405,2061
3378,1,0,0,0,42,0,664,0,1,48977,1562147,27.03701166919155,636,893,798,731,49530,416715,542798,2042,2868,2232,2204,3030,8.18535277187245,10.574981251593506,826,1,185674,4465,67,0,1406,2070
3379,1,0,0,0,41,0,646,0,1,47771,1493735,26.70205984563738,671,822,780,713,45360,377100,527940,2053,2808,2137,2162,2917,8.18535277187245,6.73127350780198,755,1,179676,1344,67,0,1382,2028
3380,1,0,0,0,41,0,621,0,1,60010,1467068,26.570660511172846,676,821,791,706,52460,446770,507032,2048,2784,2108,2163,2899,9.219544457292887,5.483301264452448,736,1,172264,2850,85,0,1372,1993
3381,1,0,0,0,41,0,592,0,1,75600,1454600,26.457513110645905,700,808,808,700,47236,500798,407288,2078,2778,2078,2186,2886,10.392304845413264,0.0,700,1,137200,0,108,0,1378,1970
3382,1,0,0,0,42,0,86,1,0,308400,1278600,24.49489742783178,450,1264,1114,600,24764,321781,349484,1981,2731,2281,2645,3395,22.67156809750927,13.226055982240474,750,1,98400,15900,514,0,1531,1617
3383,1,0,0,0,41,0,55,1,0,335064,1269237,24.63736998950984,577,1189,1159,607,27889,349197,349197,2061,2698,2121,2643,3280,23.49468024894146,5.830951894845301,637,1,101369,3720,552,0,1484,1539
3384,1,0,0,0,45,0,173,0,1,979560,2473200,32.863353450309965,1013,2054,1987,1080,52416,476320,577080,2223,3370,2357,3197,4344,30.116440692751194,8.642106768569302,1147,1,272160,4020,907,0,1210,1383
3385,1,0,0,0,44,0,34,0,1,840600,1982700,30.0,900,1834,1834,900,43890,418570,508893,2203,3103,2203,3137,4037,30.56141357987225,0.0,900,1,207900,0,934,0,1303,1269
3386,1,0,0,0,43,0,34,0,1,786480,1909650,29.49576240750525,840,1804,1774,870,38896,386320,485095,2165,3065,2225,3099,3999,30.066592756745816,5.483301264452448,900,1,192270,2220,904,0,1325,1291
3387,1,0,0,0,43,0,35,0,1,684450,1751220,28.460498941515414,810,1655,1655,810,42303,382674,516718,2162,2972,2162,3007,3817,29.068883707497267,0.0,810,1,193590,0,845,0,1352,1317
3388,1,0,0,0,42,0,35,0,1,635700,1676220,27.92848008753788,780,1595,1595,780,51870,451290,530803,2149,2929,2149,2964,3744,28.548204847240395,0.0,780,1,192660,0,815,0,1369,1334
3389,1,0,0,0,40,0,45,0,1,68400,480960,15.491933384829668,240,525,525,240,54264,456912,476952,2004,2244,2004,2289,2529,16.881943016134134,0.0,240,1,57120,0,285,0,1764,1719
3390,1,0,0,0,39,0,48,0,1,41040,358200,13.416407864998739,180,408,408,180,55454,463670,473620,1990,2170,1990,2218,2398,15.0996688705415,0.0,180,1,42840,0,228,0,1810,1762
3391,0,1,0,1,65,0,1817,0,0,10507950,13919400,65.3834841531101,4093,6915,6733,4275,49059,673992,771672,3074,7531,3438,5714,10171,49.57822102496216,13.575564726130827,4457,1,1013175,17472,2458,0,1019,798
3392,0,1,0,1,64,0,1690,0,0,10448256,13550082,64.69930447848725,4091,6777,6682,4186,54988,763932,754221,3142,7423,3332,5733,10014,49.95998398718719,9.773682308767459,4281,1,975338,12825,2496,0,949,741
3393,0,1,0,1,64,0,1604,0,0,10405772,13331106,64.2339474110069,4084,6690,6648,4126,55418,781902,739899,3189,7357,3273,5753,9921,50.21951811795888,6.495386533491135,4168,1,944854,6132,2522,0,895,709
3394,0,1,1,0,59,0,1825,0,0,2210624,2492672,28.844410203711913,415,3906,3489,832,55161,680092,728028,2579,3828,3413,5653,6902,51.54609587543949,20.798239296960425,1249,1,202176,39615,2657,0,2164,339
3395,0,0,1,0,60,1,1226,0,0,253080,543240,13.416407864998739,46,1720,1586,180,38232,651888,534186,2884,3198,3152,4424,4738,37.49666651850535,11.718240104647752,314,1,31860,23852,1406,0,2838,1612
3396,0,0,0,0,58,1,632,1,0,273465,858745,17.175564037317667,145,1372,1222,295,56619,707373,678263,2761,3206,3061,3838,4283,30.44667469527666,12.296281753706847,445,1,68735,20550,927,0,2616,1984
3397,0,0,0,0,58,1,619,1,0,304266,938961,17.97220075561143,153,1435,1265,323,56643,694773,688959,2737,3230,3077,3849,4342,30.692018506445613,13.097664939546313,493,1,76551,21420,942,0,2584,1965
3398,0,0,0,0,57,1,611,1,0,352226,1049438,19.026297590440446,200,1497,1335,362,56643,692861,687063,2737,3261,3061,3872,4396,31.192947920964443,12.95642684315187,524,1,85794,19764,973,0,2537,1926
3399,0,0,0,0,57,1,607,1,0,691998,1684308,24.124676163629637,429,1924,1771,582,56386,700348,674302,2741,3476,3047,4083,4818,34.48187929913333,12.737731642481698,735,1,135606,20808,1189,0,2312,1705
3400,0,0,0,0,57,1,604,1,0,735077,1753623,24.63736998950984,445,1980,1818,607,56635,678915,696249,2727,3496,3051,4100,4869,34.79942528261063,13.05562736842334,769,1,146287,19278,1211,0,2282,1678
3401,0,0,0,0,55,1,579,1,0,1144962,2276820,28.61817604250837,711,2325,2217,819,52000,578240,695000,2672,3599,2888,4178,5105,37.389838191679836,10.528806301837951,927,1,204750,8100,1398,0,1961,1382
3402,0,0,1,0,55,1,573,0,0,1267000,2413250,29.58039891549808,815,2383,2323,875,51516,584696,670194,2698,3633,2818,4206,5141,38.05259518088089,7.822290851349969,935,0,212625,5700,1448,1,1883,1310
3403,1,0,0,0,47,0,503,1,0,166668,539676,15.0996688705415,229,1416,959,228,39273,584649,376353,1910,2595,2824,3098,3783,27.03701166919155,21.37881211291069,685,1,36252,100997,731,0,2139,1636
3404,1,0,0,0,42,0,127,0,0,707460,1945515,30.116440692751194,907,1687,1687,907,55687,512655,499785,2145,3052,2145,2925,3832,27.92848008753788,0.0,907,0,211331,0,780,0,1238,1365
3405,1,0,0,0,43,0,362,1,0,681264,2233602,32.03123475609393,931,1785,1690,1026,34762,415807,396214,2082,3203,2272,2841,3962,25.768197453450252,10.115242524801646,1121,1,186732,13490,664,0,1151,1513
3406,1,0,0,0,44,0,444,1,0,220077,1660581,27.2213151776324,561,1218,1038,741,29055,436995,333909,2061,2982,2421,2538,3459,17.233687939614086,14.881264274500568,921,1,110409,32220,297,0,1500,1944
3407,1,0,0,0,46,0,53,1,0,565554,1674882,26.94438717061496,361,1870,1505,726,28700,403725,378348,1942,3033,2672,3086,4177,27.910571473905726,19.865046449669148,1091,1,119064,50735,779,0,1581,1528
3408,1,0,0,0,46,0,80,1,0,633609,1744128,27.51363298439521,397,1954,1594,757,26228,382464,364032,1944,3061,2664,3141,4258,28.930952282978865,19.719432407742122,1117,1,119606,47880,837,0,1547,1467
3409,1,0,0,0,46,0,103,1,0,708840,1827936,28.142494558940577,432,2047,1687,792,27825,403900,366972,1948,3100,2668,3203,4355,29.916550603303182,19.75818075394495,1152,1,125928,51840,895,0,1516,1413
3410,1,0,0,0,42,0,606,0,0,1151416,2987726,37.656340767525464,1418,2230,2230,1418,41666,528857,349762,2107,3525,2107,2919,4337,28.495613697550013,0.0,1418,1,235388,0,812,0,689,1295
3411,1,0,0,0,42,0,619,0,0,1159730,3003000,37.815340802378074,1400,2271,2241,1430,43139,375900,506100,2070,3530,2130,2911,4371,28.478061731796284,5.959073905325341,1460,1,344630,1500,811,0,670,1289
3412,1,0,0,0,42,0,629,1,0,1185912,3052384,38.05259518088089,1388,2327,2267,1448,26332,478516,244528,2048,3556,2168,2927,4435,28.61817604250837,8.217978828131171,1508,1,167968,14400,819,0,660,1289
3413,1,0,0,0,43,0,633,1,0,1214290,3146913,38.24918299781056,1343,2413,2293,1463,25199,479673,243063,2031,3614,2271,2981,4564,28.809720581775867,11.895785681528103,1583,1,165319,28680,830,0,688,1321
3414,1,0,0,0,46,0,524,1,0,1380972,3386460,38.28837943815329,1075,2799,2408,1466,29832,522060,304920,1919,3776,2701,3252,5109,30.692018506445613,21.239500770099514,1857,1,193512,89148,942,0,844,1368
3415,1,0,0,0,46,0,406,0,1,1251560,3104780,36.60601043544625,890,2724,2274,1340,54093,507423,572299,1867,3657,2767,3251,5041,30.56141357987225,21.227043939481455,1790,1,330980,43200,934,0,977,1383
3416,1,0,0,0,46,0,411,0,1,1188760,3037650,36.26292872893749,882,2652,2219,1315,56640,545160,554400,1877,3625,2743,3214,4962,30.066592756745816,20.815751515857347,1748,1,315600,52826,904,0,995,1406
3417,1,0,0,0,46,0,421,0,1,1069770,2924460,35.58089374931439,864,2513,2111,1266,53130,584430,485100,1908,3576,2712,3155,4823,29.068883707497267,20.057873316005786,1668,1,265860,69144,845,0,1044,1465
3418,1,0,0,0,46,0,427,0,1,1012230,2873988,35.24202037341219,852,2447,2057,1242,47311,585442,432718,1924,3556,2704,3129,4761,28.548204847240395,19.761388711204805,1632,1,232254,78000,815,0,1072,1499
3419,1,0,0,0,46,0,433,0,1,956130,2831850,34.899856733230294,839,2382,2003,1218,36542,562650,351075,1946,3543,2704,3110,4707,28.0178514522438,19.50040247240946,1597,1,183918,85275,785,0,1107,1540
3420,1,0,0,0,47,0,446,0,1,850872,2760060,34.23448553724738,807,2263,1898,1172,44820,586395,423900,1990,3527,2720,3081,4618,26.94438717061496,19.236999686573686,1537,1,210960,75190,726,0,1183,1629
3421,1,0,0,0,47,0,453,0,1,799704,2711640,33.896902513356586,788,2206,1845,1149,56619,549880,573480,1999,3509,2721,3056,4566,26.38181191654584,19.156817346887163,1510,1,279207,40071,696,0,1211,1664
3422,1,0,0,0,46,0,468,0,1,702144,2564592,33.2264954516723,743,2101,1740,1104,47564,436724,587719,1962,3427,2684,2959,4424,25.219040425836983,19.03057925423903,1465,1,279312,10830,636,0,1219,1687
3423,1,0,0,0,46,0,475,0,1,656774,2497256,32.89376840679705,717,2054,1689,1082,52164,477756,581616,1943,3390,2673,2915,4362,24.63736998950984,19.111996088106316,1447,1,272664,21900,607,0,1226,1701
3424,1,0,0,0,45,0,493,0,1,568880,2382640,32.2490309931942,661,1966,1587,1040,55822,565877,517766,1912,3331,2670,2838,4257,23.388031127053,19.468057864309877,1419,1,235040,55713,547,0,1251,1744
3425,1,0,0,0,46,0,518,0,1,448443,2268594,31.25699921617557,627,1786,1436,977,42921,582822,397062,1972,3299,2672,2781,4108,21.42428528562855,20.19041947923354,1327,1,167067,74550,459,0,1345,1863
3426,1,0,0,0,46,0,527,0,1,411510,2230767,30.93541659651604,633,1711,1387,957,55029,580419,515151,2007,3288,2655,2761,4042,20.73644135332772,19.761388711204805,1281,1,211497,50868,430,0,1374,1901
3427,1,0,0,0,46,0,547,0,1,340578,2115072,30.298514815086232,641,1566,1289,918,42419,389376,578304,2027,3222,2581,2675,3870,19.261360284258224,18.37406540650303,1195,1,230418,831,371,0,1386,1933
3428,1,0,0,0,45,0,558,0,1,307800,2050200,30.0,645,1497,1242,900,39591,362202,567222,2023,3178,2533,2620,3775,18.49324200890693,17.459037157655604,1155,1,224100,0,342,0,1378,1936
3429,1,0,0,0,45,0,569,0,1,276066,1987146,29.698484809834994,648,1429,1195,882,42168,378504,565503,2019,3135,2487,2566,3682,17.69180601295413,16.65566711567925,1116,1,221382,0,313,0,1371,1940
3430,1,0,0,0,44,0,593,0,1,217344,1881384,29.13760456866693,657,1297,1105,849,49022,427688,562864,2024,3065,2408,2472,3513,16.0,14.97735618475301,1041,1,215646,7104,256,0,1367,1960
3431,1,0,0,0,43,0,606,0,1,190152,1833966,28.879058156387302,664,1232,1062,834,50546,437601,558546,2029,3033,2369,2427,3431,15.0996688705415,14.025893816633586,1004,1,211836,8160,228,0,1365,1971
3432,1,0,0,0,43,0,618,0,1,164619,1789515,28.61817604250837,669,1170,1020,819,52070,447925,554990,2035,3004,2335,2386,3355,14.177446878757825,13.130475867068439,969,1,208026,8850,201,0,1366,1984
3433,1,0,0,0,43,0,642,0,1,118800,1709928,28.142494558940577,668,1066,942,792,53676,459867,544068,2035,2951,2283,2309,3225,12.24744871391589,11.718395466430005,916,1,199584,8928,150,0,1367,2009
3434,1,0,0,0,42,0,664,0,1,72105,1612116,27.54995462791182,674,939,854,759,52371,439668,537372,2039,2883,2209,2219,3063,9.746794344808963,9.628282789709404,844,1,192027,5015,95,0,1365,2029
3435,1,0,0,0,42,0,660,0,1,67500,1582500,27.386127875258307,690,900,840,750,49276,409340,535940,2050,2860,2170,2200,3010,9.486832980505138,8.246211251235321,810,1,190500,2640,90,0,1360,2020
3436,1,0,0,0,41,0,627,0,1,79380,1527330,27.110883423451916,735,843,843,735,51884,453004,494564,2078,2813,2078,2186,2921,10.392304845413264,0.0,735,1,174930,0,108,0,1343,1970
3437,1,0,0,0,43,0,435,1,0,205200,1558800,26.832815729997478,545,1180,1005,720,26880,454650,277120,1990,2885,2340,2450,3345,16.881943016134134,14.14513987011696,895,1,92160,37625,285,0,1445,1880
3438,1,0,0,0,44,0,276,1,0,337365,1641255,27.110883423451916,416,1513,1194,735,29896,451066,330484,1914,2968,2552,2692,3746,21.42428528562855,18.915016892515798,1054,1,108780,60291,459,0,1498,1774
3439,1,0,0,0,44,0,254,1,0,362096,1661338,27.23967694375247,400,1572,1230,742,31108,452278,344806,1897,2981,2581,2727,3811,22.090722034374522,19.600335151498342,1084,1,114268,62928,488,0,1497,1751
3440,1,0,0,0,44,0,37,0,1,899310,2061810,30.495901363953813,900,1927,1897,930,47200,443400,523212,2187,3147,2247,3184,4144,31.096623610932426,5.652706486041966,960,1,219480,2670,967,0,1287,1250
3441,1,0,0,0,42,0,39,0,1,591750,1604250,27.386127875258307,750,1539,1539,750,46305,404271,524055,2139,2889,2139,2928,3678,28.089143810376278,0.0,750,1,183750,0,789,0,1389,1350
3442,1,0,0,0,42,0,41,0,1,422730,1326780,25.099800796022265,600,1331,1301,630,56619,490698,511758,2076,2736,2136,2777,3437,25.903667693977237,5.490867587491313,660,1,153090,3270,671,0,1476,1435
3443,1,0,0,0,40,0,53,0,0,87210,542160,16.431676725154983,270,593,593,270,50344,465856,435736,2008,2278,2008,2331,2601,17.97220075561143,0.0,270,0,58590,0,323,0,1738,1685
3444,1,0,0,0,40,0,55,0,0,70800,482640,15.491933384829668,210,565,535,240,42218,420299,406222,1981,2251,2041,2306,2576,17.175564037317667,5.483301264452448,270,0,48480,4290,295,0,1771,1716
3445,1,0,0,0,40,0,58,0,0,56280,421260,14.491376746189438,180,508,478,210,38220,365092,421260,1976,2216,2036,2274,2514,16.3707055437449,5.483301264452448,240,0,44100,2910,268,0,1796,1738
3446,0,1,1,0,64,0,1173,0,0,10332574,12471544,62.080592780675026,3704,6685,6535,3854,50953,812236,656908,3086,7090,3386,5917,9921,51.778373863998475,12.27795318108085,4004,0,782362,27450,2681,1,618,555
3447,0,0,1,0,57,1,602,0,0,1323120,4316530,38.600518131237564,878,2990,2378,1490,49268,631546,654722,2285,4387,3509,3785,5887,29.79932885150268,25.08798245459907,2102,1,336740,75888,888,0,1407,2009
3448,0,0,0,0,56,1,950,1,0,1117656,4629122,40.422765862815474,1188,2764,2318,1634,52539,597763,705417,2387,4467,3279,3517,5597,26.153393661244042,21.294963440076554,2080,1,406866,36126,684,0,1199,2149
3449,0,0,1,0,58,1,683,0,0,240384,743680,16.0,148,1303,1195,256,55278,723345,644910,2797,3161,3013,3844,4208,30.643106892089126,10.429745618880121,364,1,56832,16632,939,0,2649,1966
3450,0,0,1,0,57,1,654,0,0,302671,907387,17.69180601295413,163,1430,1280,313,56882,689962,692861,2749,3212,3049,3866,4329,31.096623610932426,12.27795318108085,463,1,74807,18300,967,0,2586,1932
3451,0,0,0,0,57,1,665,1,0,355250,1009750,18.708286933869708,226,1489,1365,350,56882,686630,689515,2761,3235,3009,3900,4374,31.85906464414798,11.295017816300092,474,1,83650,15128,1015,0,2535,1870
3452,0,0,0,0,57,1,666,1,0,377712,1054080,19.131126469708992,246,1518,1398,366,56120,702720,662400,2760,3246,3000,3912,4398,32.12475680841802,11.07142749248319,486,1,84180,16440,1032,0,2514,1848
3453,0,0,0,0,57,1,666,1,0,403200,1106304,19.595917942265423,264,1554,1434,384,55596,708726,651106,2761,3265,3001,3931,4435,32.4037034920393,11.080810612286749,504,1,86784,16920,1050,0,2497,1831
3454,0,0,0,0,57,1,632,1,0,821744,1847636,25.37715508089904,494,2070,1920,644,54467,622573,720119,2719,3513,3019,4145,4939,35.7211421989835,12.525768210359056,794,1,161644,12300,1276,0,2225,1593
3455,1,0,0,0,47,0,482,1,0,201000,636768,16.3707055437449,229,1515,1018,268,40587,591624,387288,1879,2644,2873,3126,3891,27.386127875258307,22.299270808173084,765,1,43684,108843,750,0,2108,1626
3456,1,0,0,0,42,0,97,0,0,750204,1968484,30.265491900843113,916,1735,1735,916,51067,479227,492121,2149,3065,2149,2968,3884,28.61817604250837,0.0,916,0,209764,0,819,0,1233,1330
3457,1,0,0,0,43,0,124,0,0,753056,2004732,30.528675044947494,902,1770,1740,932,43560,473220,425898,2121,3083,2181,2959,3921,28.42534080710379,5.478746393072713,962,0,184536,4830,808,0,1219,1343
3458,1,0,0,0,45,0,504,1,0,172692,1673046,27.16615541441225,526,1184,972,738,28608,435264,337783,2055,3005,2479,2501,3451,15.297058540778355,16.20553907189115,950,1,109962,37312,234,0,1529,2033
3459,1,0,0,0,45,0,504,1,0,123120,1564308,26.153393661244042,416,1132,864,684,21708,370494,306458,2019,2971,2555,2467,3419,13.416407864998739,17.936738611021287,952,1,91656,40736,180,0,1603,2107
3460,1,0,0,0,42,0,521,0,0,1185420,2903520,37.14835124201342,1380,2239,2239,1380,56133,486024,511272,2104,3484,2104,2963,4343,29.30870177950569,0.0,1380,1,335340,0,859,0,724,1245
3461,1,0,0,0,42,0,528,0,0,1177993,2904243,37.16180835212409,1381,2234,2234,1381,50358,485793,458454,2103,3484,2103,2956,4337,29.206163733020468,0.0,1381,1,301058,0,853,0,722,1250
3462,1,0,0,0,42,0,534,0,0,1174167,2907066,37.1887079635741,1353,2262,2232,1383,45144,439318,454032,2072,3485,2132,2951,4364,29.13760456866693,5.483301264452448,1413,0,298728,3810,849,0,719,1253
3463,1,0,0,0,41,0,540,0,0,1170325,2901575,37.21558813185679,1355,2260,2230,1385,46830,467185,439950,2065,3480,2125,2940,4355,29.068883707497267,5.490867587491313,1415,0,290850,4500,845,0,710,1250
3464,1,0,0,0,42,0,546,0,0,1168696,2916188,37.255872020394314,1388,2230,2230,1388,41968,512644,361372,2101,3489,2101,2943,4331,29.017236257093817,0.0,1388,0,238736,0,842,0,713,1259
3465,1,0,0,0,41,0,564,0,0,1183852,2942758,37.49666651850535,1406,2248,2248,1406,48805,475111,449995,2093,3499,2093,2935,4341,29.017236257093817,0.0,1406,0,302290,0,842,0,687,1251
3466,1,0,0,0,45,0,579,1,0,1393630,3395280,38.79432948254165,1175,2761,2431,1505,28380,485040,297792,1926,3761,2586,3182,5017,30.430248109405877,19.400484492731994,1835,1,198660,71610,926,0,751,1330
3467,1,0,0,0,46,0,414,0,1,1335427,3214968,37.16180835212409,889,2840,2348,1381,52002,498192,565704,1836,3709,2820,3295,5168,31.096623610932426,22.207507683175155,1873,1,335583,47724,967,0,947,1361
3468,1,0,0,0,46,0,424,0,1,1209456,3070260,36.49657518178932,874,2698,2240,1332,55056,511710,571640,1847,3637,2763,3213,5003,30.133038346638727,21.404020113656895,1790,1,330336,43968,908,0,973,1397
3469,1,0,0,0,45,0,491,0,1,675036,2534694,33.21144381083123,708,2110,1715,1103,52118,473388,581394,1903,3401,2693,2910,4408,24.73863375370596,19.875116418410105,1498,1,279059,23700,612,0,1195,1686
3470,1,0,0,0,45,0,500,0,1,629724,2474534,32.89376840679705,682,2064,1664,1082,56088,521436,562602,1887,3369,2687,2869,4351,24.124676163629637,20.819741777195205,1482,1,266172,39600,582,0,1205,1705
3471,1,0,0,0,46,0,533,0,1,465534,2317680,31.606961258558215,675,1789,1465,999,47498,589280,433840,1996,3319,2644,2786,4109,21.587033144922902,19.608165863723432,1323,1,186813,64476,466,0,1321,1854
3472,1,0,0,0,46,0,542,0,1,427823,2270301,31.28897569432403,670,1725,1416,979,56643,554241,549603,2010,3298,2628,2756,4044,20.904544960366874,19.27100883121563,1288,1,232023,37389,437,0,1340,1882
3473,1,0,0,0,46,0,552,0,1,391680,2218560,30.983866769659336,677,1651,1368,960,49551,459889,575439,2028,3271,2594,2719,3962,20.199009876724155,18.584622336936953,1243,1,239040,13018,408,0,1351,1903
3474,1,0,0,0,44,0,595,0,1,262550,1975800,29.832867780352597,698,1377,1185,890,47376,417360,559440,2028,3110,2412,2515,3597,17.175564037317667,14.97735618475301,1082,1,224280,5568,295,0,1330,1925
3475,1,0,0,0,44,0,607,0,1,234500,1927625,29.58039891549808,705,1313,1143,875,49392,431788,555156,2033,3078,2373,2471,3516,16.3707055437449,14.025893816633586,1045,1,220500,6970,268,0,1328,1935
3476,1,0,0,0,43,0,618,0,1,208120,1881680,29.32575659723036,710,1252,1102,860,51408,446352,551376,2038,3048,2338,2430,3440,15.556349186104045,13.187419067680642,1010,1,216720,8250,242,0,1328,1946
3477,1,0,0,0,43,0,640,0,1,159744,1800448,28.844410203711913,724,1132,1024,832,52668,452276,545328,2056,2996,2272,2356,3296,13.856406460551018,11.204411569190134,940,1,209664,6912,192,0,1332,1972
3478,1,0,0,0,42,0,663,0,1,106798,1694422,28.231188426986208,712,1016,931,797,52208,442208,533626,2041,2923,2211,2260,3142,11.575836902790225,9.587694277262452,882,1,200047,5100,134,0,1329,1992
3479,1,0,0,0,42,0,663,0,1,97588,1662144,28.053520278211074,720,978,911,787,53750,454080,528000,2045,2899,2179,2236,3090,11.135528725660043,8.456490803821907,854,1,196750,4824,124,0,1325,1988
3480,1,0,0,0,42,0,659,0,1,93480,1638237,27.910571473905726,737,941,899,779,54216,454248,527853,2061,2882,2145,2223,3044,10.954451150103322,6.7040592262067955,821,1,195529,3276,120,0,1324,1983
3481,1,0,0,0,41,0,631,0,1,102510,1591200,27.65863337187866,765,899,899,765,50621,463840,472160,2080,2845,2080,2214,2979,11.575836902790225,0.0,765,1,173655,0,134,0,1315,1946
3482,1,0,0,0,45,0,187,0,1,465290,1789998,27.964262908219126,590,1569,1377,782,26880,320460,439488,2097,3071,2481,2884,3858,24.392621835300936,15.190631376927534,974,1,150144,10944,595,0,1507,1694
3483,1,0,0,0,45,0,77,0,1,1021650,2369850,32.4037034920393,1050,2023,2023,1050,53165,489769,552965,2257,3307,2257,3230,4280,31.192947920964443,0.0,1050,1,257250,0,973,0,1207,1284
3484,1,0,0,0,45,0,30,0,1,1009800,2295000,31.937438845342623,1020,2010,2010,1020,48822,463500,533250,2250,3270,2250,3240,4260,31.464265445104548,0.0,1020,1,241740,0,990,0,1230,1260
3485,1,0,0,0,39,0,84,0,0,35100,299550,12.24744871391589,150,384,384,150,38586,353469,435346,1997,2147,1997,2231,2381,15.297058540778355,0.0,150,0,32700,0,234,0,1847,1763
3486,0,1,1,0,64,0,1236,0,0,10468512,12612288,62.545983084447556,3827,6673,6588,3912,52080,799552,677040,3139,7136,3309,5900,9897,51.73006862551025,9.222414255489701,3997,0,821520,14790,2676,1,688,548
3487,0,0,1,0,58,1,279,0,0,1516900,4019785,37.134889255254286,748,3110,2479,1379,48620,644215,641300,2284,4294,3546,4015,6025,33.166247903554,25.134856887803004,2010,1,303380,86447,1100,0,1536,1815
3488,0,0,1,0,57,1,1237,0,0,1652360,5897780,45.221676218380054,1625,3273,2853,2045,51815,695044,620060,2464,4929,3304,3692,6157,28.42534080710379,20.705418544889394,2465,1,439675,68460,808,0,839,2076
3489,0,0,1,0,58,1,481,0,0,1985630,4919820,40.8656334834051,1129,3400,2859,1670,47232,724716,565632,2405,4616,3487,4135,6346,34.48187929913333,23.391860330443183,2211,1,320640,104413,1189,0,1276,1757
3490,0,0,1,0,57,1,719,0,0,238602,715065,15.716233645501712,162,1298,1213,247,55527,720855,645585,2810,3142,2980,3861,4193,31.080540535840107,9.257905235465769,332,1,55081,13175,966,0,2648,1929
3491,0,0,0,0,57,1,694,1,0,553632,1356114,21.77154105707724,384,1732,1642,474,53250,715250,609393,2771,3335,2951,4029,4593,34.17601498127012,9.580310602724222,564,1,100962,14220,1168,0,2387,1693
3492,1,0,0,0,43,0,95,0,0,797874,2030010,30.692018506445613,912,1819,1789,942,46104,487030,439620,2125,3097,2185,3002,3974,29.103264421710495,5.490867587491313,972,0,192168,4830,847,0,1213,1308
3493,1,0,0,0,44,0,460,1,0,442716,2083754,30.56141357987225,752,1590,1408,934,19435,377039,256565,2049,3165,2413,2705,3821,21.77154105707724,14.427286056808692,1116,1,107410,32578,474,0,1297,1757
3494,1,0,0,0,44,0,525,1,0,228664,1815576,28.42534080710379,568,1331,1091,808,38843,487599,402213,2007,3055,2487,2530,3578,16.822603841260722,16.594077143977827,1048,1,144632,42480,283,0,1439,1964
3495,1,0,0,0,46,0,193,0,1,350088,1617504,26.38181191654584,259,1636,1199,696,42552,501984,457828,1887,3020,2761,2827,3960,22.427661492005804,21.199939295265104,1133,1,137112,68172,503,0,1628,1821
3496,1,0,0,0,42,0,455,0,0,1208250,2844450,36.742346141747674,1320,2275,2245,1350,55822,476182,520429,2077,3457,2137,3002,4382,29.916550603303182,5.490867587491313,1380,1,333450,3000,895,0,757,1212
3497,1,0,0,0,42,0,468,0,0,1192933,2851961,36.75595189897821,1321,2264,2234,1351,38850,468642,369425,2081,3462,2141,2994,4375,29.715315916207253,5.5503012171862105,1381,0,236425,5580,883,0,760,1228
3498,1,0,0,0,42,0,480,0,0,1185625,2854985,36.810324638611924,1325,2260,2230,1355,37976,396116,425614,2077,3462,2137,2982,4367,29.58039891549808,5.531194905403055,1385,0,273710,3450,875,0,752,1232
3499,1,0,0,0,42,0,486,0,0,1184176,2857232,36.851051545376556,1358,2230,2230,1358,41888,471296,393448,2104,3462,2104,2976,4334,29.5296461204668,0.0,1358,0,253946,0,872,0,746,1232
3500,1,0,0,0,41,0,505,0,0,1200744,2886192,37.107950630558946,1377,2249,2249,1377,46716,479984,427584,2096,3473,2096,2968,4345,29.5296461204668,0.0,1377,0,280908,0,872,0,719,1224
3501,1,0,0,0,46,0,465,1,0,1484784,3423252,38.379682124790975,1023,2931,2481,1473,38160,557760,369516,1874,3797,2774,3332,5255,31.74901573277509,22.61456643905236,1923,1,234207,98100,1008,0,851,1316
3502,1,0,0,0,46,0,422,0,1,1424423,3322705,37.72267222772003,924,2923,2424,1423,51300,525375,532380,1836,3758,2834,3336,5258,31.63858403911275,23.68197591320708,1922,1,324444,64870,1001,0,912,1334
3503,1,0,0,0,46,0,426,0,1,1358856,3253146,37.389838191679836,882,2886,2370,1398,51623,486343,574769,1811,3725,2843,3299,5213,31.176914536239792,22.738824854660816,1914,1,345306,43344,972,0,929,1355
3504,1,0,0,0,46,0,432,0,1,1294308,3180810,37.067505985701274,875,2815,2316,1374,50702,467630,581065,1816,3689,2814,3257,5130,30.692018506445613,22.348192058599107,1873,1,344874,32934,942,0,941,1373
3505,1,0,0,0,45,0,443,0,1,1170858,3037866,36.41428291206625,856,2679,2209,1326,55902,554422,529221,1821,3617,2761,3174,4970,29.715315916207253,21.67958152963026,1796,1,306306,66740,883,0,965,1408
3506,1,0,0,0,45,0,449,0,1,1110606,2991996,36.08323710533743,845,2612,2155,1302,46116,579096,420534,1841,3600,2755,3151,4910,29.206163733020468,21.377967750354504,1759,1,238266,92771,853,0,996,1445
3507,1,0,0,0,46,0,468,0,1,943245,2886453,35.11409973215888,803,2428,1998,1233,43263,592273,400311,1911,3574,2771,3106,4769,27.65863337187866,20.798100354606355,1663,1,210843,89870,765,0,1108,1576
3508,1,0,0,0,46,0,490,0,1,790059,2709774,34.161381705077446,747,2264,1844,1167,49140,452790,585144,1902,3489,2742,2999,4586,26.019223662515376,20.516634680045396,1587,1,294084,16800,677,0,1155,1645
3509,1,0,0,0,45,0,506,0,1,694632,2572836,33.52610922848042,720,2146,1742,1124,52118,471534,579117,1885,3413,2693,2907,4435,24.859605789312106,20.881052373809556,1528,1,284372,23836,618,0,1165,1671
3510,1,0,0,0,45,0,514,0,1,649667,2511531,33.21144381083123,721,2074,1692,1103,56105,521433,557865,1895,3380,2659,2866,4351,24.269322199023193,20.276344584498222,1485,1,270235,38582,589,0,1174,1688
3511,1,0,0,0,45,0,522,0,1,605920,2461550,32.89376840679705,721,2003,1642,1082,53424,573300,482300,1914,3357,2636,2835,4278,23.664319132398465,19.8209216457752,1443,1,229384,60648,560,0,1193,1715
3512,1,0,0,0,45,0,530,0,1,564984,2425608,32.58834147360065,723,1933,1594,1062,44275,577852,399700,1945,3346,2623,2816,4217,23.065125189341593,19.405823341421346,1401,1,185850,70173,532,0,1222,1752
3513,1,0,0,0,45,0,538,0,1,523623,2390136,32.264531609803356,722,1863,1544,1041,39750,574000,365064,1977,3337,2615,2799,4159,22.427661492005804,19.087453825928232,1360,1,165519,68904,503,0,1255,1793
3514,1,0,0,0,46,0,548,0,1,484428,2361842,31.96873472629156,722,1796,1496,1022,50038,586994,455267,2011,3333,2611,2785,4107,21.77154105707724,18.858464242842828,1322,1,201334,54600,474,0,1289,1837
3515,1,0,0,0,46,0,557,0,1,447338,2314924,31.670175244226233,720,1732,1449,1003,55161,523916,560844,2025,3311,2591,2754,4040,21.118712081942874,18.538532145340913,1286,1,243729,26602,446,0,1305,1862
3516,1,0,0,0,45,0,566,0,1,411312,2256312,31.368774282716245,716,1670,1402,984,47310,435670,570957,2025,3277,2561,2711,3963,20.445048300260872,17.967677100384936,1252,1,245016,8308,418,0,1309,1875
3517,1,0,0,0,44,0,607,0,1,283044,2021612,30.265491900843113,746,1395,1225,916,47880,419330,556164,2037,3123,2377,2516,3602,17.578395831246947,13.972587229965265,1086,1,230832,5440,309,0,1291,1898
3518,1,0,0,0,43,0,617,0,1,254700,1971900,30.0,750,1333,1183,900,50094,433818,554323,2041,3091,2341,2474,3524,16.822603841260722,13.168301036937951,1050,1,227700,6600,283,0,1291,1908
3519,1,0,0,0,43,0,638,0,1,204048,1887008,29.5296461204668,764,1214,1106,872,52750,456604,541000,2056,3036,2272,2398,3378,15.297058540778355,11.204411569190134,980,1,218000,7128,234,0,1292,1930
3520,1,0,0,0,42,0,661,0,1,146300,1777336,28.91366458960192,776,1071,1011,836,52041,444334,529374,2066,2962,2186,2301,3197,13.228756555322953,8.086478275311649,896,1,208164,3660,175,0,1290,1951
3521,1,0,0,0,41,0,658,0,1,121200,1691952,28.42534080710379,778,988,958,808,56394,489996,504654,2064,2902,2124,2244,3082,12.24744871391589,5.5503012171862105,838,1,194728,3570,150,0,1286,1944
3522,1,0,0,0,41,0,647,0,1,122400,1669600,28.284271247461902,800,953,953,800,51959,465401,486271,2087,2887,2087,2240,3040,12.36931687685298,0.0,800,1,186400,0,153,0,1287,1934
3523,1,0,0,0,42,0,522,1,0,201240,1673880,27.92848008753788,672,1146,1038,780,32804,506456,298294,2038,2926,2254,2404,3292,16.06237840420901,10.781717396486519,888,1,108420,24840,258,0,1366,1888
3524,1,0,0,0,45,0,256,1,0,456960,1862112,28.5657137141714,510,1682,1376,816,27674,460964,312634,1976,3098,2588,2842,3964,23.664319132398465,17.959741683475702,1122,1,111792,60894,560,0,1466,1722
3525,1,0,0,0,45,0,257,1,0,358644,1691703,27.2213151776324,561,1405,1225,741,21442,324186,344733,2103,3024,2463,2767,3688,22.0,14.746146769881904,921,1,111891,19260,484,0,1542,1799
3526,1,0,0,0,46,0,87,0,1,787540,2165036,30.528675044947494,631,2078,1777,932,40515,508737,429755,2022,3255,2624,3168,4401,29.068883707497267,17.930757168932345,1233,1,172420,52073,845,0,1391,1478
3527,1,0,0,0,45,0,184,0,1,1027860,2521920,33.31666249791537,1080,2066,2036,1110,51695,479392,556640,2242,3382,2302,3198,4338,30.430248109405877,5.5965095842615735,1140,1,271950,2670,926,0,1162,1346
3528,1,0,0,0,45,0,141,0,1,1014120,2444040,32.863353450309965,1080,2019,2019,1080,49862,484282,527279,2263,3343,2263,3202,4282,30.643106892089126,0.0,1080,1,251640,0,939,0,1183,1324
3529,1,0,0,0,45,0,97,0,1,1000650,2374050,32.4037034920393,1050,2003,2003,1050,44505,468027,486115,2261,3311,2261,3214,4264,30.870698080866262,0.0,1050,1,225750,0,953,0,1211,1308
3530,1,0,0,0,41,0,56,0,1,356820,1189020,23.874672772626646,570,1196,1196,570,42408,387996,475608,2086,2656,2086,2712,3282,25.019992006393608,0.0,570,1,129960,0,626,0,1516,1460
3531,1,0,0,0,41,0,58,0,0,322920,1119420,23.2379000772445,540,1138,1138,540,47040,406308,497520,2073,2613,2073,2671,3211,24.454038521274967,0.0,540,0,129600,0,598,0,1533,1475
3532,1,0,0,0,40,0,72,0,0,132660,664950,18.16590212458495,330,732,732,330,53058,447330,481585,2015,2345,2015,2417,2747,20.049937655763422,0.0,330,0,78870,0,402,0,1685,1613
3533,1,0,0,0,39,0,114,0,0,28080,239400,10.954451150103322,120,354,354,120,42075,373065,448875,1995,2115,1995,2229,2349,15.297058540778355,0.0,120,0,27000,0,234,0,1875,1761
3534,0,0,1,0,57,1,1567,0,0,1429598,6355736,47.042533945356304,1894,3178,2859,2213,51308,729488,580144,2553,5085,3191,3518,6050,25.41653005427767,18.414555564936464,2532,1,447026,58377,646,0,659,2226
3535,0,0,1,0,57,1,1452,0,0,1512108,6201366,46.411205543489174,1793,3217,2856,2154,53410,705355,627622,2518,5033,3240,3581,6096,26.49528259898354,19.562409421210084,2515,1,469572,58843,702,0,725,2177
3536,0,0,1,0,57,1,769,0,0,207972,612256,14.560219778561036,170,1235,1193,212,55370,707560,652688,2846,3100,2930,3869,4123,31.32091952673165,6.495386533491135,254,1,47912,6300,981,0,2676,1907
3537,0,0,1,0,57,1,767,0,0,297150,813059,16.822603841260722,198,1418,1333,283,56640,689520,678028,2788,3156,2958,3923,4291,32.4037034920393,9.321211371972165,368,1,66788,11135,1050,0,2590,1823
3538,0,0,1,0,57,1,763,0,0,345158,914254,17.86057109949175,259,1461,1401,319,56643,679242,684974,2806,3185,2926,3948,4327,32.89376840679705,7.810249675906654,379,1,76241,7500,1082,0,2547,1784
3539,0,0,0,0,57,1,755,1,0,402876,1032099,19.0,301,1537,1477,361,56608,697596,663288,2799,3220,2919,3975,4396,33.406586176980134,7.754559014766193,421,1,83752,8280,1116,0,2498,1743
3540,0,0,0,0,57,1,721,1,0,627810,1454010,22.58317958127243,450,1801,1741,510,53217,692793,624369,2791,3361,2911,4082,4652,35.08560958569767,7.9730082341141015,570,1,111690,8280,1231,0,2341,1620
3541,0,0,0,0,56,1,709,1,0,717972,1606272,23.748684174075834,479,1922,1837,564,52192,663584,637952,2763,3412,2933,4121,4770,35.679125549822544,9.412769291411893,649,1,126336,9775,1273,0,2284,1575
3542,0,0,0,0,56,1,698,1,0,813288,1756356,24.859605789312106,528,2024,1934,618,53815,667870,650818,2752,3460,2932,4158,4866,36.27671429443411,9.740037464252968,708,1,141522,10350,1316,0,2224,1526
3543,0,0,0,0,56,1,686,1,0,916640,1904050,25.96150997149434,584,2124,2034,674,52041,590425,703425,2735,3499,2915,4185,4949,36.87817782917155,9.638070910968185,764,1,167826,5490,1360,0,2151,1465
3544,1,0,0,0,48,0,378,1,0,313560,970428,20.049937655763422,11,1573,1182,402,51376,596258,502112,2023,2816,2805,3194,3987,27.92848008753788,21.13517555702114,793,1,83616,68425,780,0,2012,1634
3545,1,0,0,0,46,0,369,0,1,252720,1668240,26.832815729997478,330,1461,1071,720,46161,516691,479619,1927,3037,2707,2668,3778,18.734993995195193,20.0530386444104,1110,1,149040,59670,351,0,1597,1966
3546,1,0,0,0,42,0,402,0,0,1211760,2779920,36.3318042491699,1320,2238,2238,1320,40832,488592,370656,2106,3426,2106,3024,4344,30.298514815086232,0.0,1320,0,232320,0,918,0,786,1188
3547,1,0,0,0,42,0,415,1,0,1201284,2815344,36.373066958946424,1263,2291,2231,1323,36400,425600,387296,2068,3451,2188,3036,4419,30.133038346638727,8.038779614196052,1383,1,240786,9120,908,0,805,1220
3548,1,0,0,0,42,0,426,0,0,1197856,2806064,36.4417343165772,1328,2230,2230,1328,41004,431052,424713,2113,3441,2113,3015,4343,30.033314835362415,0.0,1328,0,266928,0,902,0,785,1211
3549,1,0,0,0,45,0,470,1,0,1484856,3390372,38.41874542459709,1085,2873,2482,1476,27250,500746,287125,1906,3773,2688,3303,5170,31.71750305430741,21.204424625689594,1867,1,184500,88366,1006,0,821,1291
3550,1,0,0,0,46,0,439,0,1,1383432,3290784,37.62977544445356,875,2934,2393,1416,48608,455504,576352,1783,3740,2865,3301,5258,31.25699921617557,24.369869969067384,1957,1,351168,34083,977,0,908,1347
3551,1,0,0,0,46,0,445,0,1,1318224,3216912,37.30951621235526,867,2864,2339,1392,50148,459889,582372,1786,3703,2836,3258,5175,30.773365106858236,22.918882302251525,1917,1,350784,30975,947,0,919,1364
3552,1,0,0,0,45,0,450,0,1,1255824,3143664,36.98648401781386,858,2796,2286,1368,52459,480282,576798,1788,3666,2808,3216,5094,30.298514815086232,22.583526873216297,1878,1,343368,38250,918,0,930,1380
3553,1,0,0,0,45,0,457,0,1,1194360,3078705,36.6742416417845,848,2730,2233,1345,55932,542493,540204,1792,3634,2786,3177,5019,29.79932885150268,22.293857815973023,1842,1,317420,65107,888,0,944,1401
3554,1,0,0,0,45,0,462,0,1,1134739,3026411,36.345563690772494,836,2665,2180,1321,48260,581914,435290,1806,3612,2776,3150,4956,29.30870177950569,22.022809168991348,1806,1,250990,95060,859,0,970,1432
3555,1,0,0,0,46,0,482,0,1,966063,2915731,35.397740040855716,794,2483,2024,1253,46552,588731,428168,1868,3580,2786,3098,4810,27.76688675382964,21.451917059085595,1712,1,230552,88128,771,0,1074,1556
3556,1,0,0,0,46,0,489,0,1,913402,2871923,35.08560958569767,777,2427,1973,1231,55404,566919,531924,1879,3564,2787,3075,4760,27.23967694375247,21.346475849196317,1685,1,280668,60382,742,0,1102,1591
3557,1,0,0,0,46,0,504,0,1,812592,2743092,34.46737587922817,755,2305,1872,1188,50652,464109,581868,1876,3497,2742,2993,4614,26.153393661244042,21.68139689687292,1621,1,299376,21650,684,0,1121,1625
3558,1,0,0,0,45,0,520,0,1,717396,2612880,33.85262175962151,762,2156,1772,1146,52118,469680,576840,1896,3426,2664,2906,4436,25.019992006393608,20.349512138633113,1530,1,289938,22656,626,0,1134,1654
3559,1,0,0,0,45,0,526,0,1,672152,2548108,33.52610922848042,763,2083,1722,1124,56088,516876,557682,1906,3391,2628,2865,4350,24.454038521274967,19.695785377114227,1485,1,276504,35378,598,0,1143,1669
3560,1,0,0,0,45,0,535,0,1,628176,2500560,33.2264954516723,765,2012,1673,1104,53676,570780,482445,1926,3369,2604,2834,4277,23.853720883753127,19.15126747109058,1443,1,235152,55596,569,0,1161,1696
3561,1,0,0,0,45,0,543,0,1,586444,2463932,32.92415526630866,765,1944,1625,1084,45034,575069,404594,1954,3357,2592,2814,4217,23.259406699226016,18.809405232831537,1403,1,192952,63481,541,0,1189,1732
3562,1,0,0,0,45,0,560,0,1,506825,2399320,32.32645975048923,768,1807,1530,1045,50298,571704,463792,2019,3341,2573,2781,4103,22.02271554554524,18.115860437347916,1322,1,211090,45151,485,0,1251,1811
3563,1,0,0,0,45,0,569,0,1,468882,2353644,32.03123475609393,768,1741,1483,1026,53058,509268,548266,2036,3320,2552,2751,4035,21.37755832643195,17.640613921214833,1284,1,245214,22446,457,0,1268,1837
3564,1,0,0,0,45,0,578,0,1,433440,2297232,31.74901573277509,766,1680,1438,1008,46812,428452,567471,2037,3287,2521,2709,3959,20.73644135332772,17.130735330171756,1250,1,250992,6776,430,0,1271,1849
3565,1,0,0,0,45,0,588,0,1,397980,2232450,31.464265445104548,762,1620,1392,990,43500,392370,563750,2027,3245,2483,2657,3875,20.049937655763422,16.389136567907123,1218,1,247500,0,402,0,1265,1853
3566,1,0,0,0,44,0,597,0,1,365848,2173682,31.192947920964443,772,1550,1349,973,44678,397652,560734,2033,3207,2435,2610,3784,19.390719429665317,15.316994326686412,1174,1,244223,3015,376,0,1261,1858
3567,1,0,0,0,44,0,607,0,1,334950,2118798,30.93541659651604,782,1482,1307,957,46299,405162,560142,2039,3171,2389,2564,3696,18.708286933869708,14.249967263768658,1132,1,242121,3850,350,0,1257,1864
3568,1,0,0,0,43,0,627,0,1,278100,2020860,30.44667469527666,800,1354,1227,927,49841,429460,551540,2053,3107,2307,2480,3534,17.320508075688775,12.022218309728785,1054,1,234531,5461,300,0,1253,1880
3569,1,0,0,0,42,0,652,0,1,207324,1894268,29.765752132274432,819,1187,1120,886,51294,440428,532362,2071,3024,2205,2372,3325,15.297058540778355,8.77644402059324,953,1,220614,3819,234,0,1252,1904
3570,1,0,0,0,42,0,659,0,1,189000,1858500,29.58039891549808,833,1133,1091,875,51543,439668,528876,2082,2999,2166,2340,3257,14.696938456699069,6.955109380145743,917,1,217875,2436,216,0,1249,1908
3571,1,0,0,0,42,0,663,0,1,173664,1823040,29.393876913398138,834,1095,1065,864,54033,457870,525390,2080,2974,2140,2311,3205,14.177446878757825,5.623413251903491,894,1,215136,2280,201,0,1246,1909
3572,1,0,0,0,42,0,664,0,1,162260,1793400,29.223278392404914,824,1074,1044,854,55552,470400,520800,2070,2954,2130,2290,3174,13.784048752090222,5.477225575051661,884,1,211792,2850,190,0,1246,1910
3573,1,0,0,0,41,0,663,0,1,153790,1766050,29.068883707497267,815,1057,1027,845,52899,478610,482790,2060,2935,2120,2272,3147,13.490737563232042,5.477225575051661,875,1,195195,3900,182,0,1245,1908
3574,1,0,0,0,41,0,657,0,1,150660,1750167,28.930952282978865,837,1017,1017,837,45066,464202,424473,2091,2928,2091,2271,3108,13.416407864998739,0.0,837,1,169911,0,180,0,1254,1911
3575,1,0,0,0,41,0,648,0,1,151060,1738020,28.809720581775867,830,1012,1012,830,39975,429270,408330,2094,2924,2094,2276,3106,13.490737563232042,0.0,830,1,161850,0,182,0,1264,1912
3576,1,0,0,0,41,0,634,0,1,156560,1725456,28.705400188814647,824,1014,1014,824,40194,425082,414612,2094,2918,2094,2284,3108,13.784048752090222,0.0,824,1,163152,0,190,0,1270,1904
3577,1,0,0,0,41,0,618,0,1,164619,1713348,28.61817604250837,819,1020,1020,819,42267,458148,403756,2092,2911,2092,2293,3112,14.177446878757825,0.0,819,1,158067,0,201,0,1273,1891
3578,1,0,0,0,45,0,149,0,1,619340,1967875,29.410882339705484,715,1731,1581,865,25920,491400,273000,2125,3140,2425,2991,4006,26.758176320519304,12.785844799727476,1015,1,103800,34200,716,0,1410,1559
3579,1,0,0,0,45,0,238,0,1,995864,2568340,33.52610922848042,1057,2077,2010,1124,45800,457000,523265,2218,3409,2352,3171,4362,29.765752132274432,8.397588990243326,1191,1,257396,6499,886,0,1161,1399
3580,1,0,0,0,45,0,33,0,1,947430,2238390,31.464265445104548,930,2007,1947,990,36936,386631,488376,2201,3251,2321,3218,4268,30.93541659651604,7.754559014766193,1050,1,213840,4440,957,0,1271,1304
3581,1,0,0,0,44,0,53,0,1,914190,2076690,30.495901363953813,845,1998,1913,930,37030,359513,513590,2148,3163,2318,3216,4231,31.352830813181765,9.235136611923052,1015,1,213900,3485,983,0,1303,1250
3582,1,0,0,0,42,0,58,0,1,606000,1611750,27.386127875258307,683,1625,1558,750,44160,412608,494270,2082,2899,2216,2957,3774,28.42534080710379,8.37937698914232,817,1,172500,5695,808,0,1399,1341
3583,1,0,0,0,41,0,66,0,1,362520,1195290,23.874672772626646,540,1236,1206,570,38802,364878,467631,2067,2667,2127,2733,3333,25.219040425836983,5.490867587491313,600,1,127110,2070,636,0,1527,1461
3584,1,0,0,0,40,0,72,0,0,264960,983520,21.908902300206645,480,1032,1032,480,47918,397506,506103,2049,2529,2049,2601,3081,23.49468024894146,0.0,480,0,118560,0,552,0,1569,1497
3585,1,0,0,0,40,0,87,0,0,137610,665280,18.16590212458495,330,747,747,330,45269,449568,409248,2016,2346,2016,2433,2763,20.42057785666214,0.0,330,0,66990,0,417,0,1686,1599
3586,0,1,0,1,64,0,1401,0,0,10775392,13100053,63.694583757176716,4015,6755,6713,4057,48614,720067,703922,3187,7286,3271,5885,9984,51.536394906900505,6.503581472166948,4099,1,884426,5880,2656,0,828,573
3587,0,1,1,0,64,0,1269,0,0,10702966,12777707,62.984124983998946,3967,6665,6665,3967,52416,753714,721504,3221,7188,3221,5919,9886,51.94227565288221,0.0,3967,0,888608,0,2698,1,746,523
3588,0,1,1,0,64,0,258,0,0,9836680,9707250,54.86346689738081,2818,6470,6278,3010,48260,612750,819150,3033,6235,3417,6493,9695,57.16642371182581,14.744899158146904,3202,1,764540,7488,3268,0,215,43
3589,0,1,1,0,62,0,1602,0,0,7170424,6273124,44.654227123532216,1747,5837,5590,1994,45880,780208,582010,2899,5140,3393,6742,8983,59.9666574022598,15.785902032936304,2241,1,368890,43719,3596,0,1152,450
3590,0,0,1,0,56,1,1130,0,0,1111191,4932561,41.96427051671457,1442,2711,2392,1761,54189,624623,680643,2482,4562,3120,3432,5512,25.11971337416094,17.96927154016812,2080,1,427923,34133,631,0,1040,2170
3591,0,0,1,0,57,1,1263,0,0,1641820,5928680,45.387222871640866,1699,3218,2857,2060,50451,722378,578478,2517,4938,3239,3675,6096,28.231188426986208,19.449225913393157,2421,1,414060,67146,797,0,818,2081
3592,0,0,1,0,56,1,778,0,0,498315,1185948,20.42057785666214,387,1642,1612,417,56882,676872,679716,2814,3261,2874,4039,4486,34.56877203488721,5.501408174353464,447,1,99663,3660,1195,0,2427,1649
3593,0,0,0,0,56,1,742,1,0,714288,1561608,23.49468024894146,492,1906,1846,552,53815,664815,647841,2769,3381,2889,4123,4735,35.9722114972099,7.765259411425052,612,1,126408,6900,1294,0,2277,1535
3594,0,0,0,0,55,1,698,1,0,1086000,2082750,27.386127875258307,708,2240,2198,750,53212,588724,697027,2735,3527,2819,4225,5017,38.05259518088089,6.609134537568676,792,1,188250,3234,1448,0,2027,1329
3595,1,0,0,0,46,0,313,0,1,90090,423696,13.490737563232042,213,1072,677,182,54240,558720,526128,1933,2510,2723,2823,3400,22.24859546128699,20.011895632835074,577,1,41132,58855,495,0,2146,1833
3596,1,0,0,0,46,0,386,1,0,163455,595935,15.968719422671311,182,1333,896,255,40992,570228,392616,1900,2592,2774,2978,3670,25.317977802344327,21.05680933890892,692,1,42840,93081,641,0,2082,1696
3597,1,0,0,0,45,0,617,1,0,192660,1913080,29.068883707497267,545,1373,1073,845,40762,518456,402992,1964,3109,2564,2492,3637,15.0996688705415,18.338739906922676,1145,1,150410,57000,228,0,1419,2036
3598,1,0,0,0,45,0,658,1,0,121200,1857592,28.42534080710379,502,1264,958,808,34126,519574,347149,1993,3107,2605,2449,3563,12.24744871391589,18.93714320760639,1114,1,122008,65178,150,0,1491,2149
3599,1,0,0,0,46,0,652,0,1,82080,1770800,27.568097504180443,400,1228,868,760,49056,521920,510270,1970,3090,2690,2438,3558,10.392304845413264,19.372176642834223,1120,1,166440,50400,108,0,1570,2222
3600,1,0,0,0,42,0,285,0,0,1303344,2734695,35.958309192730404,1251,2343,2301,1293,56619,513945,492795,2073,3408,2157,3123,4458,31.74901573277509,6.503581472166948,1335,1,301269,5670,1008,0,822,1107
3601,1,0,0,0,42,0,313,0,0,1260330,2714160,35.91656999213594,1260,2297,2267,1290,55671,507064,486024,2074,3394,2134,3081,4401,31.25699921617557,5.478746393072713,1320,0,297990,4230,977,0,814,1127
3602,1,0,0,0,42,0,367,0,0,1210668,2756478,36.0416425818802,1299,2231,2231,1299,47234,443498,479572,2122,3421,2122,3054,4353,30.528675044947494,0.0,1299,0,293574,0,932,0,823,1190
3603,1,0,0,0,42,0,377,0,0,1215510,2756463,36.15245496505044,1307,2237,2237,1307,52704,455544,514596,2109,3416,2109,3039,4346,30.495901363953813,0.0,1307,1,318908,0,930,0,802,1179
3604,1,0,0,0,42,0,394,1,0,1249416,2858472,36.49657518178932,1247,2355,2270,1332,15355,397010,178118,2061,3478,2231,3084,4501,30.62678566222711,9.930529422773999,1417,1,110556,19125,938,0,814,1208
3605,1,0,0,0,45,0,416,1,0,1464720,3288440,37.89459064299283,1071,2821,2456,1436,31524,508380,325180,1925,3726,2655,3310,5111,31.937438845342623,20.569607022738214,1801,1,203912,79205,1020,0,854,1270
3606,1,0,0,0,46,0,446,0,1,1475496,3414636,38.18376618407357,944,2984,2470,1458,49200,480110,562080,1828,3800,2856,3354,5326,31.811947441173732,24.009777732614232,1972,1,349920,45746,1012,0,884,1330
3607,1,0,0,0,46,0,451,0,1,1409622,3335484,37.86819245752297,891,2960,2417,1434,45201,425658,574522,1783,3760,2869,3309,5286,31.352830813181765,24.373738312164544,1977,1,354198,25521,983,0,892,1343
3608,1,0,0,0,45,0,463,0,1,1281588,3183165,37.242448899072144,850,2848,2311,1387,50592,468180,569160,1758,3682,2832,3219,5143,30.397368307141328,23.173280542424056,1924,1,343976,39738,924,0,908,1371
3609,1,0,0,0,45,0,481,0,1,1103166,3023492,36.30426972134269,815,2658,2155,1318,42419,575794,387686,1791,3612,2797,3131,4952,28.930952282978865,22.427661492005804,1821,1,222742,107642,837,0,976,1457
3610,1,0,0,0,46,0,488,0,1,1047168,2988576,36.0,801,2599,2104,1296,43769,583418,398938,1811,3602,2801,3114,4905,28.42534080710379,22.25186358894463,1791,1,224208,103455,808,0,1010,1498
3611,1,0,0,0,45,0,516,0,1,837837,2778282,34.77067730142742,792,2319,1902,1209,52710,482580,576798,1881,3507,2715,2991,4617,26.324893162176366,21.238639682280603,1626,1,303459,26271,693,0,1089,1605
3612,1,0,0,0,45,0,531,0,1,742212,2650257,34.161381705077446,801,2169,1803,1167,52070,465555,576834,1905,3438,2637,2907,4440,25.219040425836983,19.841276746644777,1533,1,296418,21228,636,0,1104,1635
3613,1,0,0,0,45,0,539,0,1,695622,2587668,33.85262175962151,804,2095,1753,1146,55278,501276,562242,1916,3404,2600,2865,4353,24.63736998950984,19.15596383377071,1488,1,285354,29754,607,0,1112,1651
3614,1,0,0,0,45,0,547,0,1,651954,2536878,33.555923471125034,807,2024,1705,1126,54560,558744,495660,1934,3379,2572,2832,4277,24.06241883103193,18.53974842356081,1445,1,247720,47850,579,0,1127,1674
3615,1,0,0,0,45,0,554,0,1,610512,2499560,33.25657829663178,809,1955,1658,1106,45933,567260,413580,1963,3366,2557,2812,4215,23.49468024894146,18.062177091564944,1403,1,202398,55836,552,0,1154,1708
3616,1,0,0,0,45,0,563,0,1,569588,2468577,32.96968304366907,810,1888,1611,1087,44640,563208,408780,1994,3358,2548,2795,4159,22.891046284519195,17.7618623889712,1364,1,195660,50414,524,0,1184,1747
3617,1,0,0,0,45,0,580,0,1,493500,2386650,32.4037034920393,816,1754,1520,1050,50380,500060,520517,2039,3323,2507,2743,4027,21.6794833886788,16.720647182635105,1284,1,240450,20592,470,0,1223,1803
3618,1,0,0,0,44,0,598,0,1,423255,2275630,31.85906464414798,814,1633,1432,1015,46250,414770,560500,2041,3257,2443,2659,3875,20.42057785666214,15.45427678184721,1216,1,253750,4623,417,0,1227,1825
3619,1,0,0,0,43,0,634,0,1,304007,2067057,30.870698080866262,845,1380,1272,953,48514,414279,550926,2061,3122,2277,2488,3549,17.86057109949175,11.07198010139901,1061,1,242062,4104,319,0,1216,1850
3620,1,0,0,0,43,0,642,0,1,278883,2021667,30.643106892089126,854,1321,1236,939,50292,426294,546862,2068,3092,2238,2450,3474,17.233687939614086,9.737059976664934,1024,1,238506,3825,297,0,1214,1856
3621,1,0,0,0,42,0,649,0,1,256502,1980714,30.430248109405877,859,1270,1203,926,51408,436356,539028,2072,3065,2206,2416,3409,16.64331697709324,8.694308756644029,993,1,233352,3618,277,0,1213,1862
3622,1,0,0,0,42,0,662,0,1,185288,1835400,29.563490998188964,874,1086,1086,874,33196,405300,361200,2100,2974,2100,2312,3186,14.560219778561036,0.0,874,1,150328,0,212,0,1226,1888
3623,1,0,0,0,42,0,621,0,1,193572,1782900,29.13760456866693,849,1077,1077,849,38994,422100,407400,2100,2949,2100,2328,3177,15.0996688705415,0.0,849,1,164706,0,228,0,1251,1872
3624,1,0,0,0,46,0,344,0,1,406016,1943552,28.844410203711913,585,1567,1320,832,27946,366752,415808,2089,3168,2583,2824,3903,22.090722034374522,17.398594293166163,1079,1,148096,24453,488,0,1504,1848
3625,1,0,0,0,45,0,211,1,0,558140,1945320,29.32575659723036,770,1599,1509,860,24888,461448,275964,2172,3122,2352,2911,3861,25.475478405713993,10.195209251481318,950,1,104920,19350,649,0,1402,1613
3626,1,0,0,0,46,0,172,0,1,694848,2147376,30.397368307141328,714,1886,1676,924,34821,508956,369516,2114,3248,2534,3076,4210,27.422618401604176,15.457933012562789,1134,1,146916,41580,752,0,1400,1572
3627,1,0,0,0,45,0,104,0,1,934320,2325600,31.937438845342623,953,2003,1936,1020,40704,437760,483360,2213,3300,2347,3196,4283,30.265491900843113,8.314029025396882,1087,1,216240,7236,916,0,1260,1364
3628,1,0,0,0,40,0,90,0,0,214200,851340,20.493901531919196,420,930,930,420,53775,456075,484453,2027,2447,2027,2537,2957,22.58317958127243,0.0,420,0,100380,0,510,0,1607,1517
3629,1,0,0,0,40,0,98,0,0,164880,727560,18.973665961010276,360,818,818,360,42048,442599,388032,2021,2381,2021,2479,2839,21.400934559032695,0.0,360,0,69120,0,458,0,1661,1563
3630,0,0,0,0,56,1,899,1,0,1309620,4765002,40.97560249709576,1255,2883,2459,1679,53599,615846,700986,2414,4517,3262,3618,5721,27.92848008753788,20.80951213477095,2103,1,414713,39008,780,0,1159,2058
3631,0,0,1,0,56,1,1586,0,0,1436120,6346580,47.22287581247038,1972,3132,2874,2230,53130,720038,597660,2588,5076,3104,3490,5978,25.37715508089904,16.520272456043685,2488,1,468300,44634,644,0,616,2202
3632,0,0,1,0,57,1,1529,0,0,1476200,6274400,46.9041575982343,1923,3148,2871,2200,48514,724408,544732,2575,5052,3129,3523,6000,25.903667693977237,17.160940468146453,2477,1,420200,53738,671,0,652,2181
3633,0,0,1,0,57,1,1303,0,0,1624740,5974044,45.639894828976104,1753,3193,2863,2083,53320,711264,616620,2538,4951,3198,3648,6061,27.92848008753788,18.5930292753225,2413,1,447845,55440,780,0,785,2088
3634,0,0,1,0,57,1,1073,0,0,1752780,5669025,44.328320518603,1634,3188,2857,1965,45684,701055,542380,2554,4850,3216,3777,6073,29.866369046136157,18.499800107316396,2296,1,369420,64545,892,0,920,1993
3635,0,0,1,0,57,1,866,0,0,190736,523432,13.490737563232042,152,1260,1230,182,54918,698868,649976,2846,3058,2906,3924,4136,32.37282811247729,5.477225575051661,212,1,41132,4500,1048,0,2694,1828
3636,0,0,1,0,56,1,832,0,0,413700,995050,18.708286933869708,350,1532,1532,350,54988,670948,662419,2843,3193,2843,4025,4375,34.38022687534217,0.0,350,1,81550,0,1182,0,2493,1661
3637,0,0,1,0,56,1,807,0,0,531910,1216900,20.73644135332772,430,1667,1667,430,56400,665050,679200,2830,3260,2830,4067,4497,35.17101079013795,0.0,430,1,103200,0,1237,0,2400,1593
3638,0,0,0,0,56,1,753,1,0,863254,1757182,25.019992006393608,596,2035,2005,626,55876,642803,684908,2777,3433,2837,4186,4842,37.134889255254286,5.514871952411144,656,1,152744,2970,1379,0,2181,1428
3639,1,0,0,0,47,0,377,1,0,222024,753159,17.86057109949175,111,1445,1015,319,36580,557196,365955,1931,2680,2791,3057,3806,26.38181191654584,21.06181485735881,749,1,49445,94170,696,0,2042,1665
3640,1,0,0,0,43,0,243,0,0,723978,2116998,31.32091952673165,981,1719,1719,981,43979,476918,429442,2158,3139,2158,2896,3877,27.16615541441225,0.0,981,0,195219,0,738,0,1177,1420
3641,1,0,0,0,43,0,241,1,0,746736,2146866,31.51190251317746,963,1775,1745,993,39917,482126,386998,2132,3155,2192,2914,3937,27.422618401604176,5.5965095842615735,1023,1,177747,5490,752,0,1169,1410
3642,1,0,0,0,46,0,560,1,0,417216,2265168,31.368774282716245,707,1685,1408,984,24616,416662,313072,2025,3286,2579,2726,3987,20.591260281974,17.941805150441176,1261,1,133824,48198,424,0,1318,1878
3643,1,0,0,0,46,0,677,0,1,84780,1827480,28.0178514522438,454,1224,893,785,53823,537768,542424,1997,3113,2659,2436,3552,10.392304845413264,18.62669824273697,1116,1,182905,43030,108,0,1543,2220
3644,1,0,0,0,46,0,648,0,1,104788,1818932,27.964262908219126,447,1251,916,782,54285,537306,546610,1991,3108,2661,2460,3577,11.575836902790225,18.71321023298192,1117,1,183770,42880,134,0,1544,2192
3645,1,0,0,0,42,0,200,0,0,1365929,2692395,35.679125549822544,1243,2376,2346,1273,56628,511830,494910,2085,3388,2145,3188,4491,32.7566787083184,5.514871952411144,1303,1,297882,3960,1073,0,842,1042
3646,1,0,0,0,42,0,218,0,0,1326768,2678856,35.58089374931439,1236,2344,2314,1266,50995,497260,459172,2086,3382,2146,3164,4460,32.37282811247729,5.477225575051661,1296,1,274722,4650,1048,0,850,1068
3647,1,0,0,0,42,0,236,0,0,1292525,2660710,35.510561809129406,1261,2286,2286,1261,50388,466310,481080,2110,3371,2110,3135,4396,32.01562118716424,0.0,1261,0,287508,0,1025,0,849,1085
3648,1,0,0,0,42,0,245,0,0,1278900,2653560,35.4964786985977,1260,2275,2275,1260,49729,469638,469638,2106,3366,2106,3121,4381,31.85906464414798,0.0,1260,0,280980,0,1015,0,846,1091
3649,1,0,0,0,42,0,254,0,0,1267560,2654820,35.4964786985977,1260,2266,2266,1260,47652,480396,440363,2107,3367,2107,3113,4373,31.71750305430741,0.0,1260,0,263340,0,1006,0,847,1101
3650,1,0,0,0,42,0,313,0,0,1222080,2693668,35.679125549822544,1273,2233,2233,1273,49980,444360,503608,2116,3389,2116,3076,4349,30.983866769659336,0.0,1273,0,302974,0,960,0,843,1156
3651,1,0,0,0,42,0,317,0,0,1225920,2689362,35.73513677041127,1277,2237,2237,1277,48124,446472,478062,2106,3383,2106,3066,4343,30.983866769659336,0.0,1277,0,289879,0,960,0,829,1146
3652,1,0,0,0,46,0,364,1,0,1541901,3342462,37.907782842049734,1007,2940,2510,1437,33408,539632,334944,1896,3763,2756,3399,5266,32.7566787083184,22.33624424818777,1867,1,206928,96320,1073,0,889,1253
3653,1,0,0,0,46,0,418,0,1,1536368,3439236,38.28837943815329,978,3002,2514,1466,55328,579462,525504,1858,3812,2834,3394,5348,32.37282811247729,23.615951980346455,1954,1,328384,75640,1048,0,880,1298
3654,1,0,0,0,46,0,457,0,1,1504044,3452364,38.41874542459709,958,3013,2495,1476,55000,514580,584750,1821,3815,2857,3358,5352,31.921779399024736,24.11213127076101,1994,1,369000,45066,1019,0,863,1320
3655,1,0,0,0,46,0,469,0,1,1371840,3300990,37.8021163428716,878,2940,2389,1429,48888,448140,582120,1759,3739,2861,3270,5250,30.983866769659336,23.907763181583306,1980,1,360108,28652,960,0,881,1350
3656,1,0,0,0,45,0,475,0,1,1308986,3228176,37.49666651850535,869,2874,2337,1406,51250,470680,574000,1759,3702,2833,3227,5170,30.512292604784715,23.54672746928759,1943,1,351500,38664,931,0,890,1365
3657,1,0,0,0,45,0,481,0,1,1247466,3161538,37.1887079635741,859,2809,2285,1383,54450,514350,553212,1762,3669,2810,3188,5095,30.033314835362415,23.225139007041694,1907,1,334686,57640,902,0,903,1384
3658,1,0,0,0,45,0,493,0,1,1130610,3064020,36.578682316343766,841,2680,2183,1338,45540,579370,412200,1793,3628,2787,3135,4970,29.068883707497267,22.784700180346327,1835,1,240840,102382,845,0,952,1445
3659,1,0,0,0,46,0,500,0,1,1073856,3029432,36.27671429443411,832,2616,2132,1316,46736,584708,423568,1818,3618,2786,3118,4918,28.5657137141714,22.59185707742933,1800,1,242144,96800,816,0,986,1486
3660,1,0,0,0,46,0,514,0,1,966207,2934265,35.679125549822544,816,2489,2032,1273,54755,537065,541675,1848,3578,2762,3064,4794,27.54995462791182,22.073680491465108,1730,1,299155,49356,759,0,1032,1546
3661,1,0,0,0,45,0,528,0,1,863460,2809320,35.07135583350036,828,2334,1932,1230,54120,502480,561864,1882,3514,2686,2986,4618,26.49528259898354,20.748207032741107,1632,1,302580,32160,702,0,1054,1582
3662,1,0,0,0,45,0,535,0,1,814866,2752893,34.77067730142742,833,2259,1883,1209,54000,491832,569250,1901,3486,2653,2951,4536,25.96150997149434,20.129272487272544,1585,1,302250,28200,674,0,1068,1603
3663,1,0,0,0,45,0,543,0,1,768094,2690707,34.48187929913333,839,2185,1835,1189,52118,466178,572539,1913,3452,2613,2909,4448,25.41653005427767,19.387049435985567,1539,1,300817,20650,646,0,1074,1617
3664,1,0,0,0,44,0,558,0,1,679059,2573760,33.896902513356586,849,2040,1740,1149,55647,544320,512960,1940,3389,2540,2831,4280,24.310491562286437,17.924465864520116,1449,1,263121,40200,591,0,1091,1649
3665,1,0,0,0,44,0,565,0,1,636756,2533476,33.60059523282288,852,1970,1693,1129,48945,563244,437580,1967,3373,2521,2808,4214,23.748684174075834,17.363170339092083,1406,1,220155,48475,564,0,1115,1680
3666,1,0,0,0,44,0,590,0,1,519816,2415426,32.77193921634788,862,1770,1558,1074,49946,497029,508274,2037,3323,2461,2733,4019,22.0,15.753198174302588,1286,1,242724,19504,484,0,1175,1765
3667,1,0,0,0,44,0,599,0,1,484106,2369794,32.51153641401772,865,1707,1515,1057,49742,468578,533596,2050,3299,2434,2700,3949,21.400934559032695,15.082502027490362,1249,1,251566,12288,458,0,1185,1784
3668,1,0,0,0,44,0,607,0,1,450320,2316080,32.2490309931942,865,1648,1473,1040,50096,449854,552296,2052,3267,2402,2660,3875,20.808652046684813,14.32199278656533,1215,1,257920,8750,433,0,1187,1794
3669,1,0,0,0,43,0,624,0,1,387072,2216592,31.74901573277509,858,1542,1392,1008,49530,428805,558546,2049,3207,2349,2583,3741,19.595917942265423,13.1493192969221,1158,1,256032,6600,384,0,1191,1815
3670,1,0,0,0,43,0,633,0,1,358834,2168908,31.52776554086889,870,1479,1355,994,48006,412398,554228,2058,3176,2306,2543,3661,19.0,11.912384216891237,1118,1,252476,4836,361,0,1188,1821
3671,1,0,0,0,43,0,640,0,1,331881,2118556,31.28897569432403,884,1413,1318,979,46228,393848,549656,2069,3143,2259,2503,3577,18.411952639521967,10.429965964842806,1074,1,248666,2755,339,0,1185,1825
3672,1,0,0,0,42,0,647,0,1,308154,2070138,31.080540535840107,899,1352,1285,966,47498,400741,544322,2076,3109,2210,2462,3495,17.86057109949175,8.616819548034314,1033,1,245364,2345,319,0,1177,1824
3673,1,0,0,0,42,0,653,0,1,285900,2027984,30.870698080866262,911,1295,1253,953,50800,425600,540512,2086,3081,2170,2428,3423,17.320508075688775,6.73127350780198,995,1,242062,2226,300,0,1175,1828
3674,1,0,0,0,42,0,664,0,1,235520,1939360,30.331501776206203,920,1176,1176,920,39345,453220,385764,2108,3028,2108,2364,3284,16.0,0.0,920,1,168360,0,256,0,1188,1852
3675,1,0,0,0,43,0,509,0,0,314070,1884420,29.49576240750525,775,1326,1231,870,33699,517674,305406,2071,3036,2261,2527,3492,19.0,10.232047425710157,965,1,122670,21945,361,0,1296,1805
3676,1,0,0,0,46,0,232,0,1,739968,2302560,31.368774282716245,712,2008,1736,984,41995,531180,432900,2068,3324,2612,3092,4348,27.422618401604176,17.36288377951153,1256,1,182040,49232,752,0,1356,1588
3677,1,0,0,0,46,0,330,0,1,941031,2655339,33.896902513356586,1022,2095,1968,1149,36616,425224,459889,2184,3460,2438,3130,4406,28.61817604250837,11.651960555446681,1276,1,228651,14351,819,0,1162,1492
3678,1,0,0,0,40,0,101,0,0,247950,915300,21.213203435596427,450,1001,1001,450,53382,441378,500364,2034,2484,2034,2585,3035,23.473389188611005,0.0,450,0,110700,0,551,0,1584,1483
3679,1,0,0,0,40,0,105,0,0,220500,851340,20.493901531919196,420,945,945,420,46004,439859,429724,2027,2447,2027,2552,2972,22.9128784747792,0.0,420,0,89040,0,525,0,1607,1502
3680,1,0,0,0,41,0,162,1,0,61560,370980,13.416407864998739,72,630,522,180,33284,323577,436932,1953,2241,2169,2403,2691,18.49324200890693,11.25033949080533,288,1,38160,6264,342,0,1881,1719
3681,0,1,0,1,64,0,1257,0,0,10931578,12884644,63.198101237299845,3952,6773,6731,3994,49450,693590,741980,3184,7220,3268,5963,9999,52.316345438113316,6.503581472166948,4036,1,918620,4830,2737,0,768,489
3682,0,0,1,0,58,1,147,0,0,1733040,4082736,37.30951621235526,918,3111,2637,1392,50218,698054,618863,2459,4325,3407,4178,6044,35.2845575287547,21.82947479696659,1866,1,293712,78210,1245,0,1541,1688
3683,0,0,1,0,57,1,1341,0,0,1611090,6029478,45.89117562233506,1806,3171,2871,2106,51660,704298,601230,2563,4969,3163,3628,6034,27.65863337187866,17.765162930298995,2406,1,442260,51900,765,0,757,2098
3684,0,0,1,0,57,1,1285,0,0,1644984,5950605,45.574115460423364,1777,3169,2869,2077,49126,693330,581595,2565,4942,3165,3657,6034,28.142494558940577,17.78279410038923,2377,1,421631,53100,792,0,788,2073
3685,0,0,1,0,59,1,306,0,0,2010067,4680156,39.736632972611055,1095,3336,2852,1579,42602,705432,530556,2480,4543,3448,4237,6300,35.679125549822544,22.001502475678897,2063,1,282641,95832,1273,0,1385,1691
3686,0,0,1,0,60,1,448,0,0,1991865,3628255,34.713109915419565,829,3234,2858,1205,53105,743717,647365,2635,4216,3387,4664,6245,40.65710270051225,19.415668116689695,1581,1,259075,62792,1653,0,1806,1358
3687,0,0,0,0,56,1,790,1,0,812231,1650378,24.269322199023193,589,1968,1968,589,55680,672480,650064,2802,3391,2802,4181,4770,37.134889255254286,0.0,589,1,136648,0,1379,0,2213,1423
3688,1,0,0,0,46,0,305,1,0,153564,620956,16.3707055437449,94,1203,841,268,48906,572299,458766,1955,2585,2679,2890,3520,23.93741840717165,19.13515976005891,630,1,53064,67694,573,0,2049,1744
3689,1,0,0,0,43,0,297,0,0,716688,2181312,31.74901573277509,1008,1719,1719,1008,44325,486900,426308,2164,3172,2164,2875,3883,26.664583251946766,0.0,1008,0,198576,0,711,0,1156,1453
3690,1,0,0,0,43,0,292,1,0,765453,2248841,32.14031735997639,973,1834,1774,1033,33325,468055,337435,2117,3210,2237,2918,4011,27.2213151776324,8.038779614196052,1093,1,160115,11820,741,0,1144,1436
3691,1,0,0,0,45,0,687,1,0,190588,2045225,29.9833287011299,549,1461,1111,899,38700,511875,391300,1925,3174,2625,2487,3736,14.560219778561036,18.806812524240758,1249,1,154628,67200,212,0,1376,2063
3692,1,0,0,0,42,0,117,0,0,1437778,2672857,35.482389998420345,1217,2443,2401,1259,54834,471306,524381,2081,3382,2165,3265,4566,33.793490497431605,6.609134537568676,1301,1,310973,3612,1142,0,864,981
3693,1,0,0,0,42,0,134,0,0,1390272,2630784,35.32704346531139,1218,2392,2362,1248,54948,508028,480624,2078,3356,2138,3222,4500,33.37663853655727,5.478746393072713,1278,1,284544,4380,1114,0,860,994
3694,1,0,0,0,42,0,152,0,0,1346793,2622963,35.199431813596085,1239,2326,2326,1239,41032,472091,389528,2117,3356,2117,3204,4443,32.96968304366907,0.0,1239,0,227976,0,1087,0,878,1030
3695,1,0,0,0,42,0,196,0,0,1271820,2592840,35.07135583350036,1200,2294,2264,1230,43485,470084,411060,2078,3338,2138,3142,4402,32.155870381627054,5.483301264452448,1260,0,239850,4980,1034,0,878,1074
3696,1,0,0,0,45,0,485,0,1,1339500,3264675,37.749172176353746,915,2875,2365,1425,53676,487983,577332,1781,3716,2801,3231,5166,30.659419433511783,22.957720333735082,1935,1,359100,38760,940,0,866,1351
3697,1,0,0,0,45,0,532,0,1,943293,2902440,35.679125549822544,856,2431,2014,1273,53520,508440,547200,1863,3553,2697,3021,4711,27.2213151776324,21.003886190312073,1690,1,305520,36696,741,0,1007,1539
3698,1,0,0,0,45,0,546,0,1,843235,2786984,35.08560958569767,869,2278,1916,1231,53900,498080,554680,1902,3495,2626,2949,4542,26.1725046566048,19.647014564874116,1593,1,301595,29322,685,0,1033,1579
3699,1,0,0,0,44,0,576,0,1,665281,2572343,33.95585369269929,895,1988,1730,1153,52041,555519,466279,1973,3384,2489,2808,4219,24.020824298928627,16.701093186364393,1411,1,240977,40506,577,0,1078,1654
3700,1,0,0,0,44,0,624,0,1,447300,2311050,32.4037034920393,916,1610,1476,1050,52364,466612,543647,2067,3251,2335,2627,3811,20.639767440550294,12.5131552182536,1184,1,259350,8978,426,0,1151,1775
3701,1,0,0,0,43,0,630,0,1,417736,2263426,32.155870381627054,910,1562,1438,1034,52710,459690,549439,2065,3223,2313,2593,3751,20.09975124224178,12.059737629881619,1158,1,259534,7812,404,0,1155,1785
3702,1,0,0,0,43,0,638,0,1,389640,2219520,31.937438845342623,912,1510,1402,1020,51308,439552,552704,2068,3196,2284,2558,3686,19.544820285692065,11.18177069631855,1128,1,259080,5832,382,0,1156,1794
3703,1,0,0,0,43,0,645,0,1,363166,2172960,31.71750305430741,921,1452,1367,1006,46990,399600,548640,2075,3166,2245,2521,3612,19.0,9.855393472241717,1091,1,255524,2720,361,0,1154,1799
3704,1,0,0,0,42,0,651,0,1,339606,2125020,31.51190251317746,933,1395,1335,993,46228,389480,543560,2080,3133,2200,2482,3535,18.49324200890693,8.16338338718601,1053,1,252222,1740,342,0,1147,1798
3705,1,0,0,0,42,0,660,0,1,299421,2045559,31.12876483254676,969,1278,1278,969,53040,466531,506640,2111,3080,2111,2420,3389,17.578395831246947,0.0,969,1,232560,0,309,0,1142,1802
3706,1,0,0,0,42,0,593,0,1,278718,1914044,30.033314835362415,902,1211,1211,902,35712,407424,394692,2122,3024,2122,2431,3333,17.578395831246947,0.0,902,1,167772,0,309,0,1220,1813
3707,1,0,0,0,45,0,506,1,0,256347,1865682,28.61817604250837,484,1467,1132,819,26600,346256,398650,1943,3097,2613,2591,3745,17.69180601295413,18.837293529907715,1154,1,143325,32160,313,0,1459,1965
3708,1,0,0,0,45,0,511,1,0,244412,1843240,28.495613697550013,473,1452,1113,812,26208,354120,381360,1931,3082,2609,2571,3722,17.349351572897472,19.775821382978844,1151,1,136416,36951,301,0,1458,1969
3709,1,0,0,0,44,0,497,1,0,253530,1811970,28.460498941515414,542,1391,1123,810,27693,342261,404897,1969,3047,2505,2550,3628,17.69180601295413,17.23363909606863,1078,1,146610,24120,313,0,1427,1924
3710,1,0,0,0,44,0,420,1,0,332896,1839992,28.705400188814647,716,1336,1228,824,37536,455532,410872,2125,3057,2341,2637,3569,20.09975124224178,10.613247510664669,932,1,151616,16848,404,0,1409,1829
3711,1,0,0,0,45,0,348,1,0,445824,1949184,29.393876913398138,864,1380,1380,864,37976,455712,424128,2256,3120,2256,2772,3636,22.715633383201094,0.0,864,1,162432,0,516,0,1392,1740
3712,1,0,0,0,46,0,269,0,1,713790,2316600,31.464265445104548,743,1958,1711,990,47236,563940,458640,2093,3330,2587,3061,4298,26.851443164195103,16.70693979149355,1237,1,194040,45448,721,0,1350,1619
3713,1,0,0,0,46,0,335,0,1,917700,2641380,33.76388603226827,1006,2079,1945,1140,37149,424011,470351,2183,3457,2451,3122,4396,28.372521918222215,12.019627717482168,1274,1,231420,14338,805,0,1177,1512
3714,1,0,0,0,40,0,111,0,1,284752,979797,21.93171219946131,481,1073,1073,481,55304,454251,505176,2037,2518,2037,2629,3110,24.331050121192877,0.0,481,1,119288,0,592,0,1556,1445
3715,0,1,1,0,61,0,1565,0,0,7553000,6420050,45.552167895721496,1895,5895,5715,2075,52164,779688,640458,2914,5169,3274,6734,8989,60.332412515993425,13.541462557970705,2255,1,429525,32040,3640,0,1019,546
3716,0,0,1,0,59,1,406,0,0,1995120,4813390,40.3732584763727,1184,3300,2854,1630,45738,714626,558117,2507,4583,3399,4177,6253,34.9857113690718,21.655915532567114,2076,1,308070,86078,1224,0,1323,1729
3717,1,0,0,0,45,0,174,1,0,38227,290830,11.269427669584644,173,728,428,127,54675,556470,515250,1990,2417,2590,2591,3018,17.349351572897472,17.358105696309828,427,1,28575,45900,301,0,2163,1989
3718,1,0,0,0,43,0,349,0,0,708290,2241712,32.155870381627054,1034,1719,1719,1034,40454,489968,388072,2168,3202,2168,2853,3887,26.1725046566048,0.0,1034,0,185086,0,685,0,1134,1483
3719,1,0,0,0,45,0,528,1,0,784080,2725272,34.46737587922817,920,2116,1848,1188,24738,426684,305102,2026,3482,2562,2954,4410,25.69046515733026,17.510995463686218,1456,1,158004,49312,660,0,1106,1634
3720,1,0,0,0,46,0,588,1,0,512640,2471352,32.68026927673638,738,1878,1548,1068,34830,497510,374868,1984,3382,2644,2794,4192,21.908902300206645,19.278828895683546,1398,1,173016,62700,480,0,1246,1834
3721,1,0,0,0,42,0,54,0,0,1463371,2627388,35.17101079013795,1207,2450,2420,1237,56628,497016,514008,2094,3361,2154,3307,4574,34.39476704383968,5.572104574801163,1267,1,299354,3390,1183,0,887,941
3722,1,0,0,0,42,0,78,0,0,1388520,2574852,34.899856733230294,1218,2358,2358,1218,36925,446054,369950,2114,3332,2114,3254,4472,33.76388603226827,0.0,1218,0,213150,0,1140,0,896,974
3723,1,0,0,0,42,0,94,0,0,1348035,2573961,34.77067730142742,1179,2354,2324,1209,28576,400252,323608,2099,3338,2159,3244,4483,33.391615714128,5.959073905325341,1239,0,183768,5040,1115,0,920,1014
3724,1,0,0,0,43,0,182,1,0,1234944,2601342,34.72751070837067,1139,2297,2230,1206,26467,286881,429243,2090,3363,2224,3181,4454,32.0,8.616819548034314,1273,1,239994,2613,1024,0,951,1133
3725,1,0,0,0,46,0,442,0,1,1456688,3337640,38.05259518088089,932,2970,2454,1448,54750,504795,576250,1789,3753,2821,3311,5275,31.71750305430741,23.134005532148908,1964,1,362000,42312,1006,0,857,1299
3726,1,0,0,0,45,0,488,0,1,1431305,3362175,38.27531841800928,966,2941,2442,1465,54467,498015,576045,1796,3760,2794,3272,5236,31.25699921617557,22.719237084736633,1964,1,367715,40419,977,0,830,1318
3727,1,0,0,0,45,0,503,0,1,1309160,3238748,37.72267222772003,953,2813,2343,1423,55418,521204,550792,1806,3699,2746,3196,5089,30.331501776206203,22.013323729072262,1893,1,344366,53580,920,0,853,1356
3728,1,0,0,0,45,0,509,0,1,1249692,3183072,37.429934544425805,944,2750,2293,1401,55660,549824,522560,1815,3673,2729,3164,5022,29.866369046136157,21.70263224278014,1858,1,322230,65808,892,0,871,1380
3729,1,0,0,0,45,0,522,0,1,1135288,3086734,36.851051545376556,928,2624,2194,1358,53784,565977,490968,1843,3631,2703,3109,4897,28.91366458960192,21.174573820826314,1788,1,293328,66220,836,0,915,1437
3730,1,0,0,0,45,0,529,0,1,1080296,3041675,36.565010597564445,920,2562,2145,1337,54450,550550,511875,1858,3612,2692,3083,4837,28.42534080710379,20.935809294314634,1754,1,300825,55461,808,0,938,1467
3731,1,0,0,0,45,0,542,0,1,973088,2928322,35.9722114972099,904,2436,2046,1294,55189,518227,545383,1873,3557,2653,3015,4699,27.422618401604176,20.25234028213656,1684,1,311854,38220,752,0,969,1511
3732,1,0,0,0,44,0,570,0,1,781816,2704792,34.84250278036869,919,2153,1858,1214,55000,490160,557000,1933,3442,2523,2872,4381,25.37715508089904,17.66737638206614,1509,1,303500,25370,644,0,1014,1584
3733,1,0,0,0,44,0,584,0,1,696192,2603664,34.292856398964496,934,2010,1768,1176,55632,540216,504792,1972,3390,2456,2806,4224,24.331050121192877,16.04691241441268,1418,1,268128,33154,592,0,1038,1622
3734,1,0,0,0,44,0,592,0,1,655428,2566128,34.02939905434711,942,1940,1724,1158,52858,547352,474224,2000,3374,2432,2782,4156,23.790754506740637,15.309684289836783,1374,1,247812,32184,566,0,1058,1650
3735,1,0,0,0,44,0,599,0,1,616740,2529660,33.76388603226827,948,1873,1681,1140,53743,534779,494837,2027,3359,2411,2760,4092,23.259406699226016,14.621066420214344,1332,1,254220,25152,541,0,1079,1678
3736,1,0,0,0,44,0,615,0,1,544644,2444256,33.27160951922825,957,1749,1599,1107,53703,487968,536544,2058,3315,2358,2700,3957,22.181073012818835,13.187419067680642,1257,1,269001,12450,492,0,1101,1716
3737,1,0,0,0,43,0,637,0,1,449864,2307675,32.57299494980466,966,1580,1485,1061,52731,471975,528525,2080,3236,2270,2599,3755,20.591260281974,10.477236849499048,1156,1,257823,7220,424,0,1114,1751
3738,1,0,0,0,43,0,643,0,1,422988,2266755,32.357379374726875,962,1536,1451,1047,52858,463310,534755,2080,3212,2250,2569,3701,20.09975124224178,9.982202543931885,1132,1,258609,5950,404,0,1118,1761
3739,1,0,0,0,43,0,649,0,1,396672,2225082,32.14031735997639,966,1484,1417,1033,50347,428646,544962,2087,3187,2221,2538,3638,19.595917942265423,8.862806978978044,1100,1,261349,3082,384,0,1121,1770
3740,1,0,0,0,42,0,658,0,1,352800,2134944,31.74901573277509,978,1388,1358,1008,52961,446898,531618,2088,3126,2148,2468,3506,18.708286933869708,5.5503012171862105,1038,1,253008,2310,350,0,1110,1768
3741,1,0,0,0,42,0,597,1,0,312220,1994480,30.528675044947494,902,1297,1267,932,25488,308160,378780,2110,3072,2170,2475,3437,18.303005217723125,5.91487205010149,962,1,164964,2460,335,0,1208,1805
3742,1,0,0,0,42,0,580,1,0,325500,1980900,30.495901363953813,930,1280,1280,930,36465,398310,415350,2130,3060,2130,2480,3410,18.708286933869708,0.0,930,1,181350,0,350,0,1200,1780
3743,1,0,0,0,46,0,542,0,1,280584,2009120,29.427877939124322,608,1448,1190,866,44037,438480,540560,2062,3186,2578,2644,3768,18.0,16.275284349458516,1124,1,201778,20382,324,0,1454,1996
3744,1,0,0,0,45,0,545,1,0,247800,1890840,28.982753492378876,598,1377,1135,840,28536,369164,391674,2009,3091,2493,2546,3628,17.175564037317667,15.569348747395024,1082,1,146160,27104,295,0,1411,1956
3745,1,0,0,0,45,0,377,1,0,473550,2046638,30.033314835362415,860,1469,1427,902,30804,462876,342619,2227,3171,2311,2794,3738,22.9128784747792,6.63067838716079,944,1,136202,7938,525,0,1367,1744
3746,1,0,0,0,46,0,322,0,1,601343,2207148,30.870698080866262,803,1734,1584,953,28420,453936,335820,2166,3269,2466,2947,4050,25.11971337416094,13.552624232328649,1103,1,138185,27600,631,0,1363,1685
3747,1,0,0,0,47,0,381,0,1,767422,2554450,32.96968304366907,778,2102,1793,1087,47840,540500,488800,2041,3437,2659,3056,4452,26.570660511172846,17.916864077887357,1396,1,226096,49440,706,0,1263,1644
3748,1,0,0,0,40,0,119,0,1,325362,1048046,22.67156809750927,514,1147,1147,514,56088,464892,501594,2039,2553,2039,2672,3186,25.15949125081825,0.0,514,1,126444,0,633,0,1525,1406
3749,1,0,0,0,41,0,153,1,0,163480,696800,18.303005217723125,250,908,823,335,21875,364000,260000,1995,2415,2165,2568,2988,22.090722034374522,9.956213246629972,420,1,41875,15045,488,0,1745,1592
3750,0,0,1,0,56,1,1019,0,0,1369862,5040092,42.261093218230876,1467,2872,2553,1786,51170,606730,671636,2503,4608,3141,3589,5694,27.694764848252458,18.08381773621633,2105,1,425068,33495,767,0,1036,2055
3751,0,0,1,0,59,1,1133,0,0,620948,1207960,20.09975124224178,13,2358,1941,404,51574,720590,639860,2573,3394,3407,4527,5348,39.20459156782532,20.562939551133983,821,1,86456,68805,1537,0,2586,1453
3752,1,0,0,0,45,0,150,1,0,45000,342900,12.24744871391589,120,720,450,150,53680,557784,502920,2016,2436,2556,2586,3006,17.320508075688775,16.46403862829034,420,1,33000,42930,300,0,2136,1986
3753,1,0,0,0,45,0,160,1,0,56100,389300,13.038404810405298,100,770,500,170,47616,567920,439680,2020,2460,2560,2620,3060,18.16590212458495,16.475678111436697,440,1,32640,52380,330,0,2120,1960
3754,1,0,0,0,43,0,371,0,0,653660,2199505,31.85906464414798,1015,1659,1659,1015,46256,511412,424732,2167,3182,2167,2811,3826,25.37715508089904,0.0,1015,0,198940,0,644,0,1152,1523
3755,1,0,0,0,44,0,388,1,0,808764,2473080,33.37663853655727,990,1964,1840,1114,25536,426240,295260,2096,3334,2344,2946,4184,26.94438717061496,11.871952282220144,1238,1,148162,23684,726,0,1106,1494
3756,1,0,0,0,46,0,663,0,1,369664,2357248,32.0,645,1764,1385,1024,53628,501836,566292,1923,3326,2681,2663,4066,19.0,20.34108138801446,1403,1,251904,36384,361,0,1278,1941
3757,1,0,0,0,42,0,16,0,0,1517760,2596104,34.9857113690718,1224,2464,2464,1224,55930,504798,498435,2121,3345,2121,3361,4585,35.21363372331802,0.0,1224,1,287640,0,1240,0,897,881
3758,1,0,0,0,42,0,13,0,0,1410114,2532474,34.55430508634199,1194,2375,2375,1194,34196,436926,352086,2121,3315,2121,3302,4496,34.36568055487916,0.0,1194,0,198204,0,1181,0,927,940
3759,1,0,0,0,42,0,22,0,0,1387563,2530192,34.48187929913333,1159,2386,2356,1189,25893,402192,291536,2098,3317,2158,3295,4514,34.161381705077446,5.8721273231371045,1219,0,162893,5490,1167,0,939,961
3760,1,0,0,0,43,0,116,1,0,1239861,2571216,34.249087579087416,1065,2338,2230,1173,31916,346336,442784,2084,3365,2300,3249,4530,32.51153641401772,11.273617567818544,1281,1,236946,7884,1057,0,1019,1135
3761,1,0,0,0,45,0,408,0,1,1444345,3268631,37.72267222772003,931,2930,2438,1423,54312,503043,569656,1805,3720,2789,3312,5227,31.85906464414798,22.581442881172595,1915,1,352904,46248,1015,0,874,1282
3762,1,0,0,0,45,0,453,0,1,1421280,3293280,37.94733192202055,966,2901,2427,1440,53165,496279,560315,1813,3727,2761,3274,5188,31.416556144810016,22.134837202020684,1914,1,352800,45978,987,0,847,1300
3763,1,0,0,0,45,0,519,0,1,1281742,3225670,37.69615364994153,991,2753,2323,1421,49720,499400,513020,1840,3691,2700,3172,5023,30.033314835362415,21.07953299948845,1851,1,321146,55040,902,0,849,1368
3764,1,0,0,0,44,0,593,1,0,728400,2647200,34.64101615137755,972,2035,1807,1200,53261,487526,531646,1978,3406,2434,2813,4241,24.63736998950984,15.544382038814643,1428,1,289200,24624,607,0,1006,1599
3765,1,0,0,0,44,0,600,0,1,687924,2603946,34.38022687534217,981,1965,1764,1182,56635,530923,517705,2002,3385,2404,2785,4168,24.124676163629637,14.671197890313652,1383,1,277770,26532,582,0,1021,1621
3766,1,0,0,0,44,0,614,0,1,613032,2525600,33.88214869219483,998,1832,1682,1148,54984,510400,521400,2050,3348,2350,2734,4032,23.108440016582687,12.950100320556757,1298,1,272076,16050,534,0,1052,1666
3767,1,0,0,0,43,0,628,0,1,544608,2432880,33.406586176980134,1008,1712,1604,1116,51414,455620,536280,2072,3296,2288,2668,3892,22.090722034374522,11.115195081142032,1224,1,274536,6588,488,0,1064,1692
3768,1,0,0,0,43,0,634,0,1,514167,2385867,33.18132004607411,1016,1653,1568,1101,51728,459404,528748,2082,3268,2252,2634,3820,21.61018278497431,9.855393472241717,1186,1,268644,5780,467,0,1066,1700
3769,1,0,0,0,43,0,641,0,1,484802,2344659,32.96968304366907,1020,1600,1533,1087,52320,470226,517680,2090,3244,2224,2603,3757,21.118712081942874,8.748575453901612,1154,1,260880,5293,446,0,1070,1711
3770,1,0,0,0,42,0,652,0,1,432480,2265220,32.55764119219941,1018,1510,1468,1060,51870,448770,527839,2095,3197,2179,2545,3647,20.199009876724155,6.955109380145743,1102,1,261820,2646,408,0,1077,1729
3771,1,0,0,0,42,0,657,0,1,409768,2224904,32.37282811247729,1018,1469,1439,1048,53676,452199,534996,2093,3171,2153,2514,3592,19.77371993328519,5.623413251903491,1078,1,264096,2070,391,0,1075,1732
3772,1,0,0,0,42,0,569,0,0,375360,2054400,30.983866769659336,960,1351,1351,960,35700,449400,363800,2140,3100,2140,2531,3491,19.77371993328519,0.0,960,1,163200,0,391,0,1180,1749
3773,1,0,0,0,46,0,495,0,1,473836,2257574,31.28897569432403,804,1638,1463,979,45212,585724,410468,2131,3285,2481,2790,3944,22.0,13.798345105359472,1154,1,174262,35350,484,0,1327,1822
3774,1,0,0,0,46,0,375,0,1,570906,2238222,31.080540535840107,832,1691,1557,966,31244,495838,338282,2183,3283,2451,2908,4008,24.310491562286437,12.661445234206639,1100,1,141036,27336,591,0,1351,1726
3775,1,0,0,0,46,0,348,0,1,642124,2318008,31.52776554086889,804,1830,1640,994,43875,524700,454740,2142,3326,2522,2978,4162,25.41653005427767,15.026522167103975,1184,1,193830,32110,646,0,1338,1686
3776,1,0,0,0,46,0,347,0,1,666288,2349648,31.74901573277509,792,1885,1669,1008,48348,552447,475524,2115,3339,2547,2992,4216,25.709920264364882,15.73474847418079,1224,1,205632,37152,661,0,1323,1670
3777,1,0,0,0,46,0,379,0,1,687440,2431520,32.2490309931942,772,1969,1701,1040,45825,549430,455910,2070,3378,2606,2999,4307,25.709920264364882,17.23363909606863,1308,1,202800,48508,661,0,1298,1677
3778,1,0,0,0,47,0,433,0,1,751470,2615160,33.31666249791537,786,2111,1787,1110,42560,527744,447640,2032,3466,2680,3033,4467,26.019223662515376,18.359822325220456,1434,1,210900,56052,677,0,1246,1679
3779,1,0,0,0,40,0,131,0,0,336182,1056202,22.759613353482084,518,1167,1167,518,47424,464892,424112,2039,2557,2039,2688,3206,25.475478405713993,0.0,518,0,107744,0,649,0,1521,1390
3780,1,0,0,0,40,0,136,0,0,304512,996984,22.090722034374522,458,1142,1112,488,35448,431073,343224,2013,2531,2073,2667,3185,24.979991993593593,5.501408174353464,518,0,81984,5400,624,0,1555,1419
3781,1,0,0,0,40,0,252,0,1,48133,259715,11.269427669584644,3,630,506,127,41548,384460,451945,1921,2172,2169,2424,2675,19.467922333931785,11.871952282220144,251,1,28067,11408,379,0,1918,1666
3782,0,0,0,0,57,1,804,1,0,1564992,4911192,41.42463035441596,1299,3045,2628,1716,52961,603882,718362,2445,4578,3279,3774,5907,30.199337741083,20.742746885678333,2133,1,430716,32109,912,0,1146,1950
3783,0,0,0,0,56,1,892,1,0,1506720,4984440,41.8568990729127,1386,2978,2612,1752,54189,634435,691335,2479,4597,3211,3705,5823,29.32575659723036,19.42017530493211,2118,1,425736,39162,860,0,1093,1985
3784,0,0,1,0,56,1,1449,0,0,1596492,6185316,46.70117771534247,1989,3105,2913,2181,47124,714672,530332,2644,5017,3028,3568,5941,27.055498516937366,14.307589169369836,2373,1,407847,38400,732,0,655,2104
3785,1,0,0,0,43,0,420,1,0,666549,2301858,32.449961479175904,1023,1716,1686,1053,28296,472176,286366,2156,3239,2216,2819,3902,25.15949125081825,5.959073905325341,1083,1,137943,6570,633,0,1133,1553
3786,1,0,0,0,45,0,425,1,0,867824,2633840,34.17601498127012,978,2101,1911,1168,22692,419430,275110,2065,3423,2445,2998,4356,27.258026340878022,14.701110514623295,1358,1,142496,36860,743,0,1087,1512
3787,1,0,0,0,46,0,568,1,0,816153,2855920,35.08560958569767,908,2217,1894,1231,27744,473280,315520,1997,3551,2643,2983,4537,25.748786379167466,19.11732976050148,1554,1,167416,65246,663,0,1089,1657
3788,1,0,0,0,45,0,763,1,0,213858,2253357,31.32091952673165,704,1476,1199,981,41514,509934,429539,2020,3278,2574,2515,3773,14.7648230602334,16.925060583549502,1258,1,183447,48198,218,0,1316,2079
3789,1,0,0,0,46,0,797,0,1,155358,2209536,30.967725134404045,717,1363,1121,959,44265,523008,449280,2062,3263,2546,2466,3667,12.727922061357855,15.964973037642325,1201,1,187005,41382,162,0,1345,2142
3790,1,0,0,0,42,0,49,0,0,1751052,2871240,36.71511950137164,1288,2707,2647,1348,55860,521850,485640,2070,3478,2190,3429,4837,36.0416425818802,7.748117453886108,1408,0,307344,8880,1299,0,782,831
3791,1,0,0,0,42,0,31,0,0,1735566,2836624,36.51027252705737,1273,2695,2635,1333,54750,532000,466032,2068,3461,2188,3430,4823,36.08323710533743,7.750803389552748,1393,0,291927,9660,1302,0,795,826
3792,1,0,0,0,42,0,10,0,0,1721319,2807844,36.29049462324811,1257,2684,2624,1317,53130,539396,447720,2072,3449,2192,3439,4816,36.15245496505044,7.745966692414834,1377,1,276570,10380,1307,0,815,825
3793,1,0,0,0,42,0,71,0,0,1512870,2521450,34.56877203488721,1195,2461,2461,1195,54934,510620,478970,2110,3305,2110,3376,4571,35.58089374931439,0.0,1195,0,271265,0,1266,0,915,844
3794,1,0,0,0,42,0,63,0,0,1483750,2506944,34.45286635390443,1157,2467,2437,1187,51546,511104,449856,2082,3299,2142,3362,4579,35.35533905932738,5.572104574801163,1217,0,252831,4980,1250,0,925,862
3795,1,0,0,0,42,0,42,0,0,1406155,2484945,34.132096331752024,1135,2402,2372,1165,27200,426600,290088,2103,3298,2163,3340,4535,34.741905532080416,5.791460926441345,1195,0,158440,5910,1207,0,968,926
3796,1,0,0,0,43,0,40,1,0,1254000,2492040,33.76388603226827,1016,2364,2240,1140,19380,371620,249204,2062,3326,2310,3286,4550,33.166247903554,12.147713116697057,1264,1,129960,22444,1100,0,1046,1086
3797,1,0,0,0,43,0,74,1,0,1246320,2508796,33.97057550292606,1034,2354,2234,1154,26376,341318,365232,2054,3328,2294,3254,4528,32.863353450309965,11.385019608876545,1274,1,193872,13200,1080,0,1020,1094
3798,1,0,0,0,45,0,541,1,0,1202600,3179400,37.416573867739416,1024,2635,2259,1400,38220,442845,445116,1895,3671,2647,3130,4906,29.30870177950569,19.814465449433133,1776,1,274400,49256,859,0,871,1412
3799,1,0,0,0,44,0,572,1,0,942348,2915308,36.02776706930364,985,2337,2024,1298,36218,408772,446954,1933,3544,2559,2972,4583,26.94438717061496,18.214458107286212,1611,1,258302,34743,726,0,948,1520
3800,1,0,0,0,43,0,607,1,0,724200,2654193,34.741905532080416,1017,1997,1807,1207,49368,448596,532158,2009,3406,2389,2799,4196,24.49489742783178,14.266784873633224,1397,1,292094,15960,600,0,992,1599
3801,1,0,0,0,43,0,620,1,0,648669,2565351,34.249087579087416,1039,1860,1726,1173,56334,500823,538002,2053,3360,2321,2740,4047,23.515952032609693,12.151058826387683,1307,1,288558,13802,553,0,1014,1634
3802,1,0,0,0,43,0,627,0,1,614898,2522124,34.02939905434711,1050,1797,1689,1158,54216,470448,546678,2070,3336,2286,2709,3975,23.043437243605826,10.96830808063325,1266,1,290658,8208,531,0,1020,1647
3803,1,0,0,0,43,0,633,0,1,581278,2472430,33.793490497431605,1057,1736,1651,1142,52118,445990,547745,2080,3307,2250,2674,3901,22.561028345356956,9.692340849365527,1227,1,288926,4930,509,0,1023,1656
3804,1,0,0,0,43,0,640,0,1,550464,2426328,33.58571124749333,1061,1683,1616,1128,52208,447408,539901,2084,3279,2218,2639,3834,22.090722034374522,8.592096094735382,1195,1,283128,4087,488,0,1023,1663
3805,1,0,0,0,42,0,650,0,1,495000,2344100,33.166247903554,1070,1580,1550,1100,54900,479475,519964,2101,3231,2161,2581,3711,21.213203435596427,5.652706486041966,1130,1,268400,2730,450,0,1031,1681
3806,1,0,0,0,42,0,662,0,1,427728,2246104,32.61901286060018,1064,1466,1466,1064,47150,485530,432755,2111,3175,2111,2513,3577,20.049937655763422,0.0,1064,1,218120,0,402,0,1047,1709
3807,1,0,0,0,45,0,514,0,1,388227,2114301,30.512292604784715,931,1348,1348,931,45795,488265,483723,2271,3202,2271,2688,3619,20.42057785666214,0.0,931,1,198303,0,417,0,1340,1854
3808,1,0,0,0,47,0,475,0,1,715356,2630412,33.406586176980134,754,2119,1757,1116,42636,537396,440759,1995,3473,2719,2998,4476,25.317977802344327,19.766343392534317,1478,1,208692,65884,641,0,1241,1716
3809,1,0,0,0,40,0,142,0,0,348984,1072628,22.891046284519195,494,1220,1190,524,38544,448293,360272,2017,2571,2077,2713,3267,25.80697580112788,5.572104574801163,554,0,92224,5460,666,0,1523,1381
3810,1,0,0,0,41,0,152,1,0,287988,962290,21.587033144922902,399,1151,1084,466,27604,425390,276710,1998,2531,2132,2683,3216,24.859605789312106,8.47749576439433,533,1,62444,13802,618,0,1599,1447
3811,1,0,0,0,41,0,163,0,1,135110,605930,17.175564037317667,171,877,753,295,33428,501176,281398,1930,2349,2178,2512,2931,21.400934559032695,11.66442500998483,419,1,40415,28520,458,0,1759,1596
3812,1,0,0,0,42,0,123,0,1,216648,869856,20.199009876724155,166,1181,939,408,31200,511680,277160,1890,2540,2374,2663,3313,23.043437243605826,16.631971814319602,650,1,53040,57112,531,0,1724,1601
3813,0,1,0,1,64,0,1059,0,0,11283030,12678180,62.68971207462992,3863,6868,6801,3930,44688,632296,735528,3159,7156,3293,6097,10094,53.58171329847526,8.230562448445415,3997,1,896040,6231,2871,0,704,355
3814,0,1,0,1,64,0,1015,0,0,11251500,12554100,62.44997998398398,3858,6827,6785,3900,46864,650238,746808,3177,7119,3261,6104,10046,53.71219600798314,6.553889165207866,3942,1,904800,3990,2885,0,681,334
3815,0,1,1,0,63,0,500,0,0,10119981,9272973,54.230987451824994,2899,6424,6382,2941,55200,725190,756720,3111,6094,3195,6594,9577,58.66003750424986,6.5252844928085345,2983,0,705840,4914,3441,1,212,288
3816,0,1,1,0,58,0,538,0,0,218160,795690,16.431676725154983,30,1318,1078,270,33368,571718,506884,2707,3217,3187,3755,4265,28.42534080710379,16.57934006000858,510,1,46440,37200,808,0,2677,2139
3817,0,0,0,0,56,1,1586,1,0,1540880,6371992,47.60252094164762,2158,3054,2946,2266,46736,714248,517408,2704,5078,2920,3492,5866,26.076809620810597,10.92868589650038,2374,1,416944,21492,680,0,546,2132
3818,0,0,0,0,56,1,1533,1,0,1571908,6309992,47.286361670147556,2109,3066,2939,2236,50292,716788,558756,2695,5058,2949,3525,5888,26.514147167125703,11.798511981252409,2363,1,442728,24003,703,0,586,2119
3819,1,0,0,0,46,0,67,1,0,15390,220115,9.746794344808963,133,485,257,95,54960,530593,556080,2089,2412,2545,2479,2802,12.727922061357855,15.314698014350183,323,1,22800,26904,162,0,2222,2155
3820,1,0,0,0,46,0,82,1,0,20520,249480,10.392304845413264,110,516,298,108,53655,505890,565950,2092,2418,2528,2500,2826,13.784048752090222,14.940611189925995,326,1,26460,21582,190,0,2202,2120
3821,1,0,0,0,45,0,102,1,0,48475,399875,13.228756555322953,35,662,452,175,53824,530120,530120,2075,2460,2495,2562,2947,16.64331697709324,14.534640317255622,385,1,40600,27720,277,0,2110,2008
3822,1,0,0,0,46,0,147,0,1,117448,640701,16.64331697709324,67,911,701,277,53105,571311,497295,2103,2590,2523,2737,3224,20.591260281974,14.70048099762127,487,1,59555,35280,424,0,2036,1889
3823,1,0,0,0,45,0,469,1,0,924120,2811528,34.9857113690718,968,2235,1979,1224,19690,411163,252670,2041,3521,2553,3052,4532,27.477263328068172,17.181481884998487,1480,1,134640,50176,755,0,1073,1542
3824,1,0,0,0,42,0,2,0,0,1517823,2644188,35.08560958569767,1201,2494,2464,1231,56608,498336,524112,2118,3379,2178,3381,4642,35.11409973215888,5.531194905403055,1261,1,300364,3180,1233,0,917,915
3825,1,0,0,0,42,0,14,0,0,1577487,2675358,35.34119409414458,1249,2512,2512,1249,56640,514080,505512,2142,3391,2142,3405,4654,35.53871128783372,0.0,1249,1,294764,0,1263,0,893,879
3826,1,0,0,0,42,0,39,0,0,1698732,2751612,35.832945734337834,1284,2607,2607,1284,50600,542179,428600,2143,3427,2143,3466,4750,36.373066958946424,0.0,1284,1,256800,0,1323,0,859,820
3827,1,0,0,0,43,0,19,0,0,1719942,2803206,36.08323710533743,1272,2653,2623,1302,45069,536097,389693,2123,3455,2183,3474,4806,36.345563690772494,5.623413251903491,1332,1,235662,5520,1321,0,851,832
3828,1,0,0,0,42,0,34,0,0,1795311,2889053,36.837480912787726,1327,2710,2680,1357,54492,508831,485412,2099,3486,2159,3452,4839,36.373066958946424,5.478746393072713,1387,0,309396,4320,1323,0,772,806
3829,1,0,0,0,42,0,25,0,0,1740924,2778682,36.15245496505044,1277,2669,2639,1307,49140,497484,446460,2096,3433,2156,3458,4795,36.49657518178932,5.531194905403055,1337,0,274470,4890,1332,0,819,794
3830,1,0,0,0,42,0,85,0,0,1699914,2695632,35.52463933666322,1202,2669,2609,1262,47311,540408,399432,2076,3398,2196,3483,4805,36.701498607005135,7.745966692414834,1322,1,235994,11940,1347,0,874,789
3831,1,0,0,0,42,0,142,0,0,1605320,2546948,34.61213659975356,1168,2568,2538,1198,55552,476224,527248,2096,3324,2156,3466,4694,36.60601043544625,5.5503012171862105,1228,1,297104,2850,1340,0,928,786
3832,1,0,0,0,42,0,130,0,0,1538339,2484647,34.307433596816885,1177,2484,2484,1177,53820,493974,485530,2111,3288,2111,3418,4595,36.15245496505044,0.0,1177,0,270710,0,1307,0,934,804
3833,1,0,0,0,42,0,124,0,0,1506597,2467038,34.161381705077446,1137,2488,2458,1167,48204,494676,435484,2084,3281,2144,3405,4602,35.93048844644336,5.477225575051661,1197,0,240402,4980,1291,0,947,823
3834,1,0,0,0,42,0,112,0,0,1451300,2436850,33.91164991562634,1090,2472,2412,1150,37001,481013,345397,2059,3269,2179,3381,4591,35.52463933666322,7.746504550744806,1210,0,187450,12120,1262,0,969,857
3835,1,0,0,0,43,0,63,1,0,1311178,2428520,33.37663853655727,994,2411,2291,1114,35659,368420,459980,2060,3294,2300,3357,4591,34.307433596816885,11.563730212017028,1234,1,235054,9360,1177,0,1066,1003
3836,1,0,0,0,43,0,14,1,0,1247640,2462684,33.52610922848042,974,2384,2234,1124,28899,370279,374661,2041,3315,2341,3301,4575,33.31666249791537,12.801484421932168,1274,1,192204,18450,1110,0,1067,1081
3837,1,0,0,0,44,0,42,1,0,1292328,2562654,34.02939905434711,966,2466,2274,1158,21840,371784,287690,2021,3371,2405,3329,4679,33.406586176980134,14.666683297304546,1350,1,150540,31488,1116,0,1055,1097
3838,1,0,0,0,44,0,57,1,0,1341310,2658880,34.45286635390443,932,2572,2317,1187,22000,394240,280000,1985,3427,2495,3370,4812,33.61547262794322,17.055901153435933,1442,1,148375,45645,1130,0,1053,1110
3839,1,0,0,0,44,0,62,1,0,1360928,2694302,34.61213659975356,921,2611,2334,1198,22479,398073,285623,1972,3447,2526,3385,4860,33.704599092705436,17.70844157075606,1475,1,152146,49306,1136,0,1051,1113
3840,1,0,0,0,45,0,586,1,0,932232,2937312,36.08323710533743,1025,2295,2018,1302,43095,439920,498576,1979,3558,2533,2972,4551,26.758176320519304,17.374573441565886,1579,1,287742,28254,716,0,954,1540
3841,1,0,0,0,44,0,593,1,0,887244,2886432,35.832945734337834,1029,2230,1975,1284,45630,438360,526032,1993,3532,2503,2939,4478,26.28687885618983,16.68868233948606,1539,1,300456,21675,691,0,964,1557
3842,1,0,0,0,43,0,637,1,0,620208,2522880,34.17601498127012,1101,1766,1699,1168,49335,421200,546480,2093,3328,2227,2691,3926,23.043437243605826,8.694308756644029,1235,1,295504,3417,531,0,992,1629
3843,1,0,0,0,42,0,643,0,1,589694,2473022,33.97057550292606,1112,1707,1665,1154,49784,420028,544322,2101,3297,2185,2654,3850,22.60530911091463,6.7597809605921,1196,1,293116,2100,511,0,989,1632
3844,1,0,0,0,42,0,648,0,1,560880,2427060,33.76388603226827,1110,1662,1632,1140,54216,459864,534379,2099,3269,2159,2621,3791,22.181073012818835,5.5965095842615735,1170,1,286140,2400,492,0,989,1637
3845,1,0,0,0,42,0,653,0,1,534198,2389240,33.57082066318904,1127,1601,1601,1127,55680,491840,508800,2120,3247,2120,2594,3721,21.77154105707724,0.0,1127,1,270480,0,474,0,993,1646
3846,1,0,0,0,42,0,657,0,1,510670,2361570,33.391615714128,1115,1573,1573,1115,51300,482904,476550,2118,3233,2118,2576,3691,21.400934559032695,0.0,1115,1,250875,0,458,0,1003,1660
3847,1,0,0,0,42,0,660,0,1,488629,2333948,33.21144381083123,1103,1546,1546,1103,42336,457056,414736,2116,3219,2116,2559,3662,21.047565179849187,0.0,1103,1,216188,0,443,0,1013,1673
3848,1,0,0,0,43,0,562,1,0,467160,2209320,31.937438845342623,1020,1478,1478,1020,37230,474354,368220,2166,3186,2166,2624,3644,21.400934559032695,0.0,1020,1,173400,0,458,0,1146,1708
3849,1,0,0,0,45,0,538,0,0,416240,2202200,31.11269837220809,938,1428,1398,968,43010,523250,425425,2245,3243,2305,2705,3703,20.73644135332772,5.501408174353464,998,0,181016,5490,430,0,1307,1845
3850,1,0,0,0,41,0,236,1,0,109980,487422,15.297058540778355,6,932,704,234,32110,352027,395770,1855,2317,2311,2553,3015,21.6794833886788,15.980004050314653,462,1,44460,23484,470,0,1849,1613
3851,1,0,0,0,43,0,149,0,1,287672,1006852,21.61018278497431,137,1413,1083,467,55278,536844,478632,1826,2623,2486,2772,3569,24.819347291981714,19.127840843987745,797,1,103674,51810,616,0,1689,1540
3852,0,1,1,0,63,0,226,0,0,10439520,9881040,55.85696017507576,3060,6526,6466,3120,54253,756913,718909,3107,6287,3227,6513,9693,57.844619455918284,7.745966692414834,3180,0,708240,8760,3346,1,47,179
3853,1,0,0,0,45,0,93,1,0,54720,438528,13.856406460551018,12,657,477,192,53820,534456,525320,2104,2476,2464,2569,2941,16.881943016134134,13.466234094236986,372,1,44160,24840,285,0,2092,1999
3854,1,0,0,0,46,0,536,1,0,924180,2945982,35.58089374931439,971,2291,1996,1266,20880,418860,269932,2032,3593,2622,3057,4618,27.018512172212592,18.54794225233281,1561,1,146856,56345,730,0,1061,1597
3855,1,0,0,0,46,0,809,0,1,221400,2372875,32.01562118716424,813,1453,1241,1025,49396,539395,490780,2103,3340,2527,2531,3768,14.696938456699069,15.18899074662917,1237,1,217300,33708,216,0,1290,2099
3856,1,0,0,0,42,0,34,0,0,1495440,2663520,35.21363372331802,1210,2476,2446,1240,55304,479004,532704,2118,3388,2178,3354,4624,34.72751070837067,5.531194905403055,1270,1,307520,2880,1206,0,908,942
3857,1,0,0,0,42,0,20,0,0,1552416,2690352,35.4400902933387,1256,2492,2492,1256,55926,501228,511938,2142,3398,2142,3378,4634,35.156791662493895,0.0,1256,1,300184,0,1236,0,886,906
3858,1,0,0,0,42,0,7,0,0,1611618,2724220,35.679125549822544,1273,2539,2539,1273,54264,509320,487920,2140,3413,2140,3406,4679,35.58089374931439,0.0,1273,0,290244,0,1266,0,867,874
3859,1,0,0,0,42,0,6,0,0,1671840,2758020,35.91656999213594,1260,2616,2586,1290,53325,506706,481050,2108,3428,2168,3434,4754,36.0,5.490867587491313,1320,0,290250,4380,1296,0,848,842
3860,1,0,0,0,42,0,17,0,0,1733100,2792580,36.16628264005025,1308,2633,2633,1308,54858,525210,476105,2135,3443,2135,3460,4768,36.40054944640259,0.0,1308,0,291684,0,1325,0,827,810
3861,1,0,0,0,42,0,25,0,0,1791426,2832336,36.41428291206625,1326,2677,2677,1326,52118,540408,440016,2136,3462,2136,3487,4813,36.75595189897821,0.0,1326,0,273156,0,1351,0,810,785
3862,1,0,0,0,42,0,21,0,0,1802196,2834496,36.49657518178932,1332,2685,2685,1332,45854,483056,429856,2128,3460,2128,3481,4813,36.78314831549904,0.0,1332,0,269064,0,1353,0,796,775
3863,1,0,0,0,42,0,80,0,0,1746084,2733224,35.805027579936315,1282,2644,2644,1282,41109,454116,411476,2132,3414,2132,3494,4776,36.90528417449187,0.0,1282,0,247426,0,1362,0,850,770
3864,1,0,0,0,42,0,100,0,0,1729356,2705442,35.58089374931439,1266,2632,2632,1266,44720,459455,444496,2137,3403,2137,3503,4769,36.959437225152655,0.0,1266,0,263328,0,1366,0,871,771
3865,1,0,0,0,42,0,121,0,0,1713750,2662500,35.35533905932738,1220,2651,2621,1250,50160,485640,468600,2100,3380,2160,3501,4781,37.027017163147235,5.531194905403055,1280,0,275000,4320,1371,0,880,759
3866,1,0,0,0,42,0,142,0,0,1700595,2634255,35.14256678161116,1205,2642,2612,1235,51045,531117,437265,2103,3368,2163,3510,4775,37.107950630558946,5.477225575051661,1265,0,253175,5430,1377,0,898,756
3867,1,0,0,0,42,0,185,0,0,1530284,2423428,33.88214869219483,1148,2481,2481,1148,51788,510862,451754,2111,3259,2111,3444,4592,36.51027252705737,0.0,1148,0,245672,0,1333,0,963,778
3868,1,0,0,0,42,0,179,0,0,1498746,2410284,33.734255586866,1108,2485,2455,1138,46452,501966,415128,2088,3256,2148,3435,4603,36.29049462324811,5.5503012171862105,1168,0,223048,5430,1317,0,980,801
3869,1,0,0,0,42,0,173,0,0,1469958,2391222,33.60059523282288,1069,2491,2431,1129,44121,489258,404538,2058,3247,2178,3420,4609,36.08323710533743,7.754559014766193,1189,0,215639,10740,1302,0,989,816
3870,1,0,0,0,42,0,167,0,0,1443848,2383246,33.481338085566414,1036,2494,2409,1121,35953,486854,333782,2041,3247,2211,3414,4620,35.888716889852724,9.300149152818726,1206,0,175997,17850,1288,0,1005,838
3871,1,0,0,0,44,0,29,1,0,1271046,2474199,33.36165463522455,923,2445,2255,1113,19557,353457,273429,2033,3336,2413,3365,4668,33.793490497431605,14.621386345521588,1303,1,136899,30210,1142,0,1110,1081
3872,1,0,0,0,45,0,123,1,0,1485838,2947318,35.805027579936315,785,2938,2441,1282,35738,491986,383933,1802,3581,2796,3458,5237,34.044089061098404,23.34837829975031,1779,1,214094,91945,1159,0,1017,1140
3873,1,0,0,0,46,0,484,1,0,1336197,3278592,37.72267222772003,1073,2712,2362,1423,39585,449280,467712,1954,3727,2654,3243,5016,30.643106892089126,19.425088661131092,1773,1,288869,43400,939,0,881,1365
3874,1,0,0,0,45,0,582,1,0,1066648,3107192,36.932370625238775,1096,2414,2146,1364,46690,462434,523940,2010,3642,2546,3060,4692,27.964262908219126,17.284213537138605,1632,1,313720,26800,782,0,914,1496
3875,1,0,0,0,44,0,606,0,1,882360,2883150,35.91656999213594,1078,2186,1974,1290,52416,464880,563220,2023,3525,2447,2919,4421,26.153393661244042,15.29629022168207,1502,1,325080,14840,684,0,945,1551
3876,1,0,0,0,43,0,624,0,1,763840,2721800,35.21363372331802,1106,1990,1856,1240,50796,447780,546555,2061,3435,2329,2811,4185,24.819347291981714,12.276872470465587,1374,1,308760,9648,616,0,955,1579
3877,1,0,0,0,43,0,630,0,1,727056,2676888,34.9857113690718,1116,1926,1818,1224,52208,454896,548937,2079,3411,2295,2781,4113,24.372115213907882,11.137157851700797,1332,1,307224,7884,594,0,963,1593
3878,1,0,0,0,42,0,647,0,1,630654,2527340,34.36568055487916,1151,1745,1715,1181,49530,417300,543560,2110,3321,2170,2674,3885,23.108440016582687,5.791460926441345,1211,1,299974,1440,534,0,959,1606
3879,1,0,0,0,42,0,651,0,1,602172,2479875,34.161381705077446,1167,1683,1683,1167,54093,465375,524875,2125,3292,2125,2641,3808,22.715633383201094,0.0,1167,1,288249,0,516,0,958,1609
3880,1,0,0,0,42,0,661,0,1,531570,2405637,33.63034344160047,1101,1631,1601,1131,31600,425400,336066,2097,3258,2157,2597,3758,21.6794833886788,5.5965095842615735,1161,1,178698,5310,470,0,996,1657
3881,1,0,0,0,46,0,807,0,1,146880,2232960,30.983866769659336,726,1347,1113,960,38502,432636,481482,2092,3286,2560,2479,3673,12.36931687685298,15.337129764299183,1194,1,198720,24804,153,0,1366,2173
3882,1,0,0,0,46,0,798,0,1,155520,2226240,30.983866769659336,748,1334,1122,960,40018,433653,496266,2107,3279,2531,2481,3653,12.727922061357855,14.583569918441016,1172,1,205440,20988,162,0,1359,2157
3883,1,0,0,0,45,0,600,0,1,386100,2257200,31.464265445104548,990,1380,1380,990,48351,485640,517560,2280,3270,2280,2670,3660,19.748417658131498,0.0,990,1,224730,0,390,0,1290,1890
3884,1,0,0,0,45,0,579,0,0,416746,2272163,31.575306807693888,967,1445,1415,997,46060,535565,446684,2249,3276,2309,2697,3724,20.445048300260872,5.514871952411144,1027,0,195412,5370,418,0,1282,1861
3885,1,0,0,0,41,0,157,0,0,413094,1171571,23.853720883753127,569,1295,1295,569,38454,455039,358266,2059,2628,2059,2785,3354,26.94438717061496,0.0,569,0,99006,0,726,0,1490,1333
3886,0,1,0,1,64,0,873,0,0,11393280,12322560,61.96773353931867,3798,6849,6807,3840,46367,638591,747697,3167,7049,3251,6176,10058,54.47017532558529,6.553889165207866,3882,1,894720,3864,2967,0,631,242
3887,0,0,0,0,56,1,960,1,0,1624644,5211018,42.91852746774987,1547,3019,2724,1842,53261,625209,681789,2534,4671,3124,3711,5848,29.698484809834994,17.43267074223099,2137,1,443922,31565,882,0,987,1947
3888,0,0,0,0,55,1,1539,1,0,1629460,6312180,47.53945729601885,2193,3048,2981,2260,43516,706629,480396,2726,5053,2860,3514,5841,26.851443164195103,8.521468497772455,2327,1,388720,14070,721,0,533,2072
3889,0,0,1,0,59,1,1099,0,0,452342,952215,17.86057109949175,0,2056,1737,319,50635,737295,611925,2666,3304,3304,4403,5041,37.656340767525464,17.96500438447109,638,1,65395,57420,1418,0,2666,1567
3890,1,0,0,0,45,0,127,0,1,157974,778005,18.411952639521967,186,958,805,339,56640,550800,541620,2142,2634,2448,2761,3253,21.587033144922902,12.585635951884552,492,1,80004,19584,466,0,1956,1829
3891,1,0,0,0,43,0,508,0,0,542325,2246775,32.14031735997639,1033,1558,1558,1033,43650,489375,421950,2175,3208,2175,2700,3733,22.9128784747792,0.0,1033,0,200402,0,525,0,1142,1650
3892,1,0,0,0,47,0,642,0,1,778680,2962260,35.4964786985977,842,2296,1878,1260,44517,491359,500763,1933,3611,2769,2969,4647,24.859605789312106,21.44730650540546,1678,1,268380,53922,618,0,1091,1733
3893,1,0,0,0,43,0,251,0,0,885800,2318775,32.78719262151,1075,1899,1899,1075,54467,541407,468069,2157,3232,2157,2981,4056,28.705400188814647,0.0,1075,0,233275,0,824,0,1082,1333
3894,1,0,0,0,43,0,234,0,0,927211,2347920,32.96968304366907,1087,1940,1940,1087,51156,544320,438480,2160,3247,2160,3013,4100,29.206163733020468,0.0,1087,0,220661,0,853,0,1073,1307
3895,1,0,0,0,43,0,217,0,0,971300,2385900,33.166247903554,1100,1983,1983,1100,47918,535743,420786,2169,3269,2169,3052,4152,29.715315916207253,0.0,1100,1,213400,0,883,0,1069,1286
3896,1,0,0,0,42,0,57,0,0,1530594,2715570,35.58089374931439,1266,2475,2475,1266,53724,476190,519090,2145,3411,2145,3354,4620,34.77067730142742,0.0,1266,1,306372,0,1209,0,879,936
3897,1,0,0,0,42,0,29,0,0,1647162,2776422,36.02776706930364,1268,2597,2567,1298,46350,481275,440634,2109,3437,2169,3408,4736,35.62302626111375,5.483301264452448,1328,0,267388,4740,1269,0,841,870
3898,1,0,0,0,42,0,12,0,0,1887840,2917944,36.98648401781386,1338,2778,2748,1368,50344,528984,432999,2103,3501,2163,3513,4911,37.14835124201342,5.483301264452448,1398,0,277704,5460,1380,0,765,753
3899,1,0,0,0,42,0,55,0,0,1831206,2831010,36.41428291206625,1326,2707,2707,1326,39246,450485,397110,2135,3461,2135,3516,4842,37.16180835212409,0.0,1326,0,246636,0,1381,0,809,754
3900,1,0,0,0,42,0,75,0,0,1808964,2797812,36.16628264005025,1308,2691,2691,1308,31395,417105,344379,2139,3447,2139,3522,4830,37.1887079635741,0.0,1308,0,210588,0,1383,0,831,756
3901,1,0,0,0,42,0,177,0,0,1714824,2610792,34.9857113690718,1224,2625,2625,1224,44000,426600,469260,2133,3357,2133,3534,4758,37.429934544425805,0.0,1224,0,269280,0,1401,0,909,732
3902,1,0,0,0,42,0,197,0,0,1699854,2575170,34.77067730142742,1209,2615,2615,1209,50609,487770,470730,2130,3339,2130,3536,4745,37.49666651850535,0.0,1209,0,267189,0,1406,0,921,724
3903,1,0,0,0,42,0,217,0,0,1687340,2544155,34.56877203488721,1195,2607,2607,1195,54466,513089,481154,2129,3324,2129,3541,4736,37.57658845611187,0.0,1195,0,270070,0,1412,0,934,717
3904,1,0,0,0,42,0,238,0,0,1675839,2513168,34.36568055487916,1151,2630,2600,1181,55370,521360,480928,2098,3309,2158,3547,4758,37.66961640367472,5.477225575051661,1211,0,266906,4530,1419,0,947,709
3905,1,0,0,0,42,0,251,0,0,1623930,2450910,33.98529093593286,1125,2591,2561,1155,55822,479572,524134,2092,3277,2152,3528,4713,37.49666651850535,5.5503012171862105,1185,0,285285,2970,1406,0,967,716
3906,1,0,0,0,42,0,248,0,0,1587380,2415330,33.793490497431605,1142,2532,2532,1142,56364,488565,516060,2115,3257,2115,3505,4647,37.282703764614496,0.0,1142,0,278648,0,1390,0,973,725
3907,1,0,0,0,42,0,238,0,0,1520960,2363200,33.46640106136302,1120,2478,2478,1120,46754,508510,409340,2110,3230,2110,3468,4588,36.851051545376556,0.0,1120,0,217280,0,1358,0,990,752
3908,1,0,0,0,42,0,233,0,0,1490730,2352090,33.31666249791537,1080,2483,2453,1110,44132,500084,396253,2089,3229,2149,3462,4602,36.64696440361739,5.572104574801163,1140,0,207570,5670,1343,0,1009,776
3909,1,0,0,0,42,0,223,0,0,1435980,2325960,33.04542328371661,1025,2474,2407,1092,39746,506940,355710,2063,3222,2197,3445,4604,36.26292872893749,8.20171446926608,1159,0,182364,14003,1315,0,1038,815
3910,1,0,0,0,45,0,2,1,0,1500624,2809080,34.9857113690718,766,2908,2450,1224,30906,463590,351135,1837,3519,2753,3521,5203,35.014282800023196,22.41888060723641,1682,1,187272,84272,1226,0,1071,1069
3911,1,0,0,0,46,0,445,0,1,1332294,3232176,37.389838191679836,1074,2675,2351,1398,49268,504016,522512,1988,3710,2636,3265,4987,30.870698080866262,18.88435448052062,1722,1,315948,40500,953,0,914,1359
3912,1,0,0,0,46,0,534,1,0,1290600,3305370,37.86819245752297,1139,2629,2334,1434,51959,514015,537065,2010,3739,2600,3205,4934,30.0,18.09412369100395,1729,1,334122,35990,900,0,871,1405
3913,1,0,0,0,45,0,570,0,1,1264375,3322055,38.01315561749642,1162,2603,2320,1445,52598,508079,547162,2016,3744,2582,3174,4902,29.58039891549808,17.78146024076311,1728,1,343910,31413,875,0,854,1424
3914,1,0,0,0,44,0,606,0,1,967032,2982348,36.49657518178932,1120,2270,2058,1332,52070,458995,568706,2027,3571,2451,2965,4509,26.94438717061496,15.29629022168207,1544,1,338328,12720,726,0,907,1513
3915,1,0,0,0,44,0,624,0,1,843556,2826810,35.805027579936315,1132,2090,1940,1282,52371,456435,557865,2055,3487,2355,2863,4295,25.65151067676132,12.950100320556757,1432,1,324346,9600,658,0,923,1547
3916,1,0,0,0,43,0,640,0,1,734825,2671305,35.14256678161116,1168,1897,1830,1235,51359,439089,547239,2096,3398,2230,2758,4060,24.392621835300936,8.748575453901612,1302,1,312455,3618,595,0,928,1568
3917,1,0,0,0,42,0,645,0,1,703296,2621487,34.942810419312295,1179,1839,1797,1221,50546,427253,545338,2105,3368,2189,2723,3986,24.0,6.852548980306203,1263,1,310134,2016,576,0,926,1571
3918,1,0,0,0,42,0,649,0,1,673506,2573324,34.741905532080416,1177,1795,1765,1207,52877,445588,539396,2102,3339,2162,2690,3927,23.62202362203543,5.5503012171862105,1237,1,305371,2070,558,0,925,1574
3919,1,0,0,0,44,0,506,1,0,623232,2380400,32.89376840679705,1082,1658,1658,1082,32472,435600,360800,2200,3282,2200,2776,3858,24.0,0.0,1082,1,177448,0,576,0,1118,1624
3920,1,0,0,0,44,0,454,0,0,693240,2413260,33.015148038438355,1090,1726,1726,1090,42823,507006,414018,2214,3304,2214,2850,3940,25.219040425836983,0.0,1090,1,203830,0,636,0,1124,1578
3921,1,0,0,0,44,0,483,0,0,670140,2426520,33.090784215548595,1095,1707,1707,1095,45840,531840,423256,2216,3311,2216,2828,3923,24.73863375370596,0.0,1095,1,209145,0,612,0,1121,1604
3922,1,0,0,0,41,0,161,0,1,466176,1249206,24.63736998950984,607,1375,1375,607,46000,473340,411600,2058,2665,2058,2826,3433,27.712812921102035,0.0,607,1,121400,0,768,0,1451,1290
3923,1,0,0,0,41,0,182,1,0,337463,1039227,22.293496809607955,402,1271,1176,497,27880,428655,284376,1996,2588,2186,2770,3362,26.057628441590765,10.36120421417894,592,1,67592,19285,679,0,1594,1412
3924,1,0,0,0,42,0,267,1,0,112860,480396,15.0996688705415,38,913,723,228,29666,343441,383474,1917,2335,2297,2602,3020,22.24859546128699,14.902762265604592,418,1,41496,19570,495,0,1879,1612
3925,1,0,0,0,40,0,256,1,0,110352,464436,15.0996688705415,198,742,712,228,34565,315735,454251,2007,2265,2067,2521,2779,22.0,5.8721273231371045,258,1,50844,1230,484,0,1809,1553
3926,0,1,1,0,63,0,208,0,0,10985040,10858500,58.48076606885378,3420,6632,6632,3420,54253,758825,720725,3175,6595,3175,6387,9807,56.674509261219015,0.0,3420,0,776340,0,3212,1,245,37
3927,0,1,1,0,61,0,1934,0,0,4158960,3949980,35.91656999213594,873,4931,4514,1290,56640,734880,722632,2645,4352,3479,6286,7993,56.78027826631356,20.988436624793316,1707,1,304440,52542,3224,0,1772,162
3928,0,1,1,0,57,0,1939,0,0,527802,693330,15.556349186104045,242,2423,2423,242,49946,633165,647490,2865,3107,2865,5046,5288,46.70117771534247,0.0,242,0,54692,0,2181,1,2623,684
3929,0,0,1,0,56,1,1049,0,0,1622406,5354130,43.61192497471305,1674,2983,2755,1902,53460,619300,684045,2587,4717,3043,3668,5798,29.206163733020468,15.362912062053013,2130,1,462186,23712,853,0,913,1962
3930,0,0,1,0,55,1,1214,0,0,1511192,5512686,44.474711915874174,1851,2869,2742,1978,54208,624288,674454,2660,4765,2914,3551,5656,27.640549922170507,11.466142793898168,2105,1,478676,13843,764,0,809,2023
3931,1,0,0,0,45,0,75,1,0,72306,533286,15.297058540778355,114,663,543,234,55440,546960,526449,2159,2513,2399,2588,2942,17.578395831246947,11.009004714545675,354,1,54054,16800,309,0,2045,1970
3932,1,0,0,0,45,0,107,0,1,151194,775971,18.411952639521967,219,905,785,339,56640,549360,540204,2169,2628,2409,2735,3194,21.118712081942874,11.180339887498949,459,1,80004,14880,446,0,1950,1843
3933,1,0,0,0,43,0,396,0,1,342720,1788672,28.5657137141714,816,1236,1236,816,56635,528272,515120,2192,3008,2192,2612,3428,20.493901531919196,0.0,816,1,191760,0,420,0,1376,1772
3934,1,0,0,0,43,0,420,0,1,354061,1842631,29.0,841,1262,1262,841,54718,549941,477638,2191,3032,2191,2612,3453,20.518284528683193,0.0,841,1,183338,0,421,0,1350,1770
3935,1,0,0,0,46,0,777,0,1,394450,2616894,33.57082066318904,842,1762,1477,1127,45938,478332,517806,2037,3449,2607,2672,4084,18.708286933869708,17.360256321981996,1412,1,251321,32205,350,0,1195,1972
3936,1,0,0,0,43,0,256,0,0,957785,2405055,33.391615714128,1085,2004,1974,1115,48124,489639,457284,2127,3272,2187,3016,4161,29.30870177950569,5.477225575051661,1145,0,236380,4560,859,0,1042,1298
3937,1,0,0,0,43,0,222,0,0,1046520,2455560,33.76388603226827,1140,2058,2058,1140,54500,538500,469572,2154,3294,2154,3072,4212,30.298514815086232,0.0,1140,0,248520,0,918,0,1014,1236
3938,1,0,0,0,42,0,92,0,0,1510784,2742124,35.7211421989835,1246,2490,2460,1276,53352,464184,530803,2119,3425,2179,3333,4639,34.40930106817051,5.501408174353464,1306,1,315172,2700,1184,0,873,965
3939,1,0,0,0,42,0,78,0,0,1565983,2767904,35.93048844644336,1291,2504,2504,1291,48600,482400,463104,2144,3435,2144,3357,4648,34.828149534535996,0.0,1291,0,278856,0,1213,0,853,931
3940,1,0,0,0,43,0,50,0,0,1684179,2844450,36.373066958946424,1281,2638,2596,1323,31042,402050,356900,2108,3473,2192,3423,4788,35.679125549822544,6.609134537568676,1365,0,219618,6384,1273,0,827,877
3941,1,0,0,0,42,0,69,0,0,1890810,2871081,36.61966684720111,1311,2781,2751,1341,45770,492430,426059,2111,3482,2171,3551,4922,37.54996671103717,5.531194905403055,1371,0,266859,5130,1410,0,800,731
3942,1,0,0,0,42,0,294,0,0,1670992,2455712,33.97057550292606,1154,2602,2602,1154,47957,470288,461776,2128,3282,2128,3576,4730,38.05259518088089,0.0,1154,0,250418,0,1448,0,974,680
3943,1,0,0,0,42,0,308,0,0,1650720,2423640,33.76388603226827,1140,2588,2588,1140,51040,467720,493232,2126,3266,2126,3574,4714,38.05259518088089,0.0,1140,0,264480,0,1448,0,986,678
3944,1,0,0,0,42,0,304,0,0,1612737,2385859,33.57082066318904,1097,2588,2558,1127,51273,446687,514431,2087,3244,2147,3548,4705,37.82856063875548,5.483301264452448,1157,0,273861,2760,1431,0,990,686
3945,1,0,0,0,42,0,292,0,0,1511328,2310672,33.04542328371661,1092,2476,2476,1092,39444,482448,366068,2116,3208,2116,3500,4592,37.20215047547655,0.0,1092,0,188916,0,1384,0,1024,732
3946,1,0,0,0,42,0,288,0,0,1482340,2298168,32.89376840679705,1082,2452,2452,1082,42594,486396,395064,2124,3206,2124,3494,4576,37.013511046643494,0.0,1082,0,201252,0,1370,0,1042,754
3947,1,0,0,0,42,0,283,0,0,1452560,2278000,32.7414110874898,1042,2457,2427,1072,47436,501500,427125,2095,3197,2155,3480,4582,36.810324638611924,5.478746393072713,1102,0,215472,5250,1355,0,1053,770
3948,1,0,0,0,42,0,279,0,0,1426546,2265253,32.60368077380221,1003,2465,2405,1063,43676,519964,381449,2071,3194,2191,3473,4596,36.6333181680284,7.772191019407321,1123,0,190277,12240,1342,0,1068,789
3949,1,0,0,0,44,0,238,0,0,1292288,2272256,32.0,823,2487,2286,1024,35530,414953,421610,2018,3243,2420,3481,4706,35.52463933666322,14.953861635389433,1225,1,194560,25527,1262,0,1195,957
3950,1,0,0,0,44,0,217,1,0,1261740,2256240,31.937438845342623,802,2475,2257,1020,27792,426916,318528,1994,3232,2430,3449,4687,35.17101079013795,15.369802188941781,1238,1,146880,39676,1237,0,1192,975
3951,1,0,0,0,46,0,103,1,0,1386210,2598862,33.57082066318904,766,2718,2357,1127,29640,438140,359736,1945,3433,2667,3536,5024,35.07135583350036,20.279402834158383,1488,1,175812,59926,1230,0,1179,1076
3952,1,0,0,0,46,0,320,0,1,1366800,3119520,36.60601043544625,1001,2699,2360,1340,49880,500520,540096,1989,3668,2667,3348,5027,31.937438845342623,19.201785255365955,1679,1,310880,38307,1020,0,988,1308
3953,1,0,0,0,46,0,407,0,1,1328658,3173940,37.067505985701274,1074,2641,2341,1374,54675,519750,561330,2010,3684,2610,3277,4951,31.096623610932426,18.049223303503535,1674,1,333882,32400,967,0,936,1343
3954,1,0,0,0,46,0,450,0,1,1311264,3207168,37.30951621235526,1109,2617,2334,1392,56153,536832,555264,2021,3696,2587,3246,4921,30.692018506445613,17.78146024076311,1675,1,335472,33394,942,0,912,1362
3955,1,0,0,0,45,0,539,0,1,1271810,3275268,37.8021163428716,1173,2575,2319,1429,56334,524868,563832,2036,3721,2548,3182,4867,29.832867780352597,16.93119340372407,1685,1,351534,26624,890,0,863,1402
3956,1,0,0,0,45,0,583,0,1,1252520,3308680,38.05259518088089,1206,2555,2313,1448,56334,523265,562110,2043,3733,2527,3150,4840,29.410882339705484,16.531793648723664,1690,1,356208,24684,865,0,837,1420
3957,1,0,0,0,45,0,594,0,1,1150560,3199290,37.54996671103717,1194,2442,2226,1410,55250,501449,567250,2053,3679,2485,3085,4711,28.5657137141714,15.58370323973298,1626,1,352500,18360,816,0,859,1453
3958,1,0,0,0,45,0,600,0,1,1102464,3144528,37.30951621235526,1191,2385,2184,1392,53676,481167,569268,2058,3651,2460,3051,4644,28.142494558940577,14.998296005958716,1593,1,350784,14673,792,0,867,1467
3959,1,0,0,0,44,0,606,0,1,1055232,3086004,37.067505985701274,1184,2332,2142,1374,51816,458184,570484,2056,3620,2436,3014,4578,27.712812921102035,14.652955522209124,1564,1,348996,11210,768,0,872,1478
3960,1,0,0,0,44,0,623,0,1,926100,2917215,36.373066958946424,1173,2173,2023,1323,53928,471870,555660,2055,3528,2355,2905,4378,26.457513110645905,12.849476832533073,1473,1,333396,10950,700,0,882,1505
3961,1,0,0,0,43,0,628,0,1,887453,2867558,36.15245496505044,1180,2113,1986,1307,52668,458546,552888,2067,3501,2321,2873,4307,26.057628441590765,11.81597791836795,1434,1,329364,8128,679,0,887,1515
3962,1,0,0,0,43,0,633,0,1,849478,2815671,35.93048844644336,1183,2057,1949,1291,51612,444924,551793,2073,3472,2289,2839,4238,25.65151067676132,10.92868589650038,1399,1,326623,6048,658,0,890,1523
3963,1,0,0,0,43,0,650,1,0,542400,2453230,33.61547262794322,1130,1610,1610,1130,36984,436371,399464,2171,3301,2171,2651,3781,21.908902300206645,0.0,1130,1,207920,0,480,0,1041,1691
3964,1,0,0,0,44,0,517,1,0,682268,2503148,33.52610922848042,1124,1731,1731,1124,32760,434265,374136,2227,3351,2227,2834,3958,24.63736998950984,0.0,1124,1,188832,0,607,0,1103,1620
3965,1,0,0,0,44,0,553,1,0,652010,2521030,33.61547262794322,1130,1707,1707,1130,36285,457355,394887,2231,3361,2231,2808,3938,24.020824298928627,0.0,1130,1,200010,0,577,0,1101,1654
3966,1,0,0,0,44,0,589,1,0,621392,2533280,33.704599092705436,1136,1683,1683,1136,41769,492830,421470,2230,3366,2230,2777,3913,23.388031127053,0.0,1136,1,214704,0,547,0,1094,1683
3967,1,0,0,0,45,0,703,0,0,441200,2491677,33.21144381083123,1073,1533,1503,1103,50148,569268,449541,2229,3362,2289,2659,3792,20.0,5.514871952411144,1133,1,219497,5640,400,0,1156,1859
3968,1,0,0,0,46,0,840,0,1,209241,2435940,32.264531609803356,933,1350,1242,1041,30989,545220,311220,2232,3381,2448,2541,3690,14.177446878757825,10.799029488658043,1149,1,138453,25056,201,0,1299,2139
3969,1,0,0,0,45,0,677,0,0,388808,2389440,32.37282811247729,1048,1419,1419,1048,47897,517560,481080,2280,3328,2280,2651,3699,19.261360284258224,0.0,1048,0,221128,0,371,0,1232,1909
3970,1,0,0,0,41,0,165,0,1,523906,1329468,25.41653005427767,646,1457,1457,646,49450,473340,442470,2058,2704,2058,2869,3515,28.478061731796284,0.0,646,1,138890,0,811,0,1412,1247
3971,1,0,0,0,41,0,169,0,0,486366,1274934,24.859605789312106,618,1405,1405,618,38850,457986,361025,2063,2681,2063,2850,3468,28.053520278211074,0.0,618,0,108150,0,787,0,1445,1276
3972,1,0,0,0,42,0,252,1,0,165600,642000,17.320508075688775,66,1086,852,300,30589,361660,387340,1906,2440,2374,2692,3226,23.49468024894146,15.66595306375429,534,1,54300,26208,552,0,1840,1588
3973,1,0,0,0,42,0,264,1,0,142576,570036,16.3707055437449,76,992,800,268,33293,359463,419019,1935,2395,2319,2659,3119,23.065125189341593,14.319779673152123,460,1,52796,18240,532,0,1859,1595
3974,1,0,0,0,40,0,222,1,0,172579,651717,17.86057109949175,252,927,860,319,28906,396342,304407,1976,2362,2110,2584,2970,23.259406699226016,8.804782210438667,386,1,47531,11926,541,0,1724,1502
3975,1,0,0,0,41,0,174,0,1,262831,897176,20.808652046684813,221,1252,1040,433,40500,518000,335664,1860,2505,2284,2679,3324,24.63736998950984,14.984791701209256,645,1,70146,46216,607,0,1639,1465
3976,0,0,1,0,55,1,1295,0,0,1519800,5648760,45.16635916254486,1973,2852,2785,2040,54612,614718,681174,2702,4809,2836,3514,5621,27.294688127912362,8.345174736691893,2107,1,501840,6633,745,0,729,2024
3977,0,0,1,0,55,1,1821,0,0,1587460,6842840,49.64876634922564,2380,3194,3109,2465,36480,532992,527440,2691,5241,2861,3420,5970,25.37715508089904,9.460074866898333,2550,1,468350,11390,644,0,311,2132
3978,1,0,0,0,45,0,79,1,0,111672,676863,17.233687939614086,207,763,673,297,52371,576587,471753,2189,2576,2369,2655,3042,19.390719429665317,9.570344002193607,387,1,61479,15930,376,0,1982,1903
3979,1,0,0,0,43,0,392,0,0,310865,1729826,28.053520278211074,787,1182,1182,787,55902,507738,531916,2198,2985,2198,2593,3380,19.87460691435179,0.0,787,0,190454,0,395,0,1411,1803
3980,1,0,0,0,43,0,487,0,0,348390,1928934,29.698484809834994,882,1277,1277,882,52731,531441,474579,2187,3069,2187,2582,3464,19.87460691435179,0.0,882,0,191394,0,395,0,1305,1792
3981,1,0,0,0,43,0,524,0,1,380256,2049468,30.528675044947494,932,1340,1340,932,53535,547551,472785,2199,3131,2199,2607,3539,20.199009876724155,0.0,932,1,200380,0,408,0,1267,1791
3982,1,0,0,0,43,0,331,0,0,864690,2396490,33.31666249791537,1110,1889,1889,1110,47355,498729,442595,2159,3269,2159,2938,4048,27.910571473905726,0.0,1110,0,227550,0,779,0,1049,1380
3983,1,0,0,0,43,0,294,0,0,946647,2457663,33.63034344160047,1101,1998,1968,1131,28731,397659,341161,2143,3304,2203,3010,4171,28.930952282978865,5.8721273231371045,1161,0,177567,4710,837,0,1042,1336
3984,1,0,0,0,43,0,243,0,0,1078308,2511384,34.161381705077446,1167,2091,2091,1167,46830,451920,479896,2152,3319,2152,3076,4243,30.397368307141328,0.0,1167,0,260241,0,924,0,985,1228
3985,1,0,0,0,42,0,228,0,0,1125493,2535607,34.36568055487916,1181,2134,2134,1181,52948,523868,465899,2147,3328,2147,3100,4281,30.870698080866262,0.0,1181,0,256277,0,953,0,966,1194
3986,1,0,0,0,43,0,212,0,0,1174685,2574030,34.56877203488721,1165,2208,2178,1195,48768,547116,413568,2124,3349,2184,3137,4362,31.352830813181765,5.5503012171862105,1225,0,229440,5760,983,0,959,1171
3987,1,0,0,0,43,0,197,0,0,1223508,2618694,34.77067730142742,1179,2251,2221,1209,47628,545832,409374,2136,3375,2196,3178,4417,31.811947441173732,5.7180036243905645,1239,1,228501,5490,1012,0,957,1154
3988,1,0,0,0,43,0,99,0,0,1604106,2832867,36.29049462324811,1317,2535,2535,1317,33280,447408,344160,2151,3468,2151,3369,4686,34.899856733230294,0.0,1317,0,210720,0,1218,0,834,933
3989,1,0,0,0,43,0,244,1,0,1751357,2636088,34.741905532080416,1140,2725,2658,1207,25230,316680,380016,2117,3391,2251,3635,4909,38.09199390948182,8.862806978978044,1274,1,210018,5762,1451,0,977,733
3990,1,0,0,0,42,0,349,0,0,1666056,2410536,33.58571124749333,1098,2635,2605,1128,38367,403893,433811,2107,3265,2167,3614,4772,38.43175770115127,5.5503012171862105,1158,0,228984,3450,1477,0,1009,660
3991,1,0,0,0,42,0,356,0,0,1601600,2335300,33.166247903554,1100,2556,2556,1100,40480,390632,467060,2123,3223,2123,3579,4679,38.157568056677825,0.0,1100,0,242000,0,1456,0,1023,667
3992,1,0,0,0,42,0,350,0,0,1531875,2273625,32.78719262151,1045,2530,2500,1075,36714,446265,368010,2085,3190,2145,3540,4645,37.749172176353746,5.572104574801163,1105,0,187050,5250,1425,0,1040,690
3993,1,0,0,0,42,0,343,0,0,1469988,2242890,32.449961479175904,1053,2449,2449,1053,42240,468600,408960,2130,3183,2130,3526,4579,37.36308338453881,0.0,1053,0,202176,0,1396,0,1077,734
3994,1,0,0,0,42,0,338,0,0,1442808,2221632,32.31098884280702,1014,2456,2426,1044,47897,483056,449008,2098,3172,2158,3510,4584,37.17526059088221,5.501408174353464,1074,0,220284,4590,1382,0,1084,746
3995,1,0,0,0,42,0,335,0,0,1415546,2201386,32.155870381627054,992,2445,2403,1034,45684,517347,400252,2087,3163,2171,3498,4574,37.0,6.484411467763075,1076,0,194392,8148,1369,0,1095,760
3996,1,0,0,0,44,0,276,1,0,1253340,2202750,31.464265445104548,743,2503,2256,990,32640,453900,356000,1978,3215,2472,3491,4728,35.58089374931439,16.455853837162117,1237,1,158400,44460,1266,0,1235,959
3997,1,0,0,0,45,0,236,1,0,1229301,2261196,31.575306807693888,725,2502,2230,997,27873,369684,387828,1996,3265,2540,3501,4770,35.11409973215888,17.52996087126343,1269,1,170487,31552,1233,0,1271,1035
3998,1,0,0,0,46,0,102,0,1,1415880,2888892,35.24202037341219,838,2786,2382,1242,49815,565218,476830,1922,3568,2730,3466,5112,33.76388603226827,20.701728128471295,1646,1,254610,71508,1140,0,1084,1186
3999,1,0,0,0,46,0,192,0,1,1390273,2982628,35.76310948449533,918,2727,2366,1279,52030,564344,501380,1971,3611,2693,3419,5059,32.96968304366907,19.714474891528628,1640,1,274985,59565,1087,0,1053,1245
4000,1,0,0,0,46,0,324,0,1,1342656,3083580,36.49657518178932,1035,2637,2340,1332,54250,502355,578750,2018,3647,2612,3323,4952,31.74901573277509,18.028097721592022,1629,1,333000,24948,1008,0,983,1307
4001,1,0,0,0,45,0,499,0,1,1275242,3212710,37.49666651850535,1178,2541,2313,1406,56105,523265,559825,2057,3691,2513,3192,4826,30.116440692751194,16.080686432944365,1634,1,344470,23028,907,0,879,1378
4002,1,0,0,0,45,0,543,0,1,1256850,3243300,37.749172176353746,1209,2523,2307,1425,55822,514376,562172,2060,3701,2492,3158,4799,29.698484809834994,15.613213470166164,1641,1,351975,20520,882,0,851,1394
4003,1,0,0,0,45,0,587,0,1,1239810,3277260,38.01315561749642,1244,2504,2303,1445,55575,510300,560196,2067,3713,2469,3126,4772,29.29163703175362,15.137072600615454,1646,1,356915,18492,858,0,823,1410
4004,1,0,0,0,45,0,600,0,1,1195956,3239406,37.86819245752297,1244,2458,2268,1434,55029,499239,562491,2069,3693,2449,3093,4717,28.879058156387302,14.66890151299732,1624,1,357066,15960,834,0,825,1425
4005,1,0,0,0,44,0,605,0,1,1148376,3184584,37.62977544445356,1241,2402,2227,1416,54250,488033,562250,2074,3665,2424,3060,4651,28.478061731796284,14.044430898063302,1591,1,354000,13650,811,0,833,1438
4006,1,0,0,0,44,0,616,0,1,1056465,3072725,37.16180835212409,1228,2299,2146,1381,52118,458350,562925,2072,3606,2378,2990,4524,27.65863337187866,13.122185548803433,1534,1,349393,9945,765,0,844,1460
4007,1,0,0,0,43,0,627,0,1,971908,2962904,36.71511950137164,1221,2196,2069,1348,50953,446194,551698,2071,3546,2325,2919,4394,26.851443164195103,11.81597791836795,1475,1,338348,8382,721,0,850,1477
4008,1,0,0,0,43,0,633,0,1,933100,2911272,36.51027252705737,1225,2141,2033,1333,50600,436800,552552,2076,3517,2292,2884,4325,26.457513110645905,10.871351968433055,1441,1,337249,6264,700,0,851,1484
4009,1,0,0,0,43,0,637,0,1,895560,2859207,36.29049462324811,1232,2082,1997,1317,50800,434200,551434,2086,3488,2256,2851,4253,26.076809620810597,9.587694277262452,1402,1,334518,4675,680,0,854,1491
4010,1,0,0,0,42,0,651,0,1,795600,2718300,35.70714214271425,1245,1929,1899,1275,53874,466908,524472,2102,3407,2162,2756,4061,24.979991993593593,5.531194905403055,1305,1,313650,2910,624,0,857,1508
4011,1,0,0,0,45,0,701,1,0,524370,2598750,33.98529093593286,1155,1609,1609,1155,43659,519750,425250,2250,3405,2250,2704,3859,21.307275752662516,0.0,1155,1,218295,0,454,0,1095,1796
4012,1,0,0,0,45,0,718,0,0,484208,2574068,33.793490497431605,1142,1566,1566,1142,42550,518420,416990,2254,3396,2254,2678,3820,20.591260281974,0.0,1142,1,211270,0,424,0,1112,1830
4013,1,0,0,0,45,0,736,0,0,446745,2556060,33.63034344160047,1131,1526,1526,1131,42735,522060,418100,2260,3391,2260,2655,3786,19.87460691435179,0.0,1131,1,209235,0,395,0,1129,1865
4014,1,0,0,0,45,0,755,0,0,408800,2535680,33.46640106136302,1120,1485,1485,1120,43848,525248,427896,2264,3384,2264,2629,3749,19.1049731745428,0.0,1120,1,211680,0,365,0,1144,1899
4015,1,0,0,0,47,0,949,0,1,114156,2505090,32.51153641401772,895,1327,1165,1057,54750,592500,519030,2208,3427,2532,2478,3697,10.392304845413264,13.254920366232327,1219,1,231483,26082,108,0,1313,2262
4016,1,0,0,0,47,0,985,0,1,70484,2484824,32.43454948045371,840,1331,1119,1052,54900,531450,576328,2150,3414,2574,2429,3693,8.18535277187245,14.758605505875488,1264,1,256688,22472,67,0,1310,2295
4017,1,0,0,0,46,0,862,0,1,199880,2437484,32.43454948045371,985,1309,1242,1052,52891,525959,539861,2250,3369,2384,2507,3626,13.784048752090222,8.286047041568583,1119,1,245116,8509,190,0,1265,2127
4018,1,0,0,0,45,0,759,0,1,325890,2439915,32.63433774416144,1065,1371,1371,1065,55876,524639,559004,2291,3356,2291,2597,3662,17.4928556845359,0.0,1065,1,259860,0,306,0,1226,1985
4019,1,0,0,0,45,0,736,0,0,358785,2446164,32.72613634390714,1071,1406,1406,1071,50095,532172,491060,2284,3355,2284,2619,3690,18.303005217723125,0.0,1071,0,230265,0,335,0,1213,1949
4020,1,0,0,0,42,0,270,1,0,151519,589456,16.64331697709324,150,951,824,277,45571,423472,487312,2001,2405,2255,2675,3079,23.388031127053,12.103119191447773,404,1,63433,12319,547,0,1851,1581
4021,1,0,0,0,40,0,252,0,0,161365,599440,17.175564037317667,295,842,842,295,49220,434848,467360,2032,2327,2032,2579,2874,23.388031127053,0.0,295,1,67850,0,547,0,1737,1485
4022,1,0,0,0,40,0,236,1,0,181440,662256,18.0,264,944,884,324,27398,421064,271852,1984,2368,2104,2604,2988,23.664319132398465,8.038779614196052,384,1,43092,12480,560,0,1720,1484
4023,1,0,0,0,41,0,227,1,0,194598,702810,18.49324200890693,257,996,911,342,29694,415110,302085,1970,2397,2140,2624,3051,23.853720883753127,9.737059976664934,427,1,50274,16150,569,0,1713,1486
4024,0,0,0,0,56,1,929,1,0,1813440,5349648,43.46262762420146,1631,3107,2849,1889,53599,614544,699504,2574,4721,3090,3792,5939,30.983866769659336,16.374635887269836,2147,1,466583,23736,960,0,943,1872
4025,0,0,1,0,58,1,1001,0,0,429300,953532,18.0,216,1757,1649,324,48888,741636,570942,2835,3267,3051,4268,4700,36.40054944640259,10.551011889467135,432,1,62856,20844,1325,0,2619,1618
4026,1,0,0,0,45,0,59,1,0,96786,642410,16.822603841260722,223,685,625,283,56404,542530,535720,2210,2553,2330,2612,2955,18.49324200890693,7.780166052320878,343,1,66788,7860,342,0,1987,1928
4027,1,0,0,0,44,0,385,0,1,289556,1684620,27.640549922170507,764,1143,1143,764,56069,500535,544635,2205,2969,2205,2584,3348,19.467922333931785,0.0,764,1,188708,0,379,0,1441,1826
4028,1,0,0,0,44,0,848,0,0,263780,2425250,33.015148038438355,1060,1362,1332,1090,53536,531775,498400,2195,3315,2255,2467,3587,15.556349186104045,5.572104574801163,1120,1,244160,3810,242,0,1135,1983
4029,1,0,0,0,43,0,370,0,0,856911,2439769,33.60059523282288,1129,1888,1888,1129,49533,512157,451649,2161,3290,2161,2920,4049,27.54995462791182,0.0,1129,0,235961,0,759,0,1032,1402
4030,1,0,0,0,43,0,351,0,0,895606,2463770,33.734255586866,1138,1925,1925,1138,36736,484960,355060,2165,3303,2165,2952,4090,28.053520278211074,0.0,1138,0,186632,0,787,0,1027,1378
4031,1,0,0,0,43,0,332,0,0,936768,2500344,33.88214869219483,1118,1994,1964,1148,25527,437778,276606,2148,3326,2208,2994,4172,28.5657137141714,5.959073905325341,1178,0,145796,6180,816,0,1030,1362
4032,1,0,0,0,43,0,247,0,0,1158720,2602292,34.741905532080416,1207,2167,2167,1207,31790,366520,403172,2156,3363,2156,3116,4323,30.983866769659336,0.0,1207,0,225709,0,960,0,949,1196
4033,1,0,0,0,43,0,216,0,0,1258465,2658955,35.14256678161116,1235,2254,2254,1235,52297,518873,467201,2153,3388,2153,3172,4407,31.921779399024736,0.0,1235,0,267995,0,1019,0,918,1134
4034,1,0,0,0,43,0,176,0,0,1417892,2765274,35.805027579936315,1282,2388,2388,1282,55822,532779,487482,2157,3439,2157,3263,4545,33.25657829663178,0.0,1282,0,289732,0,1106,0,875,1051
4035,1,0,0,0,43,0,135,0,0,1586826,2861337,36.45545226711637,1329,2523,2523,1329,35145,458589,355245,2153,3482,2153,3347,4676,34.55430508634199,0.0,1329,0,219285,0,1194,0,824,959
4036,1,0,0,0,43,0,320,1,0,1730025,2552515,34.132096331752024,1075,2740,2650,1165,28906,326459,425054,2101,3356,2281,3676,4931,38.535697735995385,10.099504938362077,1255,1,226010,6210,1485,0,1026,706
4037,1,0,0,0,42,0,397,1,0,1457550,2191450,32.01562118716424,1025,2447,2447,1025,45353,463946,446842,2138,3163,2138,3560,4585,37.70941526992961,0.0,1025,1,214225,0,1422,0,1113,716
4038,1,0,0,0,46,0,223,1,0,1359980,2470860,32.55764119219941,676,2727,2343,1060,30810,454545,368298,1947,3391,2715,3614,5058,35.81898937714463,20.875008796360618,1444,1,167480,65664,1283,0,1271,1048
4039,1,0,0,0,46,0,19,0,1,1417200,2784000,34.64101615137755,796,2785,2381,1200,55440,556800,535920,1916,3520,2724,3501,5105,34.36568055487916,20.669869140747828,1604,1,277200,56964,1181,0,1120,1139
4040,1,0,0,0,46,0,109,0,1,1395336,2876025,35.17101079013795,876,2726,2365,1237,53424,585900,492900,1964,3562,2686,3453,5051,33.58571124749333,19.695785377114227,1598,1,262244,61009,1128,0,1088,1197
4041,1,0,0,0,46,0,155,0,1,1382856,2922712,35.4400902933387,917,2696,2357,1256,55000,581750,511940,1988,3583,2666,3428,5023,33.18132004607411,19.19157210952048,1595,1,276320,53901,1101,0,1071,1226
4042,1,0,0,0,45,0,327,0,1,1324674,3047148,36.41428291206625,1071,2580,2325,1326,55278,510156,572202,2043,3624,2553,3297,4878,31.606961258558215,16.72519101875932,1581,1,330174,22950,999,0,972,1299
4043,1,0,0,0,45,0,372,0,1,1308685,3078705,36.6742416417845,1111,2552,2318,1345,55800,515025,567672,2055,3634,2523,3262,4841,31.192947920964443,16.027759703794327,1579,1,333560,22230,973,0,944,1316
4044,1,0,0,0,45,0,459,0,1,1277892,3144942,37.1887079635741,1182,2508,2307,1383,55842,516198,559404,2073,3657,2475,3198,4782,30.397368307141328,15.152977180007547,1584,1,340218,19296,924,0,891,1350
4045,1,0,0,0,45,0,547,0,1,1246548,3211711,37.72267222772003,1248,2474,2299,1423,55575,507825,557479,2082,3680,2432,3133,4731,29.597297173897484,14.094251656799676,1598,1,351481,15925,876,0,834,1381
4046,1,0,0,0,44,0,590,0,1,1230879,3243864,37.986839826445156,1281,2458,2296,1443,55029,496808,559752,2086,3691,2410,3101,4706,29.206163733020468,13.61327817014572,1605,1,359307,13446,853,0,805,1395
4047,1,0,0,0,44,0,610,0,1,1195200,3221280,37.94733192202055,1290,2420,2270,1440,54531,489903,557013,2087,3677,2387,3067,4657,28.809720581775867,13.02043424578037,1590,1,358560,12150,830,0,797,1407
4048,1,0,0,0,44,0,616,0,1,1148361,3170444,37.72267222772003,1289,2364,2230,1423,55000,490160,557000,2094,3651,2362,3035,4592,28.407745422683583,12.295609359105146,1557,1,355750,11122,807,0,805,1421
4049,1,0,0,0,44,0,621,0,1,1103710,3119914,37.49666651850535,1282,2315,2191,1406,54750,485961,554750,2095,3625,2343,3004,4534,28.0178514522438,11.755504904747838,1530,1,351500,10292,785,0,813,1434
4050,1,0,0,0,43,0,645,0,1,909036,2858679,36.45545226711637,1287,2055,2013,1329,51865,440955,544203,2109,3480,2193,2835,4206,26.153393661244042,6.678188844436455,1371,1,336237,2688,684,0,822,1467
4051,1,0,0,0,42,0,652,0,1,844349,2771130,36.069377593742864,1301,1950,1950,1301,52440,485640,489900,2130,3431,2130,2779,4080,25.475478405713993,0.0,1301,1,299230,0,649,0,829,1481
4052,1,0,0,0,42,0,656,0,1,815937,2749437,35.90264614203248,1289,1922,1922,1289,43739,488457,407403,2133,3422,2133,2766,4055,25.15949125081825,0.0,1289,1,246199,0,633,0,844,1500
4053,1,0,0,0,43,0,663,1,0,672448,2633856,34.87119154832539,1149,1836,1769,1216,44707,535002,392046,2099,3382,2233,2719,4002,23.515952032609693,8.2143728690235,1283,1,220096,13668,553,0,950,1613
4054,1,0,0,0,45,0,618,1,0,678919,2688329,34.48187929913333,1129,1820,1760,1189,28536,393414,370804,2201,3450,2321,2832,4081,23.895606290697042,8.304442100362111,1249,1,194996,8220,571,0,1072,1690
4055,1,0,0,0,45,0,807,0,0,376678,2590088,33.734255586866,1138,1469,1469,1138,37932,496168,396024,2276,3414,2276,2607,3745,18.193405398660254,0.0,1138,1,198012,0,331,0,1138,1945
4056,1,0,0,0,46,0,900,0,1,196924,2504830,32.89376840679705,1040,1306,1264,1082,56153,539395,557915,2273,3397,2357,2497,3621,13.490737563232042,6.63067838716079,1124,1,260762,4956,182,0,1233,2133
4057,1,0,0,0,45,0,818,0,0,296480,2498280,33.015148038438355,1090,1362,1362,1090,54225,515700,552372,2292,3382,2292,2564,3654,16.492422502470642,0.0,1090,0,262690,0,272,0,1202,2020
4058,1,0,0,0,46,0,700,1,0,471941,2601841,33.481338085566414,1036,1627,1542,1121,34882,496694,378323,2236,3442,2406,2742,3948,20.518284528683193,9.714504923012402,1206,1,182723,16065,421,0,1200,1900
4059,1,0,0,0,46,0,657,0,1,547378,2650402,33.734255586866,1004,1753,1619,1138,41678,533341,423878,2195,3467,2463,2810,4082,21.93171219946131,11.944787945152004,1272,1,207116,25058,481,0,1191,1848
4060,1,0,0,0,41,0,170,0,1,648875,1499300,26.92582403567252,725,1620,1620,725,51750,475640,465300,2068,2793,2068,2963,3688,29.916550603303182,0.0,725,1,163125,0,895,0,1343,1173
4061,1,0,0,0,42,0,204,1,0,403045,1151789,23.259406699226016,407,1420,1286,541,23436,402381,263996,1995,2670,2263,2874,3549,27.294688127912362,12.411766163331217,675,1,67084,26130,745,0,1588,1384
4062,1,0,0,0,40,0,260,0,0,179349,637268,17.69180601295413,313,886,886,313,52890,437740,500856,2036,2349,2036,2609,2922,23.93741840717165,0.0,313,1,76998,0,573,0,1723,1463
4063,0,1,1,0,63,0,592,0,0,11649860,11884346,61.00819617067857,3655,6919,6852,3722,52206,721618,737583,3126,6915,3260,6323,10112,55.94640292279746,8.19263674150144,3789,0,859782,8576,3130,1,529,63
4064,0,1,1,0,61,0,1936,0,0,7083200,5694520,43.174066289845804,1503,6025,5664,1864,54780,760695,672100,2694,4919,3416,6855,9080,61.644140029689765,19.143040513129645,2225,0,410080,58121,3800,1,1191,745
4065,0,0,1,0,57,1,714,0,0,1992487,5232318,42.579337712087536,1474,3251,2912,1813,53410,629148,707070,2547,4699,3225,3985,6137,33.15116890850155,18.963446185355366,2152,1,444185,33222,1099,0,1073,1787
4066,0,0,1,0,55,1,1179,0,0,1724650,5644678,45.044422518220834,1921,2987,2879,2029,55860,634296,681590,2674,4811,2890,3632,5769,29.154759474226502,10.562698776726089,2137,1,497105,11448,850,0,753,1932
4067,0,0,1,0,59,1,306,0,0,2067507,3841503,35.958309192730404,1169,3016,2892,1293,53928,748692,635794,2847,4264,3095,4570,5987,39.98749804626441,11.222142929558922,1417,1,276702,20832,1599,0,1678,1372
4068,1,0,0,0,44,0,402,0,1,276568,1684620,27.640549922170507,764,1126,1126,764,54750,482895,551250,2205,2969,2205,2567,3331,19.026297590440446,0.0,764,1,191000,0,362,0,1441,1843
4069,1,0,0,0,43,0,434,0,0,275535,1725430,28.0178514522438,785,1136,1136,785,50112,509936,474768,2198,2983,2198,2549,3334,18.734993995195193,0.0,785,0,169560,0,351,0,1413,1847
4070,1,0,0,0,43,0,600,1,0,322164,2071458,30.692018506445613,882,1344,1284,942,37430,417810,433203,2139,3141,2259,2541,3543,18.49324200890693,7.789174875971784,1002,1,185574,7380,342,0,1257,1857
4071,1,0,0,0,44,0,858,0,0,307360,2513120,33.61547262794322,1130,1402,1402,1130,56048,502624,551552,2224,3354,2224,2496,3626,16.492422502470642,0.0,1130,1,280240,0,272,0,1094,1952
4072,1,0,0,0,44,0,848,0,0,304640,2477440,33.46640106136302,1120,1392,1392,1120,55404,537516,504336,2212,3332,2212,2484,3604,16.492422502470642,0.0,1120,0,255360,0,272,0,1092,1940
4073,1,0,0,0,44,0,839,0,0,309132,2470824,33.406586176980134,1116,1393,1393,1116,52398,544644,471582,2214,3330,2214,2491,3607,16.64331697709324,0.0,1116,1,237708,0,277,0,1098,1937
4074,1,0,0,0,44,0,786,0,0,359640,2466420,33.31666249791537,1080,1464,1434,1110,53463,557722,473286,2192,3332,2252,2546,3686,18.0,5.572104574801163,1140,1,236430,4830,324,0,1112,1898
4075,1,0,0,0,44,0,768,0,0,379620,2470860,33.31666249791537,1080,1482,1452,1110,54033,554274,483042,2196,3336,2256,2568,3708,18.49324200890693,5.652706486041966,1140,1,240870,4590,342,0,1116,1884
4076,1,0,0,0,44,0,706,0,0,448440,2459760,33.31666249791537,1110,1514,1514,1110,54492,529624,505248,2216,3326,2216,2620,3730,20.09975124224178,0.0,1110,0,253080,0,404,0,1106,1812
4077,1,0,0,0,44,0,684,0,0,472860,2456430,33.31666249791537,1110,1536,1536,1110,54026,526694,502351,2213,3323,2213,2639,3749,20.639767440550294,0.0,1110,0,251970,0,426,0,1103,1787
4078,1,0,0,0,44,0,660,0,0,499500,2458650,33.31666249791537,1110,1560,1560,1110,54531,551535,485085,2215,3325,2215,2665,3775,21.213203435596427,0.0,1110,1,243090,0,450,0,1105,1765
4079,1,0,0,0,43,0,409,0,0,852150,2485150,33.91164991562634,1150,1891,1891,1150,51520,484064,497030,2161,3311,2161,2902,4052,27.2213151776324,0.0,1150,0,264500,0,741,0,1011,1420
4080,1,0,0,0,43,0,389,0,0,890502,2503596,34.02939905434711,1158,1927,1927,1158,46844,516718,423752,2162,3320,2162,2931,4089,27.730849247724095,0.0,1158,0,226968,0,769,0,1004,1393
4081,1,0,0,0,43,0,251,1,0,1244256,2709408,35.32704346531139,1218,2275,2245,1248,25550,316966,379925,2141,3419,2201,3168,4446,31.575306807693888,5.791460926441345,1278,1,218400,2580,997,0,923,1174
4082,1,0,0,0,42,0,446,0,0,1390271,2078079,31.25699921617557,947,2430,2400,977,50787,516861,444543,2097,3104,2157,3550,4557,37.72267222772003,5.501408174353464,1007,0,204193,5160,1423,0,1150,704
4083,1,0,0,0,42,0,442,0,0,1364880,2069584,31.11269837220809,926,2420,2378,968,42330,532362,363460,2096,3106,2180,3548,4558,37.54996671103717,6.538739683827756,1010,0,164560,8988,1410,0,1170,728
4084,1,0,0,0,46,0,271,1,0,1379946,2454168,32.357379374726875,621,2791,2365,1047,38110,482864,433640,1918,3391,2770,3662,5135,36.30426972134269,21.885973238959636,1473,1,193695,66882,1318,0,1297,1026
4085,1,0,0,0,46,0,63,0,1,1413918,2693508,34.02939905434711,754,2783,2379,1158,49776,474504,567544,1922,3484,2730,3547,5109,34.942810419312295,20.726115890321697,1562,1,282552,32320,1221,0,1168,1105
4086,1,0,0,0,46,0,19,0,1,1405320,2721264,34.292856398964496,794,2753,2371,1176,55370,522964,566930,1932,3490,2696,3509,5067,34.56877203488721,20.12016272485334,1558,1,288120,40110,1195,0,1138,1119
4087,1,0,0,0,46,0,27,0,1,1395760,2761645,34.56877203488721,834,2724,2363,1195,56608,563884,536152,1950,3506,2672,3479,5035,34.17601498127012,19.58810578912236,1556,1,277240,48735,1168,0,1116,1143
4088,1,0,0,0,46,0,72,0,1,1386388,2804340,34.84250278036869,875,2695,2356,1214,53000,577500,489720,1971,3524,2649,3452,5005,33.793490497431605,19.045071907648474,1553,1,257368,54240,1142,0,1096,1168
4089,1,0,0,0,46,0,115,0,1,1373796,2853458,35.08560958569767,912,2666,2347,1231,52961,581818,489098,1999,3549,2637,3434,4984,33.406586176980134,18.61155430545609,1550,1,259741,52316,1116,0,1087,1202
4090,1,0,0,0,45,0,287,0,1,1321530,2982882,36.08323710533743,1068,2551,2317,1302,55278,508602,570459,2057,3593,2525,3306,4842,31.85906464414798,16.053684285514475,1536,1,324198,20592,1015,0,989,1276
4091,1,0,0,0,45,0,331,0,1,1307790,3014522,36.345563690772494,1109,2523,2311,1321,55552,511168,565936,2070,3603,2494,3272,4805,31.464265445104548,15.29629022168207,1533,1,327608,19928,990,0,961,1292
4092,1,0,0,0,45,0,418,0,1,1281120,3079040,36.87817782917155,1185,2477,2302,1360,55278,502608,563736,2089,3624,2439,3206,4741,30.692018506445613,13.88656611604207,1535,1,338640,15400,942,0,904,1322
4093,1,0,0,0,44,0,549,0,1,1239112,3180198,37.69615364994153,1287,2427,2293,1421,54780,492360,557262,2104,3659,2372,3110,4665,29.5296461204668,12.391975741304819,1555,1,353829,11256,872,0,817,1366
4094,1,0,0,0,44,0,592,0,1,1225700,3212776,37.97367509209505,1318,2416,2292,1442,54500,485704,557000,2104,3670,2352,3078,4644,29.154759474226502,11.932888170540295,1566,1,360500,9920,850,0,786,1378
4095,1,0,0,0,44,0,620,0,1,1198944,3211664,38.05259518088089,1340,2384,2276,1448,55056,492396,550064,2110,3666,2326,3046,4602,28.77498913987632,11.115195081142032,1556,1,359104,9288,828,0,770,1390
4096,1,0,0,0,44,0,630,0,1,1110775,3114415,37.61648574760805,1325,2290,2200,1415,55800,495225,545848,2111,3616,2291,2986,4491,28.0178514522438,9.987225542826152,1505,1,350920,8190,785,0,786,1416
4097,1,0,0,0,43,0,639,0,1,1031080,3017120,37.20215047547655,1317,2196,2129,1384,49276,422920,553720,2113,3564,2247,2925,4376,27.294688127912362,8.833574853908106,1451,1,351536,2814,745,0,796,1435
4098,1,0,0,0,42,0,647,0,1,959340,2909185,36.810324638611924,1325,2093,2063,1355,53463,457311,538897,2117,3502,2177,2855,4240,26.60826939130014,5.652706486041966,1385,1,340105,2310,708,0,792,1439
4099,1,0,0,0,46,0,1000,0,1,134400,2626400,33.46640106136302,1000,1360,1240,1120,49276,595630,454930,2225,3465,2465,2465,3705,10.954451150103322,11.290330617691032,1240,1,217280,22680,120,0,1225,2225
4100,1,0,0,0,46,0,1080,0,1,33300,2598510,33.31666249791537,983,1267,1140,1110,54432,524384,568863,2214,3451,2468,2371,3608,5.477225575051661,11.413542506858095,1237,1,269730,13589,30,0,1231,2311
4101,1,0,0,0,45,0,876,0,0,267840,2563452,33.406586176980134,1116,1356,1356,1116,51300,516825,523716,2297,3413,2297,2537,3653,15.491933384829668,0.0,1116,0,254448,0,240,0,1181,2057
4102,1,0,0,0,46,0,710,0,1,533319,2722611,34.161381705077446,1017,1774,1624,1167,42594,534257,433938,2183,3500,2483,2790,4107,21.37755832643195,12.5999078163187,1317,1,217062,27300,457,0,1166,1876
4103,1,0,0,0,41,0,147,0,1,697680,1584315,27.65863337187866,735,1707,1677,765,52640,463904,486685,2041,2836,2101,2983,3778,30.199337741083,5.490867587491313,795,1,179775,3570,912,0,1306,1159
4104,1,0,0,0,41,0,176,0,0,674532,1529136,27.16615541441225,738,1652,1652,738,42525,466200,391608,2072,2810,2072,2986,3724,30.23243291566195,0.0,738,0,139482,0,914,0,1334,1158
4105,1,0,0,0,41,0,181,0,0,634212,1478169,26.664583251946766,681,1633,1603,711,34506,442827,336798,2049,2790,2109,2971,3712,29.866369046136157,5.652706486041966,741,0,115182,5640,892,0,1368,1187
4106,1,0,0,0,42,0,200,1,0,489849,1286840,24.63736998950984,499,1522,1414,607,28485,447320,286200,2012,2727,2228,2927,3642,28.407745422683583,11.159351262885526,715,1,81945,22680,807,0,1513,1313
4107,1,0,0,0,42,0,210,1,0,428544,1196910,23.62202362203543,408,1476,1326,558,24638,416130,272415,1995,2703,2295,2913,3621,27.712812921102035,13.168301036937951,708,1,70866,29700,768,0,1587,1377
4108,1,0,0,0,43,0,216,1,0,400500,1150770,23.108440016582687,359,1459,1284,534,25536,413760,286615,1980,2689,2330,2905,3614,27.386127875258307,14.232222772658718,709,1,71022,33425,750,0,1621,1405
4109,1,0,0,0,43,0,239,1,0,305510,974956,21.118712081942874,163,1414,1131,446,37515,448130,400038,1903,2632,2469,2871,3600,26.1725046566048,17.85780609790561,729,1,81618,44714,685,0,1740,1501
4110,1,0,0,0,42,0,270,0,0,209304,729144,18.49324200890693,234,1062,954,342,51308,430664,541528,2024,2474,2240,2744,3194,24.73863375370596,11.25033949080533,450,1,86868,5832,612,0,1790,1520
4111,1,0,0,0,41,0,271,0,0,198330,687060,18.16590212458495,288,973,931,330,48945,405990,522582,2040,2412,2124,2683,3055,24.515301344262525,7.066112858657135,372,1,82830,1638,601,0,1752,1481
4112,0,1,1,0,63,0,567,0,0,11749788,11891262,61.0163912403872,3663,6939,6879,3723,51051,705874,737814,3134,6917,3254,6350,10133,56.178287620752556,7.759379671981613,3783,0,860013,7260,3156,1,529,38
4113,0,1,1,0,62,0,903,0,0,10329418,8661400,52.85830114561004,2632,6653,6491,2794,45180,558000,778100,2938,5894,3262,6797,9753,60.802960454241045,12.850301615905524,2956,0,701294,5346,3697,1,306,597
4114,0,1,1,0,61,0,1938,0,0,5800255,4978620,40.33608806019741,1232,5587,5192,1627,52920,771120,642600,2665,4687,3455,6625,8647,59.70762095411272,20.075354308896586,2022,0,341670,68730,3565,1,1433,505
4115,0,0,0,0,56,1,849,1,0,1979230,5388430,43.520110293977886,1639,3194,2939,1894,52668,594605,716940,2590,4739,3100,3890,6039,32.32645975048923,16.357126938984106,2149,1,477288,18105,1045,0,951,1800
4116,0,0,0,0,56,1,1019,1,0,1885170,5541018,44.429719783046124,1799,3104,2929,1974,55056,623154,696136,2632,4781,2982,3762,5911,30.903074280724887,13.470838687753037,2149,1,489552,16625,955,0,833,1852
4117,0,0,0,0,56,1,853,1,0,2051628,5394168,43.829214001622255,1921,2989,2989,1921,45816,699192,516672,2808,4729,2808,3876,5797,32.68026927673638,0.0,1921,1,353464,0,1068,0,887,1740
4118,1,0,0,0,45,0,70,1,0,191496,910212,20.09975124224178,404,878,878,404,54208,545226,504672,2253,2657,2253,2727,3131,21.77154105707724,0.0,404,1,90496,0,474,0,1849,1779
4119,1,0,0,0,45,0,75,1,0,211576,955272,20.591260281974,424,923,923,424,54120,554238,495660,2253,2677,2253,2752,3176,22.338307903688676,0.0,424,1,93280,0,499,0,1829,1754
4120,1,0,0,0,44,0,450,0,0,262975,1729355,28.0178514522438,785,1120,1120,785,49032,500081,475848,2203,2988,2203,2538,3323,18.303005217723125,0.0,785,0,169560,0,335,0,1418,1868
4121,1,0,0,0,44,0,691,1,0,386862,2335970,32.51153641401772,967,1513,1423,1057,36808,472940,380120,2120,3267,2300,2576,3723,19.131126469708992,9.522065445080457,1147,1,181804,16200,366,0,1153,1844
4122,1,0,0,0,44,0,858,0,0,348859,2571821,34.044089061098404,1159,1460,1460,1159,54510,510370,525903,2219,3378,2219,2520,3679,17.349351572897472,0.0,1159,0,274683,0,301,0,1060,1918
4123,1,0,0,0,44,0,849,0,0,346150,2547250,33.91164991562634,1120,1481,1451,1150,43362,485085,438570,2185,3365,2245,2516,3696,17.349351572897472,5.478746393072713,1180,0,227700,4800,301,0,1065,1914
4124,1,0,0,0,44,0,840,0,0,350676,2544120,33.85262175962151,1146,1452,1452,1146,40176,479520,412920,2220,3366,2220,2526,3672,17.4928556845359,0.0,1146,0,213156,0,306,0,1074,1914
4125,1,0,0,0,44,0,805,0,0,381900,2523960,33.76388603226827,1140,1475,1475,1140,49203,511434,471582,2214,3354,2214,2549,3689,18.303005217723125,0.0,1140,0,242820,0,335,0,1074,1879
4126,1,0,0,0,44,0,790,0,0,399000,2525100,33.76388603226827,1140,1490,1490,1140,45080,509450,434140,2215,3355,2215,2565,3705,18.708286933869708,0.0,1140,0,223440,0,350,0,1075,1865
4127,1,0,0,0,44,0,774,0,0,417240,2527380,33.76388603226827,1140,1506,1506,1140,43485,494391,432315,2217,3357,2217,2583,3723,19.131126469708992,0.0,1140,0,222300,0,366,0,1077,1851
4128,1,0,0,0,44,0,756,0,0,437760,2529660,33.76388603226827,1140,1524,1524,1140,42586,474866,441581,2219,3359,2219,2603,3743,19.595917942265423,0.0,1140,0,226860,0,384,0,1079,1835
4129,1,0,0,0,44,0,736,0,0,460560,2531940,33.76388603226827,1140,1544,1544,1140,39123,459747,419769,2221,3361,2221,2625,3765,20.09975124224178,0.0,1140,0,215460,0,404,0,1081,1817
4130,1,0,0,0,44,0,716,0,0,483360,2537640,33.76388603226827,1110,1594,1564,1140,36234,440748,407358,2196,3366,2256,2650,3820,20.591260281974,5.5503012171862105,1170,0,208620,4500,424,0,1086,1802
4131,1,0,0,0,44,0,648,0,0,560880,2521680,33.76388603226827,1140,1632,1632,1140,49600,548576,442400,2212,3352,2212,2704,3844,22.181073012818835,0.0,1140,1,228000,0,492,0,1072,1720
4132,1,0,0,0,43,0,427,0,0,886608,2551356,34.336569426778794,1179,1931,1931,1179,44880,441456,476080,2164,3343,2164,2916,4095,27.422618401604176,0.0,1179,0,259380,0,752,0,985,1412
4133,1,0,0,0,43,0,407,0,0,925860,2566294,34.45286635390443,1187,1967,1967,1187,46400,501584,432400,2162,3349,2162,2942,4129,27.92848008753788,0.0,1187,0,237400,0,780,0,975,1382
4134,1,0,0,0,43,0,387,1,0,965560,2595540,34.56877203488721,1165,2033,2003,1195,42484,536484,373584,2142,3367,2202,2980,4205,28.42534080710379,5.623413251903491,1225,1,205540,6330,808,0,977,1364
4135,1,0,0,0,43,0,225,1,0,1438164,2860524,36.29049462324811,1257,2469,2409,1317,25748,341004,356208,2112,3489,2232,3264,4641,33.04542328371661,7.9332512824338455,1377,1,215988,6900,1092,0,855,1080
4136,1,0,0,0,44,0,428,1,0,1723104,2483100,33.406586176980134,966,2810,2660,1116,25704,302600,420525,2075,3341,2375,3769,5035,39.293765408777,13.324894335252607,1266,1,210924,8400,1544,0,1109,681
4137,1,0,0,0,42,0,504,1,0,1403017,2049383,30.967725134404045,959,2422,2422,959,43584,410304,485099,2137,3096,2137,3600,4559,38.24918299781056,0.0,959,1,217693,0,1463,0,1178,674
4138,1,0,0,0,42,0,498,0,0,1351720,2004080,30.659419433511783,910,2408,2378,940,46812,530868,400816,2102,3072,2162,3570,4540,37.92097045171708,5.483301264452448,970,0,176720,5940,1438,0,1192,694
4139,1,0,0,0,42,0,495,0,0,1327606,1996064,30.512292604784715,871,2417,2357,931,37544,529568,325888,2084,3075,2204,3570,4561,37.76241517699841,7.849311256600636,991,0,141512,13500,1426,0,1213,718
4140,1,0,0,0,46,0,146,0,1,1408392,2611440,33.406586176980134,712,2782,2378,1116,51294,482040,582660,1936,3456,2744,3602,5122,35.52463933666322,20.836564304301803,1520,1,277884,30300,1262,0,1224,1078
4141,1,0,0,0,46,0,101,0,1,1400490,2637684,33.67491648096547,752,2751,2369,1134,50400,465200,586152,1944,3460,2708,3561,5077,35.14256678161116,20.2137064995337,1516,1,285768,23684,1235,0,1192,1091
4142,1,0,0,0,46,0,56,0,1,1393977,2665736,33.95585369269929,792,2723,2362,1153,53172,487832,582624,1951,3465,2673,3521,5035,34.77067730142742,19.605512436163284,1514,1,290556,27075,1209,0,1159,1103
4143,1,0,0,0,46,0,11,0,1,1386476,2696772,34.23448553724738,833,2694,2355,1172,56608,533832,561444,1962,3473,2640,3484,4995,34.39476704383968,18.972274991495183,1511,1,285968,36951,1183,0,1129,1118
4144,1,0,0,0,46,0,117,0,1,1354968,2822544,34.9857113690718,947,2608,2331,1224,54780,574194,507320,2029,3530,2583,3413,4914,33.27160951922825,17.40921730865171,1501,1,269280,41827,1107,0,1082,1199
4145,1,0,0,0,46,0,160,0,1,1343844,2861568,35.24202037341219,987,2579,2324,1242,56862,539136,559872,2049,3546,2559,3386,4883,32.89376840679705,16.800347042750342,1497,1,301806,28815,1082,0,1062,1222
4146,1,0,0,0,45,0,203,0,1,1331820,2889180,35.4964786985977,1026,2551,2317,1260,53965,492995,575543,2059,3553,2527,3350,4844,32.51153641401772,16.014932695390826,1494,1,316260,19188,1057,0,1033,1236
4147,1,0,0,0,45,0,247,0,1,1319928,2917399,35.76310948449533,1067,2523,2311,1279,54780,501820,567969,2069,3560,2493,3313,4804,32.12475680841802,15.215177286668172,1491,1,318471,19504,1032,0,1002,1249
4148,1,0,0,0,45,0,378,0,1,1284480,3019866,36.578682316343766,1188,2448,2298,1338,53714,482998,566507,2107,3595,2407,3217,4705,30.983866769659336,12.932914451756053,1488,1,335838,11700,960,0,919,1297
4149,1,0,0,0,44,0,421,0,1,1272446,3048710,36.851051545376556,1224,2429,2295,1358,54718,489410,563495,2111,3603,2379,3182,4674,30.610455730027933,12.151058826387683,1492,1,340858,10854,937,0,887,1308
4150,1,0,0,0,44,0,465,0,1,1260406,3086202,37.134889255254286,1255,2417,2293,1379,55552,501312,555024,2114,3617,2362,3152,4655,30.23243291566195,12.038156742151878,1503,1,341992,11160,914,0,859,1324
4151,1,0,0,0,44,0,508,0,1,1248800,3120600,37.416573867739416,1292,2400,2292,1400,54531,488151,555021,2121,3629,2337,3121,4629,29.866369046136157,11.25033949080533,1508,1,348600,8640,892,0,829,1337
4152,1,0,0,0,44,0,593,0,1,1224258,3181052,37.97367509209505,1357,2376,2291,1442,54340,485320,544882,2121,3648,2291,3055,4582,29.13760456866693,9.880111181028997,1527,1,356174,6970,849,0,764,1357
4153,1,0,0,0,43,0,628,0,1,1205568,3201744,38.157568056677825,1389,2351,2284,1456,55125,494775,538755,2132,3655,2266,3027,4550,28.77498913987632,8.862806978978044,1523,1,356720,6030,828,0,743,1371
4154,1,0,0,0,43,0,634,0,1,1162887,3155790,37.960505792204614,1381,2308,2248,1441,54656,490560,534360,2130,3631,2250,2997,4498,28.407745422683583,8.246211251235321,1501,1,351604,5280,807,0,749,1383
4155,1,0,0,0,43,0,638,0,1,1121475,3107925,37.749172176353746,1365,2272,2212,1425,53874,477639,536526,2121,3606,2241,2968,4453,28.053520278211074,8.016064826688304,1485,1,350550,4800,787,0,756,1394
4156,1,0,0,0,43,0,642,0,1,1082880,3059700,37.54996671103717,1368,2220,2178,1410,51660,444850,546840,2128,3580,2212,2938,4390,27.712812921102035,6.955109380145743,1452,1,355320,2352,768,0,760,1402
4157,1,0,0,0,42,0,650,0,1,1011624,2957480,37.17526059088221,1382,2114,2114,1382,54432,479360,520020,2140,3522,2140,2872,4254,27.055498516937366,0.0,1382,1,335826,0,732,0,758,1408
4158,1,0,0,0,44,0,642,1,0,747043,2753245,35.25620512760839,1213,1874,1844,1243,34034,403130,414205,2185,3458,2245,2816,4089,24.515301344262525,5.753771868478424,1273,1,232441,3690,601,0,972,1614
4159,1,0,0,0,46,0,1016,0,1,141360,2641380,33.76388603226827,1098,1306,1264,1140,53020,509740,558397,2275,3457,2359,2441,3623,11.135528725660043,6.538739683827756,1182,1,274740,4452,124,0,1177,2193
4160,1,0,0,0,41,0,251,1,0,249990,806520,19.748417658131498,323,1098,1031,390,21539,374308,246092,2001,2458,2135,2709,3166,25.317977802344327,8.616819548034314,457,1,46410,12730,641,0,1678,1427
4161,1,0,0,0,41,0,224,1,0,303300,940500,21.213203435596427,275,1299,1124,450,35898,388740,403370,1915,2540,2265,2764,3389,25.96150997149434,13.728829820844442,625,1,86850,21525,674,0,1640,1416
4162,0,1,1,0,61,0,1938,0,0,5972680,5066320,40.74309757492672,1299,5619,5258,1660,54216,766052,659232,2691,4712,3413,6650,8671,59.983331017875294,19.18619393981722,2021,0,358560,59565,3598,1,1392,546
4163,0,0,1,0,57,1,67,0,0,2484230,4664170,40.124805295477756,1520,3243,3153,1610,52080,718456,608370,2807,4507,2987,4440,6140,39.28103868280471,9.535934250532243,1700,1,338100,15660,1543,0,1287,1354
4164,1,0,0,0,45,0,71,1,0,107970,666700,17.175564037317667,295,661,661,295,53799,535620,513020,2260,2555,2260,2626,2921,19.131126469708992,0.0,295,1,66965,0,366,0,1965,1894
4165,1,0,0,0,45,0,74,1,0,252647,1051217,21.61018278497431,467,1008,1008,467,54189,546993,501973,2251,2718,2251,2792,3259,23.259406699226016,0.0,467,1,104141,0,541,0,1784,1710
4166,1,0,0,0,44,0,426,0,1,262656,1698816,27.712812921102035,768,1110,1110,768,54718,482216,555212,2212,2980,2212,2554,3322,18.49324200890693,0.0,768,1,192768,0,342,0,1444,1870
4167,1,0,0,0,44,0,463,0,0,254988,1736122,28.053520278211074,787,1111,1111,787,50794,513998,480908,2206,2993,2206,2530,3317,18.0,0.0,787,0,171566,0,324,0,1419,1882
4168,1,0,0,0,47,0,712,0,1,1011753,3381048,37.72267222772003,977,2580,2134,1423,51212,560736,515592,1930,3799,2822,3087,4956,26.664583251946766,22.22210229069578,1869,1,308791,69576,711,0,953,1665
4169,1,0,0,0,44,0,858,0,0,393559,2639580,34.48187929913333,1189,1520,1520,1189,49952,497280,495060,2220,3409,2220,2551,3740,18.193405398660254,0.0,1189,0,265147,0,331,0,1031,1889
4170,1,0,0,0,44,0,762,1,0,477360,2618460,34.20526275297414,1140,1608,1578,1170,21462,328986,326748,2208,3408,2268,2646,3846,20.199009876724155,6.051418581390739,1200,1,170820,3600,408,0,1068,1830
4171,1,0,0,0,43,0,405,0,0,1002456,2654856,34.9857113690718,1224,2043,2043,1224,43680,485856,422955,2169,3393,2169,2988,4212,28.61817604250837,0.0,1224,0,238680,0,819,0,945,1350
4172,1,0,0,0,43,0,386,0,0,1044351,2681775,35.11409973215888,1233,2080,2080,1233,52000,543750,452400,2175,3408,2175,3022,4255,29.103264421710495,0.0,1233,0,256464,0,847,0,942,1328
4173,1,0,0,0,43,0,368,0,0,1087625,2706011,35.25620512760839,1243,2118,2118,1243,53965,546427,468055,2177,3420,2177,3052,4295,29.58039891549808,0.0,1243,0,267245,0,875,0,934,1302
4174,1,0,0,0,44,0,268,1,0,1785693,2687607,34.77067730142742,1089,2806,2686,1209,16983,340119,246753,2103,3432,2343,3700,5029,38.43175770115127,11.986232110808638,1329,1,134199,19560,1477,0,1014,746
4175,1,0,0,0,43,0,565,1,0,1511576,2129325,31.28897569432403,859,2643,2523,979,29928,374100,378450,2055,3154,2295,3719,4818,39.293765408777,11.206010841342998,1099,1,170346,14880,1544,0,1196,631
4176,1,0,0,0,46,0,440,0,1,1230761,2132651,30.18277654557314,516,2657,2262,911,38454,517361,407334,1946,3252,2736,3692,4998,36.75595189897821,21.21794208191597,1306,1,158514,73470,1351,0,1430,990
4177,1,0,0,0,47,0,409,1,0,1297986,2240503,30.870698080866262,523,2745,2315,953,39292,491359,441988,1921,3304,2781,3713,5096,36.90528417449187,22.04027245345479,1383,1,179164,67510,1362,0,1398,989
4178,1,0,0,0,46,0,228,0,1,1398348,2517456,32.77193921634788,670,2780,2376,1074,54834,520368,578968,1940,3418,2748,3646,5124,36.08323710533743,20.845374325022544,1478,1,265278,39188,1302,0,1270,1042
4179,1,0,0,0,46,0,184,0,1,1393392,2547636,33.04542328371661,710,2750,2368,1092,52459,487597,585583,1951,3425,2715,3609,5083,35.7211421989835,20.249209532014284,1474,1,274092,28650,1276,0,1241,1057
4180,1,0,0,0,46,0,140,0,1,1387500,2575200,33.31666249791537,749,2721,2360,1110,50400,464000,584640,1959,3430,2681,3570,5041,35.35533905932738,19.668143850234117,1471,1,279720,22382,1250,0,1210,1070
4181,1,0,0,0,45,0,51,0,1,1376452,2633512,33.88214869219483,829,2666,2347,1148,54282,500092,571206,1975,3442,2613,3493,4960,34.62657938636157,18.40538034747407,1467,1,285852,28391,1199,0,1146,1095
4182,1,0,0,0,45,0,8,0,1,1366545,2666685,34.132096331752024,868,2635,2338,1165,56876,551649,540204,1992,3454,2586,3462,4924,34.249087579087416,17.7867938793894,1462,1,274940,38610,1173,0,1124,1116
4183,1,0,0,0,45,0,34,0,1,1356936,2705598,34.38022687534217,905,2607,2330,1182,53965,574539,492135,2012,3471,2566,3437,4896,33.88214869219483,17.242668092248007,1459,1,254130,44320,1148,0,1107,1141
4184,1,0,0,0,45,0,77,0,1,1347600,2751600,34.64101615137755,945,2578,2323,1200,52371,580129,474651,2038,3493,2548,3416,4871,33.51119216023208,16.68868233948606,1455,1,248400,43605,1123,0,1093,1170
4185,1,0,0,0,45,0,163,0,1,1328538,2832730,35.17101079013795,1025,2523,2311,1237,54834,508380,565630,2078,3527,2502,3364,4813,32.77193921634788,15.410129902918593,1449,1,305539,20564,1074,0,1053,1216
4186,1,0,0,0,45,0,250,0,1,1309176,2901624,35.7211421989835,1106,2472,2302,1276,53846,495732,561678,2104,3550,2444,3300,4746,32.03123475609393,13.802720429891991,1446,1,315172,15980,1026,0,998,1248
4187,1,0,0,0,45,0,337,0,1,1288364,2964948,36.27671429443411,1189,2422,2295,1316,52668,470877,567756,2126,3569,2380,3232,4675,31.28897569432403,12.042167265383636,1443,1,331632,8890,979,0,937,1274
4188,1,0,0,0,43,0,551,0,1,1236270,3117674,37.69615364994153,1361,2351,2291,1421,53165,476098,537530,2134,3615,2254,3064,4545,29.49576240750525,8.217978828131171,1481,1,348145,4500,870,0,773,1324
4189,1,0,0,0,43,0,593,0,1,1226550,3150069,37.986839826445156,1401,2335,2293,1443,53261,482443,526103,2141,3626,2225,3033,4518,29.154759474226502,6.991237203771572,1485,1,347763,3486,850,0,740,1333
4190,1,0,0,0,43,0,635,0,1,1215950,3186375,38.27531841800928,1435,2325,2295,1465,53520,485025,522000,2145,3640,2205,3005,4500,28.809720581775867,5.8721273231371045,1495,1,351600,2640,830,0,710,1345
4191,1,0,0,0,43,0,640,0,1,1176761,3141415,38.09199390948182,1421,2292,2262,1451,54675,487125,526095,2135,3616,2195,2976,4457,28.478061731796284,5.5503012171862105,1481,1,352593,2730,811,0,714,1354
4192,1,0,0,0,43,0,645,0,1,1138104,3098172,37.907782842049734,1407,2259,2229,1437,55552,482944,534688,2126,3593,2186,2948,4415,28.142494558940577,5.623413251903491,1467,1,356376,2760,792,0,719,1364
4193,1,0,0,0,42,0,648,0,1,1100628,3051612,37.70941526992961,1422,2196,2196,1422,53217,469974,521478,2146,3568,2146,2920,4342,27.820855486487112,0.0,1422,1,345546,0,774,0,724,1372
4194,1,0,0,0,42,0,652,0,1,1066613,3015260,37.53664875824692,1409,2166,2166,1409,46866,468660,457960,2140,3549,2140,2897,4306,27.51363298439521,0.0,1409,1,301526,0,757,0,731,1383
4195,1,0,0,0,45,0,596,1,0,836640,2884140,35.4964786985977,1136,2048,1924,1260,27216,494424,288414,2165,3549,2413,2953,4337,25.768197453450252,11.629613944648966,1384,1,158760,27652,664,0,1029,1625
4196,1,0,0,0,46,0,704,1,0,731721,2946039,35.73513677041127,1143,1984,1850,1277,36260,426795,452172,2173,3584,2441,2880,4291,23.93741840717165,12.168439873279091,1411,1,250292,15812,573,0,1030,1734
4197,1,0,0,0,45,0,811,1,0,574310,2895585,35.566838487557476,1145,1839,1719,1265,33456,466956,375396,2169,3554,2409,2743,4128,21.307275752662516,11.320779839735554,1385,1,207460,21120,454,0,1024,1835
4198,1,0,0,0,46,0,1022,0,1,191808,2752800,34.40930106817051,1089,1441,1346,1184,47163,551025,462675,2230,3509,2420,2487,3766,12.727922061357855,9.886585106410566,1279,1,235616,16815,162,0,1141,2163
4199,1,0,0,0,46,0,1068,0,1,127008,2749488,34.292856398964496,1026,1434,1284,1176,49894,577486,472276,2188,3514,2488,2446,3772,10.392304845413264,12.26699777646566,1326,1,237552,27450,108,0,1162,2230
4200,1,0,0,0,46,0,1008,0,1,189540,2701530,34.20526275297414,1170,1332,1332,1170,51272,535688,510289,2309,3479,2309,2471,3641,12.727922061357855,0.0,1170,1,258570,0,162,0,1139,2147
4201,1,0,0,0,46,0,982,0,0,222680,2709664,34.23448553724738,1172,1362,1362,1172,46081,524824,469336,2312,3484,2312,2502,3674,13.784048752090222,0.0,1172,0,237916,0,190,0,1140,2122
4202,1,0,0,0,41,0,93,0,0,702598,1651819,28.160255680657446,793,1679,1679,793,40050,468675,370774,2083,2876,2083,2969,3762,29.765752132274432,0.0,793,0,141154,0,886,0,1290,1197
4203,1,0,0,0,42,0,192,1,0,691353,1557582,27.2213151776324,699,1716,1674,741,31290,441420,313198,2060,2843,2144,3035,3818,30.54504869860253,6.852548980306203,783,1,110409,8274,933,0,1361,1169
4204,1,0,0,0,42,0,216,1,0,515412,1326846,24.859605789312106,448,1622,1452,618,29380,485222,279110,1977,2765,2317,2981,3769,28.879058156387302,13.707039880315492,788,1,80340,38930,834,0,1529,1313
4205,1,0,0,0,41,0,272,0,0,259233,813671,19.77371993328519,361,1084,1054,391,50038,409957,528574,2051,2472,2111,2744,3165,25.748786379167466,5.791460926441345,421,1,99314,1500,663,0,1690,1418
4206,1,0,0,0,41,0,269,1,0,258060,803505,19.77371993328519,391,1051,1051,391,48391,445935,458265,2055,2446,2055,2715,3106,25.69046515733026,0.0,391,1,87193,0,660,0,1664,1395
4207,0,1,0,1,63,0,473,0,0,11912208,11816112,60.794736614282655,3654,6961,6919,3696,46428,677764,700143,3155,6893,3239,6420,10158,56.77147170894903,6.5135556243263055,3738,1,809424,5334,3223,0,499,26
4208,0,1,1,0,58,0,1391,0,0,448470,783810,16.431676725154983,14,2187,1931,270,24978,525443,400614,2647,3173,3159,4564,5090,40.755367744629666,16.175083653877053,526,1,37260,44288,1661,0,2633,1242
4209,0,0,1,0,57,1,16,0,0,2569545,4655790,40.13726448077895,1551,3266,3206,1611,51450,708050,606900,2830,4501,2950,4485,6156,39.93745109543172,7.765259411425052,1671,1,338310,10380,1595,0,1279,1295
4210,0,0,1,0,57,1,80,0,0,2548809,4735841,40.45985664828782,1577,3254,3194,1637,52328,717464,610423,2833,4530,2953,4450,6147,39.45883931389772,7.780166052320878,1697,1,345407,10380,1557,0,1256,1336
4211,0,0,1,0,58,1,160,0,0,2502656,4825600,40.792156108742276,1597,3235,3168,1664,51623,716300,606100,2833,4564,2967,4404,6135,38.781438859330635,8.261328108906353,1731,1,347776,11725,1504,0,1236,1396
4212,0,0,0,0,55,1,1021,1,0,2011946,5646364,44.9221548904324,1884,3149,3015,2018,54312,612762,693904,2664,4816,2932,3795,5947,31.575306807693888,11.757812605679836,2152,1,500464,12462,997,0,780,1801
4213,0,0,1,0,56,1,1761,0,0,1912680,7121520,50.19960159204453,2278,3521,3279,2520,44512,587808,604764,2584,5346,3068,3585,6347,27.54995462791182,15.85472276477845,2762,1,539280,30734,759,0,306,2067
4214,1,0,0,0,46,0,252,1,0,30780,208170,9.486832980505138,60,582,432,90,55350,520425,568998,2163,2403,2463,2655,2895,18.49324200890693,12.384480471957746,240,1,22140,15150,342,0,2223,1971
4215,1,0,0,0,46,0,227,1,0,36180,249156,10.392304845413264,19,570,443,108,56386,537531,558294,2180,2415,2434,2642,2877,18.303005217723125,11.385697187787974,235,1,26136,14859,335,0,2199,1972
4216,1,0,0,0,44,0,73,1,0,296238,1143723,22.561028345356956,509,1091,1091,509,51744,519057,503328,2247,2756,2247,2829,3338,24.124676163629637,0.0,509,1,114016,0,582,0,1738,1665
4217,1,0,0,0,44,0,76,1,0,322317,1192626,23.043437243605826,531,1138,1138,531,52948,548024,487382,2246,2777,2246,2853,3384,24.63736998950984,0.0,531,1,115227,0,607,0,1715,1639
4218,1,0,0,0,44,0,435,0,0,262386,1715184,27.820855486487112,774,1113,1113,774,55822,500816,547352,2216,2990,2216,2555,3329,18.411952639521967,0.0,774,0,191178,0,339,0,1442,1877
4219,1,0,0,0,44,0,832,1,0,446313,2695923,34.68429039204925,1161,1616,1574,1203,41514,497502,419067,2199,3444,2283,2612,3857,19.261360284258224,6.570697549716149,1245,1,224961,7308,371,0,1038,1870
4220,1,0,0,0,45,0,783,1,0,500400,2719200,34.64101615137755,1140,1677,1617,1200,18923,337634,287782,2206,3466,2326,2683,3943,20.42057785666214,8.910540554035812,1260,1,152400,8520,417,0,1066,1849
4221,1,0,0,0,44,0,691,0,1,610800,2659200,34.64101615137755,1200,1709,1709,1200,50750,449848,554000,2216,3416,2216,2725,3925,22.561028345356956,0.0,1200,1,300000,0,509,0,1016,1707
4222,1,0,0,0,43,0,403,0,0,1084058,2744850,35.52463933666322,1232,2151,2121,1262,35502,398025,421950,2145,3437,2205,3034,4326,29.30870177950569,5.531194905403055,1292,0,244828,3510,859,0,913,1316
4223,1,0,0,0,43,0,385,0,0,1126106,2761883,35.651086939951774,1241,2187,2157,1271,44521,458503,458503,2143,3444,2203,3059,4360,29.765752132274432,5.478746393072713,1301,0,268181,4020,886,0,902,1287
4224,1,0,0,0,43,0,368,0,0,1171748,2784504,35.805027579936315,1282,2196,2196,1282,46886,516936,427884,2172,3454,2172,3086,4368,30.23243291566195,0.0,1282,0,252554,0,914,0,890,1258
4225,1,0,0,0,43,0,350,0,0,1217064,2819144,35.94440151122286,1292,2234,2234,1292,35850,521498,327300,2182,3474,2182,3124,4416,30.692018506445613,0.0,1292,0,193800,0,942,0,890,1240
4226,1,0,0,0,45,0,315,1,0,1729494,2631585,34.161381705077446,1014,2802,2649,1167,16986,335995,257070,2102,3422,2408,3737,5057,38.49675310984031,13.748592947072089,1320,1,133038,23715,1482,0,1088,773
4227,1,0,0,0,44,0,507,1,0,1634850,2358300,32.4037034920393,860,2797,2607,1050,27202,300964,455938,2056,3296,2436,3803,5043,39.45883931389772,14.885434894692242,1240,1,213150,6840,1557,0,1196,689
4228,1,0,0,0,42,0,611,0,0,1316826,1883070,29.698484809834994,882,2375,2375,882,47925,480375,454755,2135,3017,2135,3628,4510,38.63935817272331,0.0,882,0,187866,0,1493,0,1253,642
4229,1,0,0,0,42,0,608,0,0,1295268,1870360,29.563490998188964,844,2386,2356,874,46002,526440,400180,2110,3014,2170,3622,4526,38.49675310984031,5.514871952411144,904,0,163438,5910,1482,0,1266,658
4230,1,0,0,0,47,0,483,0,1,1249270,2126916,30.033314835362415,465,2724,2287,902,43680,528192,459810,1921,3260,2795,3743,5082,37.21558813185679,22.253882753603822,1339,1,175890,73416,1385,0,1456,973
4231,1,0,0,0,47,0,397,0,1,1394604,2352645,31.606961258558215,553,2841,2395,999,52437,544005,534585,1909,3354,2801,3751,5196,37.36308338453881,21.78325673221013,1445,1,226773,61548,1396,0,1356,959
4232,1,0,0,0,47,0,355,0,1,1390550,2388295,31.85906464414798,591,2809,2385,1015,54520,545896,552955,1929,3368,2777,3723,5162,37.013511046643494,21.288125545115367,1439,1,238525,54696,1370,0,1338,983
4233,1,0,0,0,46,0,267,0,1,1382850,2457000,32.4037034920393,668,2749,2367,1050,52731,507780,568620,1958,3390,2722,3657,5089,36.29049462324811,20.285485236964693,1432,1,255150,37818,1317,0,1290,1023
4234,1,0,0,0,46,0,223,0,1,1378788,2490576,32.68026927673638,707,2720,2359,1068,50882,480392,576004,1971,3400,2693,3623,5052,35.93048844644336,19.752473857671298,1429,1,263796,28519,1291,0,1264,1041
4235,1,0,0,0,46,0,179,0,1,1376142,2522927,32.96968304366907,748,2692,2353,1087,49302,459558,577929,1982,3408,2660,3587,5013,35.58089374931439,19.121622092417443,1426,1,270663,22035,1266,0,1234,1055
4236,1,0,0,0,45,0,92,0,1,1364445,2576162,33.51119216023208,826,2635,2338,1123,51204,467976,575794,1997,3417,2591,3509,4929,34.85685011586675,17.82611447662445,1420,1,281873,20493,1215,0,1171,1079
4237,1,0,0,0,45,0,50,0,1,1356600,2601480,33.76388603226827,863,2607,2330,1140,55575,513450,563654,2005,3422,2559,3472,4889,34.49637662132068,17.180890375359095,1417,1,281580,27146,1190,0,1142,1092
4238,1,0,0,0,45,0,7,0,1,1349070,2635608,34.02939905434711,903,2578,2323,1158,55800,564448,512100,2021,3434,2531,3441,4854,34.132096331752024,16.50672641415702,1413,1,260550,37995,1165,0,1118,1111
4239,1,0,0,0,45,0,36,0,1,1340640,2682456,34.292856398964496,942,2550,2316,1176,50546,579374,453919,2047,3457,2515,3421,4831,33.76388603226827,15.952178609495974,1410,1,234024,42822,1140,0,1105,1141
4240,1,0,0,0,45,0,79,0,1,1333620,2735355,34.56877203488721,983,2523,2311,1195,54750,572250,501291,2077,3484,2501,3405,4812,33.406586176980134,15.42479684557981,1407,1,261705,33920,1116,0,1094,1173
4241,1,0,0,0,45,0,122,0,1,1325688,2773990,34.84250278036869,1022,2498,2306,1214,56386,532405,552970,2093,3499,2477,3377,4783,33.04542328371661,14.744899158146904,1406,1,293788,22080,1092,0,1071,1193
4242,1,0,0,0,44,0,425,0,1,1267014,2995748,36.851051545376556,1298,2351,2291,1358,50094,436788,558118,2146,3564,2266,3139,4557,30.54504869860253,8.016064826688304,1418,1,343574,2760,933,0,848,1273
4243,1,0,0,0,43,0,467,0,1,1257648,3018631,37.134889255254286,1337,2333,2291,1379,51250,448745,547250,2147,3568,2231,3101,4522,30.199337741083,7.028254131782222,1421,1,344750,2310,912,0,810,1277
4244,1,0,0,0,43,0,509,0,1,1249692,3049977,37.429934544425805,1371,2323,2293,1401,52920,470232,533365,2147,3578,2207,3069,4500,29.866369046136157,5.753771868478424,1431,1,343245,2220,892,0,776,1285
4245,1,0,0,0,43,0,551,0,1,1240856,3082218,37.72267222772003,1393,2325,2295,1423,55144,489516,528504,2136,3589,2196,3038,4491,29.5296461204668,5.572104574801163,1453,1,347212,2790,872,0,743,1294
4246,1,0,0,0,43,0,592,0,1,1232585,3118310,38.01315561749642,1445,2298,2298,1445,56635,507130,520078,2158,3603,2158,3011,4456,29.206163733020468,0.0,1445,1,348245,0,853,0,713,1305
4247,1,0,0,0,43,0,647,0,1,1193808,3145450,38.24918299781056,1463,2279,2279,1463,50848,488050,481600,2150,3613,2150,2966,4429,28.5657137141714,0.0,1463,1,327712,0,816,0,687,1334
4248,1,0,0,0,43,0,664,1,0,922032,2941336,36.71511950137164,1348,2032,2032,1348,41600,453856,436400,2182,3530,2182,2866,4214,26.153393661244042,0.0,1348,1,269600,0,684,0,834,1498
4249,1,0,0,0,44,0,647,1,0,862620,2935522,36.15245496505044,1247,2027,1967,1307,29140,422248,348130,2186,3553,2306,2906,4273,25.69046515733026,8.334399795261145,1367,1,202585,9900,660,0,939,1586
4250,1,0,0,0,45,0,606,1,0,882360,2937330,35.91656999213594,1200,2064,1974,1290,24182,487278,257301,2187,3567,2367,2961,4341,26.153393661244042,9.965825211365143,1380,1,145770,20880,684,0,987,1593
4251,1,0,0,0,46,0,996,1,0,279072,2859264,34.9857113690718,1157,1519,1452,1224,36828,462528,434496,2269,3560,2403,2564,3855,15.0996688705415,8.499160266369426,1291,1,227664,9782,228,0,1112,2108
4252,1,0,0,0,46,0,1092,0,1,129600,2785200,34.64101615137755,1158,1350,1308,1200,55860,529188,568645,2279,3521,2363,2429,3671,10.392304845413264,6.570697549716149,1242,1,294000,4452,108,0,1121,2213
4253,1,0,0,0,46,0,1050,0,1,180000,2774400,34.64101615137755,1200,1350,1350,1200,52192,538696,517888,2312,3512,2312,2462,3662,12.24744871391589,0.0,1200,1,268800,0,150,0,1112,2162
4254,1,0,0,0,41,0,94,0,1,701712,1855284,29.765752132274432,856,1708,1678,886,55575,471150,517218,2064,2980,2124,2886,3802,28.142494558940577,5.531194905403055,916,1,218842,2940,792,0,1208,1302
4255,1,0,0,0,41,0,13,0,0,706398,1734720,28.879058156387302,834,1681,1681,834,46487,476320,422240,2080,2914,2080,2927,3761,29.103264421710495,0.0,834,0,169302,0,847,0,1246,1233
4256,1,0,0,0,41,0,271,1,0,290220,866040,20.493901531919196,420,1111,1111,420,50778,447454,482508,2062,2482,2062,2753,3173,26.28687885618983,0.0,420,1,98280,0,691,0,1642,1371
4257,1,0,0,0,42,0,232,1,0,364769,1055385,22.338307903688676,298,1431,1230,499,32040,380700,376470,1914,2614,2316,2846,3546,27.03701166919155,14.74661454265269,700,1,88822,26130,731,0,1616,1384
4258,1,0,0,0,42,0,225,1,0,382356,1093404,22.715633383201094,288,1485,1257,516,31062,394134,353873,1891,2635,2347,2860,3604,27.2213151776324,15.67997926561349,744,1,86172,33972,741,0,1603,1378
4259,1,0,0,0,42,0,387,1,0,340168,893362,20.518284528683193,187,1463,1229,421,39117,468962,375594,1888,2543,2356,2930,3585,28.42534080710379,15.347721065664544,655,1,74517,42822,808,0,1701,1314
4260,0,1,1,0,64,0,404,0,0,11972352,11737600,60.56401571890688,3608,6992,6932,3668,45144,691200,668800,3140,6868,3260,6464,10192,57.1314274283428,7.789174875971784,3728,0,766612,8580,3264,1,468,64
4261,0,1,1,0,58,0,1894,0,0,874752,1125888,19.595917942265423,324,2722,2662,384,31878,580536,472052,2872,3316,2992,5210,5654,47.7283982551269,7.849311256600636,444,1,61824,10260,2278,0,2548,654
4262,0,1,1,0,58,0,1149,0,0,524650,1026200,18.708286933869708,15,2184,1849,350,37736,621584,521896,2597,3282,3267,4431,5116,38.71692136521188,18.66037799535698,685,1,62300,57620,1499,0,2582,1433
4263,0,1,1,0,58,0,301,0,0,185742,891072,17.4928556845359,0,1219,913,306,46640,617344,640640,2606,3218,3218,3519,4131,24.63736998950984,17.959741683475702,612,1,67320,37944,607,0,2606,2305
4264,0,0,1,0,56,1,370,0,0,1304424,3784440,36.6333181680284,1300,2356,2314,1342,50388,642960,623220,2778,4162,2862,3792,5176,31.176914536239792,6.48074069840786,1384,0,296582,6006,972,1,1478,1848
4265,0,0,1,0,56,1,295,0,0,1584800,3998790,37.61648574760805,1385,2565,2535,1415,47840,649980,587808,2796,4241,2856,3946,5391,33.46640106136302,5.531194905403055,1445,0,294320,4800,1120,1,1411,1706
4266,0,0,1,0,56,1,281,0,0,1645650,4044006,37.82856063875548,1389,2623,2581,1431,48048,652806,587808,2784,4257,2868,3976,5449,33.91164991562634,6.481658975540136,1473,0,297648,6762,1150,1,1395,1676
4267,0,0,1,0,57,1,42,0,0,2617483,4733432,40.48456495999432,1609,3266,3236,1639,52704,704672,623808,2858,4527,2918,4485,6154,39.96248240537617,5.501408174353464,1669,1,354024,4950,1597,0,1249,1291
4268,0,0,1,0,57,1,251,0,0,2517122,4975866,41.43669871020132,1622,3278,3183,1717,55161,704214,657846,2803,4615,2993,4364,6176,38.28837943815329,9.759997214798725,1812,1,389759,14060,1466,0,1181,1432
4269,0,0,1,0,57,1,410,0,0,2422875,5136850,42.13074886588179,1563,3352,3140,1775,54880,709030,648256,2682,4669,3106,4259,6246,36.945906403822335,14.560948641917447,1987,1,397600,32648,1365,0,1119,1529
4270,0,0,1,0,57,1,491,0,0,2374890,5230176,42.49705872175156,1534,3393,3121,1806,55370,709520,654496,2624,4702,3168,4211,6289,36.26292872893749,16.49381556828984,2078,1,408156,41072,1315,0,1090,1581
4271,0,0,0,0,56,1,900,1,0,2144524,5597168,44.51965857910413,1812,3234,3064,1982,53965,607160,708824,2654,4806,2994,3906,6058,32.89376840679705,13.402306702748659,2152,1,497482,13940,1082,0,842,1742
4272,0,0,0,0,55,1,1021,1,0,2078760,5701800,45.16635916254486,1932,3167,3059,2040,54340,614900,690365,2687,4835,2903,3814,5962,31.921779399024736,10.60004836173973,2148,1,503880,10368,1019,0,755,1776
4273,0,0,0,0,55,1,1061,1,0,2057940,5741220,45.387222871640866,1965,3154,3059,2060,54120,613140,685602,2692,4847,2882,3786,5941,31.606961258558215,9.886585106410566,2155,1,506760,9310,999,0,727,1788
4274,0,0,0,0,55,1,1102,1,0,2037299,5783099,45.617978911828175,1996,3145,3060,2081,54168,616938,678076,2694,4860,2864,3758,5924,31.28897569432403,9.321211371972165,2166,1,507764,8755,979,0,698,1800
4275,1,0,0,0,45,0,124,1,0,96645,578850,15.968719422671311,255,634,634,255,49729,506210,506210,2270,2525,2270,2649,2904,19.467922333931785,0.0,255,1,56865,0,379,0,2015,1891
4276,1,0,0,0,44,0,230,0,1,329000,1567300,26.457513110645905,700,1170,1170,700,56640,528404,537360,2239,2939,2239,2709,3409,21.6794833886788,0.0,700,1,168000,0,470,0,1539,1769
4277,1,0,0,0,44,0,279,0,1,319846,1611504,26.870057685088806,722,1165,1165,722,54900,502200,544608,2232,2954,2232,2675,3397,21.047565179849187,0.0,722,1,176168,0,443,0,1510,1789
4278,1,0,0,0,44,0,321,0,1,307746,1639098,27.16615541441225,738,1155,1155,738,54988,524156,517493,2221,2959,2221,2638,3376,20.42057785666214,0.0,738,1,171954,0,417,0,1483,1804
4279,1,0,0,0,44,0,361,0,1,294032,1672448,27.422618401604176,722,1173,1143,752,53743,535984,495952,2194,2976,2254,2615,3397,19.77371993328519,5.490867587491313,782,1,167696,3960,391,0,1472,1833
4280,1,0,0,0,44,0,401,0,1,280722,1704274,27.694764848252458,737,1163,1133,767,55460,522170,524392,2192,2989,2252,2588,3385,19.131126469708992,5.572104574801163,797,1,181012,3420,366,0,1455,1856
4281,1,0,0,0,44,0,833,1,0,493200,2765619,35.11409973215888,1203,1663,1633,1233,42904,556264,388039,2213,3476,2273,2643,3906,20.0,5.684275577662207,1263,1,213309,6330,400,0,1010,1843
4282,1,0,0,0,45,0,812,0,1,514140,2784720,35.07135583350036,1163,1715,1648,1230,32850,495816,339600,2197,3494,2331,2682,3979,20.445048300260872,8.544404542961196,1297,1,184500,13869,418,0,1034,1846
4283,1,0,0,0,44,0,719,0,1,628530,2746590,35.07135583350036,1200,1771,1741,1230,35649,341649,520289,2203,3463,2263,2744,4004,22.60530911091463,5.8721273231371045,1260,1,286590,690,511,0,1003,1722
4284,1,0,0,0,43,0,384,0,0,1213060,2855800,36.193922141707716,1280,2266,2236,1310,37828,427280,420740,2150,3490,2210,3106,4446,30.430248109405877,5.572104574801163,1340,0,252830,4110,926,0,870,1254
4285,1,0,0,0,43,0,367,0,0,1257960,2890800,36.3318042491699,1320,2273,2273,1320,34428,499320,330690,2190,3510,2190,3143,4463,30.870698080866262,0.0,1320,0,199320,0,953,0,870,1237
4286,1,0,0,0,45,0,224,1,0,1706177,2703745,34.62657938636157,1019,2802,2622,1199,16008,311190,261580,2075,3454,2435,3678,5057,37.72267222772003,14.542125105462588,1379,1,139084,24660,1423,0,1056,832
4287,1,0,0,0,45,0,250,1,0,1695239,2679495,34.39476704383968,1003,2796,2616,1183,10880,289920,192525,2085,3448,2445,3698,5061,37.8549864614954,14.727164449499208,1363,1,100555,27720,1433,0,1082,832
4288,1,0,0,0,42,0,667,1,0,1298934,1827560,29.223278392404914,854,2375,2375,854,47488,453680,479360,2140,2994,2140,3661,4515,39.0,0.0,854,1,191296,0,1521,0,1286,619
4289,1,0,0,0,42,0,665,0,0,1275950,1806610,29.068883707497267,845,2355,2355,845,50160,513120,446842,2138,2983,2138,3648,4493,38.8587184554509,0.0,845,0,176605,0,1510,0,1293,628
4290,1,0,0,0,47,0,480,0,1,1375209,2262348,30.93541659651604,511,2840,2394,957,49275,517716,531900,1918,3321,2810,3801,5204,37.907782842049734,21.847213638504186,1403,1,215325,56642,1437,0,1407,927
4291,1,0,0,0,47,0,437,0,1,1371930,2294334,31.192947920964443,547,2809,2383,973,50830,521118,542340,1932,3331,2784,3768,5167,37.54996671103717,21.373770039492324,1399,1,223790,52398,1410,0,1385,948
4292,1,0,0,0,47,0,394,0,1,1370160,2330460,31.464265445104548,586,2778,2374,990,51504,522588,546128,1950,3344,2758,3738,5132,37.20215047547655,20.85422831974298,1394,1,229680,49288,1384,0,1364,970
4293,1,0,0,0,46,0,350,0,1,1368864,2366784,31.74901573277509,626,2748,2366,1008,51684,514212,554128,1966,3356,2730,3706,5096,36.851051545376556,20.303908769943586,1390,1,237888,42784,1358,0,1340,990
4294,1,0,0,0,46,0,218,0,1,1364048,2466352,32.61901286060018,745,2665,2346,1064,50652,465918,584136,1999,3382,2637,3600,4983,35.805027579936315,18.601114081787884,1383,1,268128,20097,1282,0,1254,1036
4295,1,0,0,0,46,0,174,0,1,1358992,2494010,32.89376840679705,785,2635,2338,1082,50347,458695,583165,2008,3387,2602,3561,4940,35.4400902933387,17.908164456931132,1379,1,273746,16929,1256,0,1223,1049
4296,1,0,0,0,45,0,132,0,1,1352869,2517809,33.15116890850155,822,2607,2330,1099,50546,455909,581914,2014,3390,2568,3522,4898,35.08560958569767,17.263891315603534,1376,1,279146,15235,1231,0,1192,1060
4297,1,0,0,0,45,0,48,0,1,1340388,2571912,33.67491648096547,900,2550,2316,1134,56376,551124,526176,2034,3402,2502,3450,4818,34.38022687534217,15.811388300841896,1368,1,263088,32058,1182,0,1134,1086
4298,1,0,0,0,45,0,5,0,1,1335174,2619616,33.95585369269929,941,2523,2311,1153,50292,577088,449856,2060,3425,2484,3430,4795,34.02939905434711,15.202029772713532,1365,1,228294,39220,1158,0,1119,1114
4299,1,0,0,0,45,0,81,0,1,1322010,2713098,34.51086785347479,1021,2471,2301,1191,56640,537608,546720,2108,3469,2448,3388,4749,33.31666249791537,13.990241258928085,1361,1,285840,19720,1110,0,1087,1168
4300,1,0,0,0,45,0,167,0,1,1309784,2779598,35.08560958569767,1104,2422,2295,1231,53714,483212,566758,2131,3489,2385,3322,4680,32.61901286060018,12.14464378580736,1358,1,308981,9144,1064,0,1027,1194
4301,1,0,0,0,44,0,339,0,1,1283440,2907465,36.26292872893749,1273,2333,2291,1315,50600,442200,559383,2169,3526,2253,3187,4544,31.240998703626616,7.104767262655114,1357,1,332695,2016,976,0,896,1235
4302,1,0,0,0,43,0,382,0,1,1276835,2933378,36.565010597564445,1307,2322,2292,1337,48576,421248,555082,2164,3531,2224,3149,4516,30.903074280724887,5.652706486041966,1367,1,338261,1080,955,0,857,1239
4303,1,0,0,0,43,0,424,0,1,1268372,2953650,36.851051545376556,1328,2322,2292,1358,51612,443700,550275,2145,3533,2205,3109,4497,30.56141357987225,5.684275577662207,1388,1,343574,1650,934,0,817,1241
4304,1,0,0,0,43,0,466,0,1,1261320,2984940,37.14835124201342,1380,2294,2294,1380,55822,488838,534261,2163,3543,2163,3077,4457,30.23243291566195,0.0,1380,1,340860,0,914,0,783,1249
4305,1,0,0,0,43,0,549,0,1,1248300,3072300,37.749172176353746,1425,2301,2301,1425,46620,478632,452760,2156,3581,2156,3032,4457,29.597297173897484,0.0,1425,1,299250,0,876,0,731,1280
4306,1,0,0,0,44,0,651,1,0,927322,3016816,36.6333181680284,1247,2128,2033,1342,24960,467584,269760,2153,3590,2343,2939,4376,26.28687885618983,10.097077230934874,1437,1,161040,20900,691,0,906,1557
4307,1,0,0,0,45,0,641,1,0,920412,3011652,36.49657518178932,1290,2065,2023,1332,32178,391153,420546,2219,3593,2303,2952,4326,26.28687885618983,6.955109380145743,1374,1,247752,4704,691,0,929,1570
4308,1,0,0,0,46,0,892,1,0,530400,3025100,36.05551275463989,1150,1858,1708,1300,32550,488670,360685,2177,3627,2477,2735,4185,20.199009876724155,12.429640165330436,1450,1,201500,28800,408,0,1027,1919
4309,1,0,0,0,46,0,1032,0,1,269568,2922816,35.32704346531139,1140,1572,1464,1248,46440,505872,503530,2234,3590,2450,2558,3914,14.696938456699069,10.62681426149494,1356,1,268320,14796,216,0,1094,2126
4310,1,0,0,0,46,0,1096,0,1,164820,2851140,35.07135583350036,1200,1394,1364,1230,51684,507642,547048,2288,3548,2348,2452,3712,11.575836902790225,5.5503012171862105,1260,1,290280,3390,134,0,1088,2184
4311,1,0,0,0,46,0,1080,0,1,184500,2842530,35.07135583350036,1230,1380,1380,1230,49268,522286,503798,2311,3541,2311,2461,3691,12.24744871391589,0.0,1230,1,268140,0,150,0,1081,2161
4312,1,0,0,0,46,0,897,1,0,438048,2922816,35.32704346531139,1114,1733,1599,1248,39192,498846,430928,2208,3590,2476,2693,4075,18.734993995195193,11.825513470936757,1382,1,229632,22378,351,0,1094,1991
4313,1,0,0,0,41,0,67,0,0,707000,1826125,29.58039891549808,875,1683,1683,875,45552,457053,434096,2087,2962,2087,2895,3770,28.42534080710379,0.0,875,0,182000,0,808,0,1212,1279
4314,1,0,0,0,41,0,271,0,0,335070,961146,21.42428528562855,399,1249,1189,459,48856,412518,519312,2034,2553,2154,2824,3343,27.018512172212592,7.9730082341141015,519,1,113832,3900,730,0,1635,1364
4315,1,0,0,0,41,0,271,1,0,325622,934923,21.236760581595302,451,1173,1173,451,47736,422892,485082,2073,2524,2073,2795,3246,26.870057685088806,0.0,451,1,105534,0,722,0,1622,1351
4316,0,1,1,0,64,0,201,0,0,11888950,11367100,59.58187643906493,3490,6959,6899,3550,44064,691632,653208,3142,6752,3262,6551,10161,57.87054518492115,7.810249675906654,3610,0,724200,8940,3349,1,348,147
4317,0,0,1,0,56,1,345,0,0,1501650,3980430,37.54996671103717,1380,2505,2475,1410,47470,663405,570246,2793,4233,2853,3888,5328,32.63433774416144,5.477225575051661,1440,0,284820,5190,1065,1,1413,1758
4318,0,0,1,0,57,1,183,0,0,2279284,4590648,40.049968789001575,1480,3149,3025,1604,45220,681156,543780,2738,4466,2986,4283,6011,37.69615364994153,11.193732213226145,1728,0,304760,23312,1421,1,1258,1441
4319,0,0,1,0,57,1,95,0,0,2656274,4841030,40.963398296528084,1678,3261,3261,1678,52704,703940,623160,2885,4563,2885,4468,6146,39.786932528155525,0.0,1678,0,362448,0,1583,1,1207,1302
4320,0,0,1,0,57,1,145,0,0,2656536,4926264,41.27953488110059,1704,3263,3263,1704,50141,714077,586873,2891,4595,2891,4450,6154,39.48417404479927,0.0,1704,0,345912,0,1559,1,1187,1332
4321,0,0,1,0,57,1,224,0,0,2608617,5012976,41.60528812542944,1671,3298,3238,1731,53966,700832,645808,2836,4627,2956,4403,6194,38.82009788756334,7.759379671981613,1791,1,386013,9240,1507,0,1165,1389
4322,0,0,1,0,57,1,380,0,0,2511116,5166898,42.261093218230876,1606,3372,3192,1786,52392,682748,642246,2713,4679,3073,4299,6265,37.49666651850535,13.41682193249194,1966,1,396492,27000,1406,0,1107,1487
4323,0,0,1,0,57,1,459,0,0,2464312,5251872,42.61455150532503,1576,3413,3173,1816,54225,696972,650700,2652,4708,3132,4249,6305,36.837480912787726,15.49200062368612,2056,1,408600,36240,1357,0,1076,1535
4324,0,0,1,0,57,1,540,0,0,2417184,5338872,42.988370520409354,1548,3456,3156,1848,55671,696249,667359,2589,4737,3189,4197,6345,36.16628264005025,17.320556188010737,2148,1,426888,42300,1308,0,1041,1581
4325,1,0,0,0,45,0,229,1,0,63342,371466,12.727922061357855,95,620,553,162,52779,502167,552613,2226,2455,2360,2684,2913,19.77371993328519,8.250220863768833,229,1,39042,7102,391,0,2131,1902
4326,1,0,0,0,45,0,179,1,0,82892,483996,14.560219778561036,182,633,603,212,54988,531939,538788,2253,2495,2313,2674,2916,19.77371993328519,5.501408174353464,242,1,50032,3810,391,0,2071,1892
4327,1,0,0,0,45,0,145,1,0,102000,580380,15.968719422671311,255,655,655,255,49720,514376,500720,2276,2531,2276,2676,2931,20.0,0.0,255,1,56100,0,400,0,2021,1876
4328,1,0,0,0,45,0,75,1,0,205164,952845,20.42057785666214,309,1017,909,417,38208,454715,438720,2177,2702,2393,2777,3302,22.181073012818835,10.528806301837951,525,1,80064,15120,492,0,1868,1793
4329,1,0,0,0,45,0,65,1,0,341754,1250886,23.515952032609693,493,1231,1171,553,40420,425256,486330,2202,2815,2322,2880,3493,24.859605789312106,7.810249675906654,613,1,118895,5940,618,0,1709,1644
4330,1,0,0,0,44,0,32,1,0,371844,1334718,24.372115213907882,564,1250,1220,594,50140,489846,516810,2217,2841,2277,2873,3497,25.019992006393608,5.477225575051661,624,1,136620,3630,626,0,1653,1621
4331,1,0,0,0,44,0,69,1,0,363022,1429758,25.25866188063018,638,1207,1207,638,53984,540081,501984,2241,2879,2241,2810,3448,23.853720883753127,0.0,638,1,142912,0,569,0,1603,1672
4332,1,0,0,0,44,0,402,0,0,292528,1720158,27.892651361962706,778,1154,1154,778,54990,519585,517374,2211,2989,2211,2587,3365,19.390719429665317,0.0,778,0,182052,0,376,0,1433,1835
4333,1,0,0,0,44,0,443,0,0,277550,1751737,28.160255680657446,793,1143,1143,793,53724,534578,490398,2209,3002,2209,2559,3352,18.708286933869708,0.0,793,0,176046,0,350,0,1416,1859
4334,1,0,0,0,44,0,484,0,0,261792,1788104,28.42534080710379,808,1132,1132,808,46332,517842,438174,2213,3021,2213,2537,3345,18.0,0.0,808,0,159984,0,324,0,1405,1889
4335,1,0,0,0,44,0,842,0,0,536784,2813052,35.58089374931439,1266,1690,1690,1266,50148,559944,442178,2222,3488,2222,2646,3912,20.591260281974,0.0,1266,0,251934,0,424,0,956,1798
4336,1,0,0,0,44,0,645,0,0,776776,2784288,35.510561809129406,1261,1877,1877,1261,54752,512256,521088,2208,3469,2208,2824,4085,24.819347291981714,0.0,1261,0,297596,0,616,0,947,1592
4337,1,0,0,0,44,0,625,0,0,805794,2783652,35.53871128783372,1263,1901,1901,1263,55800,546592,495900,2204,3467,2204,2842,4105,25.25866188063018,0.0,1263,0,284175,0,638,0,941,1566
4338,1,0,0,0,43,0,399,0,0,1256382,2934234,36.578682316343766,1338,2277,2277,1338,37769,392547,462723,2193,3531,2193,3132,4470,30.643106892089126,0.0,1338,0,282318,0,939,0,855,1254
4339,1,0,0,0,45,0,40,1,0,1638000,2894220,35.4964786985977,1070,2750,2560,1260,20664,385896,282531,2107,3557,2487,3597,5047,36.05551275463989,15.401309595871657,1450,1,154980,32490,1300,0,1037,997
4340,1,0,0,0,42,0,722,0,0,1255008,1745424,28.5657137141714,816,2354,2354,816,48300,491970,449190,2139,2955,2139,3677,4493,39.21734310225516,0.0,816,0,171360,0,1538,0,1323,601
4341,1,0,0,0,47,0,549,0,1,1341940,2170920,30.265491900843113,470,2827,2381,916,46866,507180,519030,1924,3286,2816,3835,5197,38.27531841800928,21.896815780532478,1362,1,200604,57088,1465,0,1454,905
4342,1,0,0,0,47,0,519,0,1,1352332,2205112,30.528675044947494,508,2807,2383,932,49880,508690,548912,1942,3298,2790,3817,5173,38.09199390948182,21.39062269777485,1356,1,216224,48336,1451,0,1434,915
4343,1,0,0,0,47,0,476,0,1,1352325,2238691,30.805843601498726,545,2778,2374,949,52156,521339,556724,1955,3308,2763,3784,5137,37.749172176353746,20.89008048942147,1353,1,223964,46056,1425,0,1410,934
4344,1,0,0,0,47,0,433,0,1,1351434,2274930,31.080540535840107,582,2749,2365,966,53550,529875,560490,1971,3321,2739,3754,5104,37.403208418530085,20.415026810746397,1350,1,229908,44544,1399,0,1389,956
4345,1,0,0,0,46,0,390,0,1,1352016,2311416,31.368774282716245,623,2719,2358,984,54189,523827,570807,1988,3333,2710,3723,5068,37.067505985701274,19.830898668669334,1345,1,239112,38266,1374,0,1365,975
4346,1,0,0,0,46,0,345,0,1,1352044,2347020,31.670175244226233,664,2690,2351,1003,53535,503100,582660,2001,3343,2679,3688,5030,36.71511950137164,19.222373987227797,1342,1,249747,29154,1348,0,1337,992
4347,1,0,0,0,46,0,301,0,1,1352106,2378194,31.96873472629156,703,2664,2345,1022,51408,474708,586404,2008,3349,2646,3650,4991,36.373066958946424,18.664647255689246,1341,1,257544,20735,1323,0,1305,1004
4348,1,0,0,0,45,0,90,0,1,1332000,2506380,33.31666249791537,898,2522,2310,1110,56644,537404,537404,2046,3368,2470,3458,4780,34.64101615137755,15.018336719432035,1322,1,264180,25652,1200,0,1148,1058
4349,1,0,0,0,45,0,47,0,1,1327704,2552669,33.60059523282288,937,2497,2305,1129,51054,574294,454461,2069,3390,2453,3437,4758,34.292856398964496,14.435603895983952,1321,1,226929,34176,1176,0,1132,1085
4350,1,0,0,0,45,0,83,0,1,1315034,2683573,34.48187929913333,1062,2422,2295,1189,54093,494283,557479,2130,3446,2384,3363,4679,33.25657829663178,12.165663908715395,1316,1,293683,10160,1106,0,1068,1151
4351,1,0,0,0,44,0,255,0,1,1295914,2818422,35.679125549822544,1231,2333,2291,1273,52750,467154,553500,2172,3487,2256,3232,4547,31.906112267087632,7.028254131782222,1315,1,318250,2772,1018,0,941,1196
4352,1,0,0,0,44,0,297,0,1,1290118,2846800,35.9722114972099,1264,2321,2291,1294,50853,442200,556600,2170,3494,2230,3197,4521,31.575306807693888,5.8721273231371045,1324,1,327382,1470,997,0,906,1203
4353,1,0,0,0,43,0,381,0,1,1280466,2900784,36.578682316343766,1338,2295,2295,1338,54033,470456,539832,2168,3506,2168,3125,4463,30.93541659651604,0.0,1338,1,333162,0,957,0,830,1211
4354,1,0,0,0,45,0,646,1,0,983520,3104918,36.959437225152655,1281,2171,2086,1366,29520,465965,327312,2188,3639,2358,2993,4444,26.832815729997478,9.607770959340817,1451,1,196704,16660,720,0,907,1553
4355,1,0,0,0,46,0,892,1,0,596748,3113526,36.578682316343766,1146,1976,1784,1338,27824,437476,344396,2135,3665,2519,2773,4303,21.118712081942874,13.98329739283976,1530,1,198024,33024,446,0,989,1881
4356,1,0,0,0,46,0,910,1,0,555104,3102208,36.4417343165772,1153,1921,1746,1328,34903,488224,390112,2161,3664,2511,2754,4257,20.445048300260872,13.4515702780965,1503,1,221776,31325,418,0,1008,1918
4357,1,0,0,0,46,0,1043,0,1,298818,2993288,35.73513677041127,1143,1645,1511,1277,49728,525056,520368,2210,3621,2478,2578,3989,15.297058540778355,11.768410567748846,1411,1,283494,18358,234,0,1067,2110
4358,1,0,0,0,46,0,1077,0,1,243648,2970729,35.62302626111375,1161,1569,1461,1269,52392,552476,519702,2233,3610,2449,2533,3910,13.856406460551018,10.435690064413366,1377,1,281718,16308,192,0,1072,2149
4359,1,0,0,0,46,0,1107,0,1,192780,2930760,35.4964786985977,1260,1413,1413,1260,51493,541958,514046,2326,3586,2326,2479,3739,12.36931687685298,0.0,1260,1,278460,0,153,0,1066,2173
4360,1,0,0,0,46,0,1098,0,1,204120,2929500,35.4964786985977,1260,1422,1422,1260,45795,495225,499875,2325,3585,2325,2487,3747,12.727922061357855,0.0,1260,1,270900,0,162,0,1065,2163
4361,1,0,0,0,47,0,893,0,1,500370,3018899,35.81898937714463,1108,1848,1673,1283,42510,512954,458835,2178,3636,2528,2743,4201,19.748417658131498,13.501111227926843,1458,1,250185,28350,390,0,1070,1963
4362,1,0,0,0,47,0,934,0,1,467495,3049725,35.98610843089316,1083,1868,1656,1295,48090,539295,494550,2143,3650,2567,2716,4223,19.0,14.843417048062975,1507,1,271950,33284,361,0,1060,1994
4363,1,0,0,0,41,0,201,0,1,698022,1967838,30.692018506445613,942,1683,1683,942,50600,480470,459580,2089,3031,2089,2830,3772,27.2213151776324,0.0,942,1,207240,0,741,0,1147,1348
4364,1,0,0,0,41,0,147,0,0,704404,1918104,30.265491900843113,916,1685,1685,916,42240,460680,402048,2094,3010,2094,2863,3779,27.730849247724095,0.0,916,0,175872,0,769,0,1178,1325
4365,1,0,0,0,43,0,215,1,0,715200,1606965,27.294688127912362,611,1839,1705,745,26280,388260,314922,2023,2902,2291,3117,3996,30.983866769659336,12.554798599321837,879,1,108770,21976,960,0,1412,1197
4366,1,0,0,0,44,0,242,1,0,531480,1362072,24.859605789312106,323,1773,1478,618,34776,476064,354844,1909,2822,2499,3064,3977,29.32575659723036,18.034963157243123,913,1,99498,57230,860,0,1586,1344
4367,1,0,0,0,42,0,266,0,0,399627,1101411,22.64950330581225,389,1416,1292,513,38640,360696,493810,2023,2660,2271,2926,3563,27.910571473905726,11.595770371638656,637,1,117990,6324,779,0,1634,1368
4368,1,0,0,0,43,0,247,1,0,404004,1130792,22.891046284519195,332,1487,1295,524,27874,390598,332332,1966,2682,2350,2929,3645,27.76688675382964,14.9090275950914,716,1,80696,30144,771,0,1634,1387
4369,1,0,0,0,43,0,242,1,0,418323,1157772,23.173260452512935,325,1528,1316,537,27531,347116,368676,1944,2693,2368,2935,3684,27.910571473905726,15.560929278697389,749,1,91827,23956,779,0,1619,1377
4370,1,0,0,0,43,0,268,1,0,436320,1162620,23.2379000772445,257,1631,1348,540,26386,359551,340174,1870,2693,2436,2961,3784,28.42534080710379,17.54372795785932,823,1,85320,38205,808,0,1613,1345
4371,1,0,0,0,42,0,585,0,0,198000,505440,15.491933384829668,173,1132,1065,240,53599,457002,520182,2039,2346,2173,2931,3238,28.722813232690143,8.616819548034314,307,1,59280,5025,825,0,1866,1281
4372,0,1,1,0,64,0,223,0,0,12038880,11501430,59.85816569190874,3493,7033,6943,3583,40397,651630,638790,3120,6793,3300,6570,10243,57.96550698475775,9.590813010750445,3673,0,713017,12420,3360,1,373,150
4373,0,1,1,0,57,0,1921,0,0,2106780,2257320,27.92848008753788,750,3511,3481,780,45510,642468,593270,2864,3674,2924,5595,6405,51.97114584074513,5.477225575051661,810,0,159900,4650,2701,1,2114,193
4374,0,1,1,0,59,0,1726,0,0,554831,824906,16.64331697709324,59,2498,2280,277,18696,452656,366294,2760,3255,3196,4981,5476,44.75488800120049,15.555352978307177,495,1,34071,32482,2003,0,2701,975
4375,0,1,1,0,59,0,847,0,0,690204,1521910,22.561028345356956,21,2353,1865,509,33631,595010,505310,2502,3499,3478,4346,5343,36.823905279043935,22.725203943000377,997,1,86021,80520,1356,0,2481,1634
4376,0,0,1,0,56,1,413,0,0,1372268,3949284,37.36308338453881,1301,2474,2379,1396,44091,585603,602577,2734,4225,2924,3812,5303,31.352830813181765,9.751111384664751,1491,0,297348,12065,983,1,1433,1846
4377,0,0,1,0,57,1,235,0,0,2677434,5087652,41.92851058647326,1698,3341,3281,1758,50794,674302,630892,2834,4652,2954,4417,6235,39.02563260217571,7.750803389552748,1818,1,383244,9120,1523,0,1136,1371
4378,0,0,0,0,57,1,626,1,0,2436495,5484495,43.64630568559039,1586,3503,3184,1905,56643,682323,688081,2560,4784,3198,4158,6382,35.76310948449533,18.31734046780737,2224,1,455295,39875,1279,0,974,1600
4379,0,0,0,0,56,1,943,1,0,2259888,5733647,45.24378410345447,1939,3259,3151,2047,55029,619021,697449,2693,4848,2909,3905,6060,33.2264954516723,10.655033166942168,2155,1,509703,9828,1104,0,754,1697
4380,1,0,0,0,45,0,193,1,0,95988,520068,15.0996688705415,228,649,649,228,52437,517787,526911,2281,2509,2281,2702,2930,20.518284528683193,0.0,228,1,52668,0,421,0,2053,1860
4381,1,0,0,0,45,0,69,1,0,267652,1108360,22.0,357,1164,1037,484,38805,455710,446550,2163,2774,2417,2843,3454,23.515952032609693,11.526200699097002,611,1,94380,17399,553,0,1806,1737
4382,1,0,0,0,44,0,395,1,0,306150,1746625,28.0178514522438,755,1205,1175,785,45507,438325,513975,2195,3010,2255,2615,3430,19.748417658131498,5.572104574801163,815,1,181335,2730,390,0,1440,1835
4383,1,0,0,0,44,0,484,0,0,274365,1812447,28.61817604250837,819,1154,1154,819,41990,489073,420470,2213,3032,2213,2548,3367,18.303005217723125,0.0,819,0,155610,0,335,0,1394,1878
4384,1,0,0,0,44,0,525,0,0,257706,1852314,28.879058156387302,804,1173,1143,834,34776,479736,357581,2191,3055,2251,2530,3394,17.578395831246947,5.684275577662207,864,0,134274,5820,309,0,1387,1912
4385,1,0,0,0,45,0,805,0,1,625650,2933460,35.91656999213594,1223,1842,1775,1290,33880,550308,318360,2207,3564,2341,2759,4116,22.02271554554524,8.862806978978044,1357,1,180600,15544,485,0,984,1789
4386,1,0,0,0,44,0,616,0,0,881280,2855088,36.0,1296,1976,1976,1296,53760,528720,493472,2203,3499,2203,2883,4179,26.076809620810597,0.0,1296,0,290304,0,680,0,907,1523
4387,1,0,0,0,44,0,596,0,0,913197,2862996,36.0416425818802,1299,2002,2002,1299,52250,551000,460636,2204,3503,2204,2907,4206,26.514147167125703,0.0,1299,0,271491,0,703,0,905,1501
4388,1,0,0,0,44,0,576,0,0,945252,2877420,36.08323710533743,1272,2058,2028,1302,41750,552500,369070,2180,3512,2240,2936,4268,26.94438717061496,5.531194905403055,1332,0,217434,6480,726,0,908,1484
4389,1,0,0,0,43,0,397,0,0,1347104,3020320,37.094473981982816,1346,2385,2355,1376,37467,454365,397295,2165,3571,2225,3174,4580,31.28897569432403,5.483301264452448,1406,0,249056,4860,979,0,819,1216
4390,1,0,0,0,45,0,216,1,0,1550836,3109820,36.851051545376556,1176,2682,2500,1358,18626,318310,306860,2108,3648,2472,3432,4972,33.793490497431605,14.547568719589476,1540,1,181972,21840,1142,0,932,1148
4391,1,0,0,0,46,0,297,1,0,1539198,2558724,33.18132004607411,859,2741,2499,1101,28050,395080,383460,2082,3425,2566,3722,5065,37.389838191679836,17.36670340791414,1343,1,181665,31460,1398,0,1223,926
4392,1,0,0,0,46,0,430,1,0,1476531,2354909,31.921779399024736,736,2751,2468,1019,29032,351272,441401,2028,3330,2594,3760,5062,38.06573262134856,18.127329115572074,1302,1,194629,21791,1449,0,1292,862
4393,1,0,0,0,42,0,780,0,0,1256869,1707174,28.231188426986208,797,2374,2374,797,49494,484092,469098,2142,2939,2142,3719,4516,39.71145930332956,0.0,797,1,174543,0,1577,0,1345,565
4394,1,0,0,0,47,0,602,0,1,1327880,2115530,29.832867780352597,466,2806,2382,890,48108,501547,541956,1953,3267,2801,3869,5183,38.62641583165593,21.462191441344597,1314,1,202920,47912,1492,0,1487,885
4395,1,0,0,0,47,0,559,0,1,1329662,2147776,30.116440692751194,503,2777,2373,907,49533,494912,561216,1964,3275,2772,3834,5145,38.28837943815329,20.973250954647128,1311,1,214959,40400,1466,0,1461,902
4396,1,0,0,0,47,0,517,0,1,1331484,2179716,30.397368307141328,542,2747,2365,924,51146,504826,563801,1977,3283,2741,3800,5106,37.960505792204614,20.398817706738477,1306,1,220836,39346,1441,0,1435,918
4397,1,0,0,0,46,0,386,0,1,1336335,2286944,31.28897569432403,660,2663,2344,979,54216,504576,586336,2017,3315,2655,3701,4999,36.945906403822335,18.697204839375203,1298,1,245729,25839,1365,0,1357,971
4398,1,0,0,0,45,0,258,0,1,1331280,2366376,32.12475680841802,777,2577,2322,1032,50038,451721,582422,2038,3325,2548,3583,4870,35.91656999213594,16.61788020703945,1287,1,262128,12750,1290,0,1261,1003
4399,1,0,0,0,45,0,216,0,1,1329300,2391900,32.4037034920393,816,2550,2316,1050,49784,446488,578612,2044,3328,2512,3544,4828,35.58089374931439,15.880004493949286,1284,1,266700,11700,1266,0,1228,1012
4400,1,0,0,0,45,0,174,0,1,1326456,2415816,32.68026927673638,856,2522,2310,1068,50038,445614,574548,2050,3330,2474,3504,4784,35.24202037341219,15.029763150103136,1280,1,271272,11024,1242,0,1194,1020
4401,1,0,0,0,44,0,131,0,1,1323966,2443576,32.96968304366907,895,2497,2305,1087,56088,512544,553008,2056,3335,2440,3466,4745,34.899856733230294,14.26023739270955,1279,1,267402,19392,1218,0,1161,1030
4402,1,0,0,0,45,0,46,0,1,1319672,2540256,33.555923471125034,976,2448,2298,1126,52290,561744,473760,2106,3382,2406,3428,4704,34.23448553724738,12.967447346601379,1276,1,236460,23850,1172,0,1130,1084
4403,1,0,0,0,44,0,41,0,1,1314042,2617581,34.161381705077446,1059,2401,2293,1167,53352,484488,554021,2135,3410,2351,3369,4644,33.555923471125034,11.159351262885526,1275,1,288249,8100,1126,0,1076,1117
4404,1,0,0,0,44,0,84,0,1,1311552,2651616,34.46737587922817,1103,2377,2292,1188,52364,473184,551304,2147,3420,2317,3336,4609,33.2264954516723,9.956213246629972,1273,1,293436,5695,1104,0,1044,1128
4405,1,0,0,0,44,0,169,0,1,1305030,2719530,35.07135583350036,1188,2333,2291,1230,52948,479787,539484,2169,3441,2253,3272,4544,32.57299494980466,7.104767262655114,1272,1,300120,3150,1061,0,981,1150
4406,1,0,0,0,44,0,212,0,1,1302080,2754400,35.38361202590826,1222,2322,2292,1252,52644,470800,541200,2170,3452,2230,3240,4522,32.2490309931942,5.684275577662207,1282,1,307992,2100,1040,0,948,1160
4407,1,0,0,0,43,0,339,0,1,1290322,2853470,36.30426972134269,1288,2327,2297,1318,51750,497950,487125,2135,3483,2195,3144,4492,31.28897569432403,5.8721273231371045,1348,1,296550,4230,979,0,847,1186
4408,1,0,0,0,43,0,381,0,1,1287360,2909970,36.61966684720111,1311,2331,2301,1341,39600,477400,390600,2140,3511,2200,3130,4501,30.983866769659336,5.483301264452448,1371,1,241380,5370,960,0,829,1210
4409,1,0,0,0,46,0,798,1,0,834808,3273620,37.36308338453881,1149,2241,1994,1396,35728,412720,476035,2098,3741,2592,2943,4586,24.454038521274967,16.335605863170553,1643,1,283388,24206,598,0,949,1747
4410,1,0,0,0,47,0,982,0,1,466200,3140856,36.49657518178932,1170,1844,1682,1332,45854,535266,476316,2196,3690,2520,2708,4202,18.708286933869708,13.009547964816395,1494,1,269064,26406,350,0,1026,2008
4411,1,0,0,0,46,0,1108,0,1,234780,3001830,35.91656999213594,1290,1472,1472,1290,46134,542191,460746,2327,3617,2327,2509,3799,13.490737563232042,0.0,1290,1,255420,0,182,0,1037,2145
4412,1,0,0,0,47,0,952,1,0,455700,3068814,36.08323710533743,1132,1822,1652,1302,40916,499684,454901,2187,3659,2527,2707,4179,18.708286933869708,13.261035176436632,1472,1,251286,26520,350,0,1055,2007
4413,1,0,0,0,47,0,928,0,1,503808,3096320,36.22154055254967,1111,1897,1696,1312,43400,512120,472000,2159,3672,2561,2744,4257,19.595917942265423,14.435687001794188,1513,1,262400,30954,384,0,1048,1976
4414,1,0,0,0,47,0,957,0,1,475798,3107844,36.30426972134269,1102,1895,1679,1318,45990,516402,495180,2142,3676,2574,2719,4253,19.0,14.937911865307736,1534,1,276780,31536,361,0,1040,1997
4415,1,0,0,0,42,0,334,0,1,679392,2120832,31.74901573277509,1008,1682,1682,1008,52974,458672,511272,2104,3112,2104,2778,3786,25.96150997149434,0.0,1008,1,244944,0,674,0,1096,1430
4416,1,0,0,0,41,0,281,0,1,690066,2061351,31.352830813181765,983,1685,1685,983,49056,459243,469728,2097,3080,2097,2799,3782,26.49528259898354,0.0,983,1,220192,0,702,0,1114,1395
4417,1,0,0,0,42,0,173,0,0,707388,1959064,30.528675044947494,902,1721,1691,932,37410,451930,365748,2072,3034,2132,2861,3823,27.54995462791182,5.7180036243905645,962,0,162168,5400,759,0,1170,1343
4418,1,0,0,0,41,0,271,1,0,399602,1067479,22.60530911091463,511,1293,1293,511,38805,415711,407355,2089,2600,2089,2871,3382,27.964262908219126,0.0,511,1,99645,0,782,0,1578,1307
4419,1,0,0,0,43,0,257,1,0,419748,1145928,23.065125189341593,370,1483,1321,532,19690,385566,236940,1992,2686,2316,2943,3637,28.089143810376278,13.778795592778089,694,1,58520,31752,789,0,1622,1365
4420,1,0,0,0,41,0,594,0,0,202312,507232,15.556349186104045,200,1120,1078,242,55527,467408,521904,2054,2338,2138,2932,3216,28.91366458960192,6.678188844436455,284,1,60258,3780,836,0,1854,1260
4421,0,1,1,0,60,0,1440,0,0,9927424,7616384,50.11985634456667,2470,6506,6464,2512,53590,697360,706456,2990,5544,3074,6984,9538,62.864934582006846,6.488991180673202,2554,0,585296,5460,3952,1,520,920
4422,0,0,1,0,56,1,401,0,0,1518552,4105017,38.06573262134856,1364,2582,2497,1449,39372,577932,546769,2748,4282,2918,3881,5415,32.37282811247729,9.235136611923052,1534,1,279657,12495,1048,0,1384,1785
4423,0,0,1,0,56,1,356,0,0,1694912,4222360,38.62641583165593,1462,2658,2628,1492,46631,625430,597130,2800,4322,2860,3966,5488,33.704599092705436,5.483301264452448,1522,0,314812,4380,1136,1,1338,1694
4424,0,0,1,0,56,1,303,0,0,1949668,4420596,39.44616584663204,1489,2876,2809,1556,42222,644907,528426,2774,4397,2908,4094,5717,35.397740040855716,8.189452396126915,1623,0,289416,12060,1253,1,1285,1588
4425,0,0,1,0,57,1,210,0,0,2438200,4791230,40.8656334834051,1580,3220,3130,1670,46452,679953,562324,2779,4539,2959,4329,6089,38.2099463490856,9.522065445080457,1760,0,327320,16290,1460,1,1199,1409
4426,0,0,1,0,57,1,399,0,0,2648160,5323905,42.883563284783136,1657,3461,3279,1839,53088,686115,648480,2713,4734,3077,4335,6356,37.94733192202055,13.492366387597757,2021,1,411936,26936,1440,0,1056,1455
4427,0,0,1,0,57,1,593,0,0,2528394,5506578,43.749285708454714,1590,3559,3235,1914,55926,673218,687603,2553,4791,3201,4198,6436,36.345563690772494,18.4303097237468,2238,1,457446,39852,1321,0,963,1556
4428,1,0,0,0,44,0,477,0,0,290628,1838160,28.77498913987632,828,1179,1179,828,45365,477300,468420,2220,3048,2220,2571,3399,18.734993995195193,0.0,828,0,174708,0,351,0,1392,1869
4429,1,0,0,0,47,0,891,1,0,632362,3194378,36.837480912787726,1015,2165,1823,1357,30459,501402,336622,2012,3711,2696,2820,4519,21.587033144922902,19.475338460884835,1699,1,194051,70452,466,0,997,1888
4430,1,0,0,0,44,0,835,0,0,645624,2935737,36.373066958946424,1323,1811,1811,1323,47718,534779,439362,2219,3542,2219,2707,4030,22.090722034374522,0.0,1323,0,261954,0,488,0,896,1731
4431,1,0,0,0,44,0,428,0,0,1348965,3091320,37.3496987939662,1395,2362,2362,1395,42136,407744,507464,2216,3611,2216,3183,4578,31.096623610932426,0.0,1395,0,319455,0,967,0,821,1249
4432,1,0,0,0,42,0,836,0,0,1260480,1676220,27.92848008753788,780,2396,2396,780,43956,477078,425502,2149,2929,2149,3765,4545,40.19950248448356,0.0,780,0,154440,0,1616,0,1369,533
4433,1,0,0,0,47,0,670,0,1,1289631,2025714,29.13760456866693,423,2794,2368,849,47475,503446,536850,1960,3235,2812,3905,5180,38.97435053981015,21.588052004293072,1275,1,191025,49842,1519,0,1537,867
4434,1,0,0,0,47,0,600,0,1,1307124,2090340,29.698484809834994,500,2746,2364,882,51728,502440,578280,1988,3252,2752,3852,5116,38.49675310984031,20.477995603068862,1264,1,215208,34762,1482,0,1488,888
4435,1,0,0,0,47,0,556,0,1,1310400,2125800,30.0,539,2717,2356,900,52890,507830,581052,2001,3262,2723,3818,5079,38.157568056677825,19.95437536675912,1261,1,221400,33573,1456,0,1462,906
4436,1,0,0,0,47,0,513,0,1,1313658,2160054,30.298514815086232,579,2688,2349,918,52500,494130,588250,2014,3271,2692,3784,5041,37.82856063875548,19.35033785836593,1257,1,229500,26781,1431,0,1435,922
4437,1,0,0,0,46,0,469,0,1,1317422,2190706,30.610455730027933,618,2662,2343,937,52668,488642,589176,2019,3275,2657,3744,5000,37.49666651850535,18.70817239228554,1256,1,236124,22649,1406,0,1401,932
4438,1,0,0,0,46,0,384,0,1,1320361,2252495,31.192947920964443,696,2607,2330,973,52877,483835,585695,2038,3288,2592,3672,4922,36.837480912787726,17.39759738731192,1250,1,246169,18005,1357,0,1342,958
4439,1,0,0,0,46,0,342,0,1,1318680,2278980,31.464265445104548,735,2577,2322,990,51816,469608,584708,2047,3292,2557,3634,4879,36.49657518178932,16.652906969743125,1245,1,251460,15555,1332,0,1312,970
4440,1,0,0,0,45,0,300,0,1,1318464,2306304,31.74901573277509,774,2550,2316,1008,51106,462176,578864,2054,3296,2522,3596,4838,36.16628264005025,15.96454295587695,1242,1,255024,14508,1308,0,1280,980
4441,1,0,0,0,45,0,258,0,1,1317384,2334150,32.03123475609393,814,2522,2310,1026,49196,445900,571025,2063,3301,2487,3559,4797,35.832945734337834,15.150533580255752,1238,1,257526,12296,1284,0,1249,991
4442,1,0,0,0,44,0,173,0,1,1316168,2386552,32.61901286060018,894,2471,2301,1064,52416,466544,565236,2073,3307,2413,3480,4714,35.17101079013795,13.414440520665401,1234,1,268128,12070,1237,0,1179,1006
4443,1,0,0,0,44,0,130,0,1,1315976,2423824,32.92415526630866,934,2448,2298,1084,56364,545584,516516,2086,3320,2386,3450,4684,34.84250278036869,12.639835959643802,1234,1,250404,20250,1214,0,1152,1022
4444,1,0,0,0,44,0,44,0,1,1312832,2518884,33.52610922848042,1016,2400,2292,1124,54756,524394,524394,2133,3365,2349,3409,4641,34.17601498127012,11.137157851700797,1232,1,263016,12096,1168,0,1117,1073
4445,1,0,0,0,44,0,43,0,1,1311708,2588406,34.161381705077446,1100,2358,2291,1167,52328,467998,550064,2151,3385,2285,3342,4576,33.52610922848042,8.748575453901612,1234,1,289416,4355,1124,0,1051,1094
4446,1,0,0,0,43,0,169,0,1,1307322,2687273,35.08560958569767,1231,2293,2293,1231,54390,484626,534835,2183,3414,2183,3245,4476,32.58834147360065,0.0,1231,1,301595,0,1062,0,952,1121
4447,1,0,0,0,43,0,254,0,1,1304072,2766368,35.7211421989835,1246,2328,2298,1276,53352,507312,494304,2138,3444,2198,3190,4496,31.96873472629156,5.959073905325341,1306,1,290928,4200,1022,0,892,1146
4448,1,0,0,0,43,0,295,0,1,1301894,2817958,36.02776706930364,1256,2343,2301,1298,42262,490646,405977,2129,3469,2213,3174,4514,31.670175244226233,6.484411467763075,1340,1,242726,7518,1003,0,873,1168
4449,1,0,0,0,44,0,511,1,0,1205976,3053664,37.1887079635741,1249,2389,2255,1383,27783,417312,324576,2074,3591,2342,3080,4597,29.5296461204668,12.035289626712379,1517,1,203301,23316,872,0,825,1336
4450,1,0,0,0,44,0,607,1,0,1161168,3197481,37.72267222772003,1356,2306,2239,1423,30438,384237,399966,2180,3670,2314,3063,4553,28.5657137141714,8.239962426314323,1490,1,253294,7973,816,0,824,1431
4451,1,0,0,0,47,0,959,1,0,573792,3237728,37.094473981982816,1160,2009,1793,1376,42240,517660,451776,2137,3729,2569,2770,4362,20.42057785666214,14.847084957501849,1592,1,264192,35856,417,0,977,1936
4452,1,0,0,0,46,0,1109,0,1,280052,3073967,36.345563690772494,1321,1533,1533,1321,50616,530556,516594,2327,3648,2327,2539,3860,14.560219778561036,0.0,1321,1,293262,0,212,0,1006,2115
4453,1,0,0,0,46,0,1110,0,1,277200,3071640,36.3318042491699,1320,1530,1530,1320,45969,537537,463073,2327,3647,2327,2537,3857,14.491376746189438,0.0,1320,1,262680,0,210,0,1007,2117
4454,1,0,0,0,42,0,414,0,1,667800,2214450,32.4037034920393,1050,1686,1686,1050,54000,455544,527250,2109,3159,2109,2745,3795,25.219040425836983,0.0,1050,1,262500,0,636,0,1059,1473
4455,1,0,0,0,44,0,263,1,0,504714,1301382,24.310491562286437,411,1625,1445,591,27777,310482,433794,2022,2793,2382,3056,3827,29.223278392404914,14.470712773397308,771,1,116427,9720,854,0,1611,1348
4456,1,0,0,0,42,0,272,1,0,447993,1158546,23.388031127053,517,1396,1366,547,33635,328290,459606,2088,2665,2148,2937,3514,28.61817604250837,6.148342568763683,577,1,118699,1470,819,0,1571,1299
4457,1,0,0,0,42,0,272,1,0,442545,1143015,23.302360395462088,543,1358,1358,543,36292,362060,444155,2105,2648,2105,2920,3463,28.548204847240395,0.0,543,1,114573,0,815,0,1562,1290
4458,1,0,0,0,42,0,268,1,0,440373,1156590,23.302360395462088,448,1449,1354,543,19980,383400,236430,2035,2673,2225,2941,3579,28.478061731796284,10.525591954947746,638,1,60273,18620,811,0,1587,1319
4459,1,0,0,0,42,0,265,1,0,444164,1172221,23.388031127053,423,1483,1359,547,18832,377168,229301,2019,2690,2267,2955,3626,28.495613697550013,12.059737629881619,671,1,58529,24180,812,0,1596,1331
4460,1,0,0,0,43,0,259,1,0,458640,1215200,23.664319132398465,385,1554,1379,560,19690,388430,238700,1995,2730,2345,2989,3724,28.61817604250837,14.267817862757997,735,1,61600,34300,819,0,1610,1351
4461,1,0,0,0,43,0,255,1,0,468856,1241558,23.853720883753127,368,1594,1393,569,22017,390578,268386,1981,2751,2383,3006,3776,28.705400188814647,15.419480652076818,770,1,69987,36984,824,0,1613,1358
4462,1,0,0,0,41,0,601,0,0,178542,453658,14.7648230602334,218,1037,1037,218,50576,453658,482792,2081,2299,2081,2900,3118,28.61817604250837,0.0,218,1,50576,0,819,0,1863,1262
4463,0,1,1,0,59,0,1932,0,0,4379869,3980847,36.59234892706397,1205,4744,4610,1339,56880,704601,713520,2839,4312,3107,6244,7717,57.19265687131522,11.837739672445862,1473,0,321360,16214,3271,1,1634,298
4464,0,0,1,0,57,1,262,0,0,2345208,4780488,40.84115571332428,1515,3227,3074,1668,43700,659180,544540,2713,4534,3019,4272,6093,37.49666651850535,12.395127579391273,1821,0,316920,27540,1406,1,1198,1460
4465,0,0,1,0,57,1,260,0,0,2604261,5051112,41.82104733265297,1719,3268,3238,1749,43166,652688,551608,2858,4637,2918,4377,6156,38.58756276314948,5.572104574801163,1779,0,334059,5250,1489,1,1139,1399
4466,0,0,1,0,57,1,266,0,0,2632695,5092812,41.96427051671457,1731,3286,3256,1761,44426,662268,561048,2862,4653,2922,4387,6178,38.66522985836241,5.5965095842615735,1791,0,341634,5250,1495,1,1131,1397
4467,0,0,1,0,57,1,273,0,0,2659500,5132835,42.1070065428546,1731,3315,3273,1773,45472,671640,567420,2853,4668,2937,4395,6210,38.72983346207417,6.538739683827756,1815,0,347508,7392,1500,1,1122,1395
4468,0,0,1,0,58,1,285,0,0,2720374,5215998,42.40283009422838,1731,3378,3311,1798,49585,681735,612111,2834,4699,2968,4414,6279,38.897300677553446,8.286047041568583,1865,1,379378,10854,1513,0,1103,1388
4469,0,0,0,0,57,1,638,1,0,2578008,5605896,44.22668877499196,1673,3557,3274,1956,56088,653448,705036,2583,4822,3149,4184,6423,36.30426972134269,17.24154634033139,2239,1,481176,29715,1318,0,910,1548
4470,0,0,0,0,56,1,869,1,0,2446962,5778864,45.36518488885502,1924,3381,3247,2058,54467,609336,704808,2674,4866,2942,3997,6189,34.48187929913333,11.850228582282101,2192,1,516558,11122,1189,0,750,1619
4471,0,0,1,0,57,1,761,0,0,2318550,5602350,44.15880433163923,1860,3229,3139,1950,44676,629187,586092,2783,4823,2963,4062,6102,34.48187929913333,10.053568030701648,2040,0,397800,13680,1189,1,923,1684
4472,1,0,0,0,45,0,153,1,0,382900,1589000,26.457513110645905,640,1307,1247,700,33286,424490,404060,2210,2970,2330,2817,3577,23.388031127053,8.111420134500735,760,1,124600,8460,547,0,1570,1723
4473,1,0,0,0,44,0,507,0,0,290358,1892421,29.13760456866693,849,1191,1191,849,41230,483693,423510,2229,3078,2229,2571,3420,18.49324200890693,0.0,849,0,161310,0,342,0,1380,1887
4474,1,0,0,0,45,0,971,1,0,200550,2632362,33.85262175962151,846,1621,1321,1146,32538,429539,399678,1997,3443,2597,2472,3918,13.228756555322953,17.714111282231546,1446,1,199404,43200,175,0,1151,2122
4475,1,0,0,0,45,0,809,0,1,730350,3055050,36.742346141747674,1290,1951,1891,1350,32670,547646,305505,2203,3613,2323,2804,4214,23.259406699226016,8.1903625881272,1410,1,182250,13980,541,0,913,1722
4476,1,0,0,0,45,0,758,0,1,799200,3086100,36.742346141747674,1216,2076,1942,1350,48741,528066,482346,2152,3636,2420,2878,4362,24.331050121192877,12.276872470465587,1484,1,284850,21172,592,0,936,1694
4477,1,0,0,0,45,0,726,0,1,842400,3072600,36.742346141747674,1242,2082,1974,1350,42300,427888,512100,2168,3626,2384,2900,4358,24.979991993593593,11.18177069631855,1458,1,303750,9288,624,0,926,1652
4478,1,0,0,0,46,0,238,1,0,1428240,2535126,32.89376840679705,782,2702,2402,1082,25619,438141,320991,2043,3425,2643,3663,5045,36.3318042491699,18.973702561340254,1382,1,148234,54300,1320,0,1261,1023
4479,1,0,0,0,47,0,736,0,1,1247552,1935968,28.42534080710379,375,2785,2352,808,48620,527120,529516,1963,3204,2829,3940,5181,39.293765408777,21.82978722081419,1241,1,178568,57589,1544,0,1588,852
4480,1,0,0,0,47,0,725,0,1,1276376,1969360,28.705400188814647,416,2781,2373,824,51092,506680,575990,1982,3214,2798,3939,5171,39.35733730830886,21.244899751739702,1232,1,198584,39576,1549,0,1566,841
4481,1,0,0,0,47,0,682,0,1,1280843,2000739,29.0,457,2748,2364,841,51832,497211,589992,1995,3220,2763,3902,5127,39.02563260217571,20.61424399597871,1225,1,208568,31104,1523,0,1538,856
4482,1,0,0,0,47,0,597,0,1,1290348,2063856,29.597297173897484,537,2688,2349,876,53965,506540,591356,2017,3232,2695,3829,5044,38.379682124790975,19.35033785836593,1215,1,219876,27459,1473,0,1480,883
4483,1,0,0,0,46,0,553,0,1,1295960,2099670,29.916550603303182,576,2662,2343,895,53172,495006,591192,2027,3241,2665,3794,5008,38.05259518088089,18.79793659385025,1214,1,225540,23287,1448,0,1451,898
4484,1,0,0,0,46,0,509,0,1,1300622,2132362,30.23243291566195,617,2634,2337,914,51816,475932,592582,2036,3247,2630,3756,4967,37.72267222772003,18.10849724838631,1211,1,232156,17820,1423,0,1419,910
4485,1,0,0,0,46,0,466,0,1,1302936,2161308,30.528675044947494,655,2607,2330,932,52371,480033,586707,2042,3251,2596,3717,4926,37.389838191679836,17.43267074223099,1209,1,235796,17728,1398,0,1387,921
4486,1,0,0,0,45,0,342,0,1,1304784,2248440,31.368774282716245,772,2522,2310,984,53172,482135,575820,2073,3269,2497,3611,4807,36.41428291206625,15.202029772713532,1196,1,247968,16112,1326,0,1301,959
4487,1,0,0,0,45,0,299,0,1,1305906,2280822,31.670175244226233,811,2497,2305,1003,51660,466170,573048,2082,3277,2466,3576,4771,36.08323710533743,14.518655793395409,1195,1,252756,13248,1302,0,1271,972
4488,1,0,0,0,45,0,257,0,1,1307138,2310742,31.96873472629156,852,2471,2301,1022,47628,427329,569772,2091,3283,2431,3540,4732,35.76310948449533,13.616448103570498,1192,1,257544,7820,1279,0,1239,982
4489,1,0,0,0,44,0,129,0,1,1310302,2406368,32.89376840679705,974,2401,2293,1082,55890,540432,511520,2116,3306,2332,3435,4625,34.79942528261063,10.781717396486519,1190,1,248860,14364,1211,0,1142,1013
4490,1,0,0,0,44,0,86,0,1,1311467,2453072,33.21144381083123,1018,2377,2292,1103,54522,518192,520416,2139,3327,2309,3413,4601,34.48187929913333,9.759997214798725,1188,1,258102,9265,1189,0,1121,1035
4491,1,0,0,0,44,0,43,0,1,1311708,2489660,33.52610922848042,1057,2358,2291,1124,52974,482870,538245,2148,3339,2282,3382,4573,34.161381705077446,8.694308756644029,1191,1,273132,5226,1167,0,1091,1048
4492,1,0,0,0,44,0,0,0,1,1313316,2526930,33.85262175962151,1104,2334,2292,1146,52858,471870,544635,2163,3351,2247,3351,4539,33.85262175962151,6.991237203771572,1188,1,283062,2940,1146,0,1059,1059
4493,1,0,0,0,43,0,43,0,1,1311708,2558064,34.161381705077446,1137,2321,2291,1167,53784,473472,545808,2162,3359,2222,3316,4513,33.52610922848042,5.652706486041966,1197,1,290583,2250,1124,0,1025,1068
4494,1,0,0,0,43,0,85,0,1,1312656,2593209,34.48187929913333,1189,2293,2293,1189,55800,490725,540888,2181,3370,2181,3285,4474,33.2264954516723,0.0,1189,1,294872,0,1104,0,992,1077
4495,1,0,0,0,43,0,169,0,1,1311912,2674377,35.11409973215888,1203,2327,2297,1233,51714,507546,479349,2139,3402,2199,3233,4496,32.61901286060018,5.7180036243905645,1263,1,272493,4500,1064,0,936,1105
4496,1,0,0,0,46,0,1106,0,1,334191,3153843,36.78314831549904,1353,1600,1600,1353,53100,550116,524475,2331,3684,2331,2578,3931,15.716233645501712,0.0,1353,1,304425,0,247,0,978,2084
4497,1,0,0,0,47,0,1067,1,0,382050,3192750,36.742346141747674,1242,1741,1633,1350,34068,482460,394955,2257,3715,2473,2648,4106,16.822603841260722,10.73170258584833,1458,1,225450,18792,283,0,1015,2082
4498,1,0,0,0,43,0,1032,0,1,439344,2938452,36.823905279043935,1166,1870,1680,1356,53436,474573,528748,1977,3523,2357,2491,4037,18.0,13.886846184065407,1546,1,330864,19000,324,0,811,1843
4499,1,0,0,0,42,0,439,0,1,666690,2240760,32.63433774416144,1065,1691,1691,1065,54934,477608,509168,2104,3169,2104,2730,3795,25.019992006393608,0.0,1065,1,257730,0,626,0,1039,1478
4500,1,0,0,0,42,0,277,1,0,705870,2086920,31.464265445104548,923,1770,1703,990,41678,482732,383656,2041,3098,2175,2821,3878,26.70205984563738,8.19263674150144,1057,1,180180,12529,713,0,1118,1395
4501,1,0,0,0,43,0,13,1,0,749048,1880032,29.5296461204668,738,1865,1731,872,31302,478632,303996,2022,3028,2290,3015,4021,29.30870177950569,12.25832084953297,1006,1,122952,29078,859,0,1284,1297
4502,1,0,0,0,43,0,90,1,0,760104,1807524,28.77498913987632,658,1916,1746,828,27641,460613,285973,2013,3011,2353,3101,4099,30.298514815086232,13.955050015729233,998,1,108468,36550,918,0,1355,1265
4503,1,0,0,0,44,0,264,1,0,545076,1371342,24.859605789312106,438,1680,1500,618,29029,317317,450457,2039,2837,2399,3101,3899,29.698484809834994,14.78435718849582,798,1,125454,8820,882,0,1601,1337
4504,1,0,0,0,42,0,272,1,0,484185,1213614,23.93741840717165,573,1418,1418,573,33825,349470,434190,2118,2691,2118,2963,3536,29.068883707497267,0.0,573,1,117465,0,845,0,1545,1273
4505,1,0,0,0,44,0,252,1,0,521413,1340256,24.63736998950984,365,1708,1466,607,24816,388608,311328,1966,2815,2450,3067,3916,29.30870177950569,16.920675912597694,849,1,85587,39446,859,0,1601,1349
4506,1,0,0,0,44,0,345,1,0,487924,1203400,23.388031127053,313,1673,1439,547,30260,374000,391600,1966,2747,2434,3092,3873,29.866369046136157,15.302712601452019,781,1,97366,27612,892,0,1653,1308
4507,1,0,0,0,42,0,601,0,0,252510,599925,16.881943016134134,255,1201,1171,285,40140,378900,469415,2075,2390,2135,2991,3306,29.765752132274432,5.623413251903491,315,1,63555,2340,886,0,1820,1219
4508,1,0,0,0,41,0,603,0,0,219904,536320,16.0,256,1115,1115,256,40796,393860,454615,2095,2351,2095,2954,3210,29.30870177950569,0.0,256,1,55552,0,859,0,1839,1236
4509,0,1,1,0,61,0,1160,0,0,10805844,8480850,52.51666402200353,2758,6676,6676,2758,50184,627300,756450,3075,5833,3075,6993,9751,62.5939294181153,0.0,2758,0,678468,0,3918,1,317,843
4510,0,1,1,0,60,0,607,0,0,784920,1927485,25.15949125081825,2,2504,1873,633,39162,651630,557235,2414,3678,3676,4285,5549,35.21363372331802,25.922072977756407,1264,1,115839,106639,1240,0,2412,1805
4511,0,0,1,0,57,1,353,0,0,1966830,4533090,39.87480407475377,1560,2857,2827,1590,40001,630071,516031,2821,4441,2881,4088,5708,35.17101079013795,5.7180036243905645,1620,0,287790,5400,1237,1,1261,1614
4512,0,0,1,0,57,1,327,0,0,2100490,4634054,40.27406113120453,1532,3007,2917,1622,44128,639968,562829,2767,4479,2947,4152,5864,35.98610843089316,9.590813010750445,1712,1,319534,14940,1295,0,1235,1562
4513,0,0,1,0,57,1,303,0,0,2243578,4742334,40.70626487409524,1507,3161,3011,1657,43320,652536,543780,2712,4519,3012,4216,6023,36.796738985948195,12.325090945468352,1807,1,314830,26550,1354,0,1205,1508
4514,0,0,1,0,57,1,269,0,0,2464110,4914540,41.352146256270665,1576,3285,3151,1710,45144,655272,569052,2740,4584,3008,4315,6159,37.960505792204614,11.581634647011523,1844,1,338580,22780,1441,0,1164,1433
4515,0,0,1,0,57,1,305,0,0,2547956,5071328,41.90465367951393,1696,3267,3207,1756,42300,649800,542944,2828,4644,2948,4339,6155,38.09199390948182,7.789174875971784,1816,1,330128,10560,1451,0,1132,1437
4516,0,0,1,0,57,1,329,0,0,2647800,5216400,42.42640687119285,1733,3338,3271,1800,47299,675234,588294,2831,4698,2965,4369,6236,38.353617821530214,8.286047041568583,1867,1,365400,11323,1471,0,1098,1427
4517,0,0,1,0,57,1,356,0,0,2814285,5404770,43.18564576337837,1715,3524,3374,1865,49042,654948,628866,2748,4763,3048,4407,6422,38.84584919911006,12.254111330655777,2015,1,404705,21750,1509,0,1033,1389
4518,0,0,1,0,57,1,378,0,0,2817000,5440566,43.3358973600409,1703,3553,3378,1878,48150,651825,619958,2722,4775,3072,4397,6450,38.72983346207417,13.232642477343864,2053,1,401892,25900,1500,0,1019,1397
4519,0,0,1,0,57,1,454,0,0,2767512,5514058,43.657759905886145,1678,3586,3358,1906,50838,642246,662497,2665,4799,3121,4345,6479,38.1051177665153,15.099959329782587,2134,1,436474,28728,1452,0,987,1441
4520,0,0,0,0,57,1,643,1,0,2650578,5667641,44.50842616853577,1713,3587,3319,1981,54340,629420,706667,2593,4842,3129,4199,6448,36.578682316343766,16.749876770383974,2249,1,489307,25728,1338,0,880,1523
4521,0,0,0,0,56,1,834,1,0,2542015,5808845,45.44227107000705,1915,3446,3296,2065,53965,604795,706063,2663,4878,2963,4044,6259,35.08560958569767,12.502807054311965,2215,1,518315,12000,1231,0,748,1582
4522,0,0,1,0,55,1,1273,0,0,2338860,6353903,47.885279575251516,2185,3421,3313,2293,37518,615162,468299,2663,5064,2879,3791,6192,31.937438845342623,10.414507905016443,2401,1,387517,20736,1020,0,478,1751
4523,0,0,1,0,57,1,1732,0,0,2397120,7555680,51.38093031466052,2220,3968,3548,2640,47286,609606,635364,2442,5502,3282,3770,6830,30.133038346638727,20.505509523846822,3060,1,586080,52080,908,0,222,1954
4524,1,0,0,0,45,0,264,1,0,69012,370980,12.727922061357855,132,618,588,162,54531,570210,501510,2260,2452,2320,2716,2908,20.639767440550294,5.478746393072713,192,1,35478,4890,426,0,2128,1864
4525,1,0,0,0,45,0,262,1,0,100488,486964,14.560219778561036,182,716,686,212,55575,567359,516825,2267,2509,2327,2771,3013,21.77154105707724,5.5965095842615735,242,1,47700,4560,474,0,2085,1823
4526,1,0,0,0,45,0,265,1,0,116766,537030,15.297058540778355,204,763,733,234,56404,548505,541620,2265,2529,2325,2794,3058,22.338307903688676,5.514871952411144,264,1,55224,3930,499,0,2061,1796
4527,1,0,0,0,45,0,255,1,0,130050,583950,15.968719422671311,255,765,765,255,54752,540440,531280,2290,2545,2290,2800,3055,22.58317958127243,0.0,255,1,59160,0,510,0,2035,1780
4528,1,0,0,0,46,0,118,1,0,251544,1036950,21.118712081942874,271,1185,1010,446,44676,509175,474300,2150,2771,2500,2889,3510,23.748684174075834,13.490839382040427,621,1,90984,26600,564,0,1879,1761
4529,1,0,0,0,44,0,433,0,0,327060,1847268,28.77498913987632,828,1223,1223,828,54960,510899,535440,2231,3059,2231,2626,3454,19.87460691435179,0.0,828,0,198720,0,395,0,1403,1836
4530,1,0,0,0,46,0,900,1,0,108864,2332512,31.74901573277509,796,1328,1116,1008,28542,492882,310076,2102,3322,2526,2422,3642,10.392304845413264,15.352421280735559,1220,1,135072,45368,108,0,1306,2206
4531,1,0,0,0,48,0,889,0,1,1028976,3726352,39.395431207184416,1067,2700,2215,1552,43164,523418,475398,1916,3953,2886,3064,5101,25.748786379167466,22.591987163774526,2037,1,307296,76630,663,0,849,1738
4532,1,0,0,0,48,0,819,0,1,1181392,3771971,39.63584236521283,1169,2725,2323,1571,48399,525819,530621,1999,3972,2803,3153,5126,27.422618401604176,20.79187287833097,1973,1,347191,53064,752,0,830,1649
4533,1,0,0,0,45,0,789,0,1,815580,3140880,37.14835124201342,1260,2091,1971,1380,49053,566724,448372,2156,3656,2396,2867,4367,24.310491562286437,11.290330617691032,1500,1,271860,22680,591,0,896,1685
4534,1,0,0,0,44,0,642,0,0,1029055,3052540,37.21558813185679,1355,2158,2128,1385,54466,498104,531164,2174,3589,2234,2947,4362,27.258026340878022,5.483301264452448,1415,0,333785,3360,743,0,819,1461
4535,1,0,0,0,44,0,624,0,0,1060432,3056376,37.255872020394314,1388,2152,2152,1388,45741,521874,424986,2202,3590,2202,2966,4354,27.640549922170507,0.0,1388,0,267884,0,764,0,814,1438
4536,1,0,0,0,44,0,485,0,0,1360866,3200688,37.86819245752297,1434,2383,2383,1434,54064,486576,553536,2232,3666,2232,3181,4615,30.805843601498726,0.0,1434,0,355632,0,949,0,798,1283
4537,1,0,0,0,43,0,804,0,0,1170112,1618304,27.422618401604176,752,2308,2308,752,46893,497112,436856,2152,2904,2152,3708,4460,39.44616584663204,0.0,752,0,152656,0,1556,0,1400,596
4538,1,0,0,0,43,0,938,1,0,1061463,1445340,25.748786379167466,462,2465,2264,663,45120,512300,418560,1979,2843,2381,3781,4645,40.01249804748511,14.329730615185033,864,1,127296,36783,1601,0,1517,579
4539,1,0,0,0,44,0,929,1,0,1048740,1453980,25.69046515733026,404,2505,2249,660,35040,528720,321638,1947,2863,2459,3792,4708,39.8622628559895,16.2518638122259,916,1,96360,58368,1589,0,1543,614
4540,1,0,0,0,47,0,723,0,1,1255824,1938000,28.5657137141714,450,2721,2355,816,53000,503500,593750,2009,3191,2741,3914,5096,39.230090491866065,20.173966970795792,1182,1,204000,29280,1539,0,1559,836
4541,1,0,0,0,46,0,593,0,1,1277480,2039608,29.5296461204668,575,2634,2337,872,52668,488851,589428,2042,3211,2636,3804,4973,38.27531841800928,18.14388455594939,1169,1,219744,21087,1465,0,1467,874
4542,1,0,0,0,46,0,550,0,1,1281600,2071920,29.832867780352597,613,2607,2330,890,51359,472584,588984,2051,3218,2605,3768,4935,37.94733192202055,17.541644118444175,1167,1,225170,16897,1440,0,1438,888
4543,1,0,0,0,46,0,509,0,1,1284312,2096077,30.116440692751194,652,2578,2323,907,51106,466822,584683,2056,3218,2566,3727,4889,37.62977544445356,16.74992996933768,1162,1,229471,15045,1416,0,1404,895
4544,1,0,0,0,45,0,426,0,1,1288656,2156238,30.692018506445613,726,2526,2310,942,53676,487557,576828,2073,3231,2505,3657,4815,36.98648401781386,15.37441339508947,1158,1,237384,16200,1368,0,1347,921
4545,1,0,0,0,45,0,385,0,1,1291200,2186880,30.983866769659336,768,2497,2305,960,53965,489770,571778,2086,3238,2470,3623,4775,36.6742416417845,14.49047300437128,1152,1,240960,14976,1345,0,1318,933
4546,1,0,0,0,45,0,342,0,1,1293259,2220372,31.28897569432403,809,2470,2300,979,53676,483084,571536,2098,3247,2438,3589,4738,36.345563690772494,13.631179030466164,1149,1,246708,12410,1321,0,1289,947
4547,1,0,0,0,44,0,257,0,1,1300244,2283579,31.921779399024736,892,2422,2295,1019,48829,432513,566973,2114,3260,2368,3517,4663,35.7211421989835,11.747494334573807,1146,1,257807,5969,1276,0,1222,965
4548,1,0,0,0,44,0,213,0,1,1303120,2312960,32.2490309931942,932,2401,2293,1040,51912,458144,560448,2116,3264,2332,3477,4625,35.397740040855716,10.73170258584833,1148,1,262080,7344,1253,0,1184,971
4549,1,0,0,0,44,0,170,0,1,1306091,2349054,32.57299494980466,976,2377,2292,1061,56088,504792,544644,2129,3275,2299,3445,4591,35.08560958569767,9.494144610579708,1146,1,261006,8415,1231,0,1153,983
4550,1,0,0,0,44,0,127,0,1,1308138,2389056,32.89376840679705,1015,2358,2291,1082,55418,505632,534336,2141,3290,2275,3417,4566,34.77067730142742,8.499160266369426,1149,1,261844,6633,1209,0,1126,999
4551,1,0,0,0,43,0,43,0,1,1311708,2461560,33.52610922848042,1094,2321,2291,1124,55575,492750,540930,2160,3314,2220,3357,4511,34.161381705077446,5.623413251903491,1154,1,277628,2730,1167,0,1066,1023
4552,1,0,0,0,43,0,0,0,1,1313316,2498280,33.85262175962151,1146,2292,2292,1146,56350,501400,534100,2180,3326,2180,3326,4472,33.85262175962151,0.0,1146,1,280770,0,1146,0,1034,1034
4553,1,0,0,0,43,0,127,0,1,1319618,2641664,34.84250278036869,1172,2343,2301,1214,43904,487424,426496,2134,3390,2218,3263,4519,32.96968304366907,6.495386533491135,1256,1,237944,7014,1087,0,962,1089
4554,1,0,0,0,47,0,558,1,0,1140975,3291540,37.1887079635741,1249,2342,2208,1383,32634,528360,349860,2246,3763,2514,3205,4722,28.722813232690143,11.850228582282101,1517,1,203301,28408,825,0,997,1555
4555,1,0,0,0,47,0,953,0,1,724548,3438336,38.1051177665153,1197,2206,1951,1452,41552,502016,464128,2113,3820,2623,2867,4574,22.338307903688676,16.001098519674933,1707,1,284592,39015,499,0,916,1869
4556,1,0,0,0,46,0,1093,0,1,409460,3243756,37.255872020394314,1358,1713,1683,1388,52800,514140,560880,2307,3725,2367,2632,4050,17.175564037317667,5.572104574801163,1418,1,333120,3240,295,0,949,2042
4557,1,0,0,0,46,0,1100,0,1,394725,3225665,37.21558813185679,1385,1670,1670,1385,52900,535670,535670,2329,3714,2329,2614,3999,16.881943016134134,0.0,1385,1,318550,0,285,0,944,2044
4558,1,0,0,0,47,0,1066,1,0,469335,3338583,37.429934544425805,1124,2013,1736,1401,41173,469451,498047,2106,3784,2660,2718,4396,18.303005217723125,16.932635452148716,1678,1,292809,32963,335,0,982,2048
4559,1,0,0,0,42,0,464,0,0,668676,2276528,32.89376840679705,1082,1700,1700,1082,49932,479712,460776,2104,3186,2104,2722,3804,24.859605789312106,0.0,1082,0,236958,0,618,0,1022,1486
4560,1,0,0,0,43,0,90,1,0,753136,1966014,30.23243291566195,764,1888,1738,914,29394,458163,296838,2001,3065,2301,2975,4039,28.705400188814647,12.740029376818088,1064,1,126132,31650,824,0,1237,1327
4561,1,0,0,0,43,0,13,1,0,768210,1893990,29.49576240750525,695,1928,1753,870,28296,470232,285187,2002,3047,2352,3060,4105,29.715315916207253,14.011829022829035,1045,1,113970,38325,883,0,1307,1294
4562,1,0,0,0,44,0,114,1,0,779976,1827396,28.77498913987632,616,1982,1770,828,25215,452435,271461,1995,3035,2419,3149,4189,30.692018506445613,15.592151840950022,1040,1,101844,45580,942,0,1379,1265
4563,1,0,0,0,44,0,266,1,0,573672,1406196,25.219040425836983,486,1688,1538,636,29946,305118,479787,2061,2847,2361,3113,3899,30.033314835362415,12.360324274125283,786,1,138012,3300,902,0,1575,1309
4564,1,0,0,0,42,0,272,1,0,527625,1284993,24.55605831561735,603,1478,1478,603,35360,362270,443248,2131,2734,2131,3006,3609,29.58039891549808,0.0,603,1,125424,0,875,0,1528,1256
4565,1,0,0,0,42,0,269,1,0,522870,1291549,24.515301344262525,511,1561,1471,601,19902,399714,229943,2059,2750,2239,3019,3710,29.49576240750525,10.244858911044867,691,1,64307,18630,870,0,1548,1279
4566,0,1,1,0,58,0,1924,0,0,4060845,3739282,35.651086939951774,1229,4508,4466,1271,56069,667834,726674,2900,4213,2984,6137,7450,56.52433104425032,6.653712290320142,1313,0,313937,4242,3195,1,1671,253
4567,0,0,1,0,57,1,398,0,0,1881395,4517250,39.81205847478876,1555,2802,2772,1585,44036,621300,575700,2820,4435,2880,4037,5652,34.45286635390443,5.501408174353464,1615,1,320170,4590,1187,0,1265,1663
4568,0,0,1,0,57,1,356,0,0,2515532,5123312,42.118879377305376,1679,3287,3192,1774,41220,661352,519840,2793,4662,2983,4306,6175,37.656340767525464,9.76859066112806,1869,1,319320,17860,1418,0,1114,1470
4569,0,0,1,0,58,1,402,0,0,2728495,5414095,43.18564576337837,1731,3462,3328,1865,48760,667690,615436,2769,4768,3037,4366,6365,38.24918299781056,11.633585509503979,1999,1,395380,20904,1463,0,1038,1440
4570,0,0,1,0,58,1,412,0,0,2800160,5490584,43.497126341863094,1722,3542,3372,1892,47475,652950,612322,2732,4794,3072,4382,6444,38.47076812334269,13.052030900365901,2062,1,399212,25670,1480,0,1010,1422
4571,0,0,1,0,57,1,499,0,0,2819256,5624883,44.12482294582042,1679,3663,3395,1947,48952,609579,670248,2621,4836,3157,4337,6552,38.05259518088089,16.37076252546435,2215,1,451704,29212,1448,0,942,1441
4572,0,0,1,0,57,1,536,0,0,2794425,5653563,44.28317965096906,1666,3681,3386,1961,50290,616962,677505,2588,4844,3178,4308,6564,37.749172176353746,17.177981230638423,2256,1,460835,32155,1425,0,922,1458
4573,1,0,0,0,45,0,234,1,0,45847,290957,11.269427669584644,127,488,488,127,52441,524639,524639,2291,2418,2291,2652,2779,19.0,0.0,127,1,29083,0,361,0,2164,1930
4574,1,0,0,0,45,0,234,1,0,57600,343350,12.24744871391589,150,534,534,150,50380,524181,503580,2289,2439,2289,2673,2823,19.595917942265423,0.0,150,1,33000,0,384,0,2139,1905
4575,1,0,0,0,45,0,233,1,0,71400,400400,13.228756555322953,175,583,583,175,51230,537680,498784,2288,2463,2288,2696,2871,20.199009876724155,0.0,175,1,38150,0,408,0,2113,1880
4576,1,0,0,0,45,0,232,1,0,87033,459888,14.177446878757825,201,634,634,201,53240,553696,503360,2288,2489,2288,2721,2922,20.808652046684813,0.0,201,1,44220,0,433,0,2087,1855
4577,1,0,0,0,45,0,229,1,0,123420,583185,15.968719422671311,255,739,739,255,54692,553454,516862,2287,2542,2287,2771,3026,22.0,0.0,255,1,57630,0,484,0,2032,1803
4578,1,0,0,0,46,0,152,1,0,237273,970776,20.42057785666214,264,1139,986,417,44916,530784,458616,2175,2745,2481,2897,3467,23.853720883753127,12.674971781690546,570,1,82149,25857,569,0,1911,1759
4579,1,0,0,0,46,0,96,1,0,358897,1289043,23.515952032609693,325,1430,1202,553,39292,487179,438228,2103,2884,2559,2980,3761,25.475478405713993,15.587863252408876,781,1,103964,35796,649,0,1778,1682
4580,1,0,0,0,44,0,407,0,0,348588,1853064,28.77498913987632,828,1249,1249,828,51750,463266,559500,2238,3066,2238,2659,3487,20.518284528683193,0.0,828,0,207000,0,421,0,1410,1817
4581,1,0,0,0,44,0,459,1,0,332350,1891250,29.154759474226502,850,1241,1241,850,50112,516200,480600,2225,3075,2225,2616,3466,19.77371993328519,0.0,850,1,183600,0,391,0,1375,1834
4582,1,0,0,0,46,0,1064,1,0,46452,2594676,33.25657829663178,787,1467,1148,1106,37636,455124,455124,2027,3452,2665,2388,3813,6.48074069840786,18.601114081787884,1425,1,214564,41789,42,0,1240,2304
4583,1,0,0,0,46,0,1000,1,0,300564,2913732,35.24202037341219,882,1844,1484,1242,24252,441048,302634,1986,3588,2706,2588,4190,15.556349186104045,19.80774559061489,1602,1,160218,68400,242,0,1104,2104
4584,1,0,0,0,48,0,865,0,1,1075196,3746848,39.44616584663204,1110,2693,2247,1556,45344,524944,500864,1962,3964,2854,3099,5101,26.28687885618983,21.81492020988695,2002,1,323648,65116,691,0,852,1717
4585,1,0,0,0,44,0,847,0,0,809678,3173484,37.656340767525464,1388,2019,1989,1418,56334,512502,550548,2208,3656,2268,2809,4257,23.895606290697042,5.572104574801163,1448,1,348828,3060,571,0,820,1667
4586,1,0,0,0,44,0,842,0,0,810795,3155450,37.61648574760805,1415,1988,1988,1415,54756,521820,521820,2230,3645,2230,2803,4218,23.93741840717165,0.0,1415,1,331110,0,573,0,815,1657
4587,1,0,0,0,44,0,513,0,0,1370610,3234465,38.144462245521304,1455,2397,2397,1455,53110,502398,522405,2223,3678,2223,3165,4620,30.692018506445613,0.0,1455,0,341925,0,942,0,768,1281
4588,1,0,0,0,44,0,497,0,0,1413258,3243471,38.24918299781056,1463,2429,2429,1463,56406,525429,527646,2217,3680,2217,3183,4646,31.080540535840107,0.0,1463,0,348194,0,966,0,754,1251
4589,1,0,0,0,43,0,772,0,0,1121133,1598337,27.2213151776324,741,2254,2254,741,50504,461598,509052,2157,2898,2157,3670,4411,38.897300677553446,0.0,741,1,174876,0,1513,0,1416,644
4590,1,0,0,0,43,0,807,0,0,1112958,1566708,26.94438717061496,726,2259,2259,726,37018,481234,358228,2158,2884,2158,3691,4417,39.153543900903784,0.0,726,0,120516,0,1533,0,1432,625
4591,1,0,0,0,44,0,939,1,0,1087162,1488192,25.96150997149434,589,2372,2287,674,25900,408480,309120,2123,2882,2293,3821,4580,40.162171256046406,9.880111181028997,759,1,94360,14960,1613,0,1534,595
4592,1,0,0,0,45,0,969,1,0,1009600,1433001,25.11971337416094,252,2610,2231,631,30756,529143,299772,1892,2902,2650,3871,4881,40.0,20.04143356654843,1010,1,83292,88686,1600,0,1640,671
4593,1,0,0,0,47,0,871,0,1,1159422,1740222,26.94438717061496,269,2780,2323,726,53874,589662,524943,1940,3123,2854,3994,5177,39.96248240537617,22.33489807768337,1183,1,158994,74034,1597,0,1671,800
4594,1,0,0,0,47,0,859,0,1,1185600,1775436,27.2213151776324,311,2771,2341,741,56404,572644,565456,1966,3137,2826,3996,5167,40.0,21.767300358194014,1171,1,174876,56330,1600,0,1655,796
4595,1,0,0,0,47,0,764,0,1,1232352,1878624,28.142494558940577,442,2698,2348,792,54282,517096,590628,2022,3164,2722,3928,5070,39.44616584663204,19.78160499207441,1142,1,197208,31150,1556,0,1580,816
4596,1,0,0,0,46,0,633,0,1,1258218,1981566,29.13760456866693,572,2608,2331,849,50953,473802,585834,2057,3183,2611,3816,4942,38.49675310984031,17.579178219311,1126,1,213099,18282,1482,0,1485,852
4597,1,0,0,0,45,0,510,0,1,1269000,2065500,30.0,688,2522,2310,900,51106,463590,580635,2083,3195,2507,3705,4817,37.54996671103717,15.3241549700458,1112,1,227700,13144,1410,0,1395,885
4598,1,0,0,0,44,0,341,0,1,1287686,2195319,31.25699921617557,850,2422,2295,977,52877,469623,568491,2120,3224,2374,3565,4669,36.30426972134269,11.747494334573807,1104,1,247181,8255,1318,0,1270,929
4599,1,0,0,0,44,0,299,0,1,1292112,2227298,31.575306807693888,889,2401,2293,997,52070,457970,567436,2126,3231,2342,3530,4635,36.0,10.8528199128497,1105,1,253238,6372,1296,0,1237,938
4600,1,0,0,0,44,0,255,0,1,1295914,2260978,31.906112267087632,933,2376,2291,1018,51816,453084,564134,2136,3239,2306,3494,4597,35.679125549822544,9.568061544601736,1103,1,258572,5100,1273,0,1203,948
4601,1,0,0,0,44,0,212,0,1,1302080,2294240,32.2490309931942,973,2359,2292,1040,53928,472084,555912,2139,3246,2273,3458,4565,35.38361202590826,8.397588990243326,1107,1,262080,5025,1252,0,1166,954
4602,1,0,0,0,43,0,169,0,1,1305030,2328895,32.57299494980466,1019,2333,2291,1061,55800,493875,544360,2153,3256,2237,3425,4528,35.07135583350036,6.589126398255297,1103,1,263128,3948,1230,0,1134,965
4603,1,0,0,0,43,0,127,0,1,1308138,2367416,32.89376840679705,1052,2321,2291,1082,56350,503240,536060,2158,3270,2218,3397,4509,34.77067730142742,5.5503012171862105,1112,1,265090,3180,1209,0,1106,979
4604,1,0,0,0,43,0,85,0,1,1312656,2407824,33.2264954516723,1104,2293,2293,1104,55692,510354,519078,2181,3285,2181,3370,4474,34.48187929913333,0.0,1104,1,262752,0,1189,0,1077,992
4605,1,0,0,0,43,0,42,0,1,1315168,2454680,33.555923471125034,1126,2294,2294,1126,51959,507940,486140,2180,3306,2180,3348,4474,34.17601498127012,0.0,1126,1,251098,0,1168,0,1054,1012
4606,1,0,0,0,43,0,0,0,1,1320201,2504820,33.896902513356586,1119,2328,2298,1149,47925,490500,464340,2150,3329,2210,3329,4508,33.896902513356586,5.477225575051661,1179,1,244737,4470,1149,0,1031,1031
4607,1,0,0,0,43,0,43,0,1,1323188,2553788,34.23448553724738,1130,2343,2301,1172,45024,488096,437979,2137,3351,2221,3308,4522,33.60059523282288,6.488991180673202,1214,1,235572,6762,1129,0,1007,1050
4608,1,0,0,0,47,0,517,1,0,1131108,3229611,36.78314831549904,1229,2313,2189,1353,37280,556171,381920,2263,3740,2511,3223,4700,28.91366458960192,11.546879086349044,1477,1,216480,26040,836,0,1034,1551
4609,1,0,0,0,47,0,706,0,1,923967,3303423,37.107950630558946,1076,2349,2048,1377,46662,484598,554169,2098,3776,2700,3070,4748,25.903667693977237,17.52480725985836,1678,1,318087,29498,671,0,1022,1728
4610,1,0,0,0,46,0,1095,0,1,458014,3312448,37.656340767525464,1418,1741,1741,1418,50838,518592,534944,2336,3754,2336,2659,4077,17.97220075561143,0.0,1418,1,324722,0,323,0,918,2013
4611,1,0,0,0,46,0,1102,0,1,442895,3299780,37.61648574760805,1415,1728,1728,1415,45570,506044,489720,2332,3747,2332,2645,4060,17.69180601295413,0.0,1415,1,297150,0,313,0,917,2019
4612,1,0,0,0,46,0,1107,0,0,432378,3297942,37.589892258425,1383,1749,1719,1413,41420,508812,443460,2304,3747,2364,2640,4083,17.4928556845359,5.514871952411144,1443,0,268470,4950,306,0,921,2028
4613,1,0,0,0,47,0,1047,1,0,517158,3388374,37.589892258425,1221,1971,1779,1413,33128,484396,393272,2206,3811,2590,2764,4369,19.131126469708992,14.332108965596055,1605,1,231732,33408,366,0,985,2032
4614,1,0,0,0,47,0,1107,1,0,461890,3420560,37.815340802378074,1133,2050,1753,1430,39668,449696,504712,2095,3822,2689,2715,4442,17.97220075561143,17.54557963638612,1727,1,301730,30888,323,0,962,2069
4615,1,0,0,0,46,0,1301,1,0,250070,3400952,38.353617821530214,1174,1938,1641,1471,40482,399976,541008,2015,3783,2609,2482,4250,13.038404810405298,18.028097721592022,1768,1,344214,15444,170,0,841,2142
4616,1,0,0,0,45,0,1390,1,0,181200,3414110,38.8587184554509,1282,1858,1630,1510,43166,431851,510986,2033,3771,2489,2381,4119,10.954451150103322,15.555087290566727,1738,1,341260,20292,120,0,751,2141
4617,1,0,0,0,42,0,541,0,1,653586,2365038,33.51119216023208,1123,1705,1705,1123,49203,486486,448578,2106,3229,2106,2688,3811,24.124676163629637,0.0,1123,1,239199,0,582,0,983,1524
4618,1,0,0,0,42,0,487,0,0,672588,2319989,33.15116890850155,1069,1741,1711,1099,42593,470753,403201,2081,3210,2141,2723,3852,24.73863375370596,5.501408174353464,1129,0,209909,5160,612,0,1012,1499
4619,1,0,0,0,44,0,137,1,0,802610,1853390,28.809720581775867,575,2052,1797,830,25544,459998,276892,1978,3063,2488,3200,4285,31.096623610932426,17.1272532204511,1085,1,102920,54825,967,0,1403,1266
4620,1,0,0,0,42,0,271,1,0,572232,1355253,25.15949125081825,633,1537,1537,633,39420,385380,468879,2141,2774,2141,3045,3678,30.066592756745816,0.0,633,1,138627,0,904,0,1508,1237
4621,1,0,0,0,43,0,266,1,0,573672,1395384,25.219040425836983,486,1688,1538,636,23246,432218,258892,2044,2830,2344,3096,3882,30.033314835362415,13.531383308295037,786,1,75048,31500,902,0,1558,1292
4622,1,0,0,0,44,0,254,1,0,609552,1488688,25.768197453450252,396,1850,1582,664,27416,412528,334058,1974,2906,2510,3160,4092,30.298514815086232,17.967677100384936,932,1,98936,44488,918,0,1578,1324
4623,1,0,0,0,42,0,573,0,0,272538,655698,17.578395831246947,309,1191,1191,309,39780,381960,468962,2122,2431,2122,3004,3313,29.698484809834994,0.0,309,1,68289,0,882,0,1813,1240
4624,1,0,0,0,42,0,573,1,0,146880,407232,13.856406460551018,84,1065,957,192,36960,489951,339360,2013,2313,2229,2886,3186,27.65863337187866,10.73170258584833,300,1,30720,22572,765,0,1929,1356
4625,0,1,1,0,59,0,1919,0,0,9290580,6696820,47.286361670147556,2206,6421,6391,2236,50398,676870,667885,2965,5231,3025,7150,9416,64.45928947793328,5.477225575051661,2266,0,498628,4170,4155,1,759,1160
4626,0,0,1,0,58,1,685,0,0,969500,4048355,37.21558813185679,1215,2255,2085,1385,46870,637214,628445,2753,4308,3093,3623,5178,26.457513110645905,13.108333333204333,1555,1,297775,23460,700,0,1538,2223
4627,0,0,1,0,57,1,402,0,0,1990224,4647108,40.32369030731191,1626,2850,2850,1626,43584,648766,548736,2858,4484,2858,4082,5708,34.9857113690718,0.0,1626,0,312192,0,1224,1,1232,1634
4628,0,0,1,0,57,1,393,0,0,2456208,5120208,42.14261501141095,1626,3309,3159,1776,43811,654441,556419,2733,4659,3033,4266,6192,37.1887079635741,12.24962545775264,1926,1,342768,25950,1383,0,1107,1500
4629,1,0,0,0,45,0,189,1,0,32076,248184,10.392304845413264,108,405,405,108,54740,528540,546924,2298,2406,2298,2595,2703,17.233687939614086,0.0,108,1,25704,0,297,0,2190,2001
4630,1,0,0,0,44,0,429,1,0,356580,1899213,29.13760456866693,849,1269,1269,849,51192,483192,530169,2237,3086,2237,2657,3506,20.493901531919196,0.0,849,1,201213,0,420,0,1388,1817
4631,1,0,0,0,45,0,582,1,0,300960,2057472,30.199337741083,845,1309,1242,912,30843,466992,336144,2189,3168,2323,2586,3565,18.16590212458495,8.456490803821907,979,1,135888,12931,330,0,1344,1926
4632,1,0,0,0,44,0,854,0,0,874455,3256290,38.144462245521304,1425,2086,2056,1455,56088,550548,510264,2208,3693,2268,2839,4324,24.515301344262525,5.501408174353464,1485,1,331740,4320,601,0,783,1637
4633,1,0,0,0,44,0,851,0,0,870600,3241534,38.09199390948182,1451,2051,2051,1451,56640,536160,527224,2234,3685,2234,2834,4285,24.49489742783178,0.0,1451,1,342436,0,600,0,783,1634
4634,1,0,0,0,45,0,769,0,1,966240,3309120,37.94733192202055,1260,2291,2111,1440,46852,507858,487176,2118,3738,2478,2969,4589,25.903667693977237,13.833892875472413,1620,1,305280,26280,671,0,858,1627
4635,1,0,0,0,44,0,573,0,0,1306780,3269880,38.27531841800928,1465,2357,2357,1465,51290,513360,497736,2232,3697,2232,3124,4589,29.866369046136157,0.0,1465,1,326695,0,892,0,767,1340
4636,1,0,0,0,44,0,540,0,0,1383949,3267124,38.43175770115127,1477,2414,2414,1477,55902,510972,535304,2212,3689,2212,3149,4626,30.610455730027933,0.0,1477,0,357434,0,937,0,735,1275
4637,1,0,0,0,44,0,468,1,0,1428768,3206016,38.1051177665153,1422,2466,2436,1452,45548,521088,426144,2178,3660,2238,3192,4674,31.368774282716245,5.753771868478424,1482,1,280236,5490,984,0,756,1224
4638,1,0,0,0,45,0,278,1,0,1471520,3084480,36.87817782917155,1236,2566,2442,1360,14175,396900,183708,2144,3628,2392,3350,4834,32.89376840679705,11.401248222293653,1484,1,110160,26784,1082,0,908,1186
4639,1,0,0,0,47,0,29,1,0,1376892,2842884,34.46737587922817,865,2670,2347,1188,32424,461849,402024,2070,3581,2716,3552,5063,34.044089061098404,19.642067978632202,1511,1,199584,51034,1159,0,1205,1234
4640,1,0,0,0,43,0,774,0,0,1066840,1545844,26.758176320519304,716,2206,2206,716,49486,490093,470662,2159,2875,2159,3649,4365,38.600518131237564,0.0,716,0,156088,0,1490,0,1443,669
4641,1,0,0,0,45,0,1024,1,0,981081,1382076,24.55605831561735,185,2648,2230,603,28250,517992,286500,1874,2895,2710,3919,4940,40.33608806019741,21.106066618130555,1021,1,75375,97394,1627,0,1689,665
4642,1,0,0,0,46,0,994,1,0,1014120,1468596,25.019992006393608,94,2778,2246,626,34428,534888,354246,1814,2972,2878,3966,5124,40.24922359499622,23.90013067469629,1158,1,94526,114380,1620,0,1720,726
4643,1,0,0,0,47,0,914,0,1,1167080,1710524,26.758176320519304,298,2764,2346,716,56640,563804,573360,1971,3105,2807,4019,5153,40.3732584763727,21.44730650540546,1134,1,171840,50578,1630,0,1673,759
4644,1,0,0,0,47,0,890,0,1,1187304,1743624,27.055498516937366,342,2744,2354,732,56069,540714,588354,1992,3114,2772,4004,5126,40.27406113120453,20.77627965883048,1122,1,180804,38610,1622,0,1650,760
4645,1,0,0,0,47,0,848,0,1,1198500,1780500,27.386127875258307,388,2710,2348,750,55800,534150,588752,2012,3124,2736,3972,5084,39.97499218261337,20.073747346028295,1112,1,186000,34752,1598,0,1624,776
4646,1,0,0,0,47,0,761,0,1,1218276,1854959,28.053520278211074,478,2644,2335,787,53928,504398,593964,2048,3144,2666,3905,5001,39.344631145812,18.653872317934994,1096,1,198324,24102,1548,0,1570,809
4647,1,0,0,0,45,0,553,0,1,1251804,2007792,29.597297173897484,684,2497,2305,876,50853,460692,579876,2100,3168,2484,3721,4789,37.8021163428716,14.682110731617461,1068,1,221628,11136,1429,0,1416,863
4648,1,0,0,0,45,0,469,0,1,1264062,2068382,30.23243291566195,764,2447,2297,914,51612,461652,572539,2113,3177,2413,3646,4710,37.1887079635741,12.849476832533073,1064,1,231242,9450,1383,0,1349,880
4649,1,0,0,0,44,0,383,0,1,1277790,2135380,30.903074280724887,847,2401,2293,955,52324,460616,567944,2128,3191,2344,3574,4637,36.578682316343766,10.781717396486519,1063,1,242570,6696,1338,0,1281,898
4650,1,0,0,0,44,0,340,0,1,1284416,2171600,31.240998703626616,891,2377,2292,976,52877,465025,562925,2140,3201,2310,3541,4602,36.27671429443411,9.53016293865306,1061,1,246928,5610,1316,0,1249,909
4651,1,0,0,0,44,0,297,0,1,1290118,2205364,31.575306807693888,930,2358,2291,997,53130,464520,559636,2145,3209,2279,3506,4570,35.9722114972099,8.456490803821907,1064,1,252241,4623,1294,0,1215,918
4652,1,0,0,0,44,0,255,0,1,1295914,2239600,31.906112267087632,976,2333,2291,1018,52961,464200,552200,2158,3218,2242,3473,4533,35.679125549822544,6.63067838716079,1060,1,255518,3192,1273,0,1182,927
4653,1,0,0,0,43,0,212,0,1,1302080,2277600,32.2490309931942,1010,2322,2292,1040,54587,483990,540930,2160,3230,2220,3442,4512,35.38361202590826,5.531194905403055,1070,1,256880,2910,1252,0,1150,938
4654,1,0,0,0,43,0,169,0,1,1307322,2319408,32.58834147360065,1062,2293,2293,1062,54516,504504,515424,2184,3246,2184,3415,4477,35.08560958569767,0.0,1062,1,250632,0,1231,0,1122,953
4655,1,0,0,0,43,0,43,0,1,1323188,2465736,33.60059523282288,1087,2343,2301,1129,45900,491400,445536,2142,3313,2226,3356,4527,34.23448553724738,6.495386533491135,1171,1,230316,6678,1172,0,1055,1012
4656,1,0,0,0,43,0,42,1,0,1333584,2574264,34.292856398964496,1091,2395,2310,1176,38804,477202,389642,2104,3365,2274,3323,4584,33.67491648096547,9.2729914971827,1261,1,209328,15130,1134,0,1013,1055
4657,1,0,0,0,44,0,189,1,0,1300950,2756775,35.199431813596085,1049,2479,2289,1239,38850,493950,389375,2035,3464,2415,3275,4704,32.4037034920393,13.912911596993856,1429,1,216825,35340,1050,0,986,1175
4658,1,0,0,0,47,0,662,0,1,922695,3231453,36.701498607005135,1047,2332,2032,1347,50076,513386,561366,2099,3746,2699,3084,4731,26.1725046566048,17.496824208506457,1647,1,315198,33000,685,0,1052,1714
4659,1,0,0,0,47,0,827,0,1,772830,3297685,37.21558813185679,1151,2177,1943,1385,51750,535725,547630,2147,3766,2615,2939,4558,23.62202362203543,15.381906354258097,1619,1,318550,29952,558,0,996,1823
4660,1,0,0,0,46,0,1097,0,1,508248,3391216,38.05259518088089,1448,1799,1799,1448,48279,541002,489478,2342,3790,2342,2693,4141,18.734993995195193,0.0,1448,1,302632,0,351,0,894,1991
4661,1,0,0,0,48,0,1080,1,0,538321,3498361,38.09199390948182,1174,2099,1822,1451,35343,455679,450857,2134,3862,2688,2782,4510,19.261360284258224,17.160940468146453,1728,1,271337,36841,371,0,960,2040
4662,1,0,0,0,46,0,1350,1,0,225000,3477000,38.72983346207417,1223,1927,1650,1500,41008,407968,540094,2041,3818,2595,2468,4245,12.24744871391589,17.5918200086578,1777,1,349500,16066,150,0,818,2168
4663,1,0,0,0,44,0,1328,1,0,263025,3362211,38.768543949960254,1341,1840,1678,1503,52080,485429,536880,2075,3740,2399,2412,4077,13.228756555322953,13.542972505685965,1665,1,360720,16848,175,0,734,2062
4664,1,0,0,0,42,0,672,0,1,616420,2518040,34.49637662132068,1160,1738,1708,1190,51076,478216,478216,2086,3306,2146,2634,3854,22.759613353482084,5.501408174353464,1220,1,268940,4020,518,0,926,1598
4665,1,0,0,0,42,0,509,1,0,677412,2361456,33.406586176980134,1086,1753,1723,1116,40680,478216,380880,2086,3232,2146,2723,3869,24.63736998950984,5.623413251903491,1146,1,200880,5550,607,0,1000,1509
4666,1,0,0,0,45,0,160,1,0,828996,1881504,28.879058156387302,579,2083,1828,834,25668,466992,279744,2001,3090,2511,3250,4339,31.52776554086889,15.972647223714874,1089,1,103416,55080,994,0,1422,1262
4667,1,0,0,0,45,0,208,1,0,835584,1850688,28.5657137141714,582,2074,1840,816,26384,439992,308448,2034,3084,2502,3292,4342,32.0,15.324919105946389,1050,1,110976,44694,1024,0,1452,1244
4668,1,0,0,0,42,0,271,1,0,616052,1417845,25.709920264364882,631,1623,1593,661,38804,467610,381810,2115,2806,2175,3077,3768,30.528675044947494,5.501408174353464,691,1,117658,5370,932,0,1484,1213
4669,1,0,0,0,44,0,263,1,0,626714,1488278,25.903667693977237,491,1785,1605,671,26586,467998,279468,2038,2889,2398,3152,4003,30.56141357987225,14.881264274500568,851,1,84546,39240,934,0,1547,1284
4670,0,1,1,0,59,0,410,0,0,450779,1473108,22.293496809607955,17,1884,1404,497,51660,622440,729144,2484,3461,3444,3871,4848,30.116440692751194,22.472733741518944,977,1,122262,40800,907,0,2467,2057
4671,0,0,1,0,58,1,510,0,0,2664079,5543649,43.669211121796096,1732,3479,3304,1907,49880,674424,625005,2732,4814,3082,4304,6386,37.376463182061514,13.306788019122699,2082,1,410005,26950,1397,0,1000,1510
4672,0,0,0,0,57,1,622,1,0,2903103,5863410,45.19955751995809,1775,3732,3464,2043,51792,596960,714630,2602,4913,3138,4291,6602,37.69615364994153,16.813932623358365,2311,1,508707,21172,1421,0,827,1449
4673,0,0,0,0,55,1,913,1,0,2737980,6036594,46.61544808322666,2131,3475,3433,2173,53502,616716,669498,2736,4951,2820,4038,6253,35.4964786985977,6.488991180673202,2215,1,523693,4578,1260,0,605,1518
4674,1,0,0,0,46,0,147,1,0,27540,248508,10.392304845413264,108,363,363,108,55209,531531,549939,2301,2409,2301,2556,2664,15.968719422671311,0.0,108,1,25812,0,255,0,2193,2046
4675,1,0,0,0,46,0,187,1,0,217358,889296,19.544820285692065,274,1059,951,382,35360,484224,395760,2220,2710,2436,2897,3387,23.853720883753127,10.700008142562027,490,1,64940,18900,569,0,1946,1759
4676,1,0,0,0,44,0,399,0,0,383350,1905700,29.154759474226502,850,1301,1301,850,53966,499966,542564,2242,3092,2242,2693,3543,21.236760581595302,0.0,850,0,205700,0,451,0,1392,1791
4677,1,0,0,0,45,0,726,1,0,234256,2222528,31.11269837220809,818,1360,1210,968,33072,486752,358176,2146,3264,2446,2538,3656,15.556349186104045,12.849476832533073,1118,1,151008,28800,242,0,1328,2054
4678,1,0,0,0,46,0,844,1,0,152541,2318025,31.575306807693888,785,1362,1150,997,30740,492900,337125,2113,3322,2537,2478,3687,12.36931687685298,15.352421280735559,1209,1,144565,43036,153,0,1328,2172
4679,1,0,0,0,47,0,1012,1,0,105165,2616948,33.27160951922825,703,1606,1202,1107,28054,399516,392424,1960,3471,2768,2459,3970,9.746794344808963,20.77614027543631,1511,1,183762,52116,95,0,1257,2269
4680,1,0,0,0,48,0,834,0,1,988195,3622385,38.66522985836241,1036,2615,2156,1495,48620,533060,535483,1964,3918,2882,3084,5038,25.709920264364882,22.21257344681199,1954,1,330395,61506,661,0,928,1762
4681,1,0,0,0,44,0,856,0,0,942537,3321959,38.58756276314948,1459,2152,2122,1489,51600,535440,479665,2201,3720,2261,2864,4383,25.15949125081825,5.478746393072713,1519,1,320135,4890,633,0,742,1598
4682,1,0,0,0,44,0,854,0,0,937035,3316005,38.535697735995385,1485,2116,2116,1485,46230,513590,448833,2233,3718,2233,2864,4349,25.11971337416094,0.0,1485,0,298485,0,631,0,748,1602
4683,1,0,0,0,45,0,796,0,1,990780,3360420,38.34057902536163,1336,2278,2144,1470,36806,546354,352044,2152,3756,2420,2960,4564,25.96150997149434,12.035289626712379,1604,1,226380,29614,674,0,816,1612
4684,1,0,0,0,44,0,615,0,0,1291950,3277395,38.535697735995385,1485,2355,2355,1485,52216,538508,472298,2207,3692,2207,3077,4562,29.49576240750525,0.0,1485,1,317790,0,870,0,722,1337
4685,1,0,0,0,44,0,583,0,0,1363440,3306940,38.66522985836241,1495,2407,2407,1495,54560,548576,486640,2212,3707,2212,3124,4619,30.199337741083,0.0,1495,0,328900,0,912,0,717,1300
4686,1,0,0,0,43,0,777,0,0,1014388,1493942,26.28687885618983,691,2159,2159,691,45864,505908,423752,2162,2853,2162,3630,4321,38.31448812133603,0.0,691,0,135436,0,1468,0,1471,694
4687,1,0,0,0,47,0,983,0,1,1116818,1607490,25.96150997149434,237,2768,2331,674,56160,572400,558090,1948,3059,2822,4042,5153,40.70626487409524,21.811090281810994,1111,1,157716,59869,1657,0,1711,728
4688,1,0,0,0,47,0,931,0,1,1160412,1680792,26.60826939130014,329,2726,2347,708,55552,531776,588752,1995,3082,2753,4013,5100,40.48456495999432,20.45224082764291,1087,1,175584,36005,1639,0,1666,735
4689,1,0,0,0,47,0,845,0,1,1184550,1756710,27.294688127912362,422,2658,2335,745,55552,528192,584784,2035,3103,2681,3948,5016,39.87480407475377,18.997411630334586,1068,1,184760,29716,1590,0,1613,768
4690,1,0,0,0,46,0,760,0,1,1205844,1827534,27.964262908219126,514,2592,2324,782,53424,495444,588924,2069,3119,2605,3879,4929,39.26830783214372,17.388617513288057,1050,1,197064,19028,1542,0,1555,795
4691,1,0,0,0,46,0,679,0,1,1219920,1886592,28.5657137141714,600,2527,2311,816,52118,476272,584936,2096,3128,2528,3807,4839,38.66522985836241,15.64307981134644,1032,1,206448,13176,1495,0,1496,817
4692,1,0,0,0,45,0,595,0,1,1235144,1949958,29.206163733020468,683,2471,2301,853,52324,470916,580644,2116,3139,2456,3734,4757,38.05259518088089,13.852363991743774,1023,1,216662,10370,1448,0,1433,838
4693,1,0,0,0,44,0,425,0,1,1267014,2083389,30.54504869860253,838,2386,2291,933,50546,444367,567182,2138,3166,2328,3591,4619,36.851051545376556,10.152715924344653,1028,1,236982,4845,1358,0,1300,875
4694,1,0,0,0,44,0,382,0,1,1276835,2117235,30.903074280724887,888,2359,2292,955,52877,463353,560901,2150,3172,2284,3554,4576,36.565010597564445,8.436161057888377,1022,1,241615,4489,1337,0,1262,880
4695,1,0,0,0,44,0,339,0,1,1283440,2154032,31.240998703626616,934,2333,2291,976,54500,481126,551750,2165,3183,2249,3522,4540,36.26292872893749,6.653712290320142,1018,1,244000,3570,1315,0,1231,892
4696,1,0,0,0,43,0,169,0,1,1311912,2323776,32.61901286060018,1034,2327,2297,1064,48231,508872,452088,2154,3248,2214,3417,4511,35.11409973215888,5.477225575051661,1094,1,220248,4950,1233,0,1120,951
4697,1,0,0,0,43,0,127,0,1,1319618,2377269,32.96968304366907,1045,2343,2301,1087,46864,507384,441774,2145,3274,2229,3401,4530,34.84250278036869,6.5135556243263055,1129,1,219574,7098,1214,0,1100,973
4698,1,0,0,0,43,0,85,0,1,1326450,2429790,33.31666249791537,1043,2372,2305,1110,45571,501281,435611,2122,3299,2256,3384,4561,34.56877203488721,8.2143728690235,1177,1,220890,11390,1195,0,1079,994
4699,1,0,0,0,45,0,357,1,0,1234888,2978336,36.11094017053558,1304,2251,2251,1304,35154,431676,424824,2284,3588,2284,3231,4535,30.773365106858236,0.0,1304,1,242544,0,947,0,980,1337
4700,1,0,0,0,46,0,1061,0,1,588126,3420494,38.24918299781056,1433,1895,1865,1463,55460,551768,549430,2308,3801,2368,2740,4233,20.049937655763422,5.477225575051661,1493,1,343805,3930,402,0,875,1936
4701,1,0,0,0,43,0,1133,0,1,390570,3083670,37.54996671103717,1325,1772,1687,1410,52070,448335,555498,2102,3597,2272,2464,3959,16.64331697709324,9.80698324197389,1495,1,358140,5100,277,0,777,1910
4702,1,0,0,0,42,0,802,0,1,570224,2662720,35.4400902933387,1226,1740,1710,1256,54036,483360,502440,2090,3376,2150,2574,3860,21.307275752662516,5.490867587491313,1286,1,297672,3630,454,0,864,1666
4703,1,0,0,0,42,0,693,0,1,620398,2555219,34.741905532080416,1207,1721,1721,1207,46384,472091,440336,2117,3324,2117,2631,3838,22.67156809750927,0.0,1207,1,251056,0,514,0,910,1603
4704,1,0,0,0,42,0,639,0,0,641826,2503476,34.38022687534217,1182,1725,1725,1182,43848,457488,429954,2118,3300,2118,2661,3843,23.302360395462088,0.0,1182,0,239946,0,543,0,936,1575
4705,1,0,0,0,42,0,531,1,0,683802,2404080,33.67491648096547,1092,1779,1737,1134,39776,479120,373120,2078,3254,2162,2723,3899,24.55605831561735,6.538739683827756,1176,1,199584,7938,603,0,986,1517
4706,1,0,0,0,43,0,164,1,0,792512,2124752,31.240998703626616,748,2016,1788,976,36292,459347,374444,1949,3153,2405,2989,4193,28.495613697550013,15.472599544720637,1204,1,167872,40128,812,0,1201,1365
4707,1,0,0,0,44,0,86,1,0,842712,1967496,29.597297173897484,618,2096,1838,876,24476,473906,260536,1988,3122,2504,3208,4342,31.016124838541646,16.062438730691476,1134,1,101616,58566,962,0,1370,1284
4708,1,0,0,0,44,0,264,1,0,674800,1556800,26.457513110645905,520,1844,1664,700,28321,495952,282448,2044,2924,2404,3188,4068,31.04834939252005,14.881264274500568,880,1,88900,41400,964,0,1524,1260
4709,1,0,0,0,45,0,259,1,0,693036,1608528,26.70205984563738,473,1925,1685,713,29808,487296,311328,2016,2969,2496,3228,4181,31.176914536239792,17.268748008795917,953,1,98394,51120,972,0,1543,1284
4710,1,0,0,0,45,0,319,1,0,652712,1509936,25.768197453450252,417,1894,1647,664,30576,445704,354744,2027,2938,2521,3257,4168,31.352830813181765,15.928538783566438,911,1,103584,42978,983,0,1610,1291
4711,0,1,0,1,65,0,107,0,0,12831444,11911536,60.29925372672534,3486,7315,7165,3636,49042,710892,740376,3126,6912,3426,6805,10591,59.405386961116584,12.263881625621906,3786,1,821736,18600,3529,0,360,253
4712,0,1,1,0,61,0,1234,0,0,11138547,8594815,52.69724850502159,2735,6830,6788,2777,42336,584955,693280,3053,5872,3137,7106,9925,63.33245613427605,6.481658975540136,2819,0,622048,3738,4011,1,318,916
4713,0,1,1,0,61,0,1357,0,0,916740,1528065,22.24859546128699,0,2842,2347,495,27966,487746,546399,2592,3582,3582,4939,5929,43.034869582700026,23.239513652234418,990,1,87615,49995,1852,0,2592,1235
4714,0,0,1,0,58,1,577,0,0,2750940,5740492,44.40720662234904,1730,3609,3367,1972,53058,695729,646242,2669,4883,3153,4306,6520,37.3496987939662,15.594459615974078,2214,1,437784,36784,1395,0,939,1516
4715,0,0,0,0,55,1,842,1,0,2857323,6043422,46.50806381693394,2073,3574,3484,2163,53382,606298,687324,2704,4957,2884,4115,6368,36.345563690772494,9.590813010750445,2253,1,532098,8460,1321,0,631,1473
4716,1,0,0,0,46,0,104,1,0,22896,248724,10.392304845413264,108,320,320,108,55454,536599,548114,2303,2411,2303,2515,2623,14.560219778561036,0.0,108,1,25704,0,212,0,2195,2091
4717,1,0,0,0,46,0,107,1,0,29718,292100,11.269427669584644,127,361,361,127,49184,533600,487600,2300,2427,2300,2534,2661,15.297058540778355,0.0,127,1,26924,0,234,0,2173,2066
4718,1,0,0,0,46,0,153,1,0,176050,816200,18.708286933869708,255,948,853,350,26019,412764,342804,2237,2682,2427,2835,3280,22.427661492005804,10.232047425710157,445,1,51450,15010,503,0,1982,1829
4719,1,0,0,0,45,0,256,0,1,433857,1816926,28.26658805020514,739,1402,1342,799,50546,452526,577596,2214,3073,2334,2817,3676,23.302360395462088,8.111420134500735,859,1,202946,3060,543,0,1475,1731
4720,1,0,0,0,44,0,365,1,0,410916,1907703,29.13760456866693,849,1333,1333,849,53628,489846,552762,2247,3096,2247,2731,3580,22.0,0.0,849,1,208854,0,484,0,1398,1763
4721,1,0,0,0,45,0,654,1,0,257887,2138507,30.512292604784715,781,1358,1208,931,34100,505340,356035,2147,3228,2447,2574,3655,16.64331697709324,12.801484421932168,1081,1,144305,30450,277,0,1366,2020
4722,1,0,0,0,43,0,671,0,0,1255170,3306485,38.79432948254165,1505,2339,2339,1505,51075,498719,494325,2197,3702,2197,3031,4536,28.879058156387302,0.0,1505,0,338625,0,834,0,692,1363
4723,1,0,0,0,43,0,623,0,0,1351380,3325425,38.92300091205713,1485,2437,2407,1515,52779,528995,480705,2165,3710,2225,3087,4632,29.866369046136157,5.830951894845301,1545,0,331785,4740,892,0,680,1303
4724,1,0,0,0,45,0,263,1,0,1455290,3090810,36.6742416417845,1218,2554,2427,1345,18909,438918,227502,2171,3643,2425,3380,4852,32.89376840679705,12.273222963506544,1472,1,133155,27813,1082,0,953,1216
4725,1,0,0,0,48,0,10,0,1,1227639,2665951,33.21144381083123,701,2618,2216,1103,41160,507570,473732,2015,3520,2819,3530,5035,33.36165463522455,21.578901951862694,1505,1,216188,60300,1113,0,1314,1304
4726,1,0,0,0,47,0,129,0,1,1169812,2439486,31.921779399024736,573,2613,2167,1019,43264,497952,497952,1948,3413,2840,3542,5007,33.88214869219483,22.483981530283888,1465,1,211952,59764,1148,0,1375,1246
4727,1,0,0,0,47,0,1051,0,1,1065972,1509705,25.15949125081825,174,2776,2317,633,53165,584325,517545,1926,3018,2844,4069,5161,41.036569057366385,22.27126113397423,1092,1,137361,75276,1684,0,1752,701
4728,1,0,0,0,47,0,929,0,1,1147296,1656971,26.514147167125703,361,2677,2335,703,55000,518540,589250,2015,3060,2699,3989,5034,40.39801975344831,19.431327343197207,1045,1,175750,29070,1632,0,1654,725
4729,1,0,0,0,46,0,843,0,1,1173744,1733199,27.2213151776324,456,2610,2325,741,54750,512241,584750,2054,3080,2624,3923,4949,39.7994974842648,17.844225790162664,1026,1,185250,23085,1584,0,1598,755
4730,1,0,0,0,46,0,763,0,1,1189638,1792584,27.820855486487112,546,2539,2311,774,53383,488676,585948,2088,3090,2544,3853,4855,39.20459156782532,16.03704157914288,1002,1,195822,15276,1537,0,1542,779
4731,1,0,0,0,46,0,721,0,1,1198296,1823976,28.142494558940577,591,2506,2305,792,52371,476721,582659,2102,3095,2504,3816,4809,38.897300677553446,15.074407482436811,993,1,200376,12261,1513,0,1511,790
4732,1,0,0,0,45,0,679,0,1,1208390,1857190,28.478061731796284,636,2476,2301,811,52118,471740,579370,2115,3101,2465,3780,4766,38.600518131237564,14.0775242440226,986,1,205183,10325,1490,0,1479,800
4733,1,0,0,0,45,0,638,0,1,1218440,1889910,28.809720581775867,680,2448,2298,830,52371,471339,576081,2127,3107,2427,3745,4725,38.31448812133603,13.038404810405298,980,1,209990,8850,1468,0,1447,809
4734,1,0,0,0,45,0,553,0,1,1238010,1958370,29.49576240750525,762,2401,2293,870,52961,474961,565001,2143,3121,2359,3674,4652,37.72267222772003,11.05073728862856,978,1,218370,7128,1423,0,1381,828
4735,1,0,0,0,44,0,510,0,1,1248291,1994949,29.8496231131986,806,2377,2292,891,51660,458995,564228,2154,3130,2324,3640,4616,37.429934544425805,9.80698324197389,976,1,224532,4760,1401,0,1348,838
4736,1,0,0,0,44,0,467,0,1,1257648,2027376,30.199337741083,845,2358,2291,912,50853,446823,562419,2156,3135,2290,3602,4581,37.134889255254286,8.544404542961196,979,1,230736,3350,1379,0,1311,844
4737,1,0,0,0,44,0,382,0,1,1276835,2101000,30.903074280724887,925,2322,2292,955,55822,497200,543400,2170,3155,2230,3537,4522,36.565010597564445,5.5503012171862105,985,1,235885,3000,1337,0,1245,863
4738,1,0,0,0,43,0,297,0,1,1294704,2183814,31.606961258558215,999,2295,2295,999,52670,500594,502780,2186,3185,2186,3482,4481,36.0,0.0,999,1,229770,0,1296,0,1187,890
4739,1,0,0,0,43,0,254,0,1,1304072,2234092,31.96873472629156,992,2328,2298,1022,47861,500594,456874,2156,3208,2216,3462,4514,35.7211421989835,5.477225575051661,1052,1,213598,4770,1276,0,1164,910
4740,1,0,0,0,43,0,126,1,0,1330056,2393664,33.04542328371661,1007,2395,2310,1092,44160,504160,420864,2107,3284,2277,3410,4587,34.899856733230294,9.257905235465769,1177,1,209664,15045,1218,0,1100,974
4741,1,0,0,0,44,0,60,1,0,1312416,2627184,34.292856398964496,964,2504,2292,1176,32292,462438,348504,2022,3410,2446,3350,4738,33.406586176980134,14.862034112126459,1388,1,183456,39644,1116,0,1058,1118
4742,1,0,0,0,46,0,227,1,0,1240398,2845764,35.11409973215888,1143,2329,2239,1233,28116,491604,304656,2218,3541,2398,3314,4637,31.71750305430741,9.560918316574591,1323,1,162756,19350,1006,0,1075,1302
4743,1,0,0,0,46,0,979,0,1,629946,3328902,37.70941526992961,1392,1895,1865,1422,54026,531407,557158,2311,3763,2371,2784,4236,21.047565179849187,5.501408174353464,1452,1,338436,3540,443,0,919,1898
4744,1,0,0,0,46,0,1007,0,1,617910,3358269,37.907782842049734,1437,1867,1867,1437,51493,544521,516477,2337,3774,2337,2767,4204,20.73644135332772,0.0,1437,1,317577,0,430,0,900,1907
4745,1,0,0,0,46,0,1033,0,0,606518,3392438,38.09199390948182,1451,1869,1869,1451,45864,547092,458248,2338,3789,2338,2756,4207,20.445048300260872,0.0,1451,0,284396,0,418,0,887,1920
4746,1,0,0,0,47,0,1110,1,0,586891,3551366,38.742741255621034,1393,2000,1892,1501,34668,506324,383292,2258,3867,2474,2757,4366,19.77371993328519,10.587221077960752,1609,1,243162,20412,391,0,865,1975
4747,1,0,0,0,42,0,877,0,1,546458,2760846,36.02776706930364,1298,1719,1719,1298,52640,476448,499845,2127,3425,2127,2548,3846,20.518284528683193,0.0,1298,1,305030,0,421,0,829,1706
4748,1,0,0,0,42,0,768,0,0,600769,2651627,35.34119409414458,1249,1730,1730,1249,40916,450076,409739,2123,3372,2123,2604,3853,21.93171219946131,0.0,1249,0,241057,0,481,0,874,1642
4749,1,0,0,0,42,0,659,0,0,649200,2552400,34.64101615137755,1200,1741,1741,1200,41790,446670,423273,2127,3327,2127,2668,3868,23.259406699226016,0.0,1200,0,238800,0,541,0,927,1586
4750,1,0,0,0,42,0,498,1,0,712399,2412673,33.60059523282288,1044,1845,1760,1129,29512,463729,290632,2052,3266,2222,2768,3982,25.11971337416094,9.412769291411893,1214,1,153544,18445,631,0,1008,1506
4751,1,0,0,0,45,0,265,0,1,795146,1736402,27.730849247724095,684,1888,1803,769,51308,456116,573532,2173,3027,2343,3292,4146,32.155870381627054,9.607770959340817,854,1,195326,4675,1034,0,1489,1224
4752,1,0,0,0,43,0,271,0,1,730730,1592860,27.018512172212592,730,1731,1731,730,49053,429854,543318,2182,2912,2182,3183,3913,31.63858403911275,0.0,730,1,181770,0,1001,0,1452,1181
4753,1,0,0,0,43,0,271,1,0,723822,1576872,26.94438717061496,726,1723,1723,726,42823,406164,497388,2172,2898,2172,3169,3895,31.575306807693888,0.0,726,1,166254,0,997,0,1446,1175
4754,1,0,0,0,43,0,272,1,0,717668,1561686,26.870057685088806,722,1716,1716,722,36477,408807,417459,2163,2885,2163,3157,3879,31.52776554086889,0.0,722,1,139346,0,994,0,1441,1169
4755,1,0,0,0,45,0,270,1,0,731731,1654984,27.03701166919155,491,1972,1732,731,27903,482232,296584,2024,2995,2504,3265,4236,31.63858403911275,17.23446937986728,971,1,95761,52080,1001,0,1533,1263
4756,1,0,0,0,43,0,479,0,0,394896,948703,20.808652046684813,433,1345,1345,433,35495,339605,501739,2191,2624,2191,3103,3536,30.199337741083,0.0,433,1,99157,0,912,0,1758,1279
4757,1,0,0,0,43,0,476,1,0,330240,830976,19.595917942265423,354,1274,1244,384,33124,365716,424144,2134,2548,2194,3024,3438,29.32575659723036,5.477225575051661,414,1,75264,2880,860,0,1780,1304
4758,0,1,0,1,65,0,128,0,0,12999140,12048610,60.58052492344384,3546,7336,7212,3670,53124,748524,764939,3159,6953,3407,6825,10619,59.51470406546604,11.193732213226145,3794,1,855110,15872,3542,0,387,259
4759,0,1,1,0,59,0,1922,0,0,5748368,4804364,40.27406113120453,1592,5196,5166,1622,55189,713842,678298,2932,4584,2992,6506,8158,59.531504264548865,5.477225575051661,1652,0,371438,4320,3544,1,1340,582
4760,0,1,1,0,62,0,1570,0,0,1071176,1616530,22.67156809750927,184,2928,2598,514,16296,528360,305065,2815,3659,3475,5229,6073,45.65084884205331,19.028366212642688,844,1,49858,64350,2084,0,2631,1061
4761,0,1,1,0,60,0,420,0,0,719776,2011256,25.768197453450252,9,2403,1748,664,54656,678496,739076,2374,3693,3684,4113,5432,32.92415526630866,26.341554828907128,1319,1,162016,70085,1084,0,2365,1945
4762,0,1,1,0,56,0,699,0,0,98280,341760,10.954451150103322,25,1034,939,120,50388,580992,703456,2753,2968,2943,3667,3882,28.61817604250837,10.21168317809702,215,1,29640,7315,819,0,2728,2029
4763,0,0,1,0,58,1,839,0,0,779526,4104386,37.376463182061514,1277,2075,1955,1397,45920,658112,602290,2818,4335,3058,3496,5013,23.62202362203543,10.996993508431213,1517,1,286385,18720,558,0,1541,2380
4764,0,0,0,0,55,1,843,1,0,2942860,6106708,46.776062254106,2103,3618,3533,2188,55144,630766,681004,2706,4979,2876,4136,6409,36.6742416417845,9.2729914971827,2273,1,533872,9180,1345,0,603,1446
4765,0,0,1,0,55,1,914,0,0,2906376,6181604,47.138094997570704,2192,3560,3530,2222,52440,634296,639860,2752,5004,2812,4090,6342,36.16628264005025,5.5503012171862105,2252,0,511060,3930,1308,1,560,1474
4766,1,0,0,0,46,0,65,1,0,24384,292354,11.269427669584644,127,319,319,127,48279,531762,481118,2302,2429,2302,2494,2621,13.856406460551018,0.0,127,1,26543,0,192,0,2175,2110
4767,1,0,0,0,46,0,111,1,0,121176,694089,17.233687939614086,177,825,705,297,23738,387942,334191,2217,2634,2457,2745,3162,20.199009876724155,11.336427594764531,417,1,42471,17760,408,0,2040,1929
4768,1,0,0,0,44,0,377,1,0,422120,1943655,29.410882339705484,865,1353,1353,865,50830,496587,516810,2247,3112,2247,2735,3600,22.090722034374522,0.0,865,1,198950,0,488,0,1382,1759
4769,1,0,0,0,48,0,909,1,0,223110,2665110,33.31666249791537,630,1791,1311,1110,27048,403368,386561,1921,3511,2881,2602,4192,14.177446878757825,22.76175479120879,1590,1,178710,63360,201,0,1291,2200
4770,1,0,0,0,48,0,830,1,0,643184,3205376,36.30426972134269,781,2343,1806,1318,35024,483968,428032,1895,3750,2969,2920,4775,22.090722034374522,24.269532065310347,1855,1,231968,85383,488,0,1114,1944
4771,1,0,0,0,44,0,858,0,0,1081584,3482514,39.42080668885405,1524,2280,2250,1554,32283,472851,342873,2211,3795,2271,2937,4521,26.38181191654584,5.623413251903491,1584,0,237762,5850,696,0,687,1545
4772,1,0,0,0,45,0,831,0,1,1071700,3463122,39.1279950930277,1423,2339,2231,1531,39292,472758,425256,2154,3793,2370,2962,4601,26.457513110645905,10.60004836173973,1639,1,287828,17064,700,0,731,1562
4773,1,0,0,0,45,0,799,0,1,1118430,3503700,39.11521443121589,1360,2431,2261,1530,37668,501510,393880,2120,3820,2460,3021,4721,27.03701166919155,13.36696240183447,1700,1,263160,31620,731,0,760,1559
4774,1,0,0,0,45,0,765,0,1,1170450,3509820,39.11521443121589,1368,2457,2295,1530,45590,445036,539090,2132,3824,2456,3059,4751,27.65863337187866,13.441596129072966,1692,1,359550,13284,765,0,764,1529
4775,1,0,0,0,48,0,185,0,0,1092894,2304456,30.93541659651604,549,2507,2099,957,35880,469560,443072,2000,3365,2816,3550,4915,33.793490497431605,21.52984554065173,1365,1,176088,58752,1142,0,1451,1266
4776,1,0,0,0,43,0,819,1,0,900432,1364688,24.979991993593593,582,2109,2067,624,29025,470205,295245,2145,2811,2229,3630,4296,37.986839826445156,6.78953034358522,666,1,84240,9030,1443,0,1563,744
4777,1,0,0,0,45,0,964,1,0,861792,1270692,23.748684174075834,411,2245,2092,564,31752,486648,331191,2100,2817,2406,3781,4498,39.08964057138413,13.419926217395696,717,1,82908,31518,1528,0,1689,725
4778,1,0,0,0,47,0,1056,0,1,1090116,1523466,25.337718918639855,247,2735,2340,642,54780,522060,590877,1978,3015,2768,4071,5108,41.20679555607303,20.795098519854925,1037,1,159858,36340,1698,0,1731,675
4779,1,0,0,0,47,0,1013,0,1,1106514,1561282,25.709920264364882,296,2700,2335,661,53463,503106,592862,1997,3023,2727,4036,5062,40.91454509095757,20.01404769274308,1026,1,165911,28470,1674,0,1701,688
4780,1,0,0,0,46,0,926,0,1,1138200,1636600,26.457513110645905,394,2632,2326,700,54216,505008,586838,2032,3038,2644,3964,4970,40.32369030731191,18.355458039267724,1006,1,175700,24174,1626,0,1638,712
4781,1,0,0,0,46,0,806,0,1,1167000,1731000,27.386127875258307,532,2524,2306,750,53714,493912,579308,2090,3058,2526,3864,4832,39.44616584663204,15.640728156069711,968,1,188250,15696,1556,0,1558,752
4782,1,0,0,0,45,0,765,0,1,1177344,1762560,27.712812921102035,578,2491,2301,768,52371,475065,580635,2105,3063,2485,3828,4786,39.153543900903784,14.621386345521588,958,1,194304,11780,1533,0,1527,762
4783,1,0,0,0,45,0,723,0,1,1188370,1794360,28.053520278211074,625,2459,2297,787,51054,458280,579120,2118,3067,2442,3790,4739,38.8587184554509,13.491653849526754,949,1,199898,8262,1510,0,1493,770
4784,1,0,0,0,45,0,680,0,1,1200009,1827855,28.407745422683583,673,2428,2294,807,51106,457530,573045,2131,3072,2399,3752,4693,38.561638969317684,12.25832084953297,941,1,204171,6834,1487,0,1458,778
4785,1,0,0,0,45,0,637,0,1,1213020,1863828,28.77498913987632,720,2401,2293,828,51706,463706,565001,2143,3079,2359,3716,4652,38.27531841800928,10.98852450445412,936,1,207828,6264,1465,0,1423,786
4786,1,0,0,0,44,0,594,0,1,1225107,1900911,29.13760456866693,764,2377,2292,849,52290,470190,557511,2154,3088,2324,3682,4616,37.986839826445156,9.737059976664934,934,1,211401,5355,1443,0,1390,796
4787,1,0,0,0,44,0,551,0,1,1236270,1937490,29.49576240750525,803,2358,2291,870,51500,458762,556750,2160,3097,2294,3648,4585,37.69615364994153,8.642106768569302,937,1,217500,3819,1421,0,1357,806
4788,1,0,0,0,43,0,424,0,1,1268372,2048262,30.56141357987225,904,2322,2292,934,56153,510969,528513,2163,3127,2223,3551,4515,36.851051545376556,5.477225575051661,964,1,225094,3570,1358,0,1259,835
4789,1,0,0,0,43,0,381,0,1,1280466,2094873,30.93541659651604,957,2295,2295,957,53820,512226,503470,2189,3146,2189,3527,4484,36.578682316343766,0.0,957,1,220110,0,1338,0,1232,851
4790,1,0,0,0,43,0,339,0,1,1290322,2142052,31.28897569432403,949,2327,2297,979,48972,505428,463856,2158,3167,2218,3506,4515,36.30426972134269,5.501408174353464,1009,1,207548,4710,1318,0,1209,870
4791,1,0,0,0,47,0,249,1,0,1226610,2917845,35.199431813596085,1119,2349,2229,1239,31603,520455,336765,2235,3594,2475,3345,4704,31.464265445104548,10.986451322313634,1359,1,177177,25680,990,0,1116,1365
4792,1,0,0,0,47,0,246,1,0,1223640,2925612,35.156791662493895,1086,2376,2226,1236,28944,511272,317178,2217,3603,2517,3357,4743,31.464265445104548,12.331628572798303,1386,1,165624,32400,990,0,1131,1377
4793,1,0,0,0,46,0,926,0,1,656120,3266640,37.36308338453881,1396,1866,1866,1396,51528,533520,528840,2340,3736,2340,2810,4206,21.6794833886788,0.0,1396,1,315496,0,470,0,944,1870
4794,1,0,0,0,47,0,1004,1,0,629717,3387791,37.960505792204614,1399,1920,1878,1441,37241,524273,392617,2309,3792,2393,2788,4271,20.904544960366874,6.63067838716079,1483,1,240647,8190,437,0,910,1914
4795,1,0,0,0,47,0,1049,1,0,624552,3486591,38.379682124790975,1378,1992,1897,1473,38080,530208,402390,2272,3840,2462,2791,4359,20.591260281974,9.951904129305408,1568,1,250410,18335,424,0,894,1943
4796,1,0,0,0,47,0,1068,1,0,626869,3534886,38.58756276314948,1365,2034,1910,1489,38025,534150,401206,2250,3863,2498,2795,4408,20.518284528683193,11.316469623900245,1613,1,251641,24180,421,0,885,1953
4797,1,0,0,0,47,0,1100,1,0,657900,3655170,39.11521443121589,1318,2172,1960,1530,40832,554248,420464,2177,3919,2601,2819,4561,20.73644135332772,14.852658030956366,1742,1,269280,41552,430,0,859,1959
4798,1,0,0,0,44,0,1507,0,1,143730,3530967,39.96248240537617,1507,1777,1687,1597,51666,481998,524007,2121,3808,2301,2301,3988,9.486832980505138,9.756499634156611,1687,1,378489,7200,90,0,614,2121
4799,1,0,0,0,42,0,1060,0,1,458700,2977380,37.282703764614496,1390,1720,1720,1390,56105,490518,524790,2142,3532,2142,2472,3862,18.16590212458495,0.0,1390,1,340550,0,330,0,752,1812
4800,1,0,0,0,42,0,950,0,0,522600,2852860,36.60601043544625,1340,1730,1730,1340,49729,474767,474767,2129,3469,2129,2519,3859,19.748417658131498,0.0,1340,0,298820,0,390,0,789,1739
4801,1,0,0,0,42,0,678,0,0,657720,2599212,34.899856733230294,1218,1758,1758,1218,42024,439604,435336,2134,3352,2134,2674,3892,23.2379000772445,0.0,1218,0,248472,0,540,0,916,1594
4802,1,0,0,0,43,0,260,1,0,811200,2285920,32.2490309931942,828,2032,1820,1040,36668,452788,391244,1986,3238,2410,2978,4230,27.92848008753788,14.852658030956366,1252,1,185120,34768,780,0,1158,1418
4803,1,0,0,0,44,0,109,1,0,851730,2165548,31.28897569432403,678,2150,1849,979,25830,453460,278712,1911,3191,2513,3082,4362,29.49576240750525,17.882645020557682,1280,1,123354,63511,870,0,1233,1342
4804,1,0,0,0,45,0,264,0,1,866176,1830928,28.42534080710379,723,1965,1880,808,53130,475860,573298,2181,3074,2351,3338,4231,32.7414110874898,9.587694277262452,893,1,204424,5950,1072,0,1458,1194
4805,1,0,0,0,44,0,270,0,1,802611,1698513,27.76688675382964,771,1812,1812,771,48216,431788,541938,2203,2974,2203,3244,4015,32.264531609803356,0.0,771,1,189666,0,1041,0,1432,1162
4806,1,0,0,0,43,0,271,1,0,783560,1661360,27.568097504180443,760,1791,1791,760,42074,421898,476548,2186,2946,2186,3217,3977,32.109188716004645,0.0,760,1,165680,0,1031,0,1426,1155
4807,1,0,0,0,43,0,270,1,0,765000,1641000,27.386127875258307,683,1837,1770,750,29223,417908,334764,2121,2938,2255,3208,4025,31.937438845342623,8.721191861163568,817,1,114750,11390,1020,0,1438,1168
4808,1,0,0,0,45,0,456,0,0,515025,1181775,22.9128784747792,465,1566,1506,525,42720,400678,540240,2191,2776,2311,3232,3817,31.32091952673165,8.334399795261145,585,1,126000,3060,981,0,1726,1270
4809,1,0,0,0,44,0,454,0,0,475547,1114766,22.338307903688676,469,1482,1452,499,41211,382014,538394,2204,2733,2264,3187,3716,30.870698080866262,5.91487205010149,529,1,120259,1170,953,0,1735,1281
4810,0,0,1,0,57,1,444,0,0,690316,3131308,32.89376840679705,835,1967,1720,1082,38409,627998,512238,2647,3976,3141,3532,4861,25.25866188063018,15.75958918465378,1329,0,191514,44213,638,1,1812,2256
4811,0,0,1,0,55,1,915,0,0,2993004,6246660,47.40253157796533,2217,3609,3579,2247,54264,661640,633840,2750,5027,2810,4112,6389,36.49657518178932,5.478746393072713,2277,0,512316,4320,1332,1,533,1448
4812,1,0,0,0,46,0,31,1,0,34170,393720,13.038404810405298,128,413,371,170,30955,474780,349716,2274,2486,2358,2517,2729,14.177446878757825,6.653712290320142,212,1,25670,7980,201,0,2146,2115
4813,1,0,0,0,46,0,44,1,0,54272,495232,14.560219778561036,127,553,468,212,28600,467200,334048,2251,2548,2421,2592,2889,16.0,9.607770959340817,297,1,30316,16150,256,0,2124,2080
4814,1,0,0,0,47,0,98,1,0,165699,852321,19.0,211,970,820,361,38994,474561,458034,2211,2722,2511,2820,3331,21.42428528562855,12.899034672654562,511,1,70034,21150,459,0,2000,1902
4815,1,0,0,0,47,0,110,0,1,211344,959616,20.199009876724155,246,1088,926,408,48990,500976,540960,2190,2760,2514,2870,3440,22.759613353482084,13.197871455595559,570,1,93840,18468,518,0,1944,1834
4816,1,0,0,0,45,0,316,1,0,440160,1894200,28.982753492378876,840,1364,1364,840,52580,496100,538945,2255,3095,2255,2779,3619,22.891046284519195,0.0,840,1,200760,0,524,0,1415,1731
4817,1,0,0,0,48,0,803,1,0,642510,3172312,36.02776706930364,734,2357,1793,1298,36200,488800,442364,1880,3742,3008,2939,4801,22.24859546128699,24.870793792091074,1862,1,234938,86292,495,0,1146,1949
4818,1,0,0,0,45,0,853,0,1,1134854,3577702,39.67366884975475,1514,2355,2295,1574,30300,459146,340950,2213,3847,2333,2994,4628,26.851443164195103,8.52469877450791,1634,1,236100,11220,721,0,699,1552
4819,1,0,0,0,45,0,850,0,1,1130400,3579600,39.6232255123179,1503,2357,2290,1570,34710,444600,405840,2213,3850,2347,3000,4637,26.832815729997478,8.892463825840219,1637,1,279460,10117,720,0,710,1560
4820,1,0,0,0,45,0,831,0,1,1139530,3545031,39.50949253027682,1427,2425,2291,1561,39565,465555,438303,2137,3832,2405,3001,4696,27.018512172212592,11.79043628304646,1695,1,301273,19832,730,0,710,1541
4821,1,0,0,0,48,0,85,0,1,1078754,2410746,31.575306807693888,509,2567,2079,997,38809,476346,476346,1930,3415,2906,3500,4985,32.89376840679705,23.22681509696983,1485,1,196409,64416,1082,0,1421,1336
4822,1,0,0,0,48,0,213,0,0,1030078,2209138,30.23243291566195,543,2412,2041,914,41710,468898,519655,2046,3331,2788,3544,4829,33.57082066318904,20.880228558579432,1285,1,196510,39697,1127,0,1503,1290
4823,1,0,0,0,45,0,1133,1,0,791048,1102880,22.090722034374522,191,2406,2109,488,32256,379680,433920,1963,2748,2557,3881,4666,40.26164427839479,17.702631218773103,785,1,93696,29403,1621,0,1772,639
4824,1,0,0,0,47,0,1216,1,0,911760,1233496,22.891046284519195,8,2780,2264,524,37392,579084,357808,1838,2878,2870,4094,5134,41.71330722922842,23.062537278120075,1040,1,79648,116100,1740,0,1830,614
4825,1,0,0,0,47,0,1162,0,1,1015008,1383996,24.124676163629637,132,2776,2326,582,53520,570720,530294,1928,2960,2828,4122,5154,41.7612260356422,21.8312049758689,1032,1,129786,68400,1744,0,1796,634
4826,1,0,0,0,47,0,1140,0,1,1044000,1425000,24.49489742783178,179,2761,2340,600,54970,546250,567625,1954,2975,2796,4115,5136,41.71330722922842,21.172677609183665,1021,1,143400,50099,1740,0,1775,635
4827,1,0,0,0,46,0,1010,0,1,1097544,1543668,25.65151067676132,327,2657,2326,658,50750,476238,586500,2015,3004,2677,4014,5003,40.84115571332428,19.05230584466527,989,1,164500,22839,1668,0,1688,678
4828,1,0,0,0,45,0,849,0,1,1143450,1666170,26.94438717061496,514,2513,2301,726,53424,486540,578340,2083,3021,2507,3870,4808,39.68626966596886,15.28251067977674,938,1,182952,14628,1575,0,1569,720
4829,1,0,0,0,45,0,765,0,1,1170450,1738080,27.65863337187866,612,2448,2295,765,50038,447584,577088,2119,3037,2425,3802,4720,39.11521443121589,13.053492324047044,918,1,194310,6885,1530,0,1507,742
4830,1,0,0,0,45,0,722,0,1,1182995,1770175,28.0178514522438,661,2416,2292,785,49784,441980,572770,2131,3040,2379,3762,4671,38.82009788756334,11.700176052913939,909,1,199390,5208,1507,0,1470,748
4831,1,0,0,0,44,0,636,0,1,1212192,1842300,28.77498913987632,761,2359,2292,828,51957,460575,558475,2158,3053,2292,3689,4584,38.262252939417984,8.521468497772455,895,1,207828,3953,1464,0,1397,761
4832,1,0,0,0,44,0,593,0,1,1224258,1877139,29.13760456866693,807,2333,2291,849,53714,473154,554961,2169,3060,2253,3653,4544,37.97367509209505,6.653712290320142,891,1,213099,2940,1442,0,1362,769
4833,1,0,0,0,44,0,551,0,1,1236270,1914870,29.49576240750525,840,2321,2291,870,55527,490823,548049,2171,3071,2231,3622,4522,37.69615364994153,5.5503012171862105,900,1,216630,2730,1421,0,1331,780
4834,1,0,0,0,43,0,509,0,1,1249692,1957048,29.866369046136157,892,2293,2293,892,55671,506814,528754,2194,3086,2194,3595,4487,37.429934544425805,0.0,892,1,214972,0,1401,0,1302,793
4835,1,0,0,0,43,0,423,0,1,1274320,2052030,30.610455730027933,937,2297,2297,937,46945,501510,448950,2190,3127,2190,3550,4487,36.87817782917155,0.0,937,1,192085,0,1360,0,1253,830
4836,1,0,0,0,43,0,381,0,1,1287360,2105280,30.983866769659336,930,2331,2301,960,43262,489039,425442,2163,3153,2223,3534,4524,36.61966684720111,5.501408174353464,990,1,186240,5040,1341,0,1233,852
4837,1,0,0,0,46,0,191,1,0,1239686,2846911,34.828149534535996,1128,2320,2235,1213,32915,532769,340315,2262,3560,2432,3369,4667,31.96873472629156,9.227509513928014,1298,1,175885,18615,1022,0,1134,1325
4838,1,0,0,0,47,0,179,0,1,1227422,2879998,34.655446902326915,1106,2318,2223,1201,45927,582714,453222,2303,3599,2493,3420,4716,31.96873472629156,9.76859066112806,1296,1,226989,18335,1022,0,1197,1376
4839,1,0,0,0,48,0,480,0,1,922500,2952000,35.07135583350036,953,2257,1980,1230,55647,549600,583200,2123,3630,2677,3150,4657,27.386127875258307,16.691908598119873,1507,1,298890,30747,750,0,1170,1650
4840,1,0,0,0,46,0,817,0,1,704550,3149674,36.6333181680284,1312,1897,1867,1342,53572,553892,532769,2317,3689,2377,2872,4244,22.9128784747792,5.483301264452448,1372,1,304634,4290,525,0,1005,1822
4841,1,0,0,0,46,0,845,0,1,691050,3177475,36.810324638611924,1355,1865,1865,1355,51051,541695,518245,2345,3700,2345,2855,4210,22.58317958127243,0.0,1355,1,299455,0,510,0,990,1835
4842,1,0,0,0,47,0,949,1,0,659390,3335155,37.61648574760805,1348,1948,1881,1415,37074,523254,393619,2290,3772,2424,2823,4305,21.587033144922902,8.361900766312248,1482,1,236305,12998,466,0,942,1891
4843,1,0,0,0,47,0,1049,1,0,676500,3582000,38.72983346207417,1310,2141,1951,1500,44946,542076,472824,2198,3888,2578,2839,4529,21.236760581595302,14.03521675058493,1690,1,297000,31920,451,0,888,1937
4844,1,0,0,0,48,0,1090,1,0,725096,3735956,39.44616584663204,1301,2277,2022,1556,35496,557032,367353,2146,3957,2656,2867,4678,21.587033144922902,16.286291307480834,1811,1,238068,55335,466,0,845,1935
4845,1,0,0,0,48,0,1086,1,0,739440,3765840,39.496835316262995,1283,2311,2034,1560,33033,557634,345202,2137,3974,2691,2888,4725,21.77154105707724,17.004933736171072,1837,1,223080,62048,474,0,854,1940
4846,1,0,0,0,45,0,1565,0,1,109344,3701376,40.39801975344831,1482,1849,1699,1632,50400,453600,571536,2118,3900,2418,2335,4117,8.18535277187245,13.038404810405298,1782,1,411264,7200,67,0,636,2201
4847,1,0,0,0,43,0,1240,0,1,358644,3201120,38.49675310984031,1452,1754,1724,1482,56608,501120,527040,2130,3642,2190,2402,3914,15.556349186104045,5.5965095842615735,1512,1,361608,3210,242,0,678,1918
4848,1,0,0,0,43,0,1184,0,1,396032,3131856,38.157568056677825,1456,1728,1728,1456,55575,483975,531297,2151,3607,2151,2423,3879,16.492422502470642,0.0,1456,1,359632,0,272,0,695,1879
4849,1,0,0,0,42,0,1130,0,1,430731,3065202,37.82856063875548,1431,1732,1732,1431,53760,479808,514080,2142,3573,2142,2443,3874,17.349351572897472,0.0,1431,1,343440,0,301,0,711,1841
4850,1,0,0,0,42,0,1075,0,0,465386,3004622,37.49666651850535,1406,1737,1737,1406,48391,476551,463729,2137,3543,2137,2468,3874,18.193405398660254,0.0,1406,0,305102,0,331,0,731,1806
4851,1,0,0,0,44,0,230,1,0,844251,2300610,32.264531609803356,801,2092,1852,1041,33368,428740,380120,1970,3251,2450,3021,4302,28.478061731796284,15.838451082838114,1281,1,179052,37200,811,0,1169,1399
4852,1,0,0,0,44,0,181,1,0,859502,2263730,31.96873472629156,752,2133,1863,1022,29204,434140,330035,1945,3237,2485,3056,4348,29.0,16.764275179295073,1292,1,152278,48870,841,0,1193,1374
4853,1,0,0,0,44,0,269,0,1,870216,1795376,28.42534080710379,808,1885,1885,808,46706,428846,537724,2222,3030,2222,3299,4107,32.817678162843876,0.0,808,1,195536,0,1077,0,1414,1145
4854,1,0,0,0,44,0,271,1,0,856800,1768000,28.284271247461902,800,1871,1871,800,41701,413270,492830,2210,3010,2210,3281,4081,32.72613634390714,0.0,800,1,178400,0,1071,0,1410,1139
4855,1,0,0,0,45,0,309,1,0,797872,1715312,27.422618401604176,505,2060,1813,752,24921,485853,266877,2034,3033,2528,3342,4341,32.57299494980466,17.415231551327217,999,1,87984,56316,1061,0,1529,1220
4856,1,0,0,0,46,0,406,1,0,722667,1558733,25.903667693977237,459,1960,1748,671,37411,485507,415817,2111,2994,2535,3400,4283,32.817678162843876,15.410129902918593,883,1,120109,35404,1077,0,1652,1246
4857,1,0,0,0,45,0,428,0,0,524229,1218332,23.259406699226016,474,1577,1510,541,41001,389596,533724,2185,2793,2319,3221,3829,31.12876483254676,8.721191861163568,608,1,128217,3283,969,0,1711,1283
4858,0,1,1,0,63,0,768,0,0,12116548,9880942,55.839054433254866,3051,7071,7004,3118,36248,624293,583096,3102,6287,3236,7055,10240,62.3377895020348,8.239962426314323,3185,0,573712,9782,3886,1,51,717
4859,0,1,1,0,59,0,1924,0,0,7415100,5745258,43.88621651498338,1866,5836,5776,1926,44943,629413,635379,2923,4909,3043,6833,8819,62.048368229954285,7.772191019407321,1986,0,410238,7920,3850,1,1057,867
4860,0,0,1,0,57,1,336,0,0,725200,2995076,32.18695387886216,854,1918,1736,1036,39776,653366,508816,2709,3927,3073,3591,4809,26.457513110645905,13.544280718635392,1218,0,182336,34398,700,1,1855,2191
4861,0,0,0,0,57,1,751,1,0,2902280,6061080,46.04345773288535,1878,3731,3489,2120,55278,634698,711891,2617,4979,3101,4228,6590,37.0,15.86330957408423,2362,1,527880,21538,1369,0,739,1490
4862,0,0,0,0,56,1,752,1,0,2998608,6098172,46.34652090502587,1936,3756,3544,2148,53928,607546,715428,2627,4987,3051,4235,6595,37.36308338453881,14.782577520775462,2360,1,541296,15476,1396,0,691,1443
4863,0,0,0,0,55,1,847,1,0,3116688,6228898,47.31807265728392,2179,3691,3631,2239,55458,650988,659334,2722,5021,2842,4174,6473,37.30951621235526,7.754559014766193,2299,1,530643,7560,1392,0,543,1390
4864,1,0,0,0,46,0,28,1,0,6365,219355,9.746794344808963,95,162,162,95,55695,547233,542615,2309,2404,2309,2376,2471,8.18535277187245,0.0,95,1,22325,0,67,0,2214,2242
4865,1,0,0,0,46,0,23,1,0,9180,249048,10.392304845413264,108,193,193,108,51480,539604,507320,2306,2414,2306,2391,2499,9.219544457292887,0.0,108,1,23760,0,85,0,2198,2221
4866,1,0,0,0,47,0,46,1,0,116435,755392,17.86057109949175,139,864,684,319,32256,454656,397824,2188,2687,2548,2733,3232,19.1049731745428,13.897196809366976,499,1,53592,28260,365,0,2049,2003
4867,1,0,0,0,47,0,88,0,1,218964,1002378,20.639767440550294,236,1130,940,426,51170,505895,560014,2163,2779,2543,2867,3483,22.67156809750927,14.170774724066149,616,1,101388,19950,514,0,1927,1839
4868,1,0,0,0,45,0,251,0,1,454160,1832860,28.478061731796284,781,1401,1371,811,54934,513020,546920,2230,3071,2290,2820,3661,23.664319132398465,5.514871952411144,841,1,196262,3360,560,0,1449,1700
4869,1,0,0,0,45,0,858,0,1,1229680,3640500,40.22437072223753,1551,2445,2378,1618,35168,504000,353250,2183,3868,2317,3010,4695,27.568097504180443,8.2143728690235,1685,1,254026,13735,760,0,632,1490
4870,1,0,0,0,45,0,853,0,1,1204604,3663536,40.049968789001575,1514,2445,2355,1604,36349,509332,372292,2194,3888,2374,3035,4729,27.40437921208944,10.219890331034485,1694,1,261452,17910,751,0,680,1533
4871,1,0,0,0,45,0,384,1,0,1398340,3188660,37.282703764614496,1240,2546,2396,1390,17430,380804,240870,2144,3684,2444,3300,4840,31.71750305430741,13.130475867068439,1540,1,145950,27600,1006,0,904,1288
4872,1,0,0,0,43,0,660,0,0,867244,1433124,25.65151067676132,658,1976,1976,658,53261,481338,524898,2178,2836,2178,3496,4154,36.30426972134269,0.0,658,1,158578,0,1318,0,1520,860
4873,1,0,0,0,43,0,702,0,0,850968,1384572,25.219040425836983,636,1974,1974,636,43200,489825,417984,2177,2813,2177,3515,4151,36.578682316343766,0.0,636,0,122112,0,1338,0,1541,839
4874,1,0,0,0,43,0,784,1,0,820505,1306620,24.392621835300936,535,2034,1974,595,25000,439200,274500,2136,2791,2256,3575,4230,37.134889255254286,7.9332512824338455,655,1,74375,12480,1379,0,1601,817
4875,1,0,0,0,47,0,1216,0,1,989892,1327482,23.62202362203543,132,2758,2332,558,51480,556686,523380,1953,2937,2805,4153,5137,42.118879377305376,21.28335584005645,984,1,122760,63900,1774,0,1821,605
4876,1,0,0,0,47,0,1182,0,1,1012608,1367424,24.0,168,2742,2334,576,51920,522280,560264,1966,2950,2782,4132,5116,41.92851058647326,20.8744866047334,984,1,135936,46512,1758,0,1798,616
4877,1,0,0,0,47,0,1139,0,1,1031730,1407770,24.392621835300936,205,2719,2329,595,50851,499226,570206,1976,2961,2756,4100,5085,41.641325627314025,20.398110805349866,985,1,143395,37050,1734,0,1771,632
4878,1,0,0,0,47,0,1094,0,1,1053360,1451296,24.819347291981714,256,2686,2326,616,49815,482980,572508,1996,2972,2716,4066,5042,41.352146256270665,19.83807537366166,976,1,149688,30600,1710,0,1740,646
4879,1,0,0,0,46,0,1054,0,1,1067871,1485018,25.15949125081825,303,2650,2320,633,47916,464508,567732,2016,2979,2676,4033,4996,41.0731055558257,19.028366212642688,963,1,153186,25080,1687,0,1713,659
4880,1,0,0,0,46,0,974,0,1,1092240,1547784,25.80697580112788,396,2576,2306,666,46624,436912,576352,2054,2990,2594,3964,4900,40.496913462633174,17.27360060772727,936,1,165168,14040,1640,0,1658,684
4881,1,0,0,0,46,0,933,0,1,1106028,1577304,26.153393661244042,444,2541,2301,684,46368,424304,581112,2066,2990,2546,3923,4847,40.2119385257662,16.23553166705966,924,1,172368,8640,1617,0,1622,689
4882,1,0,0,0,45,0,892,0,1,1121285,1608464,26.514147167125703,493,2508,2298,703,50038,450736,581152,2078,2991,2498,3883,4796,39.93745109543172,15.128415585903417,913,1,178562,10290,1595,0,1585,693
4883,1,0,0,0,44,0,764,0,1,1167392,1714416,27.640549922170507,644,2412,2292,764,49530,437580,569976,2124,3008,2364,3772,4656,39.08964057138413,11.35235258913941,884,1,194056,5040,1528,0,1480,716
4884,1,0,0,0,44,0,721,0,1,1182210,1748980,28.0178514522438,695,2381,2291,785,51054,447828,565912,2138,3013,2318,3734,4609,38.80721582386451,9.756499634156611,875,1,199390,4680,1506,0,1443,722
4885,1,0,0,0,44,0,679,0,1,1196910,1784484,28.39013913315678,746,2351,2291,806,52624,460512,560142,2154,3020,2274,3699,4565,38.535697735995385,7.896951773353783,866,1,203918,3900,1485,0,1408,729
4886,1,0,0,0,43,0,593,0,1,1226550,1867450,29.154759474226502,850,2293,2293,850,54970,505310,525083,2197,3047,2197,3640,4490,37.986839826445156,0.0,850,1,203150,0,1443,0,1347,754
4887,1,0,0,0,43,0,551,0,1,1240856,1911424,29.5296461204668,872,2295,2295,872,51051,506352,484432,2192,3064,2192,3615,4487,37.72267222772003,0.0,872,1,192712,0,1423,0,1320,769
4888,1,0,0,0,43,0,508,0,1,1255685,1962735,29.916550603303182,895,2298,2298,895,43904,491232,429828,2193,3088,2193,3596,4491,37.456641600656084,0.0,895,1,175420,0,1403,0,1298,790
4889,1,0,0,0,44,0,250,1,0,1341600,2303600,32.2490309931942,890,2480,2330,1040,35657,436355,400915,2065,3255,2365,3505,4695,35.91656999213594,12.35277120656332,1190,1,188240,22500,1290,0,1175,925
4890,1,0,0,0,45,0,55,1,0,1270500,2525600,33.166247903554,815,2540,2255,1100,26320,431648,321440,2011,3396,2581,3451,4836,33.98529093593286,16.882774321575024,1385,1,154000,51015,1155,0,1196,1141
4891,1,0,0,0,47,0,676,0,1,765600,3010084,35.7211421989835,1209,1943,1876,1276,50794,514262,549647,2292,3635,2426,2959,4302,24.49489742783178,8.230562448445415,1343,1,297308,7705,600,0,1083,1759
4892,1,0,0,0,46,0,764,0,1,724565,3084990,36.26292872893749,1315,1866,1866,1315,51212,553656,509082,2346,3661,2346,2897,4212,23.473389188611005,0.0,1315,1,285355,0,551,0,1031,1795
4893,1,0,0,0,48,0,1038,1,0,758835,3689931,39.153543900903784,1256,2305,2028,1533,34050,546389,361050,2130,3940,2684,2902,4712,22.24859546128699,16.96385803918754,1810,1,229950,59555,495,0,874,1912
4894,1,0,0,0,44,0,1619,0,1,100740,3735775,40.97560249709576,1594,1824,1739,1679,48768,427200,565150,2140,3904,2310,2285,4049,7.745966692414834,9.628282789709404,1764,1,426466,3145,60,0,546,2165
4895,1,0,0,0,43,0,1567,0,1,140420,3621184,40.64480286580315,1610,1779,1737,1652,52920,460320,552384,2150,3844,2234,2277,3971,9.219544457292887,6.609134537568676,1694,1,416304,2772,85,0,540,2107
4896,1,0,0,0,43,0,1466,0,1,214400,3478400,40.0,1570,1764,1734,1600,55647,497846,528282,2144,3774,2204,2308,3938,11.575836902790225,5.514871952411144,1630,1,388800,3330,134,0,574,2040
4897,1,0,0,0,43,0,1412,0,1,254988,3412432,39.67366884975475,1544,1766,1736,1574,54675,487800,526824,2138,3742,2198,2330,3934,12.727922061357855,5.572104574801163,1604,1,382482,3240,162,0,594,2006
4898,1,0,0,0,43,0,1305,0,1,332014,3282065,39.02563260217571,1523,1741,1741,1523,53361,497805,497805,2155,3678,2155,2373,3896,14.7648230602334,0.0,1523,1,351813,0,218,0,632,1937
4899,1,0,0,0,43,0,1251,0,1,370006,3226692,38.704004960727254,1498,1745,1745,1498,51076,486804,486804,2154,3652,2154,2401,3899,15.716233645501712,0.0,1498,1,338548,0,247,0,656,1907
4900,1,0,0,0,43,0,765,1,0,657406,2763919,35.76310948449533,1237,1835,1793,1279,35868,395463,423556,2119,3440,2203,2675,3996,22.67156809750927,6.7597809605921,1321,1,250684,4830,514,0,882,1647
4901,1,0,0,0,43,0,713,0,0,682008,2704168,35.4400902933387,1226,1829,1799,1256,39775,398305,462895,2123,3409,2183,2696,3982,23.302360395462088,5.623413251903491,1286,0,270040,2820,543,0,897,1610
4902,1,0,0,0,44,0,402,1,0,811528,2479544,33.52610922848042,974,1996,1846,1124,29044,467672,302222,2056,3330,2356,2928,4202,26.870057685088806,12.849476832533073,1274,1,153988,31500,722,0,1082,1484
4903,1,0,0,0,44,0,203,1,0,879890,2327215,32.32645975048923,775,2157,1887,1045,27550,423130,322915,1957,3272,2497,3069,4384,29.017236257093817,16.87023975571047,1315,1,151525,48060,842,0,1182,1385
4904,1,0,0,0,44,0,265,0,1,975456,1942272,29.393876913398138,834,2023,1993,864,55527,501304,559752,2218,3112,2278,3377,4271,33.60059523282288,5.477225575051661,894,1,215136,2730,1129,0,1384,1119
4905,1,0,0,0,44,0,267,0,1,957334,1910398,29.223278392404914,824,2005,1975,854,54587,494377,552539,2207,3091,2267,3358,4242,33.481338085566414,5.531194905403055,884,1,210938,2880,1121,0,1383,1116
4906,1,0,0,0,44,0,268,1,0,940485,1885195,29.068883707497267,845,1958,1958,845,51448,486358,526516,2231,3076,2231,3344,4189,33.36165463522455,0.0,845,1,199420,0,1113,0,1386,1118
4907,1,0,0,0,44,0,269,1,0,875880,1798798,28.478061731796284,684,2018,1891,811,28896,381496,372624,2091,3029,2345,3298,4236,32.863353450309965,11.764266949700929,938,1,136248,16637,1080,0,1407,1138
4908,1,0,0,0,45,0,295,1,0,860904,1797048,28.142494558940577,564,2107,1879,792,23219,492373,242783,2041,3061,2497,3356,4376,32.96968304366907,16.32515812401686,1020,1,84744,54264,1087,0,1477,1182
4909,1,0,0,0,46,0,389,1,0,782100,1649520,26.664583251946766,464,2058,1811,711,32400,522000,334080,2073,3031,2567,3420,4378,33.166247903554,16.37076252546435,958,1,102384,53599,1100,0,1609,1220
4910,1,0,0,0,44,0,368,1,0,335808,936616,20.591260281974,316,1324,1216,424,31304,379948,402038,2101,2633,2317,3001,3533,28.142494558940577,10.46373382427936,532,1,77168,12420,792,0,1785,1417
4911,1,0,0,0,43,0,354,1,0,283392,843264,19.595917942265423,234,1272,1122,384,30318,357948,408456,2046,2580,2346,2934,3468,27.16615541441225,12.384480471957746,534,1,71424,14850,738,0,1812,1458
4912,0,1,0,1,65,0,147,0,0,13459828,12277040,61.180062111769715,3648,7434,7339,3743,55680,787200,760960,3185,7023,3375,6876,10714,59.9666574022598,9.80698324197389,3838,1,868376,13205,3596,0,463,316
4913,0,1,0,1,65,0,68,0,0,13175744,11726556,59.9666574022598,3566,7290,7260,3596,54056,756552,759813,3231,6857,3291,6925,10551,60.530983801686226,5.477225575051661,3626,1,837868,3930,3664,0,335,403
4914,0,1,0,1,65,0,155,0,0,13058604,11498787,59.472682804797024,3507,7259,7229,3537,52440,747730,741228,3221,6788,3281,6943,10510,60.76183012385325,5.477225575051661,3567,1,806436,4080,3692,0,286,441
4915,0,1,0,1,64,0,377,0,0,12762974,10926136,58.215118311311535,3389,7155,7155,3389,50922,667368,793104,3224,6613,3224,6990,10379,61.36774397026503,0.0,3389,1,833694,0,3766,0,165,542
4916,0,1,1,0,63,0,833,0,0,12157160,9842100,55.632724182804495,2987,7131,7023,3095,37014,632820,591480,3072,6275,3288,7108,10311,62.67375846396959,10.498474454302341,3203,0,575670,15876,3928,1,85,748
4917,0,1,1,0,60,0,1813,0,0,2409264,2681019,29.8496231131986,594,3892,3595,891,26418,667998,358071,2712,3900,3306,5713,6901,52.0,17.79651541947286,1188,1,106029,69498,2704,0,2118,305
4918,0,1,1,0,62,0,1261,0,0,1161222,1942992,24.859605789312106,18,3097,2497,618,33901,525048,638232,2544,3762,3744,5023,6241,43.347433603386484,25.658572879823044,1218,1,125454,49800,1879,0,2526,1265
4919,0,1,1,0,62,0,960,0,0,1192849,2225273,26.70205984563738,7,3092,2386,713,32860,661652,483755,2415,3834,3827,4794,6213,40.90232267243512,27.44170445286808,1419,1,110515,136258,1673,0,2408,1448
4920,0,0,1,0,59,1,761,0,0,1213610,4571522,39.319206502675,1237,2640,2331,1546,50095,688981,635755,2648,4503,3266,3742,5597,28.0178514522438,17.641069309764326,1855,1,332390,48204,785,0,1411,2172
4921,0,0,0,0,56,1,804,1,0,2978380,6152420,46.62617290749907,1984,3734,3544,2174,54216,611280,710330,2640,5004,3020,4200,6564,37.013511046643494,13.965249839823185,2364,1,545674,14820,1370,0,656,1460
4922,0,0,0,0,55,1,814,1,0,3223632,6260680,47.41307836451879,2181,3749,3682,2248,53775,626625,665615,2718,5033,2852,4219,6534,37.86819245752297,8.19672545160342,2315,1,537272,7638,1434,0,537,1351
4923,0,0,1,0,57,1,1172,0,0,2864285,6838629,48.75448697299562,2143,3816,3582,2377,47499,612801,641571,2643,5254,3111,4082,6693,34.713109915419565,15.381906354258097,2611,1,530071,28548,1205,0,500,1672
4924,1,0,0,0,45,0,212,1,0,444389,1763498,27.94637722496424,781,1350,1350,781,51948,528372,501276,2258,3039,2258,2827,3608,23.853720883753127,0.0,781,1,173382,0,569,0,1477,1689
4925,1,0,0,0,47,0,685,1,0,178086,2115768,29.765752132274432,525,1448,1087,886,31030,511032,346260,2027,3274,2749,2589,3836,14.177446878757825,19.88151372765677,1247,1,128470,74366,201,0,1502,2187
4926,1,0,0,0,49,0,782,1,0,324600,2654146,32.89376840679705,512,1952,1382,1082,27056,436634,372856,1883,3535,3023,2753,4405,17.320508075688775,24.87678811905652,1652,1,164464,88350,300,0,1371,2153
4927,1,0,0,0,44,0,794,0,0,1294416,3588480,40.024992192379,1602,2410,2410,1602,51714,524160,495040,2240,3842,2240,3048,4650,28.42534080710379,0.0,1602,0,354042,0,808,0,638,1432
4928,1,0,0,0,46,0,416,1,0,1375217,3217700,37.403208418530085,1237,2544,2382,1399,20496,386400,280600,2138,3699,2462,3283,4844,31.352830813181765,13.577862376145214,1561,1,170678,27702,983,0,901,1317
4929,1,0,0,0,47,0,311,1,0,1224626,3013191,35.679125549822544,1045,2463,2235,1273,9145,366885,139653,2139,3640,2595,3329,4830,31.016124838541646,16.4052977943864,1501,1,75107,47880,962,0,1094,1405
4930,1,0,0,0,48,0,9,0,1,1002982,2433677,31.575306807693888,505,2495,2003,997,41615,500405,495523,1949,3438,2933,3447,4936,31.71750305430741,23.50163602729112,1489,1,202391,66912,1006,0,1444,1435
4931,1,0,0,0,47,0,1223,0,1,982128,1313928,23.515952032609693,169,2713,2329,553,48530,501336,546480,1992,2929,2760,4152,5089,42.14261501141095,20.313101760696018,937,1,127190,43008,1776,0,1823,600
4932,1,0,0,0,47,0,1179,0,1,1003896,1357437,23.93741840717165,207,2691,2325,573,48144,483276,559084,2003,2942,2735,4121,5060,41.8568990729127,19.86935036664596,939,1,135228,34038,1752,0,1796,617
4933,1,0,0,0,47,0,1137,0,1,1023568,1397120,24.331050121192877,242,2671,2321,592,48039,474360,564040,2010,2952,2710,4089,5031,41.58124577258358,19.40596017704817,942,1,141488,29400,1729,0,1768,631
4934,1,0,0,0,45,0,934,0,1,1097520,1552440,26.076809620810597,470,2504,2294,680,46046,415506,577599,2073,2963,2493,3897,4787,40.17461885320133,15.064106383522578,890,1,172040,6720,1614,0,1603,669
4935,1,0,0,0,44,0,849,0,1,1131970,1621529,26.851443164195103,571,2441,2291,721,50292,445302,571246,2099,2970,2399,3819,4690,39.6232255123179,12.5999078163187,871,1,183134,7350,1570,0,1528,679
4936,1,0,0,0,44,0,763,0,1,1166628,1696844,27.640549922170507,674,2381,2291,764,51106,448642,561913,2131,2985,2311,3748,4602,39.07684736515984,9.65116822864259,854,1,193292,5400,1527,0,1457,694
4937,1,0,0,0,43,0,592,0,1,1232585,1873188,29.206163733020468,823,2328,2298,853,44688,500688,430416,2166,3049,2226,3641,4524,38.01315561749642,5.477225575051661,883,1,167188,5160,1445,0,1343,751
4938,1,0,0,0,44,0,216,1,0,1329300,2349900,32.4037034920393,816,2550,2316,1050,35796,510264,351366,2004,3288,2472,3504,4788,35.58089374931439,15.496772346339544,1284,1,164850,48906,1266,0,1188,972
4939,1,0,0,0,45,0,181,1,0,1301690,2390472,32.46536616149585,777,2566,2289,1054,31414,512568,315252,1991,3322,2545,3503,4834,35.14256678161116,17.039400770443176,1331,1,146506,61771,1235,0,1214,1033
4940,1,0,0,0,45,0,146,1,0,1280627,2428629,32.57299494980466,742,2587,2268,1061,33912,494424,359373,1970,3350,2608,3496,4876,34.741905532080416,18.3605090127222,1380,1,166577,62843,1207,0,1228,1082
4941,1,0,0,0,47,0,36,1,0,1263052,2704256,33.793490497431605,1052,2338,2248,1142,39179,480704,457024,2278,3510,2458,3474,4706,33.25657829663178,10.32141877008138,1232,1,220406,13050,1106,0,1226,1262
4942,1,0,0,0,48,0,212,0,1,1066208,2769624,33.823069050575526,1024,2196,2076,1144,50218,576198,510831,2301,3565,2541,3353,4617,30.528675044947494,11.58292185288269,1264,1,241384,19800,932,0,1277,1489
4943,1,0,0,0,47,0,565,0,1,810386,2910524,35.014282800023196,1131,1982,1887,1226,47064,503288,527028,2279,3600,2469,3035,4356,25.709920264364882,9.80698324197389,1321,1,272172,11685,661,0,1148,1713
4944,1,0,0,0,46,0,683,0,1,754800,2994975,35.70714214271425,1275,1867,1867,1275,49940,516780,533223,2349,3624,2349,2941,4216,24.331050121192877,0.0,1275,1,289425,0,592,0,1074,1757
4945,1,0,0,0,48,0,1292,0,1,558828,3972254,40.422765862815474,1295,2315,1976,1634,48070,461890,615043,2092,4065,2770,2773,4746,18.49324200890693,19.72572176579851,1973,1,413402,14916,342,0,797,2089
4946,1,0,0,0,43,0,1466,0,1,242400,3518032,40.19950248448356,1616,1766,1766,1616,42427,441931,454993,2177,3793,2177,2327,3943,12.24744871391589,0.0,1616,1,337744,0,150,0,561,2027
4947,1,0,0,0,43,0,1415,0,0,278250,3455070,39.87480407475377,1590,1765,1765,1590,38745,410697,445465,2173,3763,2173,2348,3938,13.228756555322953,0.0,1590,0,325950,0,175,0,583,1998
4948,1,0,0,0,43,0,1364,0,0,314565,3392920,39.56008088970496,1565,1766,1766,1565,36984,398912,435768,2168,3733,2168,2369,3934,14.177446878757825,0.0,1565,0,314565,0,201,0,603,1967
4949,1,0,0,0,42,0,624,1,0,747217,2644188,35.08560958569767,1201,1868,1838,1231,43240,504780,395232,2118,3379,2178,2755,4016,24.63736998950984,5.490867587491313,1261,1,226504,5730,607,0,917,1541
4950,1,0,0,0,45,0,128,1,0,932928,2335416,32.12475680841802,762,2206,1936,1032,22230,441285,257982,1993,3295,2533,3167,4469,30.066592756745816,16.44434083993029,1302,1,117648,56970,904,0,1231,1359
4951,1,0,0,0,44,0,265,0,1,1052634,2027696,30.033314835362415,902,2069,2069,902,54450,505800,544016,2248,3150,2248,3415,4317,34.161381705077446,0.0,902,1,218284,0,1167,0,1346,1081
4952,1,0,0,0,44,0,268,1,0,1014300,1975680,29.698484809834994,882,2032,2032,882,42622,452480,472640,2240,3122,2240,3390,4272,33.91164991562634,0.0,882,1,186102,0,1150,0,1358,1090
4953,1,0,0,0,44,0,270,1,0,932400,1879080,28.982753492378876,706,2084,1950,840,25350,378053,335550,2103,3077,2371,3347,4321,33.31666249791537,12.035289626712379,974,1,126000,19296,1110,0,1397,1127
4954,0,1,0,1,65,0,126,0,0,13582627,12281724,61.22907805936653,3664,7457,7372,3749,55209,782964,756756,3191,7025,3361,6899,10733,60.19136150644875,9.219544457292887,3834,1,866019,11900,3623,0,473,347
4955,0,0,1,0,57,1,221,0,0,789710,2905328,31.71750305430741,886,1911,1791,1006,36450,649800,467856,2768,3894,3008,3673,4799,28.0178514522438,11.029743904822288,1126,0,162972,24240,785,1,1882,2103
4956,0,0,0,0,56,1,858,1,0,2906523,6193584,46.76537180435969,2012,3691,3516,2187,55000,623040,708000,2657,5019,3007,4161,6523,36.45545226711637,13.36654368325981,2362,1,546750,14700,1329,0,645,1503
4957,1,0,0,0,46,0,55,1,0,2550,196435,9.219544457292887,85,115,115,85,50127,533841,501487,2311,2396,2311,2341,2426,5.477225575051661,0.0,85,1,18445,0,30,0,2226,2281
4958,1,0,0,0,46,0,130,0,1,505571,1495296,25.475478405713993,564,1513,1428,649,55350,518400,566784,2219,2953,2389,3083,3817,27.910571473905726,9.476861953055495,734,1,159654,8585,779,0,1655,1525
4959,1,0,0,0,45,0,145,0,1,456464,1698768,27.422618401604176,752,1359,1359,752,50794,526347,492462,2259,3011,2259,2866,3618,24.63736998950984,0.0,752,1,163936,0,607,0,1507,1652
4960,1,0,0,0,45,0,855,0,1,1353604,3790758,40.82891132518721,1517,2629,2479,1667,41624,550308,391128,2124,3941,2424,3086,4903,28.495613697550013,12.384480471957746,1817,1,286724,31200,812,0,607,1462
4961,1,0,0,0,45,0,826,0,1,1359600,3778500,40.620192023179804,1422,2702,2474,1650,45750,572500,419070,2062,3940,2518,3114,4992,28.705400188814647,15.330264859427793,1878,1,301950,46512,824,0,640,1466
4962,1,0,0,0,46,0,805,0,1,1394250,3831300,40.620192023179804,1382,2763,2495,1650,40630,554958,394740,2054,3972,2590,3167,5085,29.068883707497267,16.82344397379802,1918,1,280500,55744,845,0,672,1477
4963,1,0,0,0,46,0,450,1,0,1353600,3266970,37.54996671103717,1228,2552,2370,1410,25232,384622,352184,2135,3727,2499,3277,4869,30.983866769659336,14.709286886256997,1592,1,214320,25298,960,0,907,1357
4964,1,0,0,0,49,0,1,0,1,953552,2391200,31.240998703626616,466,2463,1953,976,39585,497350,477750,1940,3426,2960,3427,4913,31.25699921617557,23.897584880023263,1486,1,190320,72420,977,0,1474,1473
4965,1,0,0,0,47,0,1307,0,1,928998,1219246,22.60530911091463,135,2705,2329,511,45136,517762,496288,2010,2897,2762,4204,5091,42.638011210655684,20.224231986271054,887,1,106288,54520,1818,0,1875,568
4966,1,0,0,0,47,0,1263,0,1,952614,1264842,23.043437243605826,170,2686,2325,531,46945,488310,545478,2021,2913,2743,4176,5068,42.35563716909474,19.840924671465334,892,1,121599,37544,1794,0,1851,588
4967,1,0,0,0,47,0,1220,0,1,975821,1306972,23.473389188611005,209,2664,2322,551,48000,474400,569280,2030,2923,2714,4143,5036,42.08325082500163,19.293883631352305,893,1,132240,28386,1771,0,1821,601
4968,1,0,0,0,47,0,1182,0,1,989368,1336892,23.790754506740637,242,2638,2314,566,49894,477124,583414,2038,2928,2686,4110,5000,41.80908992073375,18.797635494450912,890,1,139802,23976,1748,0,1796,614
4969,1,0,0,0,47,0,1143,0,1,1003950,1367700,24.124676163629637,273,2616,2307,582,49698,465300,589850,2041,2932,2659,4075,4966,41.53311931459037,18.29880415127992,891,1,146082,18231,1725,0,1768,625
4970,1,0,0,0,46,0,1102,0,1,1021200,1401000,24.49489742783178,305,2597,2302,600,48260,443650,593090,2040,2935,2630,4037,4932,41.255302689472536,17.783727623567763,895,1,152400,12390,1702,0,1735,633
4971,1,0,0,0,45,0,1019,0,1,1057166,1466124,25.25866188063018,398,2535,2295,638,47498,429726,583692,2058,2936,2538,3955,4833,40.70626487409524,16.136488203979884,878,1,162052,8880,1657,0,1660,641
4972,1,0,0,0,45,0,977,0,1,1075830,1502872,25.65151067676132,448,2503,2293,658,46368,420256,575568,2074,2942,2494,3919,4787,40.43513323831146,15.076742382695786,868,1,165816,7770,1635,0,1626,649
4973,1,0,0,0,44,0,806,0,1,1150907,1647974,27.258026340878022,653,2382,2292,743,50500,448036,554500,2128,2961,2308,3767,4600,39.35733730830886,9.613403705477898,833,1,185750,6120,1549,0,1475,669
4974,1,0,0,0,44,0,720,0,1,1186009,1732187,28.053520278211074,757,2324,2294,787,52200,495225,510632,2171,2988,2231,3708,4525,38.82009788756334,5.514871952411144,817,1,182584,3780,1507,0,1414,694
4975,1,0,0,0,43,0,676,0,1,1205957,1783389,28.478061731796284,811,2298,2298,811,49665,507969,472785,2199,3010,2199,3686,4497,38.561638969317684,0.0,811,1,174365,0,1487,0,1388,712
4976,1,0,0,0,47,0,3,0,1,1273510,2670990,33.57082066318904,1067,2317,2257,1127,42180,450300,526140,2310,3497,2430,3500,4687,33.61547262794322,8.52469877450791,1187,1,250194,5640,1130,0,1243,1240
4977,1,0,0,0,47,0,658,0,0,762248,2968224,35.52463933666322,1232,1896,1866,1262,44004,536256,453936,2322,3614,2382,2956,4248,24.576411454889016,5.490867587491313,1292,0,243566,5250,604,0,1090,1748
4978,1,0,0,0,47,0,738,1,0,743683,3097590,36.15245496505044,1222,1961,1876,1307,37910,528510,402900,2285,3677,2455,2939,4331,23.853720883753127,9.370214040084857,1392,1,222190,16320,569,0,1063,1801
4979,1,0,0,0,47,0,810,1,0,742279,3245944,36.837480912787726,1207,2054,1904,1357,33372,492752,387504,2242,3749,2542,2939,4446,23.388031127053,12.5999078163187,1507,1,219834,27150,547,0,1035,1845
4980,1,0,0,0,47,0,831,1,0,746082,3293478,37.067505985701274,1204,2087,1917,1374,34569,496179,400299,2227,3771,2567,2940,4484,23.302360395462088,13.390348098230834,1544,1,229458,30090,543,0,1023,1854
4981,1,0,0,0,48,0,1033,0,1,756360,3726792,39.08964057138413,1167,2384,2023,1528,41310,592677,414630,2078,3967,2800,2934,4823,22.24859546128699,19.426452820853335,1889,1,259760,76171,495,0,911,1944
4982,1,0,0,0,48,0,1083,0,1,721834,3790403,39.35733730830886,1167,2397,2015,1549,45510,601962,452695,2065,3996,2829,2913,4844,21.587033144922902,20.002655720989125,1931,1,286565,76018,466,0,898,1981
4983,1,0,0,0,47,0,1377,0,1,493240,3984376,40.890096600521744,1395,2244,1967,1672,40913,388429,598133,2106,4055,2660,2678,4627,17.175564037317667,17.816220302588206,1949,1,419672,0,295,0,711,2088
4984,1,0,0,0,46,0,1441,0,1,407286,3939903,41.02438299353203,1455,2153,1925,1683,45287,419039,592273,2113,4024,2569,2583,4494,15.556349186104045,16.12505215855987,1911,1,425799,4104,242,0,658,2099
4985,1,0,0,0,43,0,1548,0,1,225388,3680216,41.012193308819754,1682,1816,1816,1682,47952,472608,485736,2188,3870,2188,2322,4004,11.575836902790225,0.0,1682,1,373404,0,134,0,506,2054
4986,1,0,0,0,43,0,1507,0,0,248550,3628830,40.70626487409524,1657,1807,1807,1657,37515,448950,400770,2190,3847,2190,2340,3997,12.24744871391589,0.0,1657,0,303231,0,150,0,533,2040
4987,1,0,0,0,43,0,743,0,1,716688,2804544,36.0,1296,1849,1849,1296,44469,396012,525852,2164,3460,2164,2717,4013,23.515952032609693,0.0,1296,1,314928,0,553,0,868,1611
4988,1,0,0,0,43,0,691,0,0,740886,2738223,35.679125549822544,1273,1855,1855,1273,50112,464616,499032,2151,3424,2151,2733,4006,24.124676163629637,0.0,1273,0,295336,0,582,0,878,1569
4989,1,0,0,0,44,0,438,1,0,852640,2588288,34.17601498127012,1018,2048,1898,1168,33120,509680,319104,2066,3384,2366,2946,4264,27.018512172212592,13.02043424578037,1318,1,168192,33450,730,0,1048,1486
4990,1,0,0,0,45,0,121,0,1,1050042,2212140,31.080540535840107,876,2143,2053,966,41866,396170,554180,2200,3256,2380,3377,4433,32.96968304366907,9.965825211365143,1056,1,233772,3690,1087,0,1324,1203
4991,1,0,0,0,45,0,204,0,1,1079532,2126094,30.692018506445613,912,2118,2088,942,46272,433344,543937,2227,3199,2287,3403,4375,33.85262175962151,5.5965095842615735,972,1,227022,2100,1146,0,1315,1111
4992,1,0,0,0,45,0,268,1,0,1074069,2053394,30.18277654557314,881,2120,2090,911,31248,419244,378672,2224,3165,2284,3433,4374,34.336569426778794,5.623413251903491,941,1,153048,4470,1179,0,1343,1075
4993,1,0,0,0,46,0,355,1,0,640074,1486230,25.337718918639855,472,1809,1639,642,33280,370400,481520,2145,2957,2485,3312,4124,31.575306807693888,14.025893816633586,812,1,133536,11390,997,0,1673,1318
4994,1,0,0,0,44,0,291,1,0,333450,1004850,21.213203435596427,355,1286,1191,450,31730,372911,424270,2138,2683,2328,2974,3519,27.2213151776324,9.756499634156611,545,1,85500,9595,741,0,1783,1492
4995,0,1,0,1,65,0,229,0,0,13881146,12605602,61.98386886924694,3812,7485,7455,3842,54520,771035,761192,3251,7123,3311,6894,10766,60.108235708594876,5.483301264452448,3872,1,891344,4080,3613,0,561,332
4996,0,1,0,1,65,0,110,0,0,13407219,11751606,60.05830500438719,3607,7324,7324,3607,53808,768888,742824,3258,6865,3258,6975,10582,60.96720429870473,0.0,3607,1,822396,0,3717,0,349,459
4997,0,1,0,1,64,0,373,0,0,13044290,11116630,58.56620185738529,3388,7275,7233,3430,42940,615790,732466,3199,6671,3283,7044,10516,61.66846844214635,6.495386533491135,3472,1,775180,3696,3803,0,189,562
4998,0,1,1,0,59,0,1903,0,0,6008918,4998762,40.963398296528084,1570,5367,5259,1678,35956,530262,601758,2871,4657,3087,6560,8346,59.841457201508724,10.60004836173973,1786,1,338956,10908,3581,0,1301,602
4999,0,1,1,0,60,0,535,0,0,905576,2180304,26.851443164195103,18,2680,1977,721,55460,713664,710640,2321,3745,3727,4280,5704,35.4400902933387,27.108122858216603,1424,1,169435,93499,1256,0,2303,1768
5000,0,0,1,0,57,1,900,0,0,2451141,6022863,45.59605246071199,1794,3543,3258,2079,56628,677898,701074,2612,4976,3182,4076,6440,34.336569426778794,17.296691410759145,2364,1,503118,32775,1179,0,818,1718
5001,0,0,1,0,57,1,1315,0,0,3252174,7426914,50.76416058598822,2211,4205,3839,2577,35139,636922,458238,2516,5459,3248,4144,7087,35.52463933666322,19.594455952100883,2943,1,409743,73200,1262,0,305,1620
5002,1,0,0,0,46,0,106,1,0,19095,471144,14.177446878757825,116,381,296,201,26649,443016,330504,2259,2545,2429,2439,2725,9.746794344808963,9.607770959340817,286,1,28341,15385,95,0,2143,2249
5003,1,0,0,0,47,0,55,1,0,71874,708345,17.233687939614086,127,709,539,297,32706,493695,376830,2215,2682,2555,2627,3094,15.556349186104045,13.707039880315492,467,1,46926,31450,242,0,2088,2143
5004,1,0,0,0,46,0,77,0,1,314924,1229304,22.891046284519195,282,1367,1125,524,47945,504390,523158,2104,2870,2588,2947,3713,24.515301344262525,15.782532678371412,766,1,116852,30250,601,0,1822,1745
5005,1,0,0,0,45,0,26,0,1,471800,1586200,26.457513110645905,700,1374,1374,700,53572,514382,534776,2266,2966,2266,2940,3640,25.96150997149434,0.0,700,1,165200,0,674,0,1566,1592
5006,1,0,0,0,46,0,366,1,0,288000,1744500,27.386127875258307,534,1350,1134,750,33744,516372,353552,2110,3076,2542,2710,3676,19.595917942265423,15.165535868158557,966,1,114000,44928,384,0,1576,1942
5007,1,0,0,0,46,0,430,1,0,260691,1799460,27.730849247724095,501,1376,1108,769,35728,542880,360360,2072,3109,2608,2679,3716,18.411952639521967,16.89248111170462,1037,1,118426,57888,339,0,1571,2001
5008,1,0,0,0,49,0,685,0,1,704436,3100018,35.34119409414458,706,2356,1813,1249,40723,523702,479026,1939,3731,3025,3046,4838,23.748684174075834,23.46782041390946,1792,1,241057,83622,564,0,1233,1918
5009,1,0,0,0,44,0,690,0,0,1347496,3477660,39.44616584663204,1556,2422,2422,1556,51212,527460,484995,2235,3791,2235,3101,4657,29.427877939124322,0.0,1556,0,337652,0,866,0,679,1369
5010,1,0,0,0,45,0,765,0,1,1370286,3652482,40.17461885320133,1529,2548,2463,1614,43076,547646,402814,2178,3877,2348,3112,4811,29.13760456866693,9.494144610579708,1699,1,287292,17255,849,0,649,1414
5011,1,0,0,0,45,0,813,0,1,1393510,3770090,40.681691213615984,1535,2617,2497,1655,46899,553554,439654,2158,3933,2398,3120,4895,29.017236257093817,11.320779839735554,1775,1,319415,22680,842,0,623,1436
5012,1,0,0,0,45,0,846,0,1,1418767,3834551,41.0731055558257,1553,2662,2528,1687,56105,556885,520517,2139,3960,2407,3114,4935,29.0,11.691581880872027,1821,1,386323,19028,841,0,586,1432
5013,1,0,0,0,46,0,658,1,0,1535283,3718188,40.13726448077895,1421,2754,2564,1611,23290,392360,316196,2118,3919,2498,3261,5062,30.870698080866262,14.83400559851659,1801,1,220707,30210,953,0,697,1355
5014,1,0,0,0,48,0,290,1,0,1071000,2883370,34.49637662132068,881,2399,2090,1190,37820,591212,375565,2114,3613,2732,3323,4822,30.0,19.17120320542915,1499,1,184450,68907,900,0,1233,1523
5015,1,0,0,0,43,0,657,0,0,744940,1303050,24.392621835300936,565,1877,1847,595,47336,534360,424860,2160,2785,2220,3442,4067,35.38361202590826,5.483301264452448,625,0,115430,5670,1252,0,1595,938
5016,1,0,0,0,46,0,1035,1,0,605484,961185,20.42057785666214,225,2061,1869,417,31603,509405,329615,2113,2722,2497,3757,4366,38.1051177665153,14.682110731617461,609,1,59631,41088,1452,0,1888,853
5017,1,0,0,0,45,0,1313,1,0,602280,815400,18.973665961010276,77,2470,2033,360,34854,502830,355605,1828,2625,2702,3938,4735,40.90232267243512,20.99600361045656,797,1,56520,89148,1673,0,1905,592
5018,1,0,0,0,45,0,1363,1,0,622364,825607,19.0,134,2580,2085,361,28462,489418,304171,1792,2648,2782,4011,4867,41.52107898405339,22.39247586002374,856,1,48013,106920,1724,0,1926,563
5019,1,0,0,0,47,0,1304,0,1,922817,1214474,22.561028345356956,174,2657,2322,509,49266,493902,567868,2051,2895,2721,4199,5043,42.579337712087536,19.27900334214792,844,1,121142,31155,1813,0,1877,573
5020,1,0,0,0,47,0,1226,0,1,955947,1276760,23.259406699226016,241,2608,2308,541,48636,455480,594720,2060,2901,2660,4127,4968,42.035699113967404,18.13768681480413,841,1,136332,15900,1767,0,1819,593
5021,1,0,0,0,46,0,1186,0,1,973152,1308510,23.62202362203543,275,2585,2302,558,48768,450240,595630,2062,2903,2628,4089,4930,41.7612260356422,17.57765937056636,841,1,141732,12169,1744,0,1787,601
5022,1,0,0,0,46,0,1104,0,1,1010905,1373855,24.392621835300936,339,2550,2294,595,47244,429474,586486,2053,2904,2565,4008,4859,41.2189276910499,16.453048017039823,851,1,151130,8192,1699,0,1714,610
5023,1,0,0,0,45,0,1061,0,1,1033032,1411872,24.819347291981714,376,2533,2293,616,49530,446940,582168,2052,2908,2532,3969,4825,40.95119045888654,15.915408167362228,856,1,156464,11280,1677,0,1676,615
5024,1,0,0,0,44,0,933,0,1,1094548,1525713,26.057628441590765,529,2441,2291,679,46435,415695,563997,2097,2926,2397,3859,4688,40.149719799769464,12.574334296829354,829,1,170429,6300,1612,0,1568,635
5025,1,0,0,0,44,0,891,0,1,1113700,1561000,26.457513110645905,580,2411,2291,700,48250,430390,557500,2110,2930,2350,3821,4641,39.88734135035826,11.15593165433301,820,1,175000,6720,1591,0,1530,639
5026,1,0,0,0,44,0,848,0,1,1133540,1600674,26.870057685088806,632,2382,2292,722,50141,450051,547599,2127,2939,2307,3787,4599,39.6232255123179,9.601845894041878,812,1,178334,6660,1570,0,1495,647
5027,1,0,0,0,44,0,805,0,1,1154750,1643470,27.294688127912362,685,2355,2295,745,51624,476496,527234,2146,2951,2266,3756,4561,39.370039370059054,7.7992067098508295,805,1,178055,6240,1550,0,1461,656
5028,1,0,0,0,44,0,762,0,1,1175040,1691136,27.712812921102035,738,2328,2298,768,51528,497652,502056,2172,2970,2232,3732,4530,39.11521443121589,5.490867587491313,798,1,175104,3930,1530,0,1434,672
5029,1,0,0,0,45,0,358,1,0,1334520,2237400,31.464265445104548,774,2554,2338,990,26235,372900,359340,2044,3250,2476,3608,4814,36.71511950137164,15.038371033646465,1206,1,157410,28080,1348,0,1270,912
5030,1,0,0,0,48,0,56,1,0,1235760,2611356,32.92415526630866,950,2358,2224,1084,32683,489027,387849,2275,3493,2543,3549,4767,33.76388603226827,11.639773040550214,1218,1,174524,23852,1140,0,1325,1269
5031,1,0,0,0,47,0,520,0,1,804756,2823810,34.55430508634199,1164,1898,1868,1194,51092,501380,569965,2335,3559,2395,3039,4263,25.96150997149434,5.531194905403055,1224,1,287754,2910,674,0,1171,1691
5032,1,0,0,0,47,0,548,0,0,795413,2842485,34.741905532080416,1207,1866,1866,1207,51480,518100,551070,2355,3562,2355,3014,4221,25.67099530598687,0.0,1207,0,282438,0,659,0,1148,1696
5033,1,0,0,0,47,0,632,1,0,772500,2953750,35.35533905932738,1183,1935,1868,1250,40584,538764,420614,2296,3613,2430,2981,4298,24.859605789312106,8.2732738280919,1317,1,222500,12730,618,0,1113,1745
5034,1,0,0,0,43,0,1536,0,1,275076,3723714,41.20679555607303,1698,1860,1860,1698,41638,478074,418863,2193,3891,2193,2355,4053,12.727922061357855,0.0,1698,1,324318,0,162,0,495,2031
5035,1,0,0,0,44,0,1456,0,0,316416,3637136,40.59556626036888,1606,1882,1840,1648,27874,399467,339878,2165,3855,2249,2399,4089,13.856406460551018,6.73127350780198,1690,0,253792,6594,192,0,559,2015
5036,1,0,0,0,43,0,705,1,0,762166,2785982,35.9722114972099,1264,1913,1883,1294,46656,465048,465048,2123,3447,2183,2742,4066,24.269322199023193,5.623413251903491,1324,1,279504,4020,589,0,859,1564
5037,1,0,0,0,45,0,263,1,0,951948,2536668,33.406586176980134,844,2241,1969,1116,30160,472784,329585,2001,3389,2545,3126,4514,29.206163733020468,17.438613618632974,1388,1,161820,53856,853,0,1157,1420
5038,1,0,0,0,45,0,221,1,0,1131620,2162545,30.967725134404045,959,2139,2139,959,45368,482570,478060,2255,3214,2255,3435,4394,34.351128074635334,0.0,959,1,203308,0,1180,0,1296,1075
5039,1,0,0,0,45,0,271,1,0,1058046,2047540,30.033314835362415,740,2237,2075,902,34056,390440,449460,2108,3172,2432,3443,4507,34.249087579087416,13.143597703317598,1064,1,178596,15714,1173,0,1368,1097
5040,1,0,0,0,46,0,345,0,1,788364,1718736,27.055498516937366,474,2067,1809,732,34903,490732,392116,2090,3080,2606,3425,4415,32.817678162843876,17.02371381977504,990,1,122244,46182,1077,0,1616,1271
5041,0,1,0,1,65,0,174,0,0,13461331,11666248,59.85816569190874,3553,7370,7340,3583,52628,768416,726088,3226,6839,3286,7013,10626,61.29437168288782,5.478746393072713,3613,1,799009,4440,3757,0,327,501
5042,0,1,0,1,64,0,393,0,0,13156444,11163564,58.61740355901138,3369,7332,7265,3436,46284,659547,740772,3182,6685,3316,7078,10581,61.87891401761993,8.187175587434018,3503,1,783408,6968,3829,0,187,580
5043,0,1,1,0,64,0,1280,0,0,1375296,2229984,26.38181191654584,156,3212,2672,696,33142,467784,727308,2664,3900,3744,5180,6416,44.45222154178574,24.055651043096884,1236,1,157992,11340,1976,0,2508,1228
5044,0,1,1,0,63,0,1218,0,0,1358344,2245080,26.570660511172846,106,3230,2630,706,36134,566040,645540,2580,3886,3780,5104,6410,43.86342439892262,25.05153642071811,1306,1,143318,60000,1924,0,2474,1256
5045,0,0,0,0,56,1,965,1,0,2859516,6317379,47.3392015141785,2114,3644,3517,2241,54858,628637,693474,2692,5060,2946,4095,6463,35.7211421989835,11.360716291379575,2368,1,551286,12827,1276,0,578,1543
5046,1,0,0,0,46,0,90,1,0,9000,350550,12.24744871391589,90,270,210,150,25715,432345,324843,2277,2487,2397,2397,2607,7.745966692414834,8.038779614196052,210,1,20850,10620,60,0,2187,2277
5047,1,0,0,0,47,0,108,1,0,23328,509544,14.696938456699069,108,432,324,216,27740,448210,344414,2251,2575,2467,2467,2791,10.392304845413264,10.909289819896376,324,1,31536,19008,108,0,2143,2251
5048,1,0,0,0,48,0,55,1,0,110466,867122,19.0,127,901,667,361,45472,538048,487606,2168,2763,2636,2708,3303,17.4928556845359,15.92773453843406,595,1,73283,37206,306,0,2041,2096
5049,1,0,0,0,46,0,150,0,1,340119,1201959,22.64950330581225,338,1351,1176,513,48160,503745,524832,2168,2856,2518,3006,3694,25.748786379167466,13.555134321639665,688,1,114912,21525,663,0,1830,1680
5050,1,0,0,0,45,0,103,0,1,472758,1451450,25.25866188063018,638,1379,1379,638,54225,511875,548275,2275,2913,2275,3016,3654,27.2213151776324,0.0,638,1,153758,0,741,0,1637,1534
5051,1,0,0,0,45,0,55,0,1,469154,1493660,25.65151067676132,658,1371,1371,658,52210,515290,522100,2270,2928,2270,2983,3641,26.70205984563738,0.0,658,1,151340,0,713,0,1612,1557
5052,1,0,0,0,45,0,168,1,0,363825,1593207,26.324893162176366,585,1326,1218,693,33048,468996,372438,2191,2992,2407,2824,3625,22.9128784747792,10.748049169056976,801,1,112266,19224,525,0,1606,1774
5053,1,0,0,0,49,0,660,0,1,499500,2752800,33.31666249791537,558,2112,1560,1110,42021,503440,513360,1928,3590,3032,2930,4592,21.213203435596427,23.649288237611923,1662,1,229770,71208,450,0,1370,2030
5054,1,0,0,0,44,0,611,1,0,1364726,3402737,38.897300677553446,1483,2445,2415,1513,42823,420563,515021,2219,3762,2279,3151,4694,30.033314835362415,5.753771868478424,1543,1,346477,2430,902,0,736,1347
5055,1,0,0,0,44,0,638,0,0,1372035,3427788,39.153543900903784,1533,2428,2428,1533,51051,494156,516516,2236,3769,2236,3131,4664,29.916550603303182,0.0,1533,0,354123,0,895,0,703,1341
5056,1,0,0,0,46,0,808,0,1,1542420,3958650,41.352146256270665,1442,2880,2612,1710,41168,574120,384290,2047,4025,2583,3217,5195,30.033314835362415,16.59232609047777,1978,1,283860,58156,902,0,605,1413
5057,1,0,0,0,43,0,618,0,0,714519,1294290,24.310491562286437,591,1800,1800,591,49396,464280,510270,2190,2781,2190,3399,3990,34.77067730142742,0.0,591,1,137703,0,1209,0,1599,981
5058,1,0,0,0,43,0,654,0,0,708480,1259712,24.0,576,1806,1806,576,50094,529254,452709,2187,2763,2187,3417,3993,35.07135583350036,0.0,576,0,119232,0,1230,0,1611,957
5059,1,0,0,0,46,0,1189,1,0,523602,788994,18.49324200890693,57,2158,1873,342,41772,408339,544452,2022,2649,2592,3838,4465,39.1279950930277,17.37914745350816,627,1,80712,15960,1531,0,1965,776
5060,1,0,0,0,47,0,1348,0,1,886688,1154824,22.0,175,2625,2316,484,50058,491516,579798,2077,2870,2695,4218,5011,42.80186911806539,18.666223449047106,793,1,117612,26574,1832,0,1902,554
5061,1,0,0,0,47,0,1270,0,1,921576,1216728,22.715633383201094,239,2579,2302,516,45540,424440,596574,2081,2874,2635,4144,4937,42.261093218230876,17.529264702875853,793,1,130548,8033,1786,0,1842,572
5062,1,0,0,0,46,0,1189,0,1,963326,1282960,23.515952032609693,311,2537,2295,553,47752,436160,589280,2078,2873,2562,4062,4857,41.737273509418415,16.169941716904972,795,1,140462,8470,1742,0,1767,578
5063,1,0,0,0,45,0,1104,0,1,1008612,1358478,24.372115213907882,378,2508,2292,594,50292,452826,580898,2071,2881,2503,3985,4795,41.20679555607303,15.028584853425972,810,1,150876,11232,1698,0,1693,589
5064,1,0,0,0,45,0,1060,0,1,1032416,1400784,24.819347291981714,415,2493,2292,616,50800,454800,577596,2073,2890,2475,3950,4767,40.93897898091744,14.513506680968025,817,1,156464,11055,1676,0,1658,598
5065,1,0,0,0,45,0,1019,0,1,1052580,1436088,25.219040425836983,461,2466,2291,636,49784,442568,573532,2083,2894,2433,3913,4724,40.681691213615984,13.501111227926843,811,1,161544,8575,1655,0,1622,603
5066,1,0,0,0,44,0,976,0,1,1075172,1475894,25.65151067676132,508,2442,2292,658,49588,439628,567479,2093,2901,2393,3877,4685,40.422765862815474,12.420125667085228,808,1,166474,7950,1634,0,1585,609
5067,1,0,0,0,44,0,933,0,1,1096840,1515040,26.076809620810597,560,2413,2293,680,49551,443372,554772,2108,2908,2348,3841,4641,40.162171256046406,11.037374824906587,800,1,169320,7920,1613,0,1548,615
5068,1,0,0,0,44,0,889,0,1,1119176,1558551,26.514147167125703,613,2385,2295,703,49368,452268,536514,2127,2920,2307,3809,4602,39.89987468652001,9.613403705477898,793,1,170126,7740,1592,0,1514,625
5069,1,0,0,0,44,0,846,0,1,1141272,1603008,26.94438717061496,666,2358,2298,726,48760,468096,507840,2148,2934,2268,3780,4566,39.64845520319802,7.789174875971784,786,1,166980,6720,1572,0,1482,636
5070,1,0,0,0,44,0,759,0,1,1186542,1703574,27.820855486487112,774,2307,2307,774,45600,501828,440200,2201,2975,2201,3734,4508,39.153543900903784,0.0,774,1,154800,0,1533,0,1427,668
5071,1,0,0,0,48,0,108,1,0,1215900,2545200,32.4037034920393,965,2293,2208,1050,46428,513888,530856,2339,3474,2509,3582,4717,34.02939905434711,9.300149152818726,1135,1,229950,10625,1158,0,1374,1266
5072,1,0,0,0,48,0,32,0,1,1136100,2522100,32.4037034920393,1050,2132,2132,1050,47957,521234,530842,2402,3452,2402,3484,4534,32.89376840679705,0.0,1050,1,232050,0,1082,0,1352,1320
5073,1,0,0,0,48,0,124,0,1,994157,2569742,32.57299494980466,881,2178,1998,1061,42586,518308,481978,2242,3483,2602,3359,4600,30.610455730027933,13.687973365625968,1241,1,211139,27180,937,0,1361,1485
5074,1,0,0,0,47,0,467,0,1,816900,2763456,34.161381705077446,1167,1867,1867,1167,51012,516224,554112,2368,3535,2368,3068,4235,26.457513110645905,0.0,1167,1,273078,0,700,0,1201,1668
5075,1,0,0,0,44,0,968,1,0,651225,3160650,37.749172176353746,1330,1977,1882,1425,45200,443600,501268,2123,3643,2313,2675,4195,21.37755832643195,10.232047425710157,1520,1,322050,9595,457,0,793,1761
5076,1,0,0,0,44,0,918,0,1,680455,3096421,37.456641600656084,1336,1955,1888,1403,49572,450228,536301,2140,3610,2274,2692,4162,22.02271554554524,8.642106768569302,1470,1,340929,5561,485,0,804,1722
5077,1,0,0,0,46,0,55,1,0,1067366,2474252,32.57299494980466,881,2247,2067,1061,38586,508376,412764,2152,3393,2512,3338,4579,31.71750305430741,14.093805174152301,1241,1,187797,32220,1006,0,1271,1326
5078,1,0,0,0,46,0,75,0,1,1116900,2357220,31.937438845342623,930,2205,2115,1020,34720,358205,517664,2221,3331,2401,3406,4516,33.090784215548595,10.48136444083514,1110,1,228480,3600,1095,0,1291,1216
5079,1,0,0,0,45,0,236,1,0,1185101,2211928,31.25699921617557,947,2220,2190,977,44080,525248,430160,2234,3241,2294,3477,4484,34.828149534535996,5.5965095842615735,1007,1,185630,5460,1213,0,1287,1051
5080,1,0,0,0,45,0,245,1,0,415986,1213248,23.108440016582687,467,1380,1313,534,37980,408960,479392,2205,2806,2339,3051,3652,27.910571473905726,8.187175587434018,601,1,112674,6231,779,0,1738,1493
5081,1,0,0,0,44,0,179,0,0,290652,1015911,21.37755832643195,427,1123,1093,457,47880,422370,560196,2193,2680,2253,2859,3346,25.219040425836983,6.004624280888846,487,1,115164,1410,636,0,1766,1587
5082,0,1,0,1,65,0,412,0,0,13272765,11196636,58.677082408722406,3348,7393,7298,3443,49680,702432,747960,3157,6695,3347,7107,10645,62.08864630510155,9.746794344808963,3538,1,791890,11115,3855,0,191,603
5083,0,1,1,0,61,0,1917,0,0,9247810,6881780,47.22287581247038,1953,6654,6377,2230,31040,493760,598684,2809,5316,3363,7233,9740,64.39720490828775,17.160940468146453,2507,1,432620,23268,4147,0,856,1061
5084,0,1,1,0,58,0,1861,0,0,4403490,3992625,36.945906403822335,1335,4621,4591,1365,48952,678600,617175,2895,4290,2955,6151,7546,56.79788728465171,5.478746393072713,1395,0,288015,4770,3226,1,1560,301
5085,0,1,1,0,64,0,1265,0,0,1445466,2331912,26.94438717061496,186,3257,2717,726,35112,494648,732336,2672,3938,3752,5203,6469,44.62062303464621,24.11633884258816,1266,1,165528,17280,1991,0,2486,1221
5086,0,0,1,0,57,1,1000,0,0,2329236,6090552,45.89117562233506,1850,3468,3212,2106,56400,679620,694080,2636,4998,3148,3998,6360,33.25657829663178,16.368026731500475,2362,1,505440,30720,1106,0,786,1786
5087,0,0,0,0,55,1,1010,1,0,2995784,6460092,48.041648597857254,2248,3666,3606,2308,52182,624177,654966,2739,5107,2859,4097,6465,36.02776706930364,7.750803389552748,2368,1,540072,7200,1298,0,491,1501
5088,1,0,0,0,45,0,185,0,1,464100,1356600,24.392621835300936,595,1375,1375,595,54208,510720,551760,2280,2875,2280,3060,3655,27.92848008753788,0.0,595,1,143990,0,780,0,1685,1500
5089,1,0,0,0,45,0,89,0,1,461100,1446264,25.219040425836983,606,1391,1361,636,47064,504828,482088,2244,2910,2304,2999,3665,26.92582403567252,5.477225575051661,666,1,134832,4410,725,0,1638,1549
5090,1,0,0,0,45,0,40,0,1,459284,1495634,25.65151067676132,628,1386,1356,658,43818,495514,456873,2243,2931,2303,2971,3659,26.419689627245813,5.490867587491313,688,1,132258,4650,698,0,1615,1575
5091,1,0,0,0,50,0,611,0,1,357582,2452270,31.25699921617557,377,1943,1343,977,46566,587340,499490,1910,3487,3110,2876,4453,19.131126469708992,24.7362556105635,1577,1,194423,105000,366,0,1533,2144
5092,1,0,0,0,49,0,622,0,1,476328,2661456,32.68026927673638,531,2051,1514,1068,43681,520828,520828,1955,3560,3029,2938,4543,21.118712081942874,23.379506351337316,1605,1,223212,71958,446,0,1424,2046
5093,1,0,0,0,45,0,833,0,1,1580828,3962516,41.72529209005013,1591,2799,2649,1741,51360,546240,487064,2126,4017,2426,3184,5075,30.133038346638727,12.420125667085228,1891,1,372574,24600,908,0,535,1368
5094,1,0,0,0,46,0,800,0,1,1635600,4050720,41.71330722922842,1500,2920,2680,1740,36192,540096,363168,2088,4068,2568,3268,5248,30.659419433511783,15.760291721289946,1980,1,271440,51360,940,0,588,1388
5095,1,0,0,0,46,0,702,0,1,1619199,3880062,40.87786687193939,1429,2882,2640,1671,34408,434214,427248,2080,3993,2564,3291,5204,31.12876483254676,15.837884755288831,1913,1,307464,32428,969,0,651,1353
5096,1,0,0,0,43,0,658,0,0,666159,1207241,23.473389188611005,551,1760,1760,551,47508,486402,468874,2191,2742,2191,3400,3951,34.77067730142742,0.0,551,0,117914,0,1209,0,1640,982
5097,1,0,0,0,45,0,1008,1,0,534528,875136,19.595917942265423,250,1910,1776,384,27848,537844,268922,2145,2663,2413,3671,4189,37.30951621235526,12.333627810115374,518,1,45312,32160,1392,0,1895,887
5098,1,0,0,0,46,0,1413,1,0,526014,706860,17.4928556845359,204,2535,2025,306,32092,522060,328020,1800,2616,2820,4029,4845,41.46082488325576,22.68582113580776,816,1,43452,111690,1719,0,2004,591
5099,1,0,0,0,47,0,1394,0,1,848216,1093704,21.400934559032695,175,2593,2310,458,51750,494316,597000,2105,2846,2671,4240,4981,43.034869582700026,18.030486588777755,741,1,114500,20942,1852,0,1930,536
5100,1,0,0,0,47,0,1314,0,1,888552,1157184,22.181073012818835,237,2553,2298,492,44528,413952,595056,2097,2844,2607,4158,4905,42.49705872175156,16.87825261584672,747,1,124476,4590,1806,0,1860,546
5101,1,0,0,0,46,0,1273,0,1,911624,1191141,22.60530911091463,277,2529,2295,511,45466,417249,592074,2097,2842,2565,4115,4860,42.23742416388575,16.027759703794327,745,1,129794,5148,1784,0,1820,547
5102,1,0,0,0,46,0,1231,0,1,935622,1227672,23.043437243605826,315,2509,2293,531,47752,434656,587248,2096,2843,2528,4074,4821,41.97618372363071,15.259836841981645,747,1,134874,7560,1762,0,1781,550
5103,1,0,0,0,45,0,1188,0,1,960480,1267392,23.49468024894146,351,2493,2292,552,49276,445424,583184,2095,2848,2497,4036,4789,41.71330722922842,14.64707172595852,753,1,140208,9045,1740,0,1744,556
5104,1,0,0,0,45,0,1060,0,1,1032416,1387232,24.819347291981714,454,2454,2292,616,49644,443644,567504,2090,2868,2414,3928,4706,40.93897898091744,12.927016270999431,778,1,155232,9234,1676,0,1636,576
5105,1,0,0,0,44,0,1017,0,1,1055890,1428482,25.25866188063018,504,2427,2293,638,50096,452278,555272,2105,2877,2373,3894,4666,40.681691213615984,11.737458020983768,772,1,158224,9648,1655,0,1601,584
5106,1,0,0,0,44,0,887,0,1,1129260,1567512,26.60826939130014,648,2363,2303,708,47460,464940,500364,2154,2922,2274,3809,4577,39.93745109543172,7.864259938752337,768,1,160008,6900,1595,0,1506,619
5107,1,0,0,0,44,0,843,0,1,1152900,1617720,27.055498516937366,702,2337,2307,732,47304,477360,483990,2180,2942,2240,3785,4547,39.68626966596886,5.5965095842615735,762,1,160308,3960,1575,0,1478,635
5108,1,0,0,0,44,0,799,0,1,1177892,1670699,27.51363298439521,757,2313,2313,757,42560,494368,419330,2207,2964,2207,3763,4520,39.44616584663204,0.0,757,1,143830,0,1556,0,1450,651
5109,1,0,0,0,47,0,271,0,1,877502,2593554,32.89376840679705,987,1988,1893,1082,49880,515355,556104,2302,3479,2492,3208,4385,28.478061731796284,9.937924380926386,1177,1,251024,10735,811,0,1315,1586
5110,1,0,0,0,48,0,625,1,0,811506,3054858,35.58089374931439,1074,2099,1907,1266,36072,521208,402971,2221,3679,2605,3054,4512,25.317977802344327,14.26023739270955,1458,1,211422,35904,641,0,1147,1772
5111,1,0,0,0,48,0,690,1,0,833551,3200783,36.345563690772494,1066,2207,1952,1321,44800,542752,484600,2168,3744,2678,3054,4630,25.11971337416094,16.347922201241825,1576,1,264200,41565,631,0,1102,1792
5112,1,0,0,0,44,0,1430,0,0,348104,3617326,40.52159917870962,1642,1854,1854,1642,44100,495675,431788,2203,3845,2203,2415,4057,14.560219778561036,0.0,1642,0,321832,0,212,0,561,1991
5113,1,0,0,0,43,0,877,0,1,734124,3065388,37.429934544425805,1371,1955,1925,1401,51308,441976,555752,2158,3589,2218,2712,4143,22.891046284519195,5.753771868478424,1431,1,355854,1650,524,0,787,1664
5114,1,0,0,0,43,0,779,0,0,786282,2940070,36.851051545376556,1358,1937,1937,1358,51067,495785,482795,2165,3523,2165,2744,4102,24.06241883103193,0.0,1358,0,302834,0,579,0,807,1586
5115,1,0,0,0,46,0,32,1,0,1116993,2510820,32.7566787083184,923,2264,2114,1073,48832,524160,510120,2190,3413,2490,3381,4604,32.264531609803356,13.265214125244757,1223,1,233914,21300,1041,0,1267,1299
5116,1,0,0,0,45,0,174,1,0,1206835,2305065,31.85906464414798,1015,2204,2204,1015,43618,438303,513246,2271,3286,2271,3460,4475,34.48187929913333,0.0,1015,1,229390,0,1189,0,1256,1082
5117,1,0,0,0,46,0,271,1,0,1219296,2249054,31.25699921617557,843,2359,2225,977,46222,557084,439682,2168,3279,2436,3550,4661,35.32704346531139,12.08361278705801,1111,1,186607,25594,1248,0,1325,1054
5118,1,0,0,0,43,0,59,1,0,232902,994260,21.307275752662516,394,1027,967,454,27666,381060,348210,2130,2644,2250,2703,3217,22.64950330581225,7.759379671981613,514,1,72186,8580,513,0,1736,1677
5119,0,1,0,1,65,0,123,0,0,14197810,12543250,61.886993787063204,3800,7567,7537,3830,52437,756525,743425,3245,7105,3305,6982,10842,60.88513775955508,5.483301264452448,3860,1,869410,4170,3707,0,555,432
5120,0,1,0,1,65,0,2,0,0,14010048,12213888,61.171888968708494,3742,7486,7486,3742,53360,750720,757248,3264,7006,3264,7008,10750,61.18823416311342,0.0,3742,1,868144,0,3744,0,478,480
5121,0,0,0,0,56,1,1075,1,0,2575650,6326510,47.22287581247038,2096,3519,3385,2230,56628,663858,686554,2703,5067,2971,3992,6356,33.98529093593286,11.757812605679836,2364,1,539660,15410,1155,0,607,1682
5122,0,0,0,0,56,1,1075,1,0,2616414,6349344,47.34976240700686,2118,3533,3409,2242,56635,665520,682512,2708,5074,2956,3999,6365,34.161381705077446,11.284767849177381,2366,1,540322,14508,1167,0,590,1665
5123,0,0,0,0,56,1,1074,1,0,2663155,6374885,47.486840282335066,2135,3556,3436,2255,56628,661518,684134,2707,5082,2947,4008,6383,34.36568055487916,11.06238981080611,2375,1,545710,13680,1181,0,572,1646
5124,1,0,0,0,46,0,62,1,0,18360,252288,10.392304845413264,41,345,278,108,32232,476544,369088,2269,2444,2403,2506,2681,13.038404810405298,8.286047041568583,175,1,17064,12127,170,0,2228,2166
5125,1,0,0,0,47,0,46,1,0,21080,401370,13.038404810405298,75,389,294,170,24684,441507,311652,2266,2531,2456,2485,2750,11.135528725660043,10.21168317809702,265,1,22440,17575,124,0,2191,2237
5126,1,0,0,0,45,0,219,0,1,453816,1305867,23.93741840717165,573,1365,1365,573,50398,515054,508217,2279,2852,2279,3071,3644,28.142494558940577,0.0,573,1,127779,0,792,0,1706,1487
5127,1,0,0,0,47,0,307,1,0,272918,1658448,26.419689627245813,363,1424,1089,698,24766,482328,289872,2041,3074,2711,2767,3800,19.77371993328519,18.946743995399164,1033,1,85156,71355,391,0,1678,1985
5128,1,0,0,0,49,0,528,1,0,297540,2169780,29.49576240750525,278,1804,1212,870,44969,581102,481342,1902,3364,3086,2836,4298,18.49324200890693,25.467733056771902,1462,1,167910,105968,342,0,1624,2152
5129,1,0,0,0,45,0,508,1,0,1409280,3322084,38.31448812133603,1426,2470,2428,1468,34821,359817,495597,2221,3731,2305,3223,4733,30.983866769659336,6.885715530322088,1510,1,321492,2226,960,0,795,1303
5130,1,0,0,0,44,0,534,0,0,1417111,3344263,38.561638969317684,1457,2470,2440,1487,36406,375583,490282,2219,3736,2279,3202,4719,30.870698080866262,5.572104574801163,1517,0,324166,1950,953,0,762,1296
5131,1,0,0,0,44,0,560,0,0,1427129,3374173,38.82009788756334,1507,2454,2454,1507,43400,447800,485863,2239,3746,2239,3186,4693,30.773365106858236,0.0,1507,0,327019,0,947,0,732,1292
5132,1,0,0,0,45,0,817,0,1,1686810,4063920,42.07136793592526,1569,2924,2723,1770,32665,539560,319144,2095,4066,2497,3249,5220,30.870698080866262,14.26644049405724,1971,1,246030,46029,953,0,526,1343
5133,1,0,0,0,43,0,741,0,0,606636,1079448,22.181073012818835,492,1725,1725,492,49115,515590,458546,2194,2686,2194,3427,3919,35.11409973215888,0.0,492,0,102828,0,1233,0,1702,961
5134,1,0,0,0,45,0,1356,1,0,439020,616950,16.431676725154983,151,2317,1896,270,31570,468425,351890,1864,2555,2706,3911,4602,40.32369030731191,20.69214072882385,691,1,41580,78306,1626,0,2015,659
5135,1,0,0,0,48,0,1515,0,1,770634,964800,20.049937655763422,105,2616,2319,402,52392,532800,566400,2103,2802,2697,4317,5016,43.78355855797927,18.354366481224982,699,1,94872,34749,1917,0,1998,483
5136,1,0,0,0,47,0,1399,0,1,832050,1063350,21.213203435596427,208,2541,2299,450,46228,430066,600202,2121,2813,2605,4212,4904,43.0,16.64656967921078,692,1,114300,6050,1849,0,1913,514
5137,1,0,0,0,46,0,1316,0,1,880352,1134600,22.090722034374522,276,2504,2292,488,46228,423150,590550,2113,2813,2537,4129,4829,42.473521163190604,15.310171951475196,700,1,123952,5512,1804,0,1837,521
5138,1,0,0,0,45,0,1230,0,1,935091,1215990,23.043437243605826,356,2467,2292,531,49784,448840,581660,2115,2821,2465,4051,4757,41.96427051671457,13.66314557581616,706,1,134874,8400,1761,0,1759,529
5139,1,0,0,0,45,0,1187,0,1,959928,1256904,23.49468024894146,390,2453,2291,552,52118,469062,576081,2115,2829,2439,4016,4730,41.701318923986086,13.092209549519387,714,1,139656,10692,1739,0,1725,538
5140,1,0,0,0,45,0,1145,0,1,984414,1298418,23.93741840717165,423,2441,2291,573,51706,466796,568766,2116,2839,2416,3984,4707,41.44876355212541,12.514175867137965,723,1,143823,10650,1718,0,1693,548
5141,1,0,0,0,44,0,971,0,1,1090242,1481850,25.80697580112788,599,2370,2303,666,49980,467250,529550,2158,2891,2292,3862,4595,40.45985664828782,8.329212945039274,733,1,158508,6633,1637,0,1559,588
5142,1,0,0,0,44,0,926,0,1,1117347,1533329,26.28687885618983,649,2350,2308,691,52341,485961,530341,2177,2910,2261,3836,4569,40.2119385257662,6.609134537568676,733,1,165149,4578,1617,0,1528,602
5143,1,0,0,0,44,0,882,0,1,1144168,1583792,26.758176320519304,686,2344,2314,716,52192,515396,495488,2182,2928,2242,3810,4556,39.97499218261337,5.514871952411144,746,1,160384,4320,1598,0,1496,614
5144,1,0,0,0,44,0,838,0,1,1170039,1640574,27.2213151776324,741,2320,2320,741,43005,520290,405162,2214,2955,2214,3793,4534,39.736632972611055,0.0,741,1,135603,0,1579,0,1473,635
5145,1,0,0,0,44,0,793,1,0,1196520,1705041,27.694764848252458,737,2357,2327,767,34578,502398,340119,2193,2990,2253,3783,4580,39.496835316262995,5.830951894845301,797,1,117351,6300,1560,0,1456,663
5146,1,0,0,0,45,0,574,1,0,1324227,2062306,29.9833287011299,719,2552,2372,899,23364,454212,270692,2114,3193,2474,3767,4846,38.379682124790975,14.299387820373207,1079,1,106082,37980,1473,0,1395,821
5147,1,0,0,0,46,0,496,1,0,1256400,2079000,30.0,581,2615,2296,900,29913,390390,408870,1991,3210,2629,3706,4925,37.36308338453881,18.470987337550696,1219,1,159300,37323,1396,0,1410,914
5148,1,0,0,0,48,0,233,1,0,1226310,2425701,31.575306807693888,870,2354,2227,997,40885,537693,450105,2306,3430,2560,3663,4787,35.07135583350036,11.283549896340864,1124,1,184445,22225,1230,0,1436,1203
5149,1,0,0,0,48,0,223,0,1,1205280,2410560,31.496031496047245,907,2292,2207,992,52899,556470,561330,2345,3422,2515,3645,4722,34.85685011586675,9.290499583346438,1077,1,229152,11220,1215,0,1438,1215
5150,1,0,0,0,48,0,134,0,1,915192,2481894,32.03123475609393,864,2080,1918,1026,49115,505571,568465,2257,3445,2581,3311,4499,29.866369046136157,12.89950058566656,1188,1,241110,16362,892,0,1393,1527
5151,1,0,0,0,47,0,333,0,0,843700,2601500,33.166247903554,1100,1867,1867,1100,52650,553410,532125,2365,3465,2365,3132,4232,27.694764848252458,0.0,1100,0,247500,0,767,0,1265,1598
5152,1,0,0,0,48,0,547,1,0,828648,2954736,34.9857113690718,1034,2091,1901,1224,31228,509354,357272,2224,3638,2604,3091,4505,26.019223662515376,14.170774724066149,1414,1,181152,37810,677,0,1190,1737
5153,1,0,0,0,44,0,1368,0,1,385920,3548856,40.099875311526844,1608,1848,1848,1608,49268,498782,481126,2207,3815,2207,2447,4055,15.491933384829668,0.0,1608,1,350544,0,240,0,599,1967
5154,1,0,0,0,44,0,1371,0,0,390346,3567956,40.162171256046406,1583,1885,1855,1613,39600,497700,389312,2182,3825,2242,2454,4097,15.556349186104045,5.514871952411144,1643,0,283888,5640,242,0,599,1970
5155,1,0,0,0,43,0,933,0,1,735930,3170271,37.986839826445156,1413,1983,1953,1443,49022,424021,558038,2167,3640,2227,2707,4180,22.58317958127243,5.572104574801163,1473,1,366522,1260,510,0,754,1687
5156,1,0,0,0,43,0,884,0,1,763077,3096359,37.69615364994153,1391,1988,1958,1421,51612,444516,551287,2149,3600,2209,2716,4167,23.173260452512935,5.514871952411144,1451,1,359513,1890,537,0,758,1642
5157,1,0,0,0,45,0,455,1,0,977454,2805678,35.24202037341219,1030,2241,2029,1242,25132,465354,275598,2047,3501,2471,3046,4500,28.053520278211074,15.51474431382845,1454,1,151524,45792,787,0,1017,1472
5158,1,0,0,0,46,0,95,1,0,1135166,2601190,33.37663853655727,939,2308,2133,1114,47385,567405,455325,2160,3449,2510,3354,4643,31.921779399024736,13.511562386610331,1289,1,217230,32725,1019,0,1221,1316
5159,1,0,0,0,46,0,31,0,1,1188950,2495075,32.78719262151,985,2271,2181,1075,48694,450274,582571,2231,3396,2411,3427,4592,33.25657829663178,10.564395459581663,1165,1,269825,4860,1106,0,1246,1215
5160,1,0,0,0,46,0,307,1,0,1154748,2159444,30.528675044947494,623,2480,2171,932,37213,461083,433279,2008,3249,2626,3556,4797,35.199431813596085,18.24697093999612,1241,1,174284,44805,1239,0,1385,1078
5161,1,0,0,0,45,0,155,0,0,389006,1241403,23.473389188611005,551,1257,1257,551,44100,405540,551985,2253,2804,2253,2959,3510,26.570660511172846,0.0,551,1,134995,0,706,0,1702,1547
5162,0,1,1,0,65,0,1292,0,0,1619013,2540593,27.94637722496424,301,3334,2854,781,51504,722166,754696,2773,4034,3733,5326,6587,45.53020975132884,23.33390887083371,1261,1,181192,58080,2073,0,2472,1180
5163,0,1,1,0,64,0,1266,0,0,1601536,2536026,27.964262908219126,272,3340,2830,782,45171,612927,775077,2733,4025,3753,5291,6583,45.254833995939045,23.80472230290677,1292,1,186898,35700,2048,0,2461,1195
5164,0,1,1,0,58,0,885,0,0,272734,701800,15.556349186104045,14,1597,1369,242,54718,632200,727900,2672,3142,3128,4027,4497,33.57082066318904,15.765972429182042,470,1,60742,19152,1127,0,2658,1773
5165,0,0,1,0,57,1,1062,0,0,2145403,6053922,45.70557952810576,1821,3384,3116,2089,56394,698418,678132,2630,4987,3166,3925,6282,32.046840717924134,16.715296746065686,2357,1,488826,36448,1027,0,809,1871
5166,0,0,0,0,56,1,1130,1,0,2543639,6387310,47.50789408087881,2149,3492,3384,2257,56386,659390,684860,2722,5087,2938,3957,6322,33.57082066318904,10.551011889467135,2365,1,546194,12420,1127,0,573,1703
5167,0,0,0,0,56,1,1122,1,0,2782879,6515047,48.176757881783615,2254,3587,3520,2321,55926,670873,656838,2740,5128,2874,4006,6394,34.62657938636157,8.230562448445415,2388,1,543114,9045,1199,0,486,1608
5168,1,0,0,0,47,0,210,0,1,252144,962064,20.199009876724155,207,1227,1026,408,49560,495180,556488,2157,2766,2559,2976,3585,24.859605789312106,14.473434607486176,609,1,96288,20502,618,0,1950,1740
5169,1,0,0,0,46,0,277,0,1,336630,1062102,21.400934559032695,368,1283,1193,458,52668,484671,584388,2229,2777,2409,3054,3602,27.110883423451916,9.773414525644373,548,1,115416,6390,735,0,1861,1584
5170,1,0,0,0,45,0,301,0,1,441792,1212804,23.043437243605826,531,1363,1363,531,49932,520752,500196,2284,2815,2284,3116,3647,28.844410203711913,0.0,531,1,116289,0,832,0,1753,1452
5171,1,0,0,0,45,0,205,1,0,445794,1310451,23.93741840717165,531,1393,1351,573,39457,482557,427669,2245,2860,2329,3065,3680,27.892651361962706,6.538739683827756,615,1,107151,6762,778,0,1714,1509
5172,1,0,0,0,46,0,384,1,0,1186372,3007466,36.02776706930364,1021,2489,2212,1298,45549,437913,558397,2040,3615,2594,3231,4806,30.23243291566195,16.940303019898575,1575,1,312818,18282,914,0,1019,1403
5173,1,0,0,0,45,0,509,0,0,1451822,3346472,38.54867053479276,1486,2463,2463,1486,31243,353564,448148,2252,3738,2252,3229,4715,31.25699921617557,0.0,1486,0,295714,0,977,0,766,1275
5174,1,0,0,0,44,0,534,0,0,1463832,3376452,38.80721582386451,1506,2478,2478,1506,39585,437190,455126,2242,3748,2242,3214,4720,31.176914536239792,0.0,1506,0,305718,0,972,0,736,1270
5175,1,0,0,0,47,0,673,0,1,1539278,3811700,40.27406113120453,1432,2761,2571,1622,45200,531100,470000,2160,3972,2540,3299,5111,30.805843601498726,14.529345172540314,1812,1,324400,31160,949,0,728,1401
5176,1,0,0,0,47,0,1522,0,1,747983,935272,19.77371993328519,136,2559,2304,391,52459,499928,600392,2137,2783,2647,4305,4951,43.73785545725808,17.214950404460335,646,1,98141,18615,1913,0,2001,479
5177,1,0,0,0,46,0,1358,0,1,852275,1082506,21.61018278497431,277,2482,2292,467,48006,438102,588772,2128,2785,2508,4143,4800,42.720018726587654,14.544400792145442,657,1,118618,6650,1825,0,1851,493
5178,1,0,0,0,46,0,1315,0,1,879864,1122888,22.090722034374522,318,2461,2291,488,48260,437190,584454,2131,2789,2471,4104,4762,42.46174749112429,13.64605912284091,658,1,123952,6460,1803,0,1813,498
5179,1,0,0,0,45,0,1273,0,1,907038,1162556,22.561028345356956,359,2441,2291,509,49784,447664,580136,2134,2793,2434,4066,4725,42.21374183841087,12.69591381900158,659,1,129286,7050,1782,0,1775,502
5180,1,0,0,0,45,0,1230,0,1,935091,1204839,23.043437243605826,397,2426,2292,531,53130,476490,574057,2135,2800,2403,4030,4695,41.96427051671457,11.875984241237097,665,1,134343,9514,1761,0,1738,508
5181,1,0,0,0,45,0,1187,0,1,962220,1249780,23.515952032609693,429,2417,2293,553,54250,490420,565000,2136,2813,2384,4000,4677,41.71330722922842,11.401248222293653,677,1,138250,10416,1740,0,1707,520
5182,1,0,0,0,45,0,1143,0,1,990144,1296576,24.0,468,2403,2295,576,53816,488467,558248,2143,2827,2359,3970,4654,41.46082488325576,10.587221077960752,684,1,142848,9720,1719,0,1675,532
5183,1,0,0,0,44,0,1055,0,1,1047696,1394640,24.979991993593593,539,2388,2303,624,51972,476055,545340,2150,2859,2320,3914,4623,40.97560249709576,9.39804606644414,709,1,152256,7990,1679,0,1611,556
5184,1,0,0,0,44,0,966,0,1,1105360,1492236,25.96150997149434,644,2344,2314,674,54390,491508,542430,2184,2888,2244,3854,4558,40.496913462633174,5.5503012171862105,704,1,165130,3060,1640,0,1540,574
5185,1,0,0,0,46,0,623,1,0,1310750,2018625,29.58039891549808,695,2553,2373,875,21867,454479,256077,2127,3182,2487,3805,4860,38.704004960727254,14.542125105462588,1055,1,97125,38880,1498,0,1432,809
5186,1,0,0,0,47,0,453,1,0,1206460,2112200,29.916550603303182,653,2485,2243,895,26316,481440,304440,2118,3255,2602,3708,4845,36.71511950137164,15.677709056199316,1137,1,115455,50578,1348,0,1465,1012
5187,1,0,0,0,48,0,269,0,1,1184222,2336698,31.016124838541646,895,2260,2193,962,51948,539238,568386,2362,3391,2496,3660,4689,35.08560958569767,8.2732738280919,1029,1,225108,7973,1231,0,1467,1198
5188,1,0,0,0,47,0,252,0,1,856480,2514320,32.55764119219941,1060,1868,1868,1060,53100,533700,559792,2372,3432,2372,3180,4240,28.42534080710379,0.0,1060,1,250160,0,808,0,1312,1564
5189,1,0,0,0,44,0,1310,1,0,454575,3571205,39.93745109543172,1510,1965,1880,1595,32928,501536,329133,2154,3834,2324,2524,4204,16.881943016134134,9.607770959340817,1680,1,234465,18105,285,0,644,1954
5190,1,0,0,0,45,0,1291,1,0,494400,3616000,40.0,1473,2036,1909,1600,41514,501720,422620,2133,3860,2387,2569,4296,17.578395831246947,11.81597791836795,1727,1,299200,22098,309,0,660,1951
5191,1,0,0,0,43,0,939,0,1,768600,3204696,38.262252939417984,1464,1989,1989,1464,50800,437800,556006,2189,3653,2189,2714,4178,22.9128784747792,0.0,1464,1,371856,0,525,0,725,1664
5192,1,0,0,0,44,0,702,1,0,894880,3002880,36.87817782917155,1275,2103,2018,1360,22347,421728,258336,2123,3568,2293,2866,4311,25.65151067676132,9.759997214798725,1445,1,159120,17340,658,0,848,1550
5193,1,0,0,0,47,0,208,0,0,635600,1649200,26.457513110645905,518,1790,1608,700,45504,452352,558372,2174,3056,2538,3264,4146,30.133038346638727,14.187875184162642,882,1,165900,13832,908,0,1656,1448
5194,1,0,0,0,46,0,177,0,0,525798,1486230,25.337718918639855,547,1556,1461,642,43498,421330,553285,2220,2957,2410,3134,3871,28.61817604250837,10.252754761923411,737,1,153438,5605,819,0,1673,1496
5195,1,0,0,0,44,0,6,1,0,271432,1155658,22.759613353482084,433,1127,1042,518,22197,327957,336881,2146,2749,2316,2755,3358,22.891046284519195,9.511914438752074,603,1,78218,9775,524,0,1713,1707
5196,1,0,0,0,44,0,60,1,0,217189,1103340,22.293496809607955,363,1068,934,497,28728,337440,419580,2086,2717,2354,2657,3288,20.904544960366874,11.768410567748846,631,1,93933,10720,437,0,1723,1783
5197,0,1,0,1,65,0,40,0,0,14394036,12490850,61.75759062657804,3784,7618,7588,3814,50850,736875,740150,3245,7089,3305,7049,10893,61.43289021363068,5.477225575051661,3844,1,861964,3990,3774,0,539,499
5198,0,1,0,1,65,0,2,0,0,14326224,12373680,61.514225996918796,3754,7600,7570,3784,50830,722670,752100,3240,7054,3300,7056,10870,61.53048025166064,5.483301264452448,3814,1,870320,3690,3786,0,514,516
5199,0,1,1,0,62,0,684,0,0,1391020,2759004,29.765752132274432,0,3342,2456,886,47368,594774,772272,2228,4000,4000,4684,6456,39.6232255123179,30.632292754144505,1772,1,219728,50502,1570,0,2228,1544
5200,0,0,0,0,57,1,1171,1,0,2254122,6296602,46.87216658103186,2035,3385,3223,2197,56364,662046,699304,2704,5063,3028,3892,6251,32.03123475609393,13.05562736842334,2359,1,536068,17496,1026,0,669,1840
5201,0,0,1,0,58,1,958,0,0,3354008,6890660,48.703182647543684,2071,4087,3786,2372,49500,639100,653625,2604,5277,3206,4319,6992,37.603191353926334,17.3615940857869,2673,1,533700,38528,1414,0,533,1491
5202,1,0,0,0,48,0,96,0,1,164977,868566,19.0,26,1153,818,361,51624,519696,575034,2071,2767,2741,2863,3559,21.37755832643195,18.522305293217865,696,1,86279,35175,457,0,2045,1949
5203,1,0,0,0,45,0,331,0,1,375200,1074948,21.656407827707714,439,1299,1269,469,52080,497364,550080,2262,2761,2322,3092,3591,28.284271247461902,5.514871952411144,499,1,112560,3150,800,0,1823,1492
5204,1,0,0,0,46,0,368,1,0,1081280,2911520,35.21363372331802,898,2454,2112,1240,41118,417944,542388,2006,3588,2690,3220,4802,29.5296461204668,18.922216461064046,1582,1,286440,21888,872,0,1108,1476
5205,1,0,0,0,45,0,318,1,0,1336608,3048474,36.41428291206625,1125,2535,2334,1326,35910,434511,436810,2098,3625,2500,3307,4834,31.74901573277509,14.503273933035656,1527,1,251940,26130,1008,0,973,1291
5206,1,0,0,0,45,0,509,1,0,1501482,3391512,38.80721582386451,1506,2503,2503,1506,31500,394100,405360,2252,3758,2252,3249,4755,31.575306807693888,0.0,1506,1,271080,0,997,0,746,1255
5207,1,0,0,0,44,0,582,0,0,1556280,3529140,39.64845520319802,1572,2562,2562,1572,47286,478185,498390,2245,3817,2245,3235,4807,31.464265445104548,0.0,1572,0,348984,0,990,0,673,1255
5208,1,0,0,0,45,0,728,0,1,1744404,3974328,41.641325627314025,1600,2874,2740,1734,38048,531744,375888,2158,4026,2426,3298,5166,31.71750305430741,11.700176052913939,1868,1,284376,27738,1006,0,558,1286
5209,1,0,0,0,46,0,710,0,1,1603200,3916150,40.8656334834051,1520,2780,2630,1670,50600,593285,469000,2195,4015,2495,3305,5125,30.983866769659336,13.226055982240474,1820,1,334000,28050,960,0,675,1385
5210,1,0,0,0,47,0,699,0,1,1545822,3856350,40.50925820105819,1488,2736,2583,1641,54282,585150,512300,2197,3991,2503,3292,5086,30.692018506445613,13.361515988291586,1794,1,357738,25245,942,0,709,1408
5211,1,0,0,0,46,0,689,0,1,1490412,3788937,40.162171256046406,1451,2699,2537,1613,54093,580203,514431,2187,3962,2511,3273,5048,30.397368307141328,13.61327817014572,1775,1,353247,26406,924,0,736,1425
5212,1,0,0,0,48,0,462,1,0,928720,2957240,34.95711658589707,832,2372,1982,1222,30636,500940,358160,2030,3642,2810,3180,4792,27.568097504180443,21.195608644351836,1612,1,180856,75660,760,0,1198,1660
5213,1,0,0,0,44,0,788,0,0,523740,949440,20.73644135332772,430,1648,1648,430,38160,468096,397440,2208,2638,2208,3426,3856,34.899856733230294,0.0,430,0,77400,0,1218,0,1778,990
5214,1,0,0,0,47,0,1527,0,1,733824,909696,19.595917942265423,172,2507,2295,384,46482,433527,601726,2157,2753,2581,4280,4876,43.71498598878879,15.736737497798764,596,1,97536,5512,1911,0,1985,458
5215,1,0,0,0,46,0,1485,0,1,763156,948188,20.09975124224178,212,2485,2293,404,44022,408378,593791,2155,2751,2539,4236,4832,43.46262762420146,14.809359270225471,596,1,102212,2496,1889,0,1943,458
5216,1,0,0,0,46,0,1400,0,1,823316,1030260,21.118712081942874,284,2454,2292,446,48768,443520,586740,2148,2756,2472,4156,4764,42.96510211788167,13.47482551954778,608,1,113284,6318,1846,0,1864,464
5217,1,0,0,0,45,0,1357,0,1,851808,1071298,21.61018278497431,317,2441,2291,467,49530,447330,582676,2144,2761,2444,4118,4735,42.708313008125245,12.849476832533073,617,1,118618,6450,1824,0,1827,470
5218,1,0,0,0,45,0,1315,0,1,879864,1111664,22.090722034374522,361,2418,2291,488,50546,453322,578612,2151,2766,2405,4081,4696,42.46174749112429,11.730959300683235,615,1,123952,6477,1803,0,1790,475
5219,1,0,0,0,45,0,1228,0,1,940908,1204170,23.108440016582687,439,2391,2296,534,54750,493845,563750,2160,2789,2350,4017,4646,41.97618372363071,9.981197033715764,629,1,133500,8360,1762,0,1721,493
5220,1,0,0,0,44,0,1184,0,1,972036,1252710,23.62202362203543,473,2385,2300,558,55575,505125,554515,2160,2803,2330,3987,4630,41.737273509418415,9.39804606644414,643,1,137826,8415,1742,0,1687,503
5221,1,0,0,0,44,0,1049,0,1,1064706,1406526,25.15949125081825,591,2357,2315,633,52539,468842,553278,2180,2855,2264,3904,4579,41.012193308819754,6.589126398255297,675,1,157617,3444,1682,0,1589,540
5222,1,0,0,0,46,0,692,1,0,1303533,1950641,29.103264421710495,694,2539,2386,847,19900,458297,230300,2150,3150,2456,3842,4842,39.230090491866065,13.601470508735444,1000,1,84700,34731,1539,0,1456,764
5223,1,0,0,0,48,0,418,0,1,1217448,2209138,30.23243291566195,824,2336,2246,914,47960,526906,531740,2327,3331,2507,3749,4753,36.49657518178932,9.740037464252968,1004,1,201080,11880,1332,0,1503,1085
5224,1,0,0,0,48,0,348,0,1,1215180,2301306,30.692018506445613,834,2340,2232,942,41070,542346,451955,2335,3385,2551,3733,4783,35.91656999213594,10.429745618880121,1050,1,174270,19008,1290,0,1501,1153
5225,1,0,0,0,47,0,171,0,1,865980,2423520,31.937438845342623,1020,1869,1869,1020,53703,525096,577368,2376,3396,2376,3225,4245,29.13760456866693,0.0,1020,1,247860,0,849,0,1356,1527
5226,1,0,0,0,48,0,553,0,1,916560,3103574,35.679125549822544,934,2332,1993,1273,52670,558302,560740,2099,3711,2777,3158,4770,26.832815729997478,18.728147159276784,1612,1,292790,45087,720,0,1165,1718
5227,1,0,0,0,48,0,740,0,1,839244,3309446,36.851051545376556,1016,2318,1976,1358,48585,577569,499585,2095,3795,2779,3055,4755,24.859605789312106,19.600335151498342,1700,1,278390,58482,618,0,1079,1819
5228,1,0,0,0,44,0,1243,0,0,464744,3424592,39.293765408777,1544,1845,1845,1544,46368,459126,496832,2218,3762,2218,2519,4063,17.349351572897472,0.0,1544,0,345856,0,301,0,674,1917
5229,1,0,0,0,45,0,1235,1,0,525950,3556050,39.6232255123179,1420,2055,1905,1570,45240,525480,441675,2115,3835,2415,2600,4320,18.303005217723125,12.785844799727476,1720,1,306150,26550,335,0,695,1930
5230,1,0,0,0,43,0,944,0,1,803385,3240270,38.535697735995385,1485,2026,2026,1485,51516,462584,530226,2182,3667,2182,2723,4208,23.259406699226016,0.0,1485,1,360855,0,541,0,697,1641
5231,1,0,0,0,43,0,898,0,0,828624,3187128,38.262252939417984,1434,2060,2030,1464,43834,472409,439754,2147,3641,2207,2743,4237,23.790754506740637,5.652706486041966,1494,0,295728,4560,566,0,713,1611
5232,1,0,0,0,44,0,666,1,0,952072,3052632,36.932370625238775,1240,2186,2062,1364,22848,429696,266322,2114,3602,2362,2936,4424,26.419689627245813,11.995512529750124,1488,1,162316,25048,698,0,874,1540
5233,1,0,0,0,45,0,528,1,0,1020240,2973084,36.16628264005025,1107,2289,2088,1308,23875,434143,284125,2072,3581,2474,3053,4562,27.92848008753788,15.12126234418381,1509,1,163500,39597,780,0,965,1493
5234,1,0,0,0,45,0,437,1,0,1064228,2922808,35.679125549822544,1017,2365,2109,1273,28288,477568,312256,2040,3569,2552,3132,4661,28.91366458960192,17.15262394596582,1529,1,173128,52736,836,0,1023,1460
5235,1,0,0,0,45,0,218,1,0,1394715,2470638,32.817678162843876,987,2462,2372,1077,32184,495504,341806,2204,3371,2384,3589,4756,35.98610843089316,9.638070910968185,1167,1,160473,18360,1295,0,1217,999
5236,1,0,0,0,46,0,253,1,0,1418004,2465442,32.72613634390714,951,2515,2395,1071,32956,492628,354508,2182,3373,2422,3626,4817,36.38681079732051,11.261033825263985,1191,1,164934,23640,1324,0,1231,978
5237,1,0,0,0,46,0,273,1,0,1250370,2313630,31.464265445104548,640,2603,2253,990,33400,467400,390279,1987,3327,2687,3600,4940,35.53871128783372,19.19397666966835,1340,1,165330,58800,1263,0,1347,1074
5238,1,0,0,0,46,0,267,1,0,1191078,2263338,31.080540535840107,604,2561,2199,966,33930,456885,407682,1981,3309,2705,3576,4904,35.11409973215888,19.63820704538012,1328,1,168084,56110,1233,0,1377,1110
5239,1,0,0,0,47,0,234,1,0,921400,2001750,29.154759474226502,485,2299,1934,850,36349,525165,383865,1990,3205,2720,3439,4654,32.92415526630866,19.762878745753643,1215,1,138550,72635,1084,0,1505,1271
5240,1,0,0,0,47,0,218,0,1,825344,1911832,28.39013913315678,500,2136,1830,806,44744,564536,445936,2066,3178,2678,3396,4508,32.0,17.959741683475702,1112,1,151528,57834,1024,0,1566,1348
5241,1,0,0,0,45,0,57,1,0,368244,1306224,24.06241883103193,512,1282,1215,579,29700,372240,406080,2189,2835,2323,2892,3538,25.219040425836983,8.189452396126915,646,1,104220,7169,636,0,1677,1620
5242,0,1,0,1,65,0,23,0,0,14458874,12407943,61.57109711544857,3731,7665,7605,3791,49704,713514,746244,3213,7064,3333,7087,10938,61.75759062657804,7.748117453886108,3851,1,864348,7380,3814,0,518,541
5243,0,1,0,1,65,0,275,0,0,14069856,11759232,60.13318551349163,3466,7657,7507,3616,54756,760968,760968,3102,6868,3402,7143,10909,62.37788069500277,12.25845656828046,3766,1,846144,19800,3891,0,364,639
5244,0,1,1,0,59,0,1784,0,0,3707220,3658020,35.07135583350036,933,4541,4244,1230,41514,660228,556138,2677,4204,3271,5988,7515,54.89990892524322,17.38485989455128,1527,0,230010,51678,3014,1,1744,40
5245,0,1,0,1,65,0,1291,0,0,1790040,2737560,28.982753492378876,390,3421,2971,840,47286,694167,723498,2809,4099,3709,5390,6680,46.16275555033516,22.83021603165641,1290,1,186480,55800,2131,0,2419,1128
5246,0,0,1,0,58,1,50,0,0,955859,2771324,30.870698080866262,771,2138,1956,953,38157,689196,468188,2726,3861,3090,3911,5046,31.670175244226233,13.683682158628528,1135,1,153433,38948,1003,0,1955,1905
5247,0,0,1,0,57,1,1148,0,0,2029820,6097900,45.93473631142341,1882,3300,3072,2110,56640,693600,682040,2662,5000,3118,3852,6190,31.016124838541646,15.415592261291158,2338,1,497960,29868,962,0,780,1928
5248,0,0,1,0,57,1,1161,0,0,2048500,6134875,46.09772228646444,1907,3307,3089,2125,56635,695767,678445,2669,5012,3105,3851,6194,31.04834939252005,15.073166625245115,2343,1,499375,28994,964,0,762,1923
5249,0,0,0,0,56,1,1241,1,0,2289840,6420576,47.49736834815167,2148,3379,3271,2256,56619,663118,691578,2738,5102,2954,3861,6225,31.85906464414798,10.62681426149494,2364,1,548208,12204,1015,0,590,1831
5250,0,0,0,0,56,1,1243,1,0,2361044,6458686,47.738873049120045,2189,3405,3315,2279,56386,660322,685828,2744,5113,2924,3870,6239,32.18695387886216,9.613403705477898,2369,1,551518,10350,1036,0,555,1798
5251,0,0,1,0,58,1,847,0,0,3371988,6693200,48.041648597857254,2068,4009,3769,2308,54522,678600,675700,2660,5208,3140,4361,6909,38.22302970723278,15.500062938088007,2548,1,537764,32160,1461,0,592,1439
5252,1,0,0,0,47,0,170,1,0,37719,298450,11.269427669584644,60,491,424,127,28600,470000,336050,2283,2477,2417,2647,2841,17.233687939614086,8.544404542961196,194,1,18161,12797,297,0,2223,2053
5253,1,0,0,0,47,0,285,0,1,223236,830817,18.734993995195193,169,1169,987,351,46452,463932,560979,2185,2718,2549,3003,3536,25.219040425836983,13.810035044505925,533,1,83187,14924,636,0,2016,1731
5254,1,0,0,0,45,0,362,0,1,360368,1023570,21.118712081942874,416,1284,1254,446,49020,493425,523260,2265,2741,2325,3103,3579,28.42534080710379,5.5503012171862105,476,1,101688,3570,808,0,1849,1487
5255,1,0,0,0,49,0,343,0,1,321644,1906180,27.640549922170507,173,1776,1185,764,43524,583830,464070,1904,3259,3086,2916,4271,20.518284528683193,25.3862367260811,1355,1,142104,111108,421,0,1731,2074
5256,1,0,0,0,46,0,291,1,0,1275012,2975028,35.832945734337834,1042,2519,2277,1284,36639,410109,479619,2075,3601,2559,3310,4836,31.51190251317746,15.964973037642325,1526,1,265788,22748,993,0,1033,1324
5257,1,0,0,0,44,0,555,0,0,1606500,3535875,39.68626966596886,1575,2595,2595,1575,46800,505125,466960,2245,3820,2245,3265,4840,31.937438845342623,0.0,1575,0,327600,0,1020,0,670,1225
5258,1,0,0,0,44,0,686,0,0,500147,982574,21.047565179849187,443,1572,1572,443,51260,487960,516794,2218,2661,2218,3347,3790,33.60059523282288,0.0,443,1,103219,0,1129,0,1775,1089
5259,1,0,0,0,46,0,1377,1,0,280260,417060,13.416407864998739,211,2128,1737,180,35696,449498,426328,1926,2497,2708,3874,4445,39.45883931389772,20.153871394230936,571,1,33120,55913,1557,0,2137,760
5260,1,0,0,0,47,0,1550,0,1,647064,812592,18.49324200890693,126,2450,2234,342,51308,479952,603504,2160,2718,2592,4268,4826,43.497126341863094,15.959871257799303,558,1,86868,11448,1892,0,2034,484
5261,1,0,0,0,46,0,1526,0,1,728856,893116,19.544820285692065,212,2460,2290,382,45034,416164,591514,2168,2720,2508,4246,4798,43.68065933568311,13.990241258928085,552,1,96646,3060,1908,0,1956,430
5262,1,0,0,0,46,0,1484,0,1,762752,936876,20.09975124224178,254,2442,2292,404,47244,431334,589026,2169,2723,2469,4207,4761,43.45112196480086,13.002616415293671,554,1,102616,4500,1888,0,1915,431
5263,1,0,0,0,45,0,1356,0,1,855925,1065099,21.656407827707714,361,2402,2294,469,51816,463284,576834,2163,2740,2379,4096,4673,42.720018726587654,10.83458558167471,577,1,119126,6588,1825,0,1802,446
5264,1,0,0,0,44,0,1133,0,1,1021200,1319568,24.331050121192877,562,2347,2317,592,55890,512670,541647,2199,2821,2259,3954,4576,41.53311931459037,5.572104574801163,622,1,143856,3360,1725,0,1637,504
5265,1,0,0,0,44,0,1088,0,1,1054308,1371960,24.859605789312106,588,2354,2324,618,53192,483960,541680,2190,2838,2250,3926,4574,41.30375285612676,5.5965095842615735,648,1,150792,3000,1706,0,1602,514
5266,1,0,0,0,48,0,531,1,0,1182790,2058140,29.223278392404914,679,2414,2239,854,28152,491640,332580,2235,3264,2585,3795,4824,37.21558813185679,13.232642477343864,1029,1,117852,35175,1385,0,1556,1025
5267,1,0,0,0,48,0,475,0,1,1205846,2145006,29.765752132274432,796,2337,2247,886,48108,510831,551988,2331,3307,2511,3782,4758,36.89173349139343,9.808573176892017,976,1,202008,10170,1361,0,1535,1060
5268,1,0,0,0,48,0,364,0,1,1141932,2192762,30.033314835362415,872,2198,2168,902,53280,539682,583440,2401,3333,2461,3697,4629,35.58089374931439,5.5503012171862105,932,1,216480,3300,1266,0,1529,1165
5269,1,0,0,0,48,0,342,0,1,1117800,2181600,30.0,900,2142,2142,900,52140,533280,574488,2424,3324,2424,3666,4566,35.24202037341219,0.0,900,1,213300,0,1242,0,1524,1182
5270,1,0,0,0,48,0,48,0,1,911449,2260468,30.512292604784715,797,2044,1910,931,53410,529304,594860,2294,3359,2562,3407,4472,31.28897569432403,11.850228582282101,1065,1,228095,12998,979,0,1497,1449
5271,1,0,0,0,48,0,7,0,1,893958,2288039,30.805843601498726,864,1976,1891,949,52290,506310,600339,2326,3360,2496,3353,4387,30.692018506445613,9.412769291411893,1034,1,236301,6800,942,0,1462,1469
5272,1,0,0,0,47,0,118,0,0,868875,2357382,31.51190251317746,993,1868,1868,993,51075,534150,538898,2374,3367,2374,3249,4242,29.58039891549808,0.0,993,0,225411,0,875,0,1381,1499
5273,1,0,0,0,47,0,146,0,0,865160,2389250,31.71750305430741,976,1896,1866,1006,44200,524875,475000,2345,3381,2405,3235,4271,29.32575659723036,5.477225575051661,1036,0,201200,4800,860,0,1369,1515
5274,1,0,0,0,48,0,480,0,1,924481,3004871,35.08560958569767,896,2317,1982,1231,53124,568753,556548,2106,3672,2776,3192,4758,27.40437921208944,18.66037799535698,1566,1,280668,46565,751,0,1210,1690
5275,1,0,0,0,48,0,514,0,1,923976,3048620,35.38361202590826,891,2351,1990,1252,52440,560050,555180,2074,3687,2796,3173,4786,27.16615541441225,19.282351796343526,1613,1,285456,49096,738,0,1183,1697
5276,1,0,0,0,48,0,562,0,1,905103,3097209,35.679125549822544,891,2366,1984,1273,47250,547425,510930,2051,3706,2815,3144,4799,26.664583251946766,19.782380062471447,1655,1,267330,58446,711,0,1160,1722
5277,1,0,0,0,45,0,1154,0,1,528255,3387755,38.79432948254165,1475,1886,1856,1505,51957,465957,565001,2221,3756,2281,2602,4137,18.734993995195193,5.652706486041966,1535,1,377755,2160,351,0,746,1900
5278,1,0,0,0,44,0,1165,0,1,515394,3375680,38.82009788756334,1507,1849,1849,1507,50851,472640,539840,2240,3747,2240,2582,4089,18.49324200890693,0.0,1507,1,363187,0,342,0,733,1898
5279,1,0,0,0,44,0,1176,0,1,506185,3374063,38.87158345115362,1511,1846,1846,1511,45920,457765,500192,2233,3744,2233,2568,4079,18.303005217723125,0.0,1511,1,338464,0,335,0,722,1898
5280,1,0,0,0,45,0,1193,1,0,524970,3459890,39.179076048319466,1427,1985,1877,1535,38817,511658,385434,2146,3789,2362,2596,4239,18.49324200890693,10.8528199128497,1643,1,262485,21168,342,0,719,1912
5281,1,0,0,0,44,0,1064,0,1,673460,3374850,38.8587184554509,1443,2023,1956,1510,55575,502875,552045,2168,3745,2302,2681,4258,21.118712081942874,8.499160266369426,1577,1,372970,6164,446,0,725,1789
5282,1,0,0,0,44,0,969,0,1,756280,3267840,38.47076812334269,1450,2021,1991,1480,53172,465888,556416,2178,3688,2238,2719,4229,22.60530911091463,5.753771868478424,1510,1,372960,2220,511,0,728,1697
5283,1,0,0,0,43,0,937,0,1,785514,3227374,38.353617821530214,1471,2005,2005,1471,51695,462934,537530,2194,3665,2194,2728,4199,23.108440016582687,0.0,1471,1,360395,0,534,0,723,1660
5284,1,0,0,0,46,0,69,0,1,1288170,2713230,34.20526275297414,1080,2361,2271,1170,52416,482352,584388,2229,3489,2409,3420,4680,33.18132004607411,9.845454104733873,1260,1,294840,6300,1101,0,1149,1218
5285,1,0,0,0,47,0,194,0,1,846216,1968984,28.77498913987632,515,2163,1850,828,40443,525538,435174,2065,3206,2691,3400,4541,31.96873472629156,18.196393693986554,1141,1,151524,55401,1022,0,1550,1356
5286,1,0,0,0,45,0,63,1,0,296578,1309213,24.020824298928627,443,1225,1091,577,25760,363040,365309,2135,2846,2403,2783,3494,22.67156809750927,11.837739672445862,711,1,92897,16214,514,0,1692,1755
5287,0,1,0,1,65,0,209,0,0,14326662,12003320,60.67948582511226,3532,7723,7573,3682,51736,726980,756320,3110,6942,3410,7151,10983,62.37788069500277,12.254111330655777,3832,1,854224,18300,3891,0,422,631
5288,0,1,0,1,64,0,1110,0,0,1774224,2880672,29.79932885150268,288,3486,2886,888,37449,554724,710436,2644,4132,3844,5242,6730,44.69899327725402,24.518151455742924,1488,1,194472,42600,1998,0,2356,1246
5289,0,1,0,1,64,0,1079,0,0,1766730,2890850,29.916550603303182,271,3493,2869,895,37840,555560,710600,2606,4125,3854,5204,6723,44.429719783046124,24.988472028803724,1519,1,196900,43680,1974,0,2335,1256
5290,0,0,1,0,57,1,1204,0,0,1990752,6158088,46.216880033165374,1935,3269,3068,2136,56643,689037,683271,2682,5019,3084,3815,6152,30.528675044947494,14.426620007868419,2337,1,506232,25929,932,0,747,1951
5291,0,0,1,0,57,1,1228,0,0,2031708,6229416,46.54030511288038,1984,3286,3104,2166,56882,687364,684488,2694,5042,3058,3814,6162,30.62678566222711,13.76807963665223,2348,1,515508,22568,938,0,710,1938
5292,0,0,0,0,57,1,1240,1,0,2055444,6266704,46.71188285650665,2007,3299,3124,2182,56640,677792,689280,2697,5054,3047,3814,6171,30.692018506445613,13.480748117239651,2357,1,523680,20475,942,0,690,1930
5293,0,0,1,0,56,1,1233,0,0,3269938,7136248,50.269274910227224,2497,3851,3821,2527,39160,621280,502672,2794,5351,2854,4118,6675,35.9722114972099,5.483301264452448,2557,1,449806,5430,1294,0,297,1530
5294,1,0,0,0,45,0,392,0,1,345984,974776,20.591260281974,424,1240,1240,424,48837,503481,512677,2299,2723,2299,3115,3539,28.5657137141714,0.0,424,1,94552,0,816,0,1875,1483
5295,1,0,0,0,44,0,506,0,0,1633800,3496332,39.44616584663204,1556,2606,2606,1556,52628,530292,501081,2247,3803,2247,3297,4853,32.4037034920393,0.0,1556,0,346988,0,1050,0,691,1197
5296,1,0,0,0,46,0,747,0,1,1570054,3903282,41.0,1591,2705,2615,1681,52668,585144,485298,2232,4003,2412,3256,5027,30.56141357987225,10.50882969403483,1771,1,351329,15120,934,0,641,1388
5297,1,0,0,0,46,0,738,0,1,1509928,3840900,40.64480286580315,1562,2656,2566,1652,51500,581250,478950,2235,3977,2415,3239,4981,30.23243291566195,10.564395459581663,1742,1,340312,14760,914,0,673,1411
5298,1,0,0,0,47,0,672,0,1,1195840,3510560,38.47076812334269,1288,2480,2288,1480,34545,557420,348684,2180,3852,2564,3180,4852,28.42534080710379,14.9090275950914,1672,1,217560,43008,808,0,892,1564
5299,1,0,0,0,49,0,214,0,1,660951,2315646,30.44667469527666,414,2153,1640,927,56635,587030,602018,1985,3425,3011,3211,4651,26.70205984563738,23.843270311263915,1440,1,223407,60021,713,0,1571,1785
5300,1,0,0,0,47,0,1503,1,0,293650,413700,13.228756555322953,255,2283,1853,175,34398,553176,347508,1934,2539,2794,4042,4647,40.963398296528084,21.148191821297242,605,1,25725,95890,1678,0,2189,686
5301,1,0,0,0,47,0,1561,0,1,521852,676087,16.822603841260722,27,2383,2127,283,55552,535136,592472,2133,2672,2645,4233,4772,42.941821107167776,17.196003990823552,539,1,70184,23552,1844,0,2106,545
5302,1,0,0,0,47,0,1555,0,1,556500,714000,17.320508075688775,72,2383,2155,300,53424,504560,599760,2152,2680,2608,4235,4763,43.069710934716056,16.34105140025627,528,1,75600,15732,1855,0,2080,525
5303,1,0,0,0,47,0,1544,0,1,594297,754435,17.86057109949175,118,2383,2182,319,49841,465905,598345,2164,2684,2566,4228,4748,43.162483709814474,15.367873887452573,520,1,80707,8844,1863,0,2046,502
5304,1,0,0,0,46,0,1532,0,1,634269,795633,18.411952639521967,164,2385,2210,339,47058,436542,593791,2172,2686,2522,4218,4732,43.255057507764334,14.303831968839111,514,1,85767,4725,1871,0,2008,476
5305,1,0,0,0,46,0,1518,0,1,678319,840408,19.0,211,2390,2240,361,46299,426024,588984,2178,2689,2478,4207,4718,43.347433603386484,13.168301036937951,511,1,91333,3600,1879,0,1967,449
5306,1,0,0,0,46,0,1506,0,1,721216,882420,19.544820285692065,255,2397,2270,382,48260,438900,586740,2183,2692,2437,4198,4707,43.45112196480086,12.022218309728785,509,1,97028,4318,1888,0,1928,422
5307,1,0,0,0,45,0,1484,0,1,762752,926776,20.09975124224178,296,2400,2292,404,49530,447330,582676,2186,2698,2402,4182,4694,43.45112196480086,10.96830808063325,512,1,102616,4536,1888,0,1890,406
5308,1,0,0,0,45,0,1441,0,1,795342,970428,20.639767440550294,331,2388,2293,426,51308,460156,578612,2183,2704,2373,4145,4666,43.2087954009366,10.097077230934874,521,1,108204,5225,1867,0,1852,411
5309,1,0,0,0,45,0,1352,0,1,865524,1067922,21.77154105707724,407,2367,2300,474,53130,473130,570009,2186,2727,2320,4079,4620,42.731721238442994,8.521468497772455,541,1,119922,4690,1826,0,1779,427
5310,1,0,0,0,44,0,1307,0,1,901194,1118259,22.338307903688676,457,2347,2305,499,54180,481815,564732,2199,2740,2283,4047,4588,42.49705872175156,6.7040592262067955,541,1,125748,3234,1806,0,1742,435
5311,1,0,0,0,44,0,1261,0,1,937650,1170750,22.9128784747792,495,2341,2311,525,56088,508440,548580,2200,2755,2260,4016,4571,42.261093218230876,5.514871952411144,555,1,129150,3120,1786,0,1705,444
5312,1,0,0,0,48,0,228,0,1,965125,2142000,29.58039891549808,713,2140,1978,875,47040,587520,479808,2286,3323,2610,3551,4588,33.21144381083123,12.946415163759095,1037,1,171500,29646,1103,0,1573,1345
5313,1,0,0,0,47,0,37,0,1,872948,2269093,30.870698080866262,953,1869,1869,953,52416,533344,557154,2381,3334,2381,3297,4250,30.265491900843113,0.0,953,1,223002,0,916,0,1428,1465
5314,1,0,0,0,45,0,1100,1,0,632589,3414767,38.948684188300895,1409,2042,1934,1517,55552,504224,558248,2143,3768,2359,2668,4293,20.42057785666214,10.715687343984417,1625,1,376216,10476,417,0,734,1834
5315,1,0,0,0,45,0,596,1,0,1068972,3140964,37.067505985701274,1173,2353,2152,1374,37835,537210,368046,2085,3660,2487,3064,4639,27.892651361962706,15.316994326686412,1575,1,221214,42612,778,0,912,1508
5316,1,0,0,0,46,0,272,1,0,1559040,2615200,33.46640106136302,938,2694,2512,1120,39444,532380,403955,2153,3455,2517,3727,5029,37.30951621235526,14.016733822252778,1302,1,193760,35490,1392,0,1215,943
5317,1,0,0,0,47,0,180,0,1,913500,2071470,29.49576240750525,519,2271,1920,870,35870,502391,404770,2030,3251,2732,3431,4652,32.4037034920393,19.18679567029442,1221,1,147900,62478,1050,0,1511,1331
5318,1,0,0,0,45,0,113,1,0,254364,1286484,23.748684174075834,372,1207,1015,564,26607,335307,412861,2089,2845,2473,2732,3488,21.236760581595302,14.26023739270955,756,1,102084,15744,451,0,1717,1830
5319,1,0,0,0,47,0,180,1,0,55404,384750,12.727922061357855,54,612,504,162,28560,484500,332500,2267,2537,2483,2717,2987,18.49324200890693,10.96830808063325,270,1,22680,21384,342,0,2213,2033
5320,1,0,0,0,48,0,47,1,0,86768,779317,17.86057109949175,63,847,591,319,34170,491043,415310,2187,2762,2699,2715,3290,16.492422502470642,16.83995851132013,575,1,54230,42496,272,0,2124,2171
5321,1,0,0,0,48,0,95,0,1,124836,750870,17.578395831246947,10,1032,713,309,51493,537030,566190,2111,2739,2749,2834,3462,20.09975124224178,18.10879194843846,628,1,71997,38280,404,0,2121,2026
5322,1,0,0,0,48,0,131,0,1,125670,715375,17.175564037317667,5,1021,721,295,51714,535925,567450,2125,2720,2725,2851,3446,20.639767440550294,17.558109344587677,595,1,69030,35400,426,0,2130,1999
5323,1,0,0,0,46,0,421,0,1,333300,930008,20.09975124224178,404,1229,1229,404,48618,511044,504138,2302,2706,2302,3127,3531,28.722813232690143,0.0,404,1,88476,0,825,0,1898,1477
5324,1,0,0,0,48,0,14,1,0,295887,1300614,23.173260452512935,214,1411,1088,537,26467,481978,322126,2099,2959,2745,2973,3833,23.473389188611005,18.997411630334586,860,1,71421,64277,551,0,1885,1871
5325,1,0,0,0,48,0,295,1,0,860904,2650106,32.96968304366907,781,2185,1879,1087,47736,497352,570492,2132,3525,2744,3230,4623,28.142494558940577,17.599483741842185,1393,1,254358,29376,792,0,1351,1646
5326,1,0,0,0,46,0,224,1,0,1210692,2854992,34.899856733230294,923,2507,2212,1218,39639,424264,513336,2049,3562,2639,3338,4851,31.52776554086889,17.733957346589627,1513,1,266742,25370,994,0,1126,1350
5327,1,0,0,0,44,0,457,0,0,1659960,3449028,39.20459156782532,1537,2617,2617,1537,48399,495924,491436,2244,3781,2244,3324,4861,32.863353450309965,0.0,1537,0,336603,0,1080,0,707,1164
5328,1,0,0,0,47,0,689,0,0,1150322,3499509,38.353617821530214,1301,2423,2253,1471,32844,566202,328302,2209,3850,2549,3161,4802,27.964262908219126,14.287402165123776,1641,1,202998,39440,782,0,908,1597
5329,1,0,0,0,48,0,647,1,0,1022130,3329540,37.21558813185679,1143,2365,2123,1385,46320,576960,463972,2162,3789,2646,3142,4769,27.16615541441225,16.690779620400967,1627,1,267305,45012,738,0,1019,1666
5330,1,0,0,0,49,0,493,1,0,771894,2854617,34.044089061098404,735,2249,1825,1159,31800,522156,369450,2039,3622,2887,3129,4712,25.80697580112788,21.5837767977639,1583,1,173850,83952,666,0,1304,1797
5331,1,0,0,0,49,0,387,1,0,692728,2600088,32.37282811247729,532,2225,1709,1048,48090,568149,521010,1965,3529,2997,3142,4706,25.709920264364882,23.610882368071564,1564,1,220080,81012,661,0,1433,1820
5332,1,0,0,0,44,0,576,0,0,455812,996364,21.118712081942874,446,1468,1468,446,56165,533926,524990,2234,2680,2234,3256,3702,31.96873472629156,0.0,446,0,104810,0,1022,0,1788,1212
5333,1,0,0,0,47,0,1561,0,1,469302,613782,16.06237840420901,11,2324,2077,258,55328,532896,587613,2132,2637,2626,4198,4703,42.649736224272246,16.820713082702085,505,1,63726,22230,1819,0,2121,560
5334,1,0,0,0,47,0,1537,0,1,544698,699138,17.233687939614086,107,2321,2131,297,49588,461384,595562,2164,2651,2544,4188,4675,42.82522621072771,14.86819892722909,487,1,75141,7980,1834,0,2057,520
5335,1,0,0,0,46,0,1523,0,1,587598,745503,17.86057109949175,157,2323,2161,319,47564,439356,591261,2175,2656,2499,4179,4660,42.91852746774987,13.722545606326204,481,1,80707,4860,1842,0,2018,495
5336,1,0,0,0,46,0,1512,0,1,627489,785802,18.411952639521967,205,2324,2190,339,46990,428830,588772,2184,2657,2452,4169,4642,43.02324952859791,12.431722618206066,473,1,86106,3618,1851,0,1979,467
5337,1,0,0,0,45,0,1499,0,1,671460,829939,19.0,253,2329,2221,361,48514,439109,583946,2191,2660,2407,4159,4628,43.12771730569565,11.07198010139901,469,1,91694,3780,1860,0,1938,439
5338,1,0,0,0,45,0,1485,0,1,717696,876672,19.595917942265423,299,2338,2253,384,50546,454317,579882,2198,2667,2368,4152,4621,43.23193264243457,9.737059976664934,469,1,97536,3995,1869,0,1899,414
5339,1,0,0,0,45,0,1471,0,1,766632,925752,20.199009876724155,341,2354,2287,408,52624,471952,574057,2202,2677,2336,4148,4623,43.347433603386484,8.521468497772455,475,1,103224,4154,1879,0,1861,390
5340,1,0,0,0,45,0,1436,0,1,809277,977714,20.808652046684813,373,2362,2302,433,53676,480954,569016,2198,2691,2318,4127,4620,43.23193264243457,7.896951773353783,493,1,109116,4380,1869,0,1825,389
5341,1,0,0,0,44,0,1299,0,1,922590,1134750,22.58317958127243,510,2319,2319,510,54056,516200,518425,2225,2735,2225,4034,4544,42.532340636273474,0.0,510,1,118830,0,1809,0,1715,416
5342,1,0,0,0,44,0,1253,0,1,961230,1193751,23.173260452512935,537,2327,2327,537,49720,502398,489060,2223,2760,2223,4013,4550,42.30839160261236,0.0,537,1,118140,0,1790,0,1686,433
5343,1,0,0,0,48,0,733,1,0,1134680,1825520,27.568097504180443,477,2536,2253,760,28282,379516,429958,2119,3162,2685,3895,4938,38.63935817272331,16.82785260599149,1043,1,136040,28300,1493,0,1642,909
5344,1,0,0,0,47,0,43,0,1,874698,2180804,30.23243291566195,914,1871,1871,914,50718,510604,565482,2386,3300,2386,3343,4257,30.93541659651604,0.0,914,1,216618,0,957,0,1472,1429
5345,1,0,0,0,48,0,257,1,0,902210,2649019,32.96968304366907,832,2172,1917,1087,38664,526392,436223,2182,3524,2692,3267,4609,28.809720581775867,16.253319647167952,1342,1,194573,44625,830,0,1350,1607
5346,1,0,0,0,48,0,489,0,1,911430,3006120,35.07135583350036,864,2337,1971,1230,45342,559676,483912,2078,3674,2810,3185,4781,27.2213151776324,20.10971882685018,1596,1,243540,62220,741,0,1214,1703
5347,1,0,0,0,44,0,1037,0,0,589560,3235355,38.01315561749642,1445,1853,1853,1445,54050,514970,526165,2239,3684,2239,2647,4092,20.199009876724155,0.0,1445,0,339575,0,408,0,794,1831
5348,1,0,0,0,44,0,1048,0,0,579200,3243520,38.05259518088089,1418,1878,1848,1448,47124,517440,456960,2210,3688,2270,2640,4118,20.0,5.531194905403055,1478,0,295392,5010,400,0,792,1840
5349,1,0,0,0,43,0,871,0,0,785496,3126331,37.72267222772003,1423,1975,1975,1423,46631,485537,463567,2197,3620,2197,2749,4172,23.49468024894146,0.0,1423,0,300253,0,552,0,774,1645
5350,1,0,0,0,46,0,476,1,0,1175456,3121968,36.71511950137164,1053,2515,2220,1348,38212,539628,379824,2021,3664,2611,3188,4831,29.5296461204668,18.191910698644556,1643,1,221072,61360,872,0,968,1444
5351,1,0,0,0,46,0,267,1,0,1285200,2983500,35.70714214271425,1065,2493,2283,1275,45696,524160,477360,2130,3615,2550,3348,4833,31.74901573277509,14.751211939005659,1485,1,260100,33180,1008,0,1065,1332
5352,1,0,0,0,45,0,10,1,0,1439975,2728185,34.56877203488721,1195,2400,2400,1195,44520,483996,479430,2283,3478,2283,3488,4683,34.713109915419565,0.0,1195,1,250950,0,1205,0,1088,1078
5353,1,0,0,0,46,0,118,1,0,1511880,2701460,34.23448553724738,1087,2547,2462,1172,31524,511710,327310,2220,3477,2390,3595,4852,35.91656999213594,9.412769291411893,1257,1,166424,18360,1290,0,1133,1015
5354,1,0,0,0,47,0,185,1,0,1088700,2277675,30.903074280724887,509,2541,2095,955,34626,474615,414990,1939,3340,2831,3525,4926,33.76388603226827,21.461306299797045,1401,1,166170,71360,1140,0,1430,1245
5355,1,0,0,0,46,0,34,1,0,418320,1532512,25.768197453450252,511,1447,1294,664,26376,362356,387744,2155,2972,2461,2938,3755,25.099800796022265,12.555809127227581,817,1,111552,16830,630,0,1644,1678
5356,1,0,0,0,45,0,127,1,0,259650,1326523,24.020824298928627,361,1243,1027,577,25986,326458,420717,2083,2876,2515,2749,3542,21.213203435596427,15.07878453091895,793,1,105591,15552,450,0,1722,1849
5357,0,1,1,0,59,0,1786,0,0,4464987,4165173,37.429934544425805,1167,4822,4588,1401,41449,680817,538113,2739,4374,3207,6160,7795,56.45352070508977,15.430515836556204,1635,0,253581,43992,3187,1,1572,214
5358,0,0,1,0,58,1,1368,0,0,854644,5369952,42.82522621072771,1804,2330,2300,1834,54502,696864,670512,2898,4762,2958,3394,5258,21.587033144922902,5.477225575051661,1864,1,419986,4290,466,0,1094,2462
5359,0,0,1,0,58,1,866,0,0,3599427,7003776,48.774993593028796,2019,4252,3892,2379,42355,579968,632960,2584,5323,3304,4457,7196,38.897300677553446,19.083426178037392,2739,1,511485,40320,1513,0,565,1431
5360,1,0,0,0,47,0,403,0,1,179828,636232,16.3707055437449,141,1066,939,268,46436,446312,586378,2247,2642,2501,3045,3440,25.903667693977237,11.66725943004119,395,1,66196,6858,671,0,2106,1703
5361,1,0,0,0,46,0,452,0,1,321024,885504,19.595917942265423,384,1220,1220,384,47912,521156,488872,2306,2690,2306,3142,3526,28.91366458960192,0.0,384,1,81408,0,836,0,1922,1470
5362,1,0,0,0,45,0,492,0,0,1681884,3534462,39.57271787481876,1566,2640,2640,1566,50290,530395,482998,2257,3823,2257,3331,4897,32.77193921634788,0.0,1566,0,335124,0,1074,0,691,1183
5363,1,0,0,0,49,0,244,0,1,588845,2223227,29.9833287011299,404,2049,1554,899,56608,573736,603412,1978,3372,2968,3128,4522,25.592967784139454,23.274174079841927,1394,1,219356,53955,655,0,1574,1818
5364,1,0,0,0,44,0,490,0,0,446919,1041410,21.61018278497431,467,1424,1424,467,54273,510670,528510,2230,2697,2230,3187,3654,30.93541659651604,0.0,467,1,110679,0,957,0,1763,1273
5365,1,0,0,0,44,0,533,0,0,436634,993688,21.118712081942874,446,1425,1425,446,48410,523580,458968,2228,2674,2228,3207,3653,31.28897569432403,0.0,446,0,91876,0,979,0,1782,1249
5366,1,0,0,0,44,0,622,1,0,414504,904556,20.09975124224178,374,1460,1430,404,29414,427649,344806,2209,2643,2269,3265,3699,32.03123475609393,5.514871952411144,434,1,62216,5100,1026,0,1835,1213
5367,1,0,0,0,47,0,1282,0,1,178943,299720,11.269427669584644,168,1831,1536,127,50589,516840,545160,2065,2487,2655,3769,4191,37.53664875824692,18.22953961474712,422,1,29337,35400,1409,0,2233,951
5368,1,0,0,0,47,0,1542,0,1,458235,601290,15.968719422671311,43,2264,2052,255,52668,492822,594216,2146,2613,2570,4155,4622,42.391036788453285,15.560929278697389,467,1,64260,13144,1797,0,2103,561
5369,1,0,0,0,46,0,1528,0,1,499985,649011,16.64331697709324,95,2264,2082,277,49588,459228,592779,2161,2620,2525,4148,4607,42.485291572496,14.444156265082537,459,1,70081,7644,1805,0,2066,538
5370,1,0,0,0,46,0,1503,0,1,581218,736252,17.86057109949175,195,2265,2141,319,47752,433904,586232,2184,2627,2432,4130,4573,42.68489194082609,11.871952282220144,443,1,81026,4092,1822,0,1989,486
5371,1,0,0,0,45,0,1475,0,1,673806,832284,19.131126469708992,299,2274,2207,366,50038,447978,577596,2207,2640,2341,4115,4548,42.906875905849866,8.642106768569302,433,1,92964,3216,1841,0,1908,433
5372,1,0,0,0,45,0,1460,0,1,723741,883660,19.77371993328519,349,2284,2242,391,52371,467820,571780,2218,2651,2302,4111,4544,43.02324952859791,6.78953034358522,433,1,98923,2688,1851,0,1869,409
5373,1,0,0,0,44,0,1382,0,1,870440,1047160,21.6794833886788,470,2322,2322,470,53118,505756,521352,2228,2698,2228,4080,4550,43.034869582700026,0.0,470,1,109980,0,1852,0,1758,376
5374,1,0,0,0,44,0,1104,1,0,1106640,1424004,25.219040425836983,569,2443,2376,636,32916,472429,349284,2172,2875,2306,3979,4682,41.71330722922842,8.345174736691893,703,1,99216,12864,1740,0,1603,499
5375,1,0,0,0,48,0,863,1,0,1139760,1739520,26.832815729997478,411,2612,2303,720,26260,488032,314080,2107,3136,2725,3999,5028,39.786932528155525,19.431531788435954,1029,1,93600,63345,1583,0,1696,833
5376,1,0,0,0,49,0,307,0,1,922194,2007369,28.61817604250837,629,2135,1945,819,52670,561279,563730,2261,3270,2641,3577,4586,33.555923471125034,13.886846184065407,1009,1,188370,25080,1126,0,1632,1325
5377,1,0,0,0,45,0,954,0,1,644827,3181805,37.5632799419859,1411,1868,1868,1411,55000,496100,563750,2255,3666,2255,2712,4123,21.37755832643195,0.0,1411,1,352750,0,457,0,844,1798
5378,1,0,0,0,44,0,978,0,0,618355,3175260,37.61648574760805,1385,1882,1852,1415,45046,500412,453288,2214,3659,2274,2681,4126,20.904544960366874,5.531194905403055,1445,0,285830,4770,437,0,829,1807
5379,1,0,0,0,44,0,910,0,1,735816,3154312,37.76241517699841,1426,1942,1942,1426,54014,499912,528668,2212,3638,2212,2728,4154,22.715633383201094,0.0,1426,1,340814,0,516,0,786,1696
5380,1,0,0,0,44,0,852,0,0,776965,3100835,37.48332962798263,1375,1988,1958,1405,43050,463470,452435,2177,3612,2237,2760,4195,23.515952032609693,5.477225575051661,1435,0,288025,4200,553,0,802,1654
5381,1,0,0,0,44,0,700,1,0,899621,3029586,36.89173349139343,1266,2117,2022,1361,35525,451878,389550,2131,3587,2321,2887,4343,25.709920264364882,10.012227554748348,1456,1,238175,15485,661,0,865,1565
5382,1,0,0,0,45,0,550,1,0,1041624,3027636,36.49657518178932,1120,2326,2114,1332,34717,529609,338677,2061,3605,2485,3055,4599,27.964262908219126,15.29629022168207,1544,1,198468,46852,782,0,941,1491
5383,1,0,0,0,45,0,9,1,0,1487160,2805408,34.9857113690718,1224,2439,2439,1224,42436,472152,472152,2292,3516,2292,3507,4731,34.85685011586675,0.0,1224,1,252144,0,1215,0,1068,1077
5384,1,0,0,0,47,0,210,1,0,1465200,2629590,33.31666249791537,825,2715,2430,1110,32437,471431,386147,2084,3479,2654,3689,5084,36.3318042491699,17.0844991841999,1395,1,180930,48450,1320,0,1259,1049
5385,1,0,0,0,46,0,106,1,0,386567,1572671,26.019223662515376,476,1449,1248,677,26219,387941,364711,2122,3000,2524,2894,3772,23.895606290697042,14.417702721914399,878,1,106289,27336,571,0,1646,1752
5386,0,1,0,1,65,0,297,0,0,15679354,13537523,64.11708040764177,4069,7967,7925,4111,48697,767269,688237,3251,7404,3335,7107,11260,61.75759062657804,6.488991180673202,4153,1,859199,6846,3814,0,818,521
5387,0,1,0,1,65,0,258,0,0,15609568,13446108,63.89053137985315,4022,7966,7906,4082,48760,757620,698328,3234,7376,3354,7118,11260,61.83849933496123,7.759379671981613,4142,1,865384,9360,3824,0,788,530
5388,0,1,0,1,65,0,18,0,0,15194323,12838402,62.505999712027645,3783,7920,7796,3907,51480,768924,722920,3162,7193,3410,7175,11206,62.36184731067546,11.140052311785754,4031,1,859540,18600,3889,0,621,603
5389,0,1,0,1,65,0,1237,0,0,2109120,3149760,30.983866769659336,558,3559,3157,960,47520,708696,721820,2879,4241,3683,5478,6840,46.87216658103186,20.291233021204096,1362,1,211200,52260,2197,0,2321,1084
5390,0,0,1,0,59,1,1138,0,0,755760,4762896,40.099875311526844,1513,2173,2078,1608,56643,707918,701994,2867,4570,3057,3432,5135,21.6794833886788,9.886585106410566,1703,1,381096,12160,470,0,1354,2492
5391,0,0,0,0,57,1,1373,1,0,1865030,6339330,47.06378650300037,2088,3184,3057,2215,56105,655398,701190,2735,5077,2989,3704,6046,29.017236257093817,11.45501536000853,2342,1,542675,13716,842,0,647,2020
5392,0,0,1,0,56,1,1416,0,0,2789332,7117084,50.21951811795888,2414,3736,3628,2522,41610,618018,536180,2714,5344,2930,3928,6558,33.25657829663178,10.471798365004291,2630,1,479180,18036,1106,0,300,1716
5393,1,0,0,0,46,0,477,0,1,280098,790020,18.49324200890693,342,1161,1161,342,50624,517440,522060,2310,2652,2310,3129,3471,28.61817604250837,0.0,342,1,77292,0,819,0,1968,1491
5394,1,0,0,0,46,0,484,1,0,342125,905165,19.77371993328519,361,1296,1266,391,38454,511615,402810,2285,2706,2345,3190,3611,29.58039891549808,5.5965095842615735,421,1,68034,5580,875,0,1924,1440
5395,1,0,0,0,47,0,130,1,0,1355331,2927318,35.08560958569767,976,2587,2332,1231,29760,456576,368590,2123,3609,2633,3479,4965,33.18132004607411,16.865082595929092,1486,1,190805,43350,1101,0,1147,1277
5396,1,0,0,0,46,0,285,0,1,1634776,3299561,37.8021163428716,1321,2681,2573,1429,38553,417929,491817,2201,3738,2417,3453,4990,33.823069050575526,11.159351262885526,1537,1,304377,9936,1144,0,880,1165
5397,1,0,0,0,46,0,310,1,0,1658184,3341052,38.1051177665153,1367,2679,2594,1452,28650,345150,439491,2216,3753,2386,3443,4980,33.793490497431605,10.11645006986175,1537,1,277332,6205,1142,0,849,1159
5398,1,0,0,0,45,0,688,0,0,1582080,3716240,40.59556626036888,1648,2608,2608,1648,45590,529925,437470,2255,3903,2255,3215,4863,30.983866769659336,0.0,1648,0,319712,0,960,0,607,1295
5399,1,0,0,0,47,0,710,0,0,1021016,3381046,37.76241517699841,1264,2304,2142,1426,38936,588008,372247,2209,3797,2533,3087,4675,26.758176320519304,13.894308421737083,1588,1,223882,33858,716,0,945,1655
5400,1,0,0,0,49,0,555,1,0,714204,2877822,34.161381705077446,806,2140,1779,1167,41888,586908,434016,2105,3633,2827,3078,4606,24.73863375370596,20.267611964116938,1528,1,205392,72922,612,0,1299,1854
5401,1,0,0,0,46,0,1534,0,1,413712,549432,15.297058540778355,24,2212,2002,234,53172,495428,591696,2138,2582,2558,4116,4560,42.04759208325728,15.35214491697784,444,1,58968,13860,1768,0,2114,580
5402,1,0,0,0,46,0,1507,0,1,494168,641532,16.64331697709324,127,2211,2061,277,49530,451620,588264,2166,2593,2466,4100,4527,42.23742416388575,12.950100320556757,427,1,70358,6300,1784,0,2039,532
5403,1,0,0,0,46,0,1493,0,1,537900,690300,17.320508075688775,180,2213,2093,300,49276,446394,584454,2181,2601,2421,4094,4514,42.34383071948026,11.58292185288269,420,1,76200,5040,1793,0,2001,508
5404,1,0,0,0,45,0,1478,0,1,583848,740340,18.0,234,2216,2126,324,49276,443290,580390,2195,2609,2375,4087,4501,42.44997055358225,10.008987875452021,414,1,82296,3960,1802,0,1961,483
5405,1,0,0,0,45,0,1462,0,1,634200,794150,18.708286933869708,290,2222,2162,350,49784,444724,576326,2209,2619,2329,4081,4491,42.567593307585526,8.137062211202972,410,1,88900,2940,1812,0,1919,457
5406,1,0,0,0,45,0,1446,0,1,685072,847128,19.390719429665317,346,2228,2198,376,51612,459612,570009,2223,2629,2283,4075,4481,42.68489194082609,5.684275577662207,406,1,95128,1890,1822,0,1877,431
5407,1,0,0,0,44,0,1431,0,1,736866,900882,20.049937655763422,402,2235,2235,402,53784,484056,558009,2241,2643,2241,4074,4476,42.81354925721529,0.0,402,1,100098,0,1833,0,1839,408
5408,1,0,0,0,45,0,1139,1,0,1104890,1408500,25.019992006393608,531,2486,2391,626,28710,445500,326250,2155,2876,2345,4015,4736,42.01190307520001,9.96633033441658,721,1,90770,17765,1765,0,1624,485
5409,1,0,0,0,48,0,699,0,1,1149106,1879648,27.892651361962706,736,2297,2255,778,54612,536352,594336,2374,3194,2458,3893,4713,38.43175770115127,6.570697549716149,820,1,191388,4158,1477,0,1638,939
5410,1,0,0,0,48,0,559,0,1,1048662,1915118,27.964262908219126,722,2183,2123,782,37648,509392,443269,2389,3231,2509,3790,4632,36.61966684720111,7.896951773353783,842,1,141542,9840,1341,0,1667,1108
5411,1,0,0,0,47,0,177,0,1,867328,2024330,29.103264421710495,847,1871,1871,847,51513,552090,532970,2390,3237,2390,3414,4261,32.0,0.0,847,1,188881,0,1024,0,1543,1366
5412,1,0,0,0,47,0,149,0,0,865872,2054728,29.30870177950569,859,1867,1867,859,49504,535808,528632,2392,3251,2392,3400,4259,31.74901573277509,0.0,859,0,189839,0,1008,0,1533,1384
5413,1,0,0,0,47,0,93,1,0,867394,2119312,29.765752132274432,826,1925,1865,886,41132,540592,435344,2332,3278,2452,3371,4317,31.28897569432403,7.765259411425052,946,1,161252,10980,979,0,1506,1413
5414,1,0,0,0,48,0,101,1,0,904706,2449326,31.670175244226233,775,2133,1905,1003,38014,559218,405372,2214,3445,2670,3344,4575,30.033314835362415,15.44356399070129,1231,1,166498,46056,902,0,1439,1540
5415,1,0,0,0,49,0,153,0,1,924408,2552532,32.264531609803356,758,2212,1929,1041,47234,554152,512468,2169,3493,2735,3340,4664,29.79932885150268,17.206711988225443,1324,1,217569,43865,888,0,1411,1564
5416,1,0,0,0,44,0,885,0,1,740250,3128790,37.54996671103717,1410,1935,1935,1410,51273,468209,539217,2219,3629,2219,2744,4154,22.9128784747792,0.0,1410,1,342630,0,525,0,809,1694
5417,1,0,0,0,44,0,681,1,0,881062,2995343,36.59234892706397,1254,2082,1997,1339,33631,445163,378053,2152,3576,2322,2895,4319,25.65151067676132,9.649220942233358,1424,1,226291,14025,658,0,898,1579
5418,1,0,0,0,46,0,140,1,0,1464044,2985778,35.805027579936315,1192,2514,2424,1282,36624,391272,507722,2239,3611,2419,3471,4843,33.793490497431605,10.170822872186891,1372,1,279476,5940,1142,0,1047,1187
5419,1,0,0,0,45,0,27,1,0,1536178,2880647,35.397740040855716,1253,2479,2479,1253,44496,473594,496584,2299,3552,2299,3525,4778,35.014282800023196,0.0,1253,1,270648,0,1226,0,1046,1073
5420,1,0,0,0,45,0,9,1,0,1561230,2861010,35.2845575287547,1215,2529,2499,1245,47008,519348,477984,2268,3543,2328,3552,4827,35.41186241925155,5.531194905403055,1275,1,258960,4680,1254,0,1053,1044
5421,1,0,0,0,46,0,114,1,0,1637712,2839680,34.9857113690718,1157,2629,2562,1224,41912,575360,392080,2253,3544,2387,3658,4949,36.578682316343766,8.314029025396882,1291,1,206856,14405,1338,0,1096,982
5422,1,0,0,0,47,0,235,1,0,1737846,2844954,34.72751070837067,1044,2809,2647,1206,42120,552006,424620,2197,3565,2521,3800,5168,37.960505792204614,13.05562736842334,1368,1,217080,31428,1441,0,1153,918
5423,1,0,0,0,47,0,4,1,0,608396,1853196,27.892651361962706,560,1778,1560,778,38553,431142,507366,2164,3160,2600,3164,4160,27.964262908219126,15.655278323665375,996,1,165714,20056,782,0,1604,1600
5424,1,0,0,0,47,0,13,1,0,575280,1815345,27.65863337187866,553,1729,1517,765,36808,408156,507822,2161,3138,2585,3125,4102,27.422618401604176,15.352421280735559,977,1,163710,16536,752,0,1608,1621
5425,1,0,0,0,46,0,133,1,0,404538,1653452,26.570660511172846,478,1507,1279,706,26394,388772,372378,2114,3048,2570,2915,3849,23.93741840717165,15.46280395471841,934,1,112254,29868,573,0,1636,1769
5426,0,1,0,1,65,0,237,0,0,15750828,13481433,63.94528911499267,4004,8026,7941,4089,48300,758310,692370,3212,7386,3382,7149,11323,62.0644825967316,9.235136611923052,4174,1,858690,13515,3852,0,792,555
5427,0,0,1,0,57,1,1375,0,0,1775844,6305121,46.76537180435969,1995,3191,2999,2187,55912,668856,694803,2691,5070,3075,3695,6074,28.495613697550013,14.042896465990824,2379,1,527067,22656,812,0,696,2071
5428,0,0,1,0,57,1,1372,0,0,3674700,7872024,52.172789842982326,2637,4157,4072,2722,41907,662268,529236,2807,5614,2977,4242,7049,36.742346141747674,9.219863456115478,2807,1,498126,15810,1350,0,170,1542
5429,1,0,0,0,45,0,811,1,0,1467576,3803580,41.02438299353203,1653,2585,2555,1683,30176,415840,370640,2230,3943,2290,3132,4845,29.5296461204668,5.478746393072713,1713,1,276012,4530,872,0,577,1388
5430,1,0,0,0,45,0,803,1,0,1405050,3745698,40.65710270051225,1623,2533,2503,1653,30378,414678,376156,2236,3919,2296,3116,4799,29.154759474226502,5.572104574801163,1683,1,274398,4410,850,0,613,1416
5431,1,0,0,0,45,0,796,0,0,1344672,3676736,40.29888335921977,1624,2452,2452,1624,36480,430160,434688,2264,3888,2264,3092,4716,28.77498913987632,0.0,1624,0,311808,0,828,0,640,1436
5432,1,0,0,0,49,0,414,0,1,565551,2426046,31.416556144810016,490,2057,1560,987,54216,616958,530928,1961,3445,2955,3031,4515,23.93741840717165,23.05144218210619,1484,1,213192,81508,573,0,1471,1885
5433,1,0,0,0,49,0,313,0,1,531278,2227940,30.033314835362415,405,1988,1491,902,54366,607620,545870,1973,3372,2967,3059,4458,24.269322199023193,23.287508036518286,1399,1,199342,79023,589,0,1568,1881
5434,1,0,0,0,44,0,449,0,0,399170,999932,21.118712081942874,446,1341,1341,446,50640,473062,538080,2242,2688,2242,3137,3583,29.916550603303182,0.0,446,0,107040,0,895,0,1796,1347
5435,1,0,0,0,46,0,1540,0,1,332544,450240,13.856406460551018,48,2164,1924,192,56165,551075,560455,2105,2537,2585,4077,4509,41.617304093369626,16.172956550623297,432,1,45888,26640,1732,0,2153,613
5436,1,0,0,0,46,0,1527,0,1,368668,495444,14.560219778561036,2,2161,1951,212,54500,509466,584250,2127,2549,2547,4076,4498,41.701318923986086,15.195478829531048,422,1,53000,16380,1739,0,2125,598
5437,1,0,0,0,46,0,1498,0,1,453048,595464,16.06237840420901,108,2164,2014,258,50038,454676,586232,2158,2566,2458,4064,4472,41.90465367951393,12.81730439318685,408,1,65532,7050,1756,0,2050,552
5438,1,0,0,0,45,0,1482,0,1,499495,648636,16.822603841260722,163,2168,2048,283,50292,453816,582168,2172,2575,2412,4057,4460,42.01190307520001,11.418751370995183,403,1,71882,6120,1765,0,2009,527
5439,1,0,0,0,45,0,1465,0,1,548166,703593,17.578395831246947,219,2173,2083,309,50094,450846,576081,2187,2586,2367,4051,4450,42.118879377305376,9.845454104733873,399,1,78177,4950,1774,0,1968,503
5440,1,0,0,0,45,0,1449,0,1,597640,758105,18.303005217723125,275,2179,2119,335,49698,448074,568013,2203,2598,2323,4047,4442,42.23742416388575,7.994134176674909,395,1,84085,3540,1784,0,1928,479
5441,1,0,0,0,45,0,1432,0,1,649428,814500,19.026297590440446,332,2186,2156,362,49400,450000,555750,2220,2612,2280,4044,4436,42.35563716909474,5.5965095842615735,392,1,89414,2160,1794,0,1888,456
5442,1,0,0,0,44,0,1415,0,1,703950,873210,19.748417658131498,390,2195,2195,390,49980,470190,532882,2239,2629,2239,4044,4434,42.485291572496,0.0,390,1,92820,0,1805,0,1849,434
5443,1,0,0,0,49,0,906,1,0,1058167,1643950,25.903667693977237,437,2482,2248,671,35600,436100,490000,2216,3121,2684,4027,4932,39.71145930332956,15.34052413788951,905,1,134200,24336,1577,0,1779,873
5444,1,0,0,0,48,0,20,1,0,902400,2337600,30.983866769659336,744,2116,1900,960,40710,560050,430995,2219,3395,2651,3375,4551,30.659419433511783,14.963720443328649,1176,1,169920,41688,940,0,1475,1495
5445,1,0,0,0,49,0,238,0,1,954095,2703453,33.21144381083123,701,2370,1968,1103,45969,566181,487749,2049,3554,2853,3316,4821,29.410882339705484,20.260281056787452,1505,1,219497,69144,865,0,1348,1586
5446,1,0,0,0,49,0,375,0,1,924264,2863818,34.161381705077446,844,2282,1959,1167,53536,549696,586506,2131,3621,2777,3246,4736,28.142494558940577,19.25477977415276,1490,1,278913,36822,792,0,1287,1662
5447,1,0,0,0,45,0,728,0,1,762420,3003830,36.193922141707716,1243,1959,1892,1310,53676,488409,577836,2226,3603,2360,2875,4252,24.124676163629637,8.592096094735382,1377,1,330120,4623,582,0,983,1711
5448,1,0,0,0,45,0,801,0,1,718506,3022542,36.578682316343766,1338,1875,1875,1338,54918,510534,548937,2259,3597,2259,2796,4134,23.173260452512935,0.0,1338,1,325134,0,537,0,921,1722
5449,1,0,0,0,45,0,824,0,0,706352,3037044,36.71511950137164,1348,1872,1872,1348,50400,504672,506925,2253,3601,2253,2777,4125,22.891046284519195,0.0,1348,0,303300,0,524,0,905,1729
5450,1,0,0,0,45,0,870,1,0,662704,3078586,36.851051545376556,1273,1931,1846,1358,39471,505541,401259,2182,3625,2352,2755,4198,22.090722034374522,9.370214040084857,1443,1,240366,15810,488,0,909,1779
5451,1,0,0,0,45,0,893,0,1,687060,3136880,37.255872020394314,1254,2017,1883,1388,55304,503980,560480,2126,3648,2394,2755,4277,22.24859546128699,11.709062801829726,1522,1,344224,12864,495,0,872,1765
5452,1,0,0,0,44,0,832,0,1,762033,3071643,37.1887079635741,1383,1934,1934,1383,48972,470852,513051,2221,3604,2221,2772,4155,23.473389188611005,0.0,1383,1,319473,0,551,0,838,1670
5453,1,0,0,0,45,0,573,1,0,934990,2916340,35.98610843089316,1145,2167,2017,1295,34496,441392,396352,2102,3547,2402,2974,4419,26.870057685088806,12.69591381900158,1445,1,227920,23100,722,0,957,1530
5454,1,0,0,0,45,0,544,1,0,960305,2905406,35.90264614203248,1114,2209,2034,1289,35020,464324,383180,2079,3543,2429,2999,4463,27.294688127912362,13.601470508735444,1464,1,219130,30100,745,0,965,1509
5455,1,0,0,0,45,0,457,1,0,1038768,2907532,35.679125549822544,1017,2345,2089,1273,36348,532172,356304,2028,3557,2540,3100,4629,28.5657137141714,16.52448491690208,1529,1,198588,55040,816,0,1011,1468
5456,1,0,0,0,45,0,428,1,0,1067229,2912355,35.62302626111375,992,2387,2110,1269,35264,532440,348840,2018,3564,2572,3136,4682,29.0,17.386049277927572,1546,1,192888,60386,841,0,1026,1454
5457,1,0,0,0,46,0,101,1,0,1516506,2985541,35.81898937714463,1223,2525,2465,1283,37910,395590,518921,2267,3610,2387,3509,4852,34.38022687534217,8.334399795261145,1343,1,286109,3840,1182,0,1044,1145
5458,1,0,0,0,45,0,8,1,0,1610345,2926627,35.679125549822544,1273,2538,2538,1273,48399,508079,503481,2299,3572,2299,3564,4837,35.566838487557476,0.0,1273,1,278787,0,1265,0,1026,1034
5459,1,0,0,0,47,0,37,1,0,597960,1889712,28.142494558940577,550,1789,1547,792,31200,381760,465270,2144,3178,2628,3141,4175,27.477263328068172,16.38186260813823,1034,1,154440,20328,755,0,1594,1631
5460,1,0,0,0,47,0,73,1,0,535224,1819454,27.730849247724095,529,1705,1465,769,29415,376194,437710,2126,3135,2606,3062,4071,26.38181191654584,16.077559228392104,1009,1,142265,22800,696,0,1597,1670
5461,0,1,0,1,66,0,177,0,0,15828588,13424400,63.7808748764079,3944,8083,7959,4068,48364,745800,706200,3176,7368,3424,7191,11383,62.37788069500277,11.15359010904883,4192,1,870552,18476,3891,0,768,591
5462,0,0,1,0,58,1,1178,0,0,665115,4703655,39.93745109543172,1553,2054,2012,1595,56144,684168,713658,2907,4544,2991,3366,5003,20.42057785666214,6.570697549716149,1637,1,385990,4872,417,0,1354,2532
5463,0,0,1,0,58,1,1317,0,0,1740528,6211296,46.184412955021955,1891,3191,2949,2133,54984,675584,690144,2670,5045,3154,3728,6103,28.5657137141714,15.588391269727603,2375,1,505521,30250,816,0,779,2096
5464,0,0,1,0,57,1,1415,0,0,1727000,6342600,46.9041575982343,2008,3177,2985,2200,56144,668856,697686,2691,5083,3075,3668,6060,28.0178514522438,14.01173814462286,2392,1,532400,22464,785,0,683,2098
5465,0,0,0,0,57,1,1446,1,0,1739287,6395944,47.19110085598767,2077,3158,3008,2227,56120,660560,700768,2722,5099,3022,3653,6030,27.94637722496424,12.401817263524045,2377,1,543388,16650,781,0,645,2091
5466,1,0,0,0,48,0,108,1,0,122400,732300,17.320508075688775,45,963,708,300,37001,554107,397883,2186,2741,2696,2849,3404,20.199009876724155,16.72519101875932,555,1,48900,51765,408,0,2141,2033
5467,1,0,0,0,49,0,45,1,0,138250,860300,18.708286933869708,53,1042,745,350,39904,570256,422776,2161,2808,2755,2853,3500,19.87460691435179,18.039393808150304,647,1,60200,59400,395,0,2108,2063
5468,1,0,0,0,49,0,26,0,1,163047,1032075,20.42057785666214,56,1169,808,417,46920,569250,504900,2114,2892,2836,2866,3644,19.77371993328519,19.810993840312925,778,1,85068,59565,391,0,2058,2084
5469,1,0,0,0,49,0,83,0,1,140030,825775,18.303005217723125,31,1119,753,335,51948,547230,576810,2099,2800,2831,2883,3584,20.445048300260872,19.458563894296514,701,1,78390,43554,418,0,2130,2047
5470,1,0,0,0,47,0,446,1,0,291327,857736,19.0,276,1253,1168,361,33418,515592,365904,2291,2737,2461,3183,3629,28.407745422683583,9.53016293865306,446,1,55594,17000,807,0,2015,1569
5471,1,0,0,0,46,0,238,0,1,1606368,3241968,37.30951621235526,1242,2696,2546,1392,40158,482103,451826,2179,3721,2479,3483,5025,33.97057550292606,13.130475867068439,1542,1,270048,22200,1154,0,937,1175
5472,1,0,0,0,45,0,804,0,0,1247365,3616564,39.8622628559895,1589,2374,2374,1589,32160,364160,457476,2276,3865,2276,3061,4650,28.0178514522438,0.0,1589,0,319389,0,785,0,687,1491
5473,1,0,0,0,48,0,691,0,0,782180,3110590,35.98610843089316,1079,2115,1899,1295,37820,586088,372310,2186,3697,2618,3006,4517,24.576411454889016,15.94330286141657,1511,1,200725,48168,604,0,1107,1798
5474,1,0,0,0,49,0,619,0,1,660240,2890908,34.336569426778794,879,2039,1739,1179,49276,622808,475688,2152,3631,2752,3012,4491,23.664319132398465,18.73206598980908,1479,1,228726,55500,560,0,1273,1892
5475,1,0,0,0,49,0,367,0,1,508760,2264120,30.331501776206203,407,1986,1473,920,48608,610328,482356,1948,3381,2974,3014,4447,23.515952032609693,23.52793887664223,1433,1,180320,97470,553,0,1541,1908
5476,1,0,0,0,46,0,1518,0,1,328320,446592,13.856406460551018,18,2112,1902,192,55575,523350,574522,2116,2518,2536,4036,4438,41.352146256270665,15.051585138588687,402,1,47424,19320,1710,0,2134,616
5477,1,0,0,0,46,0,1485,0,1,417934,557084,15.556349186104045,92,2119,1969,242,50853,462702,582406,2152,2544,2452,4029,4421,41.557189510360296,12.72513248597547,392,1,61226,8700,1727,0,2060,575
5478,1,0,0,0,45,0,1468,0,1,465248,613184,16.3707055437449,148,2124,2004,268,50148,455312,576576,2168,2556,2408,4024,4412,41.66533331199932,11.35235258913941,388,1,67536,7200,1736,0,2020,552
5479,1,0,0,0,45,0,1451,0,1,515070,671420,17.175564037317667,205,2131,2041,295,50298,459752,566724,2186,2571,2366,4022,4407,41.78516483155236,9.82680210338744,385,1,73455,6390,1746,0,1981,530
5480,1,0,0,0,45,0,1433,0,1,567188,731272,17.97220075561143,263,2139,2079,323,48400,452800,547888,2204,2587,2324,4020,4403,41.90465367951393,8.016064826688304,383,1,78166,4680,1756,0,1941,508
5481,1,0,0,0,44,0,1398,0,1,673483,850855,19.467922333931785,379,2156,2156,379,44377,446755,500635,2245,2624,2245,4022,4401,42.15447781671598,0.0,379,1,84517,0,1777,0,1866,468
5482,1,0,0,0,45,0,1346,0,1,844392,1051296,21.587033144922902,399,2345,2278,466,45549,543696,426384,2189,2722,2323,4068,4601,42.567593307585526,8.436161057888377,533,1,88074,12797,1812,0,1790,444
5483,1,0,0,0,46,0,1086,1,0,1123632,1513728,25.45584412271571,414,2616,2382,648,24157,474208,277984,2102,2984,2570,4070,4952,41.641325627314025,16.28785364436188,882,1,77112,50310,1734,0,1688,602
5484,1,0,0,0,49,0,511,0,1,890226,1775398,26.870057685088806,530,2147,1955,722,46631,543439,518849,2267,3181,2651,3692,4606,35.11409973215888,13.901665601458292,914,1,152342,28032,1233,0,1737,1226
5485,1,0,0,0,48,0,311,0,1,850980,1875900,27.92848008753788,780,1871,1871,780,46716,490620,550745,2405,3185,2405,3496,4276,33.03028912982749,0.0,780,1,178620,0,1091,0,1625,1314
5486,1,0,0,0,47,0,283,0,0,851400,1900008,28.142494558940577,792,1867,1867,792,47304,525381,518184,2399,3191,2399,3474,4266,32.78719262151,0.0,792,0,171072,0,1075,0,1607,1324
5487,1,0,0,0,48,0,3,0,1,918720,2338908,30.93541659651604,699,2175,1917,957,42136,559676,449696,2186,3401,2702,3404,4619,30.983866769659336,16.334344014509284,1215,1,176088,47730,960,0,1487,1484
5488,1,0,0,0,47,0,548,0,1,873600,2954016,35.32704346531139,1073,2123,1948,1248,46482,433161,601218,2192,3615,2542,3067,4490,26.457513110645905,14.11109767230738,1423,1,316992,4550,700,0,1119,1667
5489,1,0,0,0,45,0,649,0,1,794352,2922808,35.679125549822544,1188,1982,1897,1273,52118,472976,580888,2211,3569,2381,2920,4278,24.979991993593593,9.494144610579708,1358,1,322069,5100,624,0,1023,1672
5490,1,0,0,0,45,0,723,0,1,750100,2940600,36.05551275463989,1300,1877,1877,1300,54450,508950,547404,2262,3562,2262,2839,4139,24.020824298928627,0.0,1300,1,314600,0,577,0,962,1685
5491,1,0,0,0,44,0,830,0,1,724584,3061776,36.90528417449187,1267,1989,1894,1362,55144,508048,548512,2153,3610,2343,2780,4237,23.065125189341593,9.82390283601982,1457,1,332328,10165,532,0,886,1716
5492,1,0,0,0,44,0,779,0,0,782412,3021168,36.823905279043935,1356,1933,1933,1356,48840,490160,494616,2228,3584,2228,2805,4161,24.020824298928627,0.0,1356,0,301032,0,577,0,872,1651
5493,1,0,0,0,46,0,3,1,0,1624348,2934265,35.679125549822544,1273,2549,2549,1273,45084,470220,509405,2305,3578,2305,3581,4854,35.7211421989835,0.0,1273,1,281333,0,1276,0,1032,1029
5494,1,0,0,0,48,0,142,1,0,1422984,2709964,33.52610922848042,794,2720,2390,1124,39457,508721,450857,2081,3535,2741,3677,5131,35.58089374931439,18.609188360013338,1454,1,210188,53130,1266,0,1287,1145
5495,1,0,0,0,48,0,43,0,1,893508,2235156,30.397368307141328,563,2252,1891,924,42432,503152,493476,2058,3343,2780,3386,4671,31.096623610932426,19.762101378474206,1285,1,188496,50179,967,0,1495,1452
5496,1,0,0,0,48,0,11,0,1,730140,2082920,29.32575659723036,565,2004,1709,860,37824,465024,477134,2127,3282,2717,3271,4426,29.13760456866693,18.216939832741396,1155,1,169420,37170,849,0,1562,1573
5497,1,0,0,0,48,0,59,1,0,622440,1968057,28.61817604250837,547,1851,1579,819,29097,382077,439749,2131,3222,2675,3163,4254,27.568097504180443,17.400445235248032,1091,1,149877,26384,760,0,1584,1643
5498,1,0,0,0,47,0,159,1,0,431262,1764321,27.2213151776324,456,1608,1323,741,22630,347626,369055,2096,3122,2666,2963,3989,24.124676163629637,17.48865077192607,1026,1,114855,31350,582,0,1640,1799
5499,1,0,0,0,47,0,176,1,0,299172,1527318,25.337718918639855,430,1320,1108,642,25519,359229,402051,2167,3021,2591,2845,3699,21.587033144922902,14.664067678903075,854,1,108498,21412,466,0,1737,1913
5500,0,0,0,0,57,1,1489,1,0,1685232,6436152,47.3392015141785,2091,3143,2993,2241,56133,663432,697896,2722,5113,3022,3624,6015,27.422618401604176,12.36812780528175,2391,1,544563,17100,752,0,631,2120
5501,1,0,0,0,47,0,315,1,0,103716,481797,14.177446878757825,9,927,717,201,35168,536928,376329,2187,2598,2607,2913,3324,22.715633383201094,14.89966442575134,411,1,31557,43050,516,0,2196,1881
5502,1,0,0,0,49,0,87,0,1,152950,864500,18.708286933869708,26,1163,787,350,54285,570570,580450,2094,2820,2846,2907,3633,20.904544960366874,19.70559420103982,726,1,82250,47752,437,0,2120,2033
5503,1,0,0,0,47,0,518,0,1,76560,286800,10.954451150103322,25,853,758,120,56120,549700,583160,2295,2510,2485,3028,3243,25.25866188063018,10.079301689331968,215,1,29280,9690,638,0,2270,1752
5504,1,0,0,0,46,0,566,0,1,168912,503712,14.696938456699069,216,998,998,216,53040,515372,559680,2332,2548,2332,3114,3330,27.964262908219126,0.0,216,1,51840,0,782,0,2116,1550
5505,1,0,0,0,46,0,566,1,0,195536,563134,15.556349186104045,242,1050,1050,242,49062,516594,514267,2327,2569,2327,3135,3377,28.42534080710379,0.0,242,1,53482,0,808,0,2085,1519
5506,1,0,0,0,47,0,31,0,1,1596192,3024835,35.76310948449533,1023,2783,2527,1279,49776,482460,577060,2109,3644,2621,3613,5148,35.32704346531139,16.814563709866416,1535,1,312076,20992,1248,0,1086,1117
5507,1,0,0,0,46,0,1506,0,1,294175,405300,13.228756555322953,35,2066,1856,175,55860,528048,567420,2106,2491,2526,3997,4382,41.0,14.932884222740682,385,1,42875,22470,1681,0,2141,635
5508,1,0,0,0,46,0,1489,0,1,339690,463908,14.177446878757825,21,2071,1891,201,53846,503144,570076,2128,2509,2488,3998,4379,41.10960958218893,13.858755107602944,381,1,49647,17100,1690,0,2107,618
5509,1,0,0,0,45,0,1378,0,1,648879,836605,19.261360284258224,371,2120,2120,371,40824,426195,487080,2255,2626,2255,4004,4375,41.82104733265297,0.0,371,1,80136,0,1749,0,1884,506
5510,1,0,0,0,48,0,929,0,1,1044246,1598940,25.65151067676132,573,2330,2245,658,52704,524880,592920,2345,3088,2515,4017,4760,39.83716857408418,9.310388377026886,743,1,160552,8330,1587,0,1772,843
5511,1,0,0,0,48,0,195,1,0,871276,2046994,29.0,714,2004,1877,841,32499,503838,382138,2307,3275,2561,3470,4438,32.18695387886216,11.270999429035628,968,1,132037,23749,1036,0,1593,1398
5512,1,0,0,0,48,0,139,1,0,889140,2141820,29.597297173897484,701,2066,1891,876,35948,511005,420540,2270,3321,2620,3460,4511,31.85906464414798,13.249871956203288,1051,1,150672,30450,1015,0,1569,1430
5513,1,0,0,0,49,0,83,1,0,911258,2240214,30.23243291566195,686,2139,1911,914,38010,514710,443631,2223,3365,2679,3448,4590,31.575306807693888,15.0996688705415,1142,1,165434,37620,997,0,1537,1454
5514,1,0,0,0,45,0,644,0,1,779916,2860954,35.52463933666322,1232,1910,1880,1262,54412,505541,553148,2237,3529,2297,2885,4177,24.859605789312106,5.514871952411144,1292,1,307928,3120,618,0,1005,1649
5515,1,0,0,0,45,0,667,0,1,767684,2875002,35.651086939951774,1271,1875,1875,1271,51051,522522,499902,2262,3533,2262,2866,4137,24.576411454889016,0.0,1271,1,280891,0,604,0,991,1658
5516,1,0,0,0,45,0,711,1,0,746910,2929590,35.91656999213594,1248,1911,1869,1290,40420,488265,426948,2229,3561,2313,2850,4182,24.06241883103193,6.609134537568676,1332,1,242520,6930,579,0,981,1692
5517,1,0,0,0,45,0,766,1,0,707087,2993030,36.15245496505044,1137,2018,1848,1307,45333,501510,474030,2120,3597,2460,2831,4308,23.259406699226016,13.261035176436632,1477,1,270549,25330,541,0,983,1749
5518,1,0,0,0,45,0,780,0,1,718389,2999241,36.373066958946424,1148,2041,1866,1323,52245,487405,550881,2092,3590,2442,2810,4308,23.302360395462088,13.271742520787742,1498,1,321489,16975,543,0,944,1724
5519,1,0,0,0,44,0,751,0,1,793122,2994002,36.6333181680284,1342,1933,1933,1342,52664,506437,517592,2231,3573,2231,2822,4164,24.310491562286437,0.0,1342,1,311344,0,591,0,889,1640
5520,1,0,0,0,44,0,698,0,0,813288,2932048,36.27671429443411,1286,1964,1934,1316,47443,505756,465652,2198,3544,2258,2846,4192,24.859605789312106,5.477225575051661,1346,0,275044,4680,618,0,912,1610
5521,1,0,0,0,45,0,531,1,0,904666,2839298,35.397740040855716,1091,2137,1975,1253,38701,518914,382954,2104,3519,2428,2988,4403,26.870057685088806,13.117536098593346,1415,1,211757,32238,722,0,1013,1544
5522,1,0,0,0,47,0,227,1,0,1167600,2820000,34.64101615137755,865,2508,2173,1200,36736,526400,385400,2015,3550,2685,3323,4858,31.192947920964443,18.48335216920125,1535,1,196800,66330,973,0,1150,1377
5523,1,0,0,0,46,0,63,1,0,1648948,2888165,35.397740040855716,1223,2599,2569,1253,48178,502490,509405,2275,3558,2335,3621,4904,36.27671429443411,5.477225575051661,1283,1,276913,3930,1316,0,1052,989
5524,1,0,0,0,46,0,81,1,0,1694866,2910172,35.52463933666322,1262,2605,2605,1262,48923,555746,468118,2306,3568,2306,3649,4911,36.64696440361739,0.0,1262,1,256186,0,1343,0,1044,963
5525,1,0,0,0,48,0,47,0,1,1014504,2391120,31.368774282716245,560,2439,2015,984,40090,512730,461700,2006,3414,2854,3461,4869,32.109188716004645,21.288125545115367,1408,1,186960,66992,1031,0,1446,1399
5526,1,0,0,0,48,0,69,1,0,638010,2018280,28.879058156387302,533,1900,1599,834,30260,411400,430760,2119,3254,2721,3185,4320,27.65863337187866,18.338618300332826,1135,1,148452,35217,765,0,1586,1655
5527,1,0,0,0,47,0,198,0,1,257488,1461768,24.819347291981714,466,1184,1034,616,34880,379680,517314,2223,2989,2523,2791,3557,20.445048300260872,12.5999078163187,766,1,134288,8250,418,0,1757,1955
5528,0,1,0,1,65,0,19,0,0,15900066,13182106,63.221831672294975,3805,8167,7975,3997,52170,732156,775030,3106,7295,3490,7276,11465,63.071388124885914,14.132314290900673,4189,1,939295,22656,3978,0,699,680
5529,0,1,1,0,57,0,979,0,0,201950,502425,13.228756555322953,0,1504,1329,175,55876,657459,700524,2696,3046,3046,4025,4375,33.97057550292606,13.613476355868046,350,1,42700,19075,1154,0,2696,1717
5530,0,0,1,0,57,1,1650,0,0,2357424,7365024,50.67543783727971,2393,3661,3486,2568,31659,524844,496164,2693,5436,3043,3786,6529,30.298514815086232,13.57796224751577,2743,1,444264,24325,918,0,300,1950
5531,0,0,1,0,58,1,1511,0,0,3544032,8073600,52.76362383309168,2784,4057,4057,2784,41736,643800,545200,2900,5684,2900,4173,6957,35.679125549822544,0.0,2784,1,523392,0,1273,0,116,1627
5532,1,0,0,0,46,0,593,1,0,217344,597504,16.0,214,1147,1105,256,39928,506478,429456,2292,2590,2376,3183,3481,29.13760456866693,6.5252844928085345,298,1,47104,7224,849,0,2078,1485
5533,1,0,0,0,47,0,384,1,0,1498257,3362850,37.82856063875548,1269,2640,2478,1431,35046,415950,465300,2188,3781,2512,3397,4990,32.357379374726875,13.6673582272763,1593,1,283338,17010,1047,0,919,1303
5534,1,0,0,0,44,0,408,0,0,332928,915960,20.199009876724155,408,1224,1224,408,50225,460225,550025,2245,2653,2245,3061,3469,28.5657137141714,0.0,408,1,99960,0,816,0,1837,1429
5535,1,0,0,0,44,0,457,0,0,322944,861696,19.595917942265423,354,1255,1225,384,40075,513876,392700,2214,2628,2274,3085,3499,29.0,5.483301264452448,414,0,67200,5820,841,0,1860,1403
5536,1,0,0,0,45,0,1338,0,1,684535,890330,19.87460691435179,395,2128,2128,395,44100,441784,507150,2254,2649,2254,3987,4382,41.6293165929973,0.0,395,1,88875,0,1733,0,1859,521
5537,1,0,0,0,48,0,471,0,1,823446,1703052,26.49528259898354,672,1905,1875,702,51695,511886,594370,2396,3128,2456,3599,4331,34.249087579087416,5.572104574801163,732,1,171990,2670,1173,0,1724,1253
5538,1,0,0,0,48,0,305,1,0,850034,1895568,27.964262908219126,715,1936,1869,782,34164,530856,378144,2357,3206,2491,3511,4360,32.96968304366907,8.187175587434018,849,1,121992,13467,1087,0,1642,1337
5539,1,0,0,0,49,0,79,0,1,944196,2297046,30.54504869860253,665,2213,1945,933,45046,549026,497324,2194,3395,2730,3474,4675,31.811947441173732,16.377596016249214,1201,1,188466,42880,1012,0,1529,1450
5540,1,0,0,0,45,0,589,0,1,794052,2793978,35.11409973215888,1233,1877,1877,1233,50176,507584,507584,2266,3499,2266,2910,4143,25.37715508089904,0.0,1233,1,276192,0,644,0,1033,1622
5541,1,0,0,0,45,0,612,0,0,784333,2815395,35.25620512760839,1243,1874,1874,1243,41800,498300,430350,2265,3508,2265,2896,4139,25.11971337416094,0.0,1243,0,236170,0,631,0,1022,1634
5542,1,0,0,0,45,0,636,0,0,774972,2849088,35.41186241925155,1224,1902,1872,1254,36980,488480,390784,2242,3526,2302,2890,4174,24.859605789312106,5.623413251903491,1284,0,215688,5430,618,0,1018,1654
5543,1,0,0,0,45,0,684,1,0,736812,2902938,35.58089374931439,1139,1975,1848,1266,22712,382931,311848,2166,3559,2420,2875,4268,24.124676163629637,11.539076697242356,1393,1,172176,19939,582,0,1027,1711
5544,1,0,0,0,44,0,705,0,1,796384,2933632,36.22154055254967,1282,1949,1919,1312,51212,485212,527696,2206,3548,2266,2843,4185,24.63736998950984,5.514871952411144,1342,1,309632,3300,607,0,924,1629
5545,1,0,0,0,47,0,60,1,0,1312416,2808288,34.292856398964496,975,2493,2292,1176,39856,506256,448944,2187,3564,2589,3504,4881,33.406586176980134,15.05898450319845,1377,1,221088,32361,1116,0,1212,1272
5546,1,0,0,0,47,0,38,1,0,1347560,2817840,34.351128074635334,1005,2497,2322,1180,41410,489540,482376,2213,3568,2563,3530,4885,33.793490497431605,14.128060878879506,1355,1,238360,23975,1142,0,1208,1246
5547,1,0,0,0,47,0,27,1,0,1457874,2816646,34.55430508634199,1086,2523,2415,1194,34164,368004,516621,2251,3553,2467,3580,4882,34.942810419312295,10.96830808063325,1302,1,261486,5292,1221,0,1165,1138
5548,1,0,0,0,46,0,123,1,0,1671948,2843298,35.11409973215888,1233,2589,2589,1233,49220,530380,493484,2306,3539,2306,3662,4895,36.823905279043935,0.0,1233,1,263862,0,1356,0,1073,950
5549,1,0,0,0,46,0,173,1,0,1819070,2942390,35.566838487557476,1175,2793,2703,1265,37200,558240,360530,2236,3591,2416,3764,5119,37.92097045171708,9.601845894041878,1355,1,196075,19890,1438,0,1061,888
5550,1,0,0,0,48,0,39,0,1,1032892,2429689,31.575306807693888,551,2479,2033,997,40128,509333,467904,1991,3434,2883,3473,4916,32.18695387886216,21.82293485004397,1443,1,191424,67792,1036,0,1440,1401
5551,1,0,0,0,48,0,22,0,1,933035,2324470,30.903074280724887,547,2340,1932,955,42840,511140,496536,2026,3389,2842,3411,4774,31.25699921617557,20.969673057821545,1363,1,194820,57528,977,0,1479,1457
5552,1,0,0,0,48,0,14,0,1,883551,2271855,30.54504869860253,542,2271,1880,933,40018,521090,455345,2044,3368,2826,3382,4706,30.773365106858236,20.60070320460027,1324,1,174471,64515,947,0,1502,1488
5553,1,0,0,0,48,0,3,0,1,791208,2174040,29.8496231131986,529,2141,1779,891,39879,514840,461160,2078,3331,2802,3328,4581,29.79932885150268,19.998249770265595,1253,1,168399,57196,888,0,1549,1552
5554,1,0,0,0,48,0,148,1,0,339093,1594993,25.709920264364882,460,1375,1174,661,37245,460883,470535,2212,3074,2614,2926,3788,22.64950330581225,14.589047800658264,862,1,128895,25527,513,0,1752,1900
5555,0,1,1,0,60,0,1731,0,0,4989330,4608360,39.11521443121589,1224,5097,4791,1530,43134,713844,548184,2706,4542,3318,6273,8109,57.105166141076936,17.736601446820277,1836,0,278460,59364,3261,1,1482,249
5556,0,1,1,0,62,0,1623,0,0,3871980,4111674,36.29049462324811,982,4592,4257,1317,34050,708694,468300,2787,4439,3457,6062,7714,54.22176684690383,18.316201395491056,1652,1,197550,71690,2940,0,1805,182
5557,0,1,0,1,65,0,1200,0,0,2564100,3656340,33.31666249791537,815,3715,3420,1110,48790,783972,675270,2999,4404,3589,5604,7009,48.062459362791664,17.537427861251444,1405,1,227550,50740,2310,0,2184,984
5558,0,1,0,1,65,0,1153,0,0,2511930,3661890,33.31666249791537,760,3723,3373,1110,50268,778564,702687,2949,4409,3649,5562,7022,47.57099956906519,18.919448368858667,1460,1,236430,56350,2263,0,2189,1036
5559,1,0,0,0,45,0,827,0,0,977130,3396195,38.535697735995385,1443,2185,2143,1485,36162,562602,336189,2245,3772,2329,2945,4472,25.65151067676132,6.78953034358522,1527,1,218295,9534,658,0,802,1629
5560,1,0,0,0,46,0,819,0,0,925380,3352320,38.144462245521304,1388,2158,2091,1455,39250,576000,361728,2237,3759,2371,2940,4462,25.219040425836983,8.721191861163568,1522,1,228435,14472,636,0,849,1668
5561,1,0,0,0,48,0,590,0,0,469491,2523384,32.264531609803356,670,1863,1492,1041,42525,589032,424200,2053,3465,2795,2875,4287,21.236760581595302,20.042272041644882,1412,1,182175,76797,451,0,1383,1973
5562,1,0,0,0,44,0,408,0,0,312409,877795,19.77371993328519,391,1190,1190,391,52405,500635,527575,2245,2636,2245,3044,3435,28.26658805020514,0.0,391,1,91885,0,799,0,1854,1446
5563,1,0,0,0,45,0,1315,0,1,667046,884051,19.77371993328519,361,2127,2097,391,43890,429590,522291,2231,2652,2291,3967,4388,41.30375285612676,5.5503012171862105,421,1,90321,2490,1706,0,1870,555
5564,1,0,0,0,49,0,915,0,1,1039500,1632180,25.69046515733026,468,2427,2235,660,49220,568790,529222,2281,3133,2665,4048,4900,39.68626966596886,14.332108965596055,852,1,141240,29568,1575,0,1813,898
5565,1,0,0,0,49,0,859,0,1,976536,1601208,25.45584412271571,420,2383,2155,648,49374,578214,521381,2243,3119,2699,3978,4854,38.82009788756334,15.20892758594158,876,1,136728,36936,1507,0,1823,964
5566,1,0,0,0,49,0,845,0,1,952526,1585834,25.317977802344327,423,2345,2127,641,45548,583864,477482,2256,3115,2692,3960,4819,38.54867053479276,14.899966739097728,859,1,123713,39894,1486,0,1833,988
5567,1,0,0,0,48,0,443,1,0,820494,1721331,26.664583251946766,711,1865,1865,711,42984,522936,481779,2421,3132,2421,3575,4286,33.97057550292606,0.0,711,1,141489,0,1154,0,1710,1267
5568,1,0,0,0,48,0,261,0,1,942390,2666220,33.31666249791537,854,2215,1959,1110,49335,468390,607706,2146,3512,2658,3251,4617,29.13760456866693,16.433479630243024,1366,1,280830,10240,849,0,1292,1553
5569,1,0,0,0,47,0,367,0,1,908198,2714208,33.97057550292606,974,2121,1941,1154,49022,453936,597408,2172,3506,2532,3139,4473,28.053520278211074,14.034855041500148,1334,1,293116,7020,787,0,1198,1565
5570,1,0,0,0,45,0,534,0,0,808555,2737760,34.713109915419565,1205,1876,1876,1205,42924,497568,445312,2272,3477,2272,2943,4148,25.903667693977237,0.0,1205,0,236180,0,671,0,1067,1601
5571,1,0,0,0,46,0,615,1,0,761994,2844531,35.11409973215888,1109,1975,1851,1233,27745,412953,357585,2183,3540,2431,2925,4282,24.859605789312106,11.531095399343346,1357,1,191115,18972,618,0,1074,1689
5572,1,0,0,0,44,0,651,0,1,799402,2866865,35.73513677041127,1235,1945,1903,1277,49862,480430,523085,2203,3522,2287,2871,4190,25.019992006393608,6.481658975540136,1319,1,297541,4704,626,0,968,1619
5573,1,0,0,0,44,0,647,0,1,815988,2872637,35.81898937714463,1253,1949,1919,1283,47652,467951,510492,2209,3522,2269,2875,4188,25.219040425836983,5.5965095842615735,1313,1,292524,3330,636,0,956,1603
5574,1,0,0,0,44,0,642,0,1,832048,2876104,35.888716889852724,1288,1934,1934,1288,47085,480095,489027,2233,3521,2233,2879,4167,25.41653005427767,0.0,1288,1,282072,0,646,0,945,1587
5575,1,0,0,0,44,0,617,0,0,838950,2847075,35.70714214271425,1245,1963,1933,1275,42816,497959,428736,2203,3508,2263,2891,4196,25.65151067676132,5.490867587491313,1305,0,244800,5100,658,0,958,1575
5576,1,0,0,0,44,0,564,1,0,855565,2802756,35.34119409414458,1164,2019,1934,1249,35524,480216,372504,2159,3493,2329,2929,4263,26.1725046566048,9.300149152818726,1334,1,207334,15810,685,0,995,1559
5577,1,0,0,0,47,0,158,1,0,1123728,2688268,33.793490497431605,763,2505,2126,1142,32465,506110,355454,1975,3496,2733,3338,4859,31.368774282716245,19.636523361580412,1521,1,172442,75800,984,0,1212,1370
5578,1,0,0,0,46,0,164,1,0,1649645,2784755,34.713109915419565,1205,2574,2574,1205,47304,499176,506109,2311,3516,2311,3680,4885,37.0,0.0,1205,1,263895,0,1369,0,1106,942
5579,1,0,0,0,47,0,130,1,0,1767336,3018144,35.58089374931439,1056,2872,2662,1266,31020,560240,314688,2174,3650,2594,3780,5256,37.36308338453881,14.967226076702845,1476,1,167112,49350,1396,0,1118,988
5580,1,0,0,0,48,0,39,0,1,507276,1783884,27.055498516937366,372,1785,1425,732,35880,448408,475215,2077,3169,2797,3130,4222,26.324893162176366,19.921065175345397,1092,1,142740,42480,693,0,1705,1744
5581,1,0,0,0,48,0,64,1,0,445200,1703800,26.457513110645905,394,1642,1336,700,37810,484366,462460,2128,3134,2740,3070,4076,25.219040425836983,17.867412248786327,1006,1,133000,43452,636,0,1734,1798
5582,0,1,0,1,66,0,174,0,0,16565472,13812876,64.48255578061404,3996,8304,8142,4158,38850,697620,614570,3160,7480,3484,7306,11626,63.118935352238,12.815404336892843,4320,1,769230,26082,3984,0,836,662
5583,0,1,0,1,64,0,299,0,0,15686982,12330662,61.75759062657804,3814,7927,7927,3814,54934,782386,733891,3233,7047,3233,7346,11160,64.13267497929586,0.0,3814,1,865778,0,4113,0,581,880
5584,1,0,0,0,48,0,22,0,1,1151208,2576412,32.58834147360065,727,2481,2146,1062,53572,572536,550702,2091,3488,2761,3510,4907,32.92415526630866,18.355619735009306,1397,1,241074,48240,1084,0,1364,1342
5585,1,0,0,0,47,0,62,0,1,1482563,2968873,35.34119409414458,949,2736,2436,1249,49820,503924,558595,2077,3626,2677,3564,5113,34.45286635390443,18.115187604342275,1549,1,293515,31800,1187,0,1128,1190
5586,1,0,0,0,45,0,857,0,1,1054044,3502693,39.25557285278104,1541,2225,2225,1541,47478,438689,559158,2273,3814,2273,2957,4498,26.153393661244042,0.0,1541,1,379086,0,684,0,732,1589
5587,1,0,0,0,46,0,819,0,0,797616,3211344,37.30951621235526,1332,2025,1965,1392,40992,562908,387576,2247,3699,2367,2880,4332,23.93741840717165,8.459383112926107,1452,1,233856,11100,573,0,915,1734
5588,1,0,0,0,47,0,786,0,0,671832,3059700,36.08323710533743,1194,1926,1818,1302,38376,578100,366600,2242,3652,2458,2866,4276,22.715633383201094,11.593204083914486,1410,1,203112,22140,516,0,1048,1834
5589,1,0,0,0,44,0,406,0,0,294032,844496,19.390719429665317,376,1158,1158,376,50032,530056,476152,2246,2622,2246,3028,3404,27.964262908219126,0.0,376,0,79712,0,782,0,1870,1464
5590,1,0,0,0,46,0,1363,0,1,440910,621810,16.431676725154983,143,2030,1903,270,41730,449085,492842,2176,2573,2430,3936,4333,40.4103947023535,11.651960555446681,397,1,57780,14097,1633,0,2033,670
5591,1,0,0,0,45,0,1306,0,1,599760,820800,18.973665961010276,300,2086,2026,360,40991,408120,522120,2220,2640,2340,3946,4366,40.8166632639171,8.086478275311649,420,1,82440,4080,1666,0,1920,614
5592,1,0,0,0,47,0,1307,0,1,978348,1258180,23.065125189341593,331,2572,2371,532,38844,588885,368940,2164,2897,2566,4204,4937,42.883563284783136,14.772739067640114,733,1,82992,44823,1839,0,1833,526
5593,1,0,0,0,49,0,1224,0,1,893332,1271122,22.67156809750927,324,2442,2252,514,41118,571263,440194,2283,2987,2663,4211,4915,41.689327171351664,13.919868588335374,704,1,91492,36670,1738,0,1959,735
5594,1,0,0,0,49,0,910,0,1,944304,1527078,24.859605789312106,362,2402,2146,618,47861,565859,516439,2215,3089,2727,3999,4873,39.08964057138413,16.09203727962367,874,1,129162,40704,1528,0,1853,943
5595,1,0,0,0,49,0,894,0,1,921672,1515312,24.73863375370596,365,2365,2118,612,45076,584336,472916,2229,3088,2723,3982,4841,38.80721582386451,15.839457737396804,859,1,116892,45942,1506,0,1864,970
5596,1,0,0,0,49,0,678,0,1,789480,1511028,24.73863375370596,527,1987,1902,612,52030,530835,597498,2384,3081,2554,3759,4456,35.91656999213594,9.460074866898333,697,1,148104,8415,1290,0,1857,1179
5597,1,0,0,0,48,0,439,0,0,826980,1740596,26.758176320519304,716,1871,1871,716,40809,542113,444873,2431,3147,2431,3586,4302,33.98529093593286,0.0,716,0,131028,0,1155,0,1715,1276
5598,1,0,0,0,49,0,264,1,0,904176,2047644,28.77498913987632,666,2082,1920,828,49259,561371,536641,2311,3301,2635,3565,4555,33.04542328371661,12.78620360159678,990,1,179676,23814,1092,0,1645,1381
5599,1,0,0,0,45,0,456,0,1,829737,2657259,34.161381705077446,1167,1878,1878,1167,45369,485001,485001,2277,3444,2277,2988,4155,26.664583251946766,0.0,1167,1,248571,0,711,0,1110,1566
5600,1,0,0,0,44,0,589,0,1,831992,2815491,35.397740040855716,1253,1917,1917,1253,49248,485352,512316,2247,3500,2247,2911,4164,25.768197453450252,0.0,1253,1,285684,0,664,0,994,1583
5601,1,0,0,0,44,0,585,0,0,848566,2817642,35.482389998420345,1259,1933,1933,1259,46216,487884,474456,2238,3497,2238,2912,4171,25.96150997149434,0.0,1259,0,266908,0,674,0,979,1564
5602,1,0,0,0,46,0,320,1,0,954500,2650750,33.91164991562634,882,2248,1980,1150,31605,495575,338835,2037,3455,2573,3135,4553,28.809720581775867,16.85250848289984,1418,1,169050,54672,830,0,1155,1475
5603,1,0,0,0,46,0,239,1,0,1006830,2623860,33.61547262794322,811,2340,2021,1130,31160,441180,380808,2003,3452,2641,3213,4662,29.8496231131986,18.509900150377497,1449,1,185320,50083,891,0,1192,1431
5604,1,0,0,0,46,0,159,1,0,1068012,2612556,33.406586176980134,732,2457,2073,1116,31672,500974,346468,1957,3457,2725,3298,4798,30.93541659651604,20.27745410950857,1500,1,165168,77952,957,0,1225,1384
5605,1,0,0,0,47,0,36,1,0,1192140,2649570,33.31666249791537,801,2493,2184,1110,36504,515592,403403,2078,3497,2696,3461,4880,32.77193921634788,18.10142012676136,1419,1,187590,57165,1074,0,1277,1313
5606,1,0,0,0,47,0,94,0,1,1383120,2695050,33.61547262794322,960,2524,2354,1130,49692,481770,586710,2215,3515,2555,3609,4909,34.9857113690718,13.707039880315492,1300,1,277980,12750,1224,0,1255,1161
5607,1,0,0,0,46,0,205,1,0,1626614,2724755,34.307433596816885,1177,2559,2559,1177,50850,523190,520875,2315,3492,2315,3697,4874,37.17526059088221,0.0,1177,1,264825,0,1382,0,1138,933
5608,1,0,0,0,47,0,182,1,0,1784640,2957760,35.32704346531139,1068,2858,2678,1248,34839,561690,348390,2190,3618,2550,3800,5228,37.815340802378074,13.821695372860482,1428,1,183456,40500,1430,0,1122,940
5609,1,0,0,0,49,0,31,0,1,640560,1926390,28.0178514522438,390,1996,1601,785,46428,537426,520248,2059,3239,2849,3270,4450,28.5657137141714,20.8747064796687,1180,1,166420,56880,816,0,1669,1638
5610,0,1,0,1,65,0,1154,0,0,2719080,3858660,34.20526275297414,875,3789,3494,1170,49742,784924,689282,3003,4468,3593,5622,7087,48.2078831727758,17.439603507543996,1465,1,244530,49560,2324,0,2128,974
5611,1,0,0,0,48,0,12,0,1,1299564,2727270,33.67491648096547,732,2682,2280,1134,56133,555555,584415,2003,3539,2807,3551,5087,33.85262175962151,20.7830503132296,1536,1,275562,45426,1146,0,1271,1259
5612,1,0,0,0,47,0,162,1,0,1435840,3047314,35.805027579936315,987,2697,2402,1282,38745,487285,449253,2082,3659,2672,3497,5074,33.46640106136302,17.845809558153523,1577,1,242298,44545,1120,0,1095,1257
5613,1,0,0,0,47,0,215,1,0,1427244,3108046,36.15245496505044,1024,2682,2399,1307,39179,482734,458954,2095,3685,2661,3470,5060,33.04542328371661,17.54372795785932,1590,1,252251,41318,1092,0,1071,1286
5614,1,0,0,0,46,0,857,0,1,1245608,3809904,40.29888335921977,1500,2515,2391,1624,46215,457470,556002,2222,3970,2470,3113,4861,27.694764848252458,12.01674731570393,1748,1,384888,9920,767,0,722,1579
5615,1,0,0,0,45,0,845,0,0,812514,3225950,37.656340767525464,1388,2021,1991,1418,48443,571025,439075,2245,3693,2305,2848,4296,23.93741840717165,5.5503012171862105,1448,1,273674,5310,573,0,857,1702
5616,1,0,0,0,47,0,1328,0,1,920993,1186577,22.427661492005804,313,2524,2334,503,33221,563801,327901,2169,2862,2549,4190,4883,42.790185790669334,14.344660619261914,693,1,69917,44080,1831,0,1856,528
5617,1,0,0,0,48,0,1194,0,1,900232,1280132,22.891046284519195,482,2284,2242,524,51092,517916,588763,2401,2967,2485,4161,4727,41.44876355212541,6.538739683827756,566,1,126284,4074,1718,0,1919,725
5618,1,0,0,0,49,0,777,0,1,773550,1421040,23.93741840717165,465,2031,1923,573,53788,560480,590240,2372,3053,2588,3830,4511,36.742346141747674,10.587221077960752,681,1,136374,12744,1350,0,1907,1130
5619,1,0,0,0,48,0,684,0,1,766636,1461512,24.454038521274967,568,1910,1880,598,53072,523016,606112,2414,3042,2474,3726,4354,35.805027579936315,5.5503012171862105,628,1,148304,2610,1282,0,1846,1162
5620,1,0,0,0,48,0,604,0,0,779285,1534592,25.11971337416094,589,1908,1866,631,41495,522880,469376,2390,3063,2474,3667,4340,35.14256678161116,6.488991180673202,673,0,121783,6720,1235,0,1801,1197
5621,1,0,0,0,49,0,315,0,1,903526,1994044,28.39013913315678,653,2080,1927,806,52650,578916,556650,2321,3280,2627,3595,4554,33.481338085566414,12.438613279124889,959,1,181350,22032,1121,0,1668,1353
5622,1,0,0,0,45,0,400,0,1,839844,2598054,33.734255586866,1138,1876,1876,1138,48168,509109,493128,2283,3421,2283,3021,4159,27.16615541441225,0.0,1138,1,245808,0,738,0,1145,1545
5623,1,0,0,0,46,0,514,1,0,785880,2739960,34.351128074635334,979,2047,1846,1180,44377,462078,517806,2121,3502,2523,2988,4369,25.80697580112788,14.513506680968025,1381,1,263140,20904,666,0,1142,1656
5624,1,0,0,0,45,0,540,0,1,797589,2751261,34.68429039204925,1079,1990,1866,1203,52080,480270,567176,2163,3490,2411,2950,4277,25.748786379167466,11.41455123074134,1327,1,298344,10168,663,0,1084,1624
5625,1,0,0,0,44,0,531,0,1,848232,2746656,34.9857113690718,1224,1917,1917,1224,50848,509388,502656,2244,3468,2244,2937,4161,26.324893162176366,0.0,1224,1,274176,0,693,0,1020,1551
5626,1,0,0,0,46,0,232,1,0,1559060,2640160,33.734255586866,1108,2538,2508,1138,49980,473280,568400,2290,3458,2350,3690,4858,37.013511046643494,5.514871952411144,1168,1,278810,2400,1370,0,1182,950
5627,1,0,0,0,46,0,248,1,0,1602608,2655324,33.88214869219483,1148,2544,2544,1148,49665,534303,497295,2313,3461,2313,3709,4857,37.36308338453881,0.0,1148,1,246820,0,1396,0,1165,917
5628,1,0,0,0,47,0,171,1,0,1736410,2946710,35.14256678161116,1025,2851,2641,1235,32376,544008,338812,2176,3621,2596,3792,5237,37.49666651850535,14.990732154983036,1445,1,175370,46620,1406,0,1151,980
5629,1,0,0,0,48,0,157,0,1,1459148,2753024,33.645207682521445,802,2751,2421,1132,37350,547200,403712,2102,3564,2762,3721,5183,35.90264614203248,18.79458604781815,1462,1,187912,65340,1289,0,1300,1143
5630,0,1,0,1,66,0,468,0,0,17585244,14698710,66.58828725834597,4344,8490,8400,4434,45353,719355,692835,3225,7749,3405,7281,11805,62.976185975335156,9.522065445080457,4524,1,926706,12960,3966,0,1119,651
5631,0,1,0,1,66,0,432,0,0,17501065,14598170,66.37017402418047,4345,8438,8378,4405,43600,722452,662800,3254,7719,3374,7287,11752,63.0317380372777,7.780166052320878,4465,1,881000,9360,3973,0,1091,659
5632,0,1,0,1,66,0,210,0,0,17029359,14121288,65.06150935845248,4125,8364,8256,4233,35070,700560,557112,3228,7569,3444,7359,11700,63.42712353559792,10.394308954048586,4341,1,706911,19440,4023,0,897,687
5633,0,1,0,1,65,0,97,0,0,16420404,13173160,63.2771680782255,3896,8213,8105,4004,43792,605360,783020,3182,7294,3398,7391,11503,64.03905058634146,10.684669642126707,4112,1,952952,6804,4101,0,714,811
5634,0,1,1,0,60,0,1004,0,0,1138037,2062819,26.019223662515376,22,3013,2358,677,52416,633776,767844,2392,3724,3702,4728,6060,41.0,26.424907445506914,1332,1,170604,45195,1681,0,2370,1366
5635,0,0,1,0,60,1,805,0,0,4436874,7663923,50.46781152378217,1974,4862,4289,2547,52192,701097,674016,2436,5556,3582,4751,7871,41.737273509418415,24.199925743112722,3120,1,570528,82512,1742,0,462,1267
5636,1,0,0,0,45,0,875,0,0,885000,3357100,38.40572873934304,1475,2075,2075,1475,42486,441544,498444,2276,3751,2276,2876,4351,24.49489742783178,0.0,1475,0,323025,0,600,0,801,1676
5637,1,0,0,0,47,0,789,0,0,502902,2840130,34.72751070837067,1026,1803,1623,1206,50094,595815,466290,2175,3561,2535,2772,4158,20.42057785666214,14.108872824359281,1386,1,238788,32220,417,0,1149,1938
5638,1,0,0,0,47,0,716,1,0,403277,2601191,32.96968304366907,787,1758,1458,1087,41085,595857,394845,2093,3480,2693,2764,4151,19.261360284258224,18.00655506037119,1387,1,179355,65400,371,0,1306,2022
5639,1,0,0,0,48,0,666,1,0,370747,2478151,32.046840717924134,667,1748,1388,1027,48260,612902,458470,2053,3440,2773,2774,4161,19.0,19.68150370737571,1387,1,195130,70920,361,0,1386,2052
5640,1,0,0,0,45,0,292,0,0,285600,919224,20.199009876724155,408,1108,1108,408,53846,491154,556491,2253,2661,2253,2953,3361,26.457513110645905,0.0,408,1,100776,0,700,0,1845,1553
5641,1,0,0,0,45,0,347,0,0,275154,853508,19.467922333931785,379,1105,1105,379,45540,517960,445896,2252,2631,2252,2978,3357,26.94438717061496,0.0,379,0,75042,0,726,0,1873,1526
5642,1,0,0,0,45,0,1269,0,1,527670,758010,18.16590212458495,245,2014,1929,330,52152,486964,565062,2212,2627,2382,3896,4311,39.98749804626441,9.39804606644414,415,1,81180,7565,1599,0,1967,698
5643,1,0,0,0,45,0,1251,0,1,579960,824400,18.973665961010276,300,2031,1971,360,50508,474030,558760,2230,2650,2350,3901,4321,40.13726448077895,8.334399795261145,420,1,87840,5220,1611,0,1930,679
5644,1,0,0,0,45,0,1234,0,1,633360,888420,19.748417658131498,360,2044,2014,390,46800,444210,546720,2248,2668,2308,3902,4322,40.29888335921977,5.8721273231371045,420,1,93600,2280,1624,0,1888,654
5645,1,0,0,0,49,0,1116,1,0,976861,1418843,24.020824298928627,427,2420,2270,577,37996,580324,395899,2309,3036,2609,4152,4879,41.14608122288197,12.54961581009077,727,1,92897,31950,1693,0,1882,766
5646,1,0,0,0,49,0,889,0,1,771660,1346760,23.2379000772445,378,2131,1969,540,48614,543692,556162,2332,3034,2656,3923,4625,37.8021163428716,12.781057885822433,702,1,120420,20898,1429,0,1954,1065
5647,1,0,0,0,48,0,8,0,1,960384,2388168,31.368774282716245,750,2194,1960,984,46937,453849,609177,2193,3411,2661,3403,4621,31.240998703626616,15.868317327710571,1218,1,246984,10296,976,0,1443,1451
5648,1,0,0,0,45,0,299,0,1,865956,2503956,33.04542328371661,1050,1927,1885,1092,52392,509046,541148,2251,3385,2335,3086,4220,28.160255680657446,6.488991180673202,1134,1,257712,4914,793,0,1201,1500
5649,1,0,0,0,44,0,476,0,1,847757,2671683,34.48187929913333,1189,1902,1902,1189,50778,525798,487599,2247,3436,2247,2960,4149,26.70205984563738,0.0,1189,1,258013,0,713,0,1058,1534
5650,1,0,0,0,44,0,473,0,0,860874,2684112,34.55430508634199,1194,1915,1915,1194,46308,510296,458592,2248,3442,2248,2969,4163,26.851443164195103,0.0,1194,0,243576,0,721,0,1054,1527
5651,1,0,0,0,46,0,290,1,0,1579200,2597280,33.46640106136302,1120,2530,2530,1120,44916,528732,456843,2319,3439,2319,3729,4849,37.54996671103717,0.0,1120,1,220640,0,1410,0,1199,909
5652,1,0,0,0,48,0,188,1,0,1652685,2873975,34.56877203488721,955,2818,2578,1195,30660,526695,336700,2165,3600,2645,3788,5223,37.1887079635741,16.112635589370203,1435,1,167300,51840,1383,0,1210,1022
5653,1,0,0,0,48,0,179,0,1,1445220,2721924,33.406586176980134,786,2741,2411,1116,36023,539019,397557,2109,3555,2769,3734,5180,35.98610843089316,18.86248868583109,1446,1,181908,64680,1295,0,1323,1144
5654,1,0,0,0,49,0,164,0,1,1196685,2489795,31.85906464414798,565,2644,2194,1015,44736,571549,470976,2003,3468,2903,3632,5097,34.336569426778794,21.75779218831967,1465,1,194880,81900,1179,0,1438,1274
5655,1,0,0,0,48,0,80,0,1,546000,1714300,26.457513110645905,279,1901,1480,700,56350,600005,563270,2028,3149,2870,3229,4350,27.92848008753788,20.836011579499555,1121,1,161000,60203,780,0,1749,1669
5656,0,1,0,1,66,0,412,0,0,17664828,14658894,66.43794096749237,4354,8476,8416,4414,40916,704052,640953,3261,7735,3381,7323,11797,63.26136261573884,7.822290851349969,4474,1,851902,9360,4002,0,1093,681
5657,0,1,0,1,66,0,78,0,0,16644879,13367628,63.56886030125127,3917,8284,8160,4041,38420,562360,747608,3184,7349,3432,7427,11592,64.17943595888016,11.64690025978279,4165,1,913266,7440,4119,0,733,811
5658,0,1,0,1,64,0,247,0,0,16165254,12656154,62.44197306299666,3899,8045,8045,3899,47742,707628,710874,3246,7145,3246,7392,11291,64.389440128021,0.0,3899,1,853881,0,4146,0,653,900
5659,1,0,0,0,47,0,5,0,1,1323644,2737980,33.88214869219483,740,2709,2301,1148,50400,536625,534240,1977,3533,2793,3538,5094,33.95585369269929,20.678667666863078,1556,1,257152,55488,1153,0,1237,1232
5660,1,0,0,0,47,0,95,0,1,1381896,2926584,34.9857113690718,863,2714,2353,1224,44325,537975,471027,2030,3615,2752,3520,5105,33.60059523282288,19.35444257449484,1585,1,241128,59926,1129,0,1167,1262
5661,1,0,0,0,46,0,904,0,1,1030017,3613656,39.534794801541594,1503,2282,2222,1563,54656,517888,564128,2252,3875,2372,2971,4594,25.67099530598687,8.246211251235321,1623,1,381372,5340,659,0,749,1653
5662,1,0,0,0,45,0,879,0,0,754542,3204684,37.589892258425,1383,1977,1947,1413,47064,503496,480816,2238,3681,2298,2802,4245,23.108440016582687,5.477225575051661,1443,0,299556,4410,534,0,855,1734
5663,1,0,0,0,46,0,837,0,0,538038,2940264,35.53871128783372,1143,1809,1689,1263,41415,584328,384120,2208,3591,2448,2754,4137,20.639767440550294,11.544767501009671,1383,1,208395,25800,426,0,1065,1902
5664,1,0,0,0,46,0,1279,0,1,418230,624240,16.431676725154983,162,1927,1819,270,55647,529448,561816,2204,2582,2420,3861,4239,39.35733730830886,10.684669642126707,378,1,65610,12096,1549,0,2042,763
5665,1,0,0,0,45,0,1242,0,1,518760,756690,18.16590212458495,263,1969,1902,330,54560,504460,568664,2226,2623,2360,3865,4262,39.64845520319802,8.361900766312248,397,1,81840,6164,1572,0,1963,721
5666,1,0,0,0,45,0,1224,0,1,570240,823680,18.973665961010276,318,1986,1944,360,54858,510224,562848,2246,2648,2330,3872,4274,39.7994974842648,6.678188844436455,402,1,88560,4200,1584,0,1928,704
5667,1,0,0,0,45,0,1207,0,1,622830,888420,19.748417658131498,360,2017,1987,390,53240,501160,551276,2248,2668,2308,3875,4295,39.96248240537617,5.684275577662207,420,1,94380,3120,1597,0,1888,681
5668,1,0,0,0,45,0,1190,0,1,676200,954660,20.493901531919196,420,2030,2030,420,47945,488695,506879,2273,2693,2273,3883,4303,40.124805295477756,0.0,420,1,93660,0,1610,0,1853,663
5669,1,0,0,0,48,0,1306,0,1,834720,1150560,21.6794833886788,440,2276,2246,470,49742,511632,582624,2418,2918,2478,4224,4724,42.14261501141095,5.7180036243905645,500,1,111860,2940,1776,0,1978,672
5670,1,0,0,0,49,0,1016,0,1,786420,1282430,22.67156809750927,258,2300,2044,514,43700,573850,474050,2239,3009,2751,4025,4795,39.11521443121589,16.008781829803965,770,1,97660,46080,1530,0,1981,965
5671,1,0,0,0,49,0,924,0,1,731340,1270410,22.58317958127243,386,2068,1944,510,50076,533074,582894,2367,3001,2615,3925,4559,37.86819245752297,11.193732213226145,634,1,119340,13640,1434,0,1981,1057
5672,1,0,0,0,48,0,765,0,0,726984,1350192,23.49468024894146,522,1899,1869,552,39008,518552,450064,2416,2998,2476,3763,4345,36.29049462324811,5.514871952411144,582,0,101568,4950,1317,0,1894,1129
5673,1,0,0,0,49,0,625,1,0,779376,1534416,24.979991993593593,564,1933,1873,624,35328,472128,452456,2399,3083,2519,3708,4392,35.34119409414458,7.994134176674909,684,1,114816,8400,1249,0,1835,1210
5674,1,0,0,0,48,0,76,0,1,958956,2300364,30.692018506445613,700,2202,1960,942,52459,510378,612942,2200,3384,2684,3460,4644,31.906112267087632,16.193542366022758,1184,1,236442,18150,1018,0,1500,1424
5675,1,0,0,0,45,0,267,0,1,862960,2454880,32.7414110874898,1072,1877,1877,1072,47508,490060,508380,2290,3362,2290,3095,4167,28.372521918222215,0.0,1072,1,237984,0,805,0,1218,1485
5676,1,0,0,0,46,0,360,1,0,832500,2592960,33.31666249791537,990,1980,1860,1110,30328,520928,317696,2216,3446,2456,3086,4316,27.386127875258307,11.661903789690601,1230,1,150960,26760,750,0,1226,1586
5677,1,0,0,0,46,0,386,1,0,814680,2615904,33.406586176980134,906,2056,1846,1116,44622,471144,520368,2134,3460,2554,3074,4400,27.018512172212592,14.978918561885752,1326,1,247752,22470,730,0,1228,1614
5678,1,0,0,0,45,0,417,1,0,859978,2607750,34.044089061098404,1159,1901,1901,1159,46081,510750,456750,2250,3409,2250,2992,4151,27.23967694375247,0.0,1159,1,235277,0,742,0,1091,1508
5679,1,0,0,0,46,0,317,1,0,1513718,2511322,32.89376840679705,1082,2481,2481,1082,51525,531509,522225,2321,3403,2321,3720,4802,37.403208418530085,0.0,1082,1,243450,0,1399,0,1239,922
5680,1,0,0,0,47,0,377,1,0,1695008,2652958,33.57082066318904,1037,2721,2631,1127,30084,513172,324852,2264,3481,2444,3858,5075,38.781438859330635,9.903872795307445,1217,1,155526,19440,1504,0,1227,850
5681,1,0,0,0,48,0,209,1,0,1641590,2850934,34.36568055487916,941,2811,2571,1181,32335,538322,350030,2174,3595,2654,3804,5225,37.282703764614496,16.22284026900147,1421,1,171245,51600,1390,0,1233,1024
5682,1,0,0,0,49,0,192,0,1,1245184,2512896,32.0,604,2660,2240,1024,50525,576690,527610,2034,3478,2874,3670,5114,34.87119154832539,21.10244945038756,1444,1,220160,66360,1216,0,1430,1238
5683,1,0,0,0,49,0,172,0,1,964800,2216700,30.0,334,2538,1972,900,54755,578805,573879,1897,3363,3029,3535,5001,32.7414110874898,24.454055617009967,1466,1,209700,76410,1072,0,1563,1391
5684,1,0,0,0,48,0,113,0,1,537768,1658118,26.057628441590765,255,1895,1471,679,56334,600732,559218,2018,3121,2866,3234,4337,28.142494558940577,20.866346343235108,1103,1,155491,61056,792,0,1763,1650
5685,1,0,0,0,48,0,100,0,1,470844,1551616,25.25866188063018,273,1741,1376,638,56608,564224,593408,2067,3070,2797,3170,4173,27.16615541441225,19.38282808158041,1003,1,155672,39420,738,0,1794,1694
5686,0,1,0,1,66,0,281,0,0,17582480,14451888,65.84831053261732,4336,8391,8391,4336,39457,703263,623271,3333,7669,3333,7388,11724,63.67888189973188,0.0,4336,1,810832,0,4055,0,1003,722
5687,0,1,0,1,65,0,167,0,0,16619034,13120290,63.198101237299845,3934,8215,8155,3994,36425,509175,771975,3225,7279,3345,7446,11500,64.50581369148055,8.246211251235321,4054,1,938590,1380,4161,0,709,876
5688,0,1,1,0,64,0,1016,0,0,2181780,3393880,32.46536616149585,511,3667,3124,1054,51246,705180,753480,2677,4274,3763,5290,6887,45.4972526643093,23.55937483017521,1597,1,246636,62445,2070,0,2166,1150
5689,0,1,1,0,59,0,1013,0,0,853320,1627325,23.388031127053,23,2631,2107,547,43344,511700,749700,2451,3522,3499,4535,5606,39.496835316262995,23.47097267253875,1071,1,137844,0,1560,0,2428,1415
5690,0,1,1,0,59,0,1012,0,0,732000,1442040,22.090722034374522,22,2454,1988,488,50652,593955,744660,2489,3443,3421,4455,5409,38.72983346207417,22.12570290698305,954,1,122976,29824,1500,0,2467,1455
5691,0,0,1,0,56,1,1886,0,0,1318947,6920221,49.28488612140643,2399,3002,2972,2429,49042,643874,618233,2819,5278,2879,3392,5851,23.302360395462088,5.501408174353464,2459,0,527093,4350,543,1,420,2306
5692,1,0,0,0,46,0,918,0,1,1127968,3729728,40.19950248448356,1574,2356,2314,1616,51546,491604,558536,2266,3924,2350,3006,4664,26.419689627245813,7.104767262655114,1658,1,391072,2898,698,0,692,1610
5693,1,0,0,0,49,0,549,0,1,281656,2144248,29.5296461204668,398,1669,1195,872,44469,597537,449997,1985,3331,2933,2782,4128,17.97220075561143,22.00985438372454,1346,1,159576,94326,323,0,1587,2136
5694,1,0,0,0,45,0,1214,0,1,509520,754710,18.16590212458495,288,1916,1874,330,54780,503140,569463,2245,2617,2329,3831,4203,39.293765408777,6.609134537568676,372,1,82170,3822,1544,0,1957,743
5695,1,0,0,0,45,0,1197,0,1,560520,821160,18.973665961010276,330,1947,1917,360,55860,520068,558845,2251,2641,2311,3838,4228,39.45883931389772,5.572104574801163,390,1,88200,3210,1557,0,1921,724
5696,1,0,0,0,45,0,1180,0,1,612300,886470,19.748417658131498,390,1960,1960,390,54510,538701,522790,2273,2663,2273,3843,4233,39.6232255123179,0.0,390,1,89700,0,1570,0,1883,703
5697,1,0,0,0,47,0,1340,1,0,734844,993168,20.445048300260872,238,2356,2176,418,25707,496584,292248,2196,2794,2556,4134,4732,41.92851058647326,14.2828568570857,598,1,51414,39420,1758,0,1958,618
5698,1,0,0,0,49,0,1470,0,1,727651,972417,19.77371993328519,190,2453,2252,391,49086,604341,502374,2286,2878,2688,4348,4940,43.139309220245984,14.344321818363715,592,1,78982,36180,1861,0,2096,626
5699,1,0,0,0,50,0,1033,0,1,726240,1201440,21.908902300206645,290,2183,1993,480,43600,545654,500600,2313,2983,2693,4016,4686,38.897300677553446,13.822074075384924,670,1,96000,29640,1513,0,2023,990
5700,1,0,0,0,45,0,212,0,0,868608,2397024,32.31098884280702,1044,1876,1876,1044,46209,484456,502824,2296,3340,2296,3128,4172,28.844410203711913,0.0,1044,0,228636,0,832,0,1252,1464
5701,1,0,0,0,46,0,349,0,1,826100,2543200,33.166247903554,890,2061,1851,1100,48694,448528,580312,2102,3412,2522,3063,4373,27.40437921208944,14.826647610630195,1310,1,276100,11550,751,0,1212,1561
5702,1,0,0,0,45,0,359,0,0,871230,2547020,33.61547262794322,1130,1901,1901,1130,44642,498134,455308,2254,3384,2254,3025,4155,27.76688675382964,0.0,1130,0,228260,0,771,0,1124,1483
5703,1,0,0,0,45,0,345,1,0,910174,2588914,33.793490497431605,1057,2024,1939,1142,35457,505541,360453,2182,3409,2352,3064,4291,28.231188426986208,9.332611979058527,1227,1,181578,17170,797,0,1125,1470
5704,1,0,0,0,45,0,295,1,0,912366,2553288,33.37663853655727,980,2067,1933,1114,29670,492780,316296,2158,3406,2426,3111,4359,28.61817604250837,11.889245776390416,1248,1,153732,28542,819,0,1178,1473
5705,1,0,0,0,46,0,242,1,0,918515,2510970,32.96968304366907,897,2122,1932,1087,35070,485100,385770,2120,3397,2500,3155,4432,29.068883707497267,14.318161748821744,1277,1,181529,34200,845,0,1223,1465
5706,1,0,0,0,48,0,171,0,1,679102,1809205,27.258026340878022,219,2181,1657,743,56876,586835,574660,1911,3178,2959,3349,4616,30.23243291566195,23.43851910715862,1267,1,175348,67072,914,0,1692,1521
5707,0,1,0,1,66,0,335,0,0,17911404,14714826,66.35510530471637,4361,8513,8471,4403,39951,691794,645006,3300,7745,3384,7410,11855,63.7808748764079,6.570697549716149,4445,1,849779,6300,4068,0,1061,726
5708,0,1,0,1,65,0,188,0,0,15871389,12700224,62.37788069500277,3849,8012,7970,3891,37195,701760,564672,3222,7155,3306,7343,11276,63.86704940734306,6.63067838716079,3933,1,673143,7602,4079,0,627,815
5709,0,1,1,0,62,0,1610,0,0,4893291,4801900,39.35733730830886,1036,5221,4708,1549,40128,706800,545600,2587,4649,3613,6259,8321,56.20498198558558,22.719087853033027,2062,1,272624,97983,3159,0,1551,59
5710,0,0,0,0,57,1,1815,1,0,1341756,6837246,48.774993593028796,2226,3096,2943,2379,54560,632280,712752,2721,5253,3027,3438,5970,23.748684174075834,12.407318298018154,2532,1,589992,14382,564,0,495,2310
5711,0,0,0,0,57,1,1839,1,0,1319832,6850215,48.8978527135906,2267,3067,2943,2391,54880,641760,701925,2741,5256,2989,3417,5932,23.49468024894146,11.157371872753709,2515,1,585795,13020,552,0,474,2313
5712,1,0,0,0,48,0,7,0,1,1037330,2440060,31.85906464414798,625,2427,2037,1015,52864,538496,567344,2014,3419,2794,3426,4831,31.96873472629156,19.754776666701613,1405,1,239540,46020,1022,0,1389,1382
5713,1,0,0,0,48,0,748,1,0,277440,2454120,31.937438845342623,659,1653,1292,1020,34881,555786,363306,2045,3426,2767,2678,4059,16.492422502470642,19.640979227978956,1381,1,154020,78337,272,0,1386,2134
5714,1,0,0,0,48,0,688,1,0,261120,2333760,30.983866769659336,539,1653,1232,960,39204,588302,393822,2010,3391,2852,2703,4084,16.492422502470642,21.230519432610105,1381,1,155520,91778,272,0,1471,2159
5715,1,0,0,0,45,0,267,1,0,257278,885615,19.77371993328519,391,1049,1049,391,36672,434880,432615,2265,2656,2265,2923,3314,25.65151067676132,0.0,391,1,74681,0,658,0,1874,1607
5716,1,0,0,0,45,0,1170,0,1,550800,819000,18.973665961010276,360,1890,1890,360,53580,518700,534625,2275,2635,2275,3805,4165,39.11521443121589,0.0,360,1,84600,0,1530,0,1915,745
5717,1,0,0,0,46,0,1214,1,0,748800,1043100,21.213203435596427,390,2174,2114,450,27051,493734,294386,2258,2768,2378,3982,4492,40.792156108742276,8.427403136094702,510,1,57150,13200,1664,0,1868,654
5718,1,0,0,0,48,0,1425,1,0,653350,886220,19.1049731745428,95,2425,2155,365,29213,541444,318068,2158,2793,2698,4218,4853,42.30839160261236,17.54715310232173,635,1,47815,61020,1790,0,2063,638
5719,1,0,0,0,48,0,1355,0,1,828084,1117822,21.37755832643195,397,2329,2269,457,45540,562580,484308,2386,2903,2506,4258,4775,42.567593307585526,7.780166052320878,517,1,90486,10320,1812,0,1989,634
5720,1,0,0,0,49,0,1196,0,1,804480,1199520,21.908902300206645,180,2456,2156,480,46864,579768,504798,2199,2979,2799,4175,4955,40.93897898091744,17.68163930394199,780,1,96960,50700,1676,0,2019,823
5721,1,0,0,0,49,0,949,0,1,659390,1144962,21.587033144922902,466,1881,1881,466,48480,496314,589680,2457,2923,2457,3872,4338,37.61648574760805,0.0,466,1,111840,0,1415,0,1991,1042
5722,1,0,0,0,49,0,697,1,0,768740,1474410,24.392621835300936,565,1917,1887,595,45136,515424,537726,2448,3073,2508,3770,4395,35.94440151122286,5.652706486041966,625,1,129115,3690,1292,0,1883,1186
5723,1,0,0,0,49,0,471,0,1,902002,1844869,27.258026340878022,563,2137,1957,743,48530,571090,523913,2303,3226,2663,3697,4620,34.84250278036869,13.521180352041128,923,1,156773,28260,1214,0,1740,1269
5724,1,0,0,0,46,0,134,0,0,877232,2321848,31.71750305430741,1006,1878,1878,1006,48777,491604,528532,2308,3314,2308,3180,4186,29.5296461204668,0.0,1006,0,230374,0,872,0,1302,1436
5725,1,0,0,0,46,0,290,0,1,836451,2470797,32.72613634390714,861,2062,1852,1071,48165,449865,569829,2097,3378,2517,3088,4369,27.94637722496424,14.778474098445196,1281,1,264537,13440,781,0,1236,1526
5726,1,0,0,0,45,0,297,0,1,840060,2471715,32.817678162843876,897,2037,1857,1077,46566,456705,537030,2115,3372,2475,3075,4332,27.92848008753788,13.64881300169067,1257,1,252018,16020,780,0,1218,1515
5727,1,0,0,0,45,0,300,0,0,880000,2487100,33.166247903554,1100,1900,1900,1100,41382,472549,447678,2261,3361,2261,3061,4161,28.284271247461902,0.0,1100,0,217800,0,800,0,1161,1461
5728,1,0,0,0,46,0,188,1,0,924320,2457080,32.55764119219941,859,2133,1932,1060,36890,503006,394060,2117,3378,2519,3190,4451,29.5296461204668,14.70834415446928,1261,1,180200,37185,872,0,1258,1446
5729,1,0,0,0,48,0,69,1,0,1011852,2334744,31.176914536239792,498,2487,2013,972,33741,497214,391526,1928,3374,2876,3443,4889,32.264531609803356,22.606088202847335,1446,1,158436,85320,1041,0,1430,1361
5730,1,0,0,0,48,0,95,1,0,1026954,2328536,31.096623610932426,517,2479,2029,967,30888,476784,375648,1958,3375,2858,3470,4887,32.58834147360065,21.387148020643366,1417,1,150852,79200,1062,0,1441,1346
5731,1,0,0,0,48,0,208,0,1,1121280,2324160,30.983866769659336,660,2428,2128,960,44036,489042,527778,2121,3381,2721,3589,4849,34.17601498127012,17.73928915010946,1260,1,209280,34200,1168,0,1461,1253
5732,1,0,0,0,46,0,391,1,0,1427090,2359875,31.85906464414798,1015,2421,2421,1015,49268,525450,506850,2325,3340,2325,3731,4746,37.49666651850535,0.0,1015,1,221270,0,1406,0,1310,919
5733,1,0,0,0,48,0,246,0,1,1415287,2627777,32.7566787083184,738,2727,2392,1073,48945,614699,477555,2114,3522,2784,3768,5176,36.318039594669756,19.08518858775573,1408,1,209235,64320,1319,0,1376,1130
5734,0,1,0,1,67,0,387,0,0,18242458,14971150,66.85057965343307,4361,8659,8551,4469,38335,686750,626450,3242,7819,3458,7432,12009,63.89053137985315,10.551011889467135,4577,1,835703,16524,4082,0,1119,732
5735,0,1,1,0,59,0,1695,0,0,6117354,5292165,42.035699113967404,1585,5411,5229,1767,47096,694840,607985,2813,4762,3177,6457,8406,58.8387627334226,13.505375795393066,1949,0,358701,30576,3462,1,1228,467
5736,0,1,1,0,62,0,1600,0,0,4995876,4887270,39.67366884975475,1071,5251,4748,1574,41400,714150,558900,2602,4679,3608,6279,8356,56.3382640840131,22.512367029116934,2077,1,283320,95570,3174,0,1531,69
5737,0,1,1,0,64,0,1532,0,0,4498269,4764800,38.58756276314948,1098,4901,4510,1489,34272,716800,489600,2809,4689,3591,6221,8101,54.96362433464518,20.01404769274308,1880,1,227817,81719,3021,0,1711,179
5738,1,0,0,0,47,0,299,0,1,1276110,3062664,35.90264614203248,1077,2491,2279,1289,55029,525096,591624,2164,3665,2588,3366,4867,31.464265445104548,15.113085106743466,1501,1,320961,19504,990,0,1087,1386
5739,1,0,0,0,46,0,638,0,1,1186464,3374734,38.13135192987524,1346,2378,2270,1454,56350,533830,568645,2213,3775,2429,3137,4699,28.5657137141714,10.684669642126707,1562,1,356230,11124,816,0,867,1505
5740,1,0,0,0,46,0,930,1,0,734400,3312000,37.94733192202055,1398,1992,1950,1440,30070,446200,356500,2258,3740,2342,2810,4292,22.58317958127243,6.78953034358522,1482,1,223200,7224,510,0,860,1790
5741,1,0,0,0,46,0,922,1,0,632040,3190560,37.14835124201342,1320,1898,1838,1380,24030,411536,312120,2252,3692,2372,2770,4210,21.400934559032695,8.39589984422804,1440,1,186300,10260,458,0,932,1854
5742,1,0,0,0,49,0,1496,1,0,602580,816090,18.16590212458495,118,2368,2156,330,39840,593520,410518,2261,2803,2685,4299,4841,42.731721238442994,14.632570524736149,542,1,54780,44944,1826,0,2143,647
5743,1,0,0,0,49,0,809,1,0,717162,1329126,23.108440016582687,449,1962,1877,534,42140,535135,487844,2404,3023,2574,3832,4451,36.64696440361739,9.222414255489701,619,1,104664,13345,1343,0,1955,1146
5744,1,0,0,0,49,0,779,1,0,736596,1375864,23.515952032609693,493,1945,1885,553,44944,527456,527456,2428,3041,2548,3820,4433,36.49657518178932,7.9730082341141015,613,1,117236,8040,1332,0,1935,1156
5745,1,0,0,0,46,0,31,0,1,916566,2208048,30.692018506445613,900,1957,1915,942,51000,478176,586000,2302,3286,2386,3317,4301,31.192947920964443,6.570697549716149,984,1,235500,2982,973,0,1402,1371
5746,1,0,0,0,46,0,33,0,1,889920,2223360,30.983866769659336,960,1887,1887,960,51935,511836,544260,2316,3276,2316,3243,4203,30.44667469527666,0.0,960,1,225600,0,927,0,1356,1389
5747,1,0,0,0,46,0,56,0,0,882816,2237048,31.11269837220809,968,1880,1880,968,50175,515353,519975,2311,3279,2311,3223,4191,30.199337741083,0.0,968,0,217800,0,912,0,1343,1399
5748,1,0,0,0,46,0,101,0,0,874482,2279970,31.416556144810016,957,1903,1873,987,38570,468930,438900,2280,3297,2340,3196,4213,29.765752132274432,5.483301264452448,1017,0,187530,4410,886,0,1323,1424
5749,1,0,0,0,47,0,200,1,0,843776,2414592,32.0,823,2049,1848,1024,50561,511686,549414,2157,3382,2559,3182,4407,28.705400188814647,14.720977403022477,1225,1,238592,22914,824,0,1334,1534
5750,1,0,0,0,45,0,241,0,0,888930,2432241,32.72613634390714,1071,1901,1901,1071,37213,451929,424677,2271,3342,2271,3101,4172,28.809720581775867,0.0,1071,0,200277,0,830,0,1200,1441
5751,1,0,0,0,46,0,81,1,0,934416,2358720,31.74901573277509,740,2203,1935,1008,34882,500760,381420,2072,3348,2608,3267,4543,30.44667469527666,16.987366343099428,1276,1,164304,50652,927,0,1332,1413
5752,1,0,0,0,47,0,30,1,0,944559,2324385,31.416556144810016,664,2267,1944,987,33755,506325,369735,2032,3342,2678,3312,4622,30.93541659651604,18.600647937130564,1310,1,154959,63308,957,0,1368,1398
5753,1,0,0,0,48,0,146,1,0,1016792,2269960,30.62678566222711,488,2472,2022,938,31930,498520,375100,1970,3358,2870,3504,4892,32.92415526630866,21.313165694461638,1388,1,145390,84150,1084,0,1482,1336
5754,1,0,0,0,47,0,468,1,0,1622269,2530485,32.57299494980466,911,2740,2590,1061,36729,550935,379215,2235,3446,2535,3914,5125,39.102429592034305,12.801484421932168,1211,1,168699,31500,1529,0,1324,856
5755,1,0,0,0,48,0,240,0,1,701316,1754742,26.94438717061496,137,2281,1692,726,56608,589748,560744,1828,3143,3006,3383,4698,31.080540535840107,24.638723950621422,1315,1,168432,81871,966,0,1691,1451
5756,1,0,0,0,48,0,214,0,1,479952,1432134,24.372115213907882,176,1820,1402,594,56105,590695,552119,1993,3005,2829,3219,4231,28.42534080710379,20.578993713510656,1012,1,136026,58520,808,0,1817,1603
5757,0,0,1,0,60,1,495,0,0,490050,2979900,31.464265445104548,778,1697,1485,990,55647,689290,731430,2798,4000,3222,3505,4707,22.24859546128699,14.852658030956366,1202,1,240570,23744,495,0,2020,2515
5758,0,0,0,0,57,1,1871,1,0,1304892,6970680,49.1121166312347,2262,3103,2953,2412,51376,601120,713830,2740,5302,3040,3431,5993,23.259406699226016,12.360324274125283,2562,1,595764,12300,541,0,478,2349
5759,0,0,1,0,59,1,2122,0,0,1616615,8061339,52.124850119688595,2382,3647,3312,2717,29051,620103,412413,2632,5684,3302,3562,6614,24.392621835300936,18.994895158384313,3052,1,377663,68675,595,0,250,2372
5760,1,0,0,0,48,0,1,0,1,967272,2363132,31.352830813181765,592,2358,1967,983,53074,536092,572152,2013,3387,2795,3388,4762,31.368774282716245,19.780054577908317,1374,1,233954,44574,984,0,1421,1420
5761,1,0,0,0,47,0,181,0,1,1272102,2918136,34.95711658589707,980,2505,2263,1222,55902,551628,577896,2146,3610,2630,3429,4893,32.264531609803356,16.146712387708863,1464,1,295724,28072,1041,0,1166,1347
5762,1,0,0,0,47,0,868,1,0,268620,2641800,33.31666249791537,825,1637,1352,1110,35334,556920,359380,2095,3490,2665,2622,4017,15.556349186104045,17.47831248741716,1395,1,167610,62700,242,0,1270,2138
5763,1,0,0,0,49,0,533,0,1,224370,2007180,28.460498941515414,444,1453,1087,810,49288,604632,500556,2112,3288,2844,2755,3931,16.64331697709324,19.42017530493211,1176,1,163620,66246,277,0,1668,2201
5764,1,0,0,0,49,0,1082,0,1,592800,989600,20.0,400,1882,1882,400,49712,514592,591286,2474,2874,2474,3956,4356,38.49675310984031,0.0,400,1,95600,0,1482,0,2074,992
5765,1,0,0,0,49,0,951,1,0,645322,1139962,21.400934559032695,334,1991,1867,458,37664,532646,438064,2365,2947,2613,3898,4480,37.53664875824692,11.401248222293653,582,1,80608,21824,1409,0,2031,1080
5766,1,0,0,0,46,0,87,0,1,911088,2140464,30.199337741083,882,1941,1911,912,47478,452971,577362,2317,3259,2377,3346,4288,31.606961258558215,5.7180036243905645,942,1,224352,1920,999,0,1435,1348
5767,1,0,0,0,46,0,43,0,1,893508,2151072,30.397368307141328,924,1891,1891,924,48150,498192,523800,2328,3252,2328,3295,4219,31.096623610932426,0.0,924,1,207900,0,967,0,1404,1361
5768,1,0,0,0,46,0,156,1,0,845845,2342340,31.63858403911275,733,2114,1846,1001,42365,432900,535860,2072,3341,2608,3185,4454,29.068883707497267,16.628058050793765,1269,1,229229,20904,845,0,1339,1495
5769,1,0,0,0,46,0,182,1,0,862208,2371584,32.0,904,1986,1866,1024,31960,393720,435408,2196,3340,2436,3158,4302,29.017236257093817,11.702672623215602,1144,1,192512,12840,842,0,1292,1474
5770,1,0,0,0,45,0,182,0,0,894219,2375562,32.264531609803356,1041,1900,1900,1041,35460,449554,410760,2282,3323,2282,3141,4182,29.30870177950569,0.0,1041,0,187380,0,859,0,1241,1423
5771,1,0,0,0,46,0,158,1,0,936600,2426550,32.4037034920393,930,2062,1942,1050,29346,464511,337406,2191,3361,2431,3203,4373,29.866369046136157,11.602338718189415,1170,1,153300,22680,892,0,1261,1419
5772,1,0,0,0,46,0,54,1,0,932427,2323620,31.51190251317746,753,2172,1932,993,34937,507780,376740,2100,3333,2580,3279,4512,30.643106892089126,16.043341638998395,1233,1,159873,46560,939,0,1347,1401
5773,1,0,0,0,47,0,50,1,0,948051,2248181,30.805843601498726,589,2308,1948,949,35259,518811,381409,2009,3318,2729,3368,4677,31.606961258558215,19.635268570458013,1309,1,152789,70560,999,0,1420,1370
5774,1,0,0,0,47,0,101,1,0,960792,2224159,30.512292604784715,514,2380,1963,931,33150,527969,358350,1972,3320,2806,3421,4769,32.12475680841802,21.1424009650473,1348,1,139650,87153,1032,0,1458,1357
5775,1,0,0,0,46,0,481,1,0,1380960,2241183,30.967725134404045,959,2399,2399,959,44928,504792,486096,2337,3296,2337,3777,4736,37.94733192202055,0.0,959,1,199472,0,1440,0,1378,897
5776,1,0,0,0,46,0,496,1,0,1419585,2272305,31.12876483254676,939,2464,2434,969,40136,544040,405685,2315,3314,2375,3810,4809,38.27531841800928,5.791460926441345,999,1,167637,5970,1465,0,1376,880
5777,0,1,0,1,67,0,93,0,0,17988160,14459136,65.4828221749796,4258,8513,8483,4288,49815,819396,691260,3342,7660,3402,7567,11885,64.7688196588451,5.501408174353464,4318,1,879040,5280,4195,0,916,823
5778,0,1,1,0,62,0,1580,0,0,5212956,5063364,40.32369030731191,1152,5306,4832,1626,41760,722448,560520,2640,4740,3588,6320,8420,56.621550667568265,21.824858974192548,2100,1,292680,91482,3206,0,1488,92
5779,0,1,0,1,65,0,1149,0,0,3490020,4547100,37.14835124201342,1230,4059,3909,1380,41574,810570,556855,3145,4675,3445,5824,7354,50.28916384272063,12.882345016608866,1530,1,233220,31950,2529,0,1915,766
5780,0,0,1,0,58,1,1744,0,0,1318980,6800846,48.104053883222775,2139,3059,2884,2314,50429,620129,702421,2764,5253,3114,3509,5998,23.874672772626646,13.406666223469482,2489,1,553046,17150,570,0,625,2369
5781,0,0,0,0,57,1,1896,1,0,1297620,7042140,49.29503017546495,2296,3098,2964,2430,53599,628866,715806,2764,5328,3032,3432,5996,23.108440016582687,11.627706147355314,2564,1,600210,12328,534,0,468,2364
5782,0,0,1,0,57,1,2143,0,0,1076460,7394255,50.62608023538856,2478,3068,2983,2563,32560,634700,426980,2800,5448,2970,3305,5953,20.493901531919196,9.460074866898333,2648,1,379324,17765,420,0,322,2465
5783,1,0,0,0,47,0,345,0,1,1223524,3046536,35.94440151122286,1142,2389,2239,1292,54250,511686,589500,2208,3650,2508,3305,4747,30.773365106858236,12.81730439318685,1442,1,323000,12750,947,0,1066,1411
5784,1,0,0,0,46,0,517,0,1,1181984,3204704,37.094473981982816,1291,2320,2235,1376,55552,521696,577592,2244,3705,2414,3188,4649,29.30870177950569,9.737059976664934,1461,1,341248,7820,859,0,953,1470
5785,1,0,0,0,45,0,962,0,0,932880,3566160,39.496835316262995,1560,2158,2158,1560,33371,505206,345186,2286,3846,2286,2884,4444,24.454038521274967,0.0,1560,0,235560,0,598,0,726,1688
5786,1,0,0,0,46,0,953,1,0,644370,3285300,37.54996671103717,1302,1975,1867,1410,32625,524250,337850,2222,3740,2438,2787,4305,21.37755832643195,10.909289819896376,1518,1,204450,23328,457,0,920,1873
5787,1,0,0,0,47,0,879,1,0,217080,2586600,32.863353450309965,757,1604,1281,1080,35728,555640,368830,2072,3475,2718,2596,3999,14.177446878757825,18.61031326627034,1403,1,166320,69768,201,0,1315,2194
5788,1,0,0,0,49,0,555,0,1,206550,2007990,28.460498941515414,468,1407,1065,810,46172,590002,480926,2137,3289,2821,2734,3886,15.968719422671311,18.819090221381778,1152,1,157140,62928,255,0,1669,2224
5789,1,0,0,0,48,0,1417,1,0,485070,693405,16.881943016134134,38,2234,1987,285,32944,564456,345486,2186,2718,2680,4135,4667,41.255302689472536,17.04546152360514,532,1,40470,55575,1702,0,2148,731
5790,1,0,0,0,49,0,1572,0,1,550765,728650,17.175564037317667,200,2257,2162,295,50429,521170,590330,2375,2765,2565,4337,4727,43.2087954009366,9.937924380926386,390,1,70505,9310,1867,0,2175,603
5791,1,0,0,0,49,0,1580,0,1,583701,760758,17.578395831246947,242,2265,2198,309,49560,517020,581032,2395,2771,2529,4351,4727,43.46262762420146,8.345174736691893,376,1,72924,6834,1889,0,2153,573
5792,1,0,0,0,49,0,1408,1,0,712185,983945,19.87460691435179,123,2470,2198,395,38646,562966,425961,2219,2886,2763,4294,4961,42.46174749112429,16.709298150981567,667,1,67545,52768,1803,0,2096,688
5793,1,0,0,0,49,0,973,1,0,640350,1124100,21.213203435596427,330,1993,1873,450,42900,549560,487110,2378,2948,2618,3921,4491,37.72267222772003,10.95920259392275,570,1,87750,19560,1423,0,2048,1075
5794,1,0,0,0,48,0,315,0,1,958266,2027454,28.879058156387302,664,2153,1983,834,53676,517803,612612,2261,3265,2601,3580,4584,33.896902513356586,13.573165933825017,1004,1,210168,13090,1149,0,1597,1282
5795,1,0,0,0,46,0,120,0,1,895104,2071704,29.79932885150268,888,1896,1896,888,51700,513260,548255,2333,3221,2333,3341,4229,31.74901573277509,0.0,888,1,208680,0,1008,0,1445,1325
5796,1,0,0,0,47,0,65,1,0,859200,2281920,30.983866769659336,785,2030,1855,960,35400,475400,420729,2202,3337,2552,3272,4407,29.916550603303182,13.979730073175512,1135,1,169920,27650,895,0,1417,1482
5797,1,0,0,0,46,0,104,1,0,942080,2379776,32.0,904,2064,1944,1024,29747,457828,350924,2204,3348,2444,3244,4388,30.331501776206203,11.786621224697859,1144,1,154624,21720,920,0,1300,1404
5798,1,0,0,0,46,0,78,1,0,937440,2348640,31.74901573277509,858,2088,1938,1008,31557,468330,365810,2180,3338,2480,3260,4418,30.495901363953813,13.038404810405298,1158,1,158256,26850,930,0,1322,1400
5799,1,0,0,0,47,0,78,1,0,937440,2207820,30.495901363953813,600,2268,1938,930,33904,493792,386962,2044,3304,2704,3382,4642,31.74901573277509,18.9436189047169,1260,1,151590,60060,1008,0,1444,1366
5800,1,0,0,0,47,0,104,1,0,942080,2187760,30.331501776206203,560,2304,1944,920,32499,492246,373346,2018,3298,2738,3402,4682,32.0,19.729043246863508,1280,1,144440,67320,1024,0,1458,1354
5801,1,0,0,0,48,0,274,1,0,1005375,2141125,29.58039891549808,467,2432,2024,875,35154,530999,396414,2039,3322,2855,3596,4879,33.896902513356586,20.435124191631246,1283,1,141750,78744,1149,0,1572,1298
5802,1,0,0,0,46,0,528,0,1,1355940,2178990,30.495901363953813,930,2388,2388,930,47286,499059,520146,2343,3273,2343,3801,4731,38.18376618407357,0.0,930,1,206460,0,1458,0,1413,885
5803,1,0,0,0,47,0,538,1,0,1558368,2415168,31.74901573277509,855,2707,2554,1008,33448,541496,354608,2243,3404,2549,3942,5103,39.319206502675,12.712009014913464,1161,1,149184,33048,1546,0,1388,850
5804,0,1,0,1,67,0,117,0,0,17733310,14411250,65.34523701081817,4210,8483,8423,4270,50094,816750,698625,3315,7645,3435,7528,11858,64.4437739428721,7.772191019407321,4330,1,883890,10440,4153,0,895,778
5805,0,1,0,1,67,0,93,0,0,17365894,14247534,64.91532946846992,4094,8455,8335,4214,50715,828345,699867,3261,7595,3501,7502,11836,64.19501538281614,10.986451322313634,4334,1,872298,21120,4121,0,833,740
5806,0,1,0,1,67,0,216,0,0,13745017,12095759,60.00833275470999,3250,7769,7418,3601,23482,668441,396362,3008,6960,3710,7176,11128,61.78187436457395,18.778788002554194,3952,1,424918,74412,3817,0,242,458
5807,0,1,1,0,63,0,1523,0,0,4982640,5067281,39.96248240537617,1105,5209,4717,1597,19995,682195,295089,2681,4770,3665,6293,8382,55.85696017507576,22.252566955872705,2089,1,148521,120540,3120,0,1576,53
5808,0,1,0,1,65,0,1394,0,0,4253520,4823320,38.47076812334269,1238,4596,4354,1480,45652,736534,658318,3017,4739,3501,6133,7855,53.60970061472084,15.88081601204312,1722,1,298960,39446,2874,0,1779,385
5809,0,0,0,0,58,1,1736,1,0,1317297,6780273,48.03123983409131,2157,3028,2878,2307,52824,626007,728872,2789,5246,3089,3510,5967,23.895606290697042,12.470060607585795,2457,1,572136,12900,571,0,632,2368
5810,1,0,0,0,47,0,7,0,1,1004994,2404340,31.71750305430741,588,2423,2005,1006,55632,544920,583160,1972,3396,2808,3389,4813,31.606961258558215,20.748570889308567,1424,1,245464,45980,999,0,1384,1391
5811,1,0,0,0,45,0,687,0,1,1110780,3329436,38.1051177665153,1422,2247,2217,1452,56120,527390,559492,2263,3745,2323,3058,4540,27.65863337187866,5.5965095842615735,1482,1,354288,3120,765,0,841,1528
5812,1,0,0,0,46,0,966,1,0,682560,3339360,37.94733192202055,1373,1981,1914,1440,40824,563517,389592,2252,3759,2386,2793,4300,21.77154105707724,8.2143728690235,1507,1,241920,14271,474,0,879,1845
5813,1,0,0,0,47,0,955,1,0,432150,3040530,35.91656999213594,1115,1800,1625,1290,39312,445473,490256,2182,3647,2532,2692,4157,18.303005217723125,13.901758655477392,1465,1,268320,19075,335,0,1067,2022
5814,1,0,0,0,46,0,951,1,0,389340,2958480,35.4964786985977,1068,1761,1569,1260,37014,436728,467252,2156,3608,2540,2657,4109,17.578395831246947,14.332108965596055,1452,1,250740,22272,309,0,1088,2039
5815,1,0,0,0,48,0,840,1,0,148500,2402730,31.464265445104548,599,1531,1140,990,41108,580053,417444,2036,3417,2818,2577,3958,12.24744871391589,19.77452826245464,1381,1,170280,80546,150,0,1437,2277
5816,1,0,0,0,46,0,169,1,0,247380,976920,20.493901531919196,296,1133,1009,420,36337,416354,472178,2202,2746,2450,2915,3459,24.269322199023193,11.755504904747838,544,1,85260,12648,589,0,1906,1737
5817,1,0,0,0,50,0,1424,1,0,642240,903600,18.973665961010276,25,2479,2144,360,41907,574790,459330,2175,2870,2845,4294,4989,42.23742416388575,18.590734067693752,695,1,65880,62310,1784,0,2150,726
5818,1,0,0,0,49,0,1167,1,0,532818,870480,18.734993995195193,309,1911,1869,351,39676,540640,451360,2438,2831,2522,3998,4391,38.961519477556315,6.495386533491135,393,1,63882,7350,1518,0,2129,962
5819,1,0,0,0,49,0,674,0,1,844872,1603716,25.337718918639855,489,2111,1958,642,52664,579536,567046,2345,3140,2651,3814,4609,36.27671429443411,12.49435617882431,795,1,145734,21267,1316,0,1856,1182
5820,1,0,0,0,47,0,89,1,0,875052,2103336,29.866369046136157,807,1958,1873,892,24739,407934,337194,2273,3250,2443,3339,4316,31.32091952673165,9.587694277262452,977,1,127556,13430,981,0,1466,1377
5821,1,0,0,0,47,0,67,1,0,874038,2129622,30.033314835362415,807,1966,1871,902,21920,377760,323457,2266,3263,2456,3330,4327,31.12876483254676,10.252754761923411,997,1,123574,13870,969,0,1459,1392
5822,1,0,0,0,47,0,23,1,0,878774,2194620,30.430248109405877,799,2002,1875,926,23427,405270,324690,2243,3296,2497,3319,4372,30.805843601498726,11.83366848156067,1053,1,126862,20447,949,0,1444,1421
5823,1,0,0,0,47,0,6,1,0,859320,2218980,30.495901363953813,738,2046,1854,930,41193,493902,474814,2194,3316,2578,3310,4432,30.397368307141328,14.561839326296232,1122,1,185070,27456,924,0,1456,1462
5824,1,0,0,0,47,0,14,1,0,855576,2219092,30.528675044947494,716,2066,1850,932,44254,483343,519058,2165,3313,2597,3299,4447,30.298514815086232,15.309684289836783,1148,1,203176,24840,918,0,1449,1463
5825,1,0,0,0,47,0,22,1,0,851808,2218250,30.56141357987225,692,2088,1846,934,43164,470250,517750,2133,3309,2617,3287,4463,30.199337741083,16.02581635611341,1176,1,203612,26136,912,0,1441,1463
5826,1,0,0,0,47,0,38,1,0,851568,2223120,30.692018506445613,684,2104,1846,942,37024,420080,490880,2102,3302,2618,3264,4464,30.066592756745816,16.072563944740665,1200,1,195936,24252,904,0,1418,1456
5827,1,0,0,0,46,0,65,1,0,902394,2266798,31.352830813181765,983,1901,1901,983,33712,451976,396632,2306,3289,2306,3224,4207,30.298514815086232,0.0,983,1,169076,0,918,0,1323,1388
5828,1,0,0,0,49,0,327,1,0,990340,2075320,29.068883707497267,445,2417,2017,845,36504,530496,415064,2056,3301,2856,3628,4873,34.23448553724738,20.29359657724962,1245,1,142805,74000,1172,0,1611,1284
5829,1,0,0,0,47,0,547,0,1,1260378,2092986,29.698484809834994,822,2371,2311,882,47916,469854,574266,2313,3255,2433,3802,4744,37.8021163428716,8.36489227295508,942,1,213444,4560,1429,0,1491,944
5830,1,0,0,0,48,0,484,1,0,1521485,2458330,31.85906464414798,805,2724,2514,1015,44180,569170,455336,2212,3437,2632,3921,5146,38.71692136521188,14.967226076702845,1225,1,190820,39480,1499,0,1407,923
5831,1,0,0,0,48,0,336,0,1,1082692,2152094,29.765752132274432,376,2618,2108,886,53352,599963,524664,1919,3315,2939,3651,5047,34.95711658589707,22.904644105113274,1396,1,191376,85170,1222,0,1543,1207
5832,1,0,0,0,48,0,335,0,1,917700,1950515,28.372521918222215,207,2543,1945,805,56168,571828,576674,1825,3228,3021,3563,4966,33.76388603226827,24.684775987507244,1403,1,191590,75946,1140,0,1618,1283
5833,0,1,0,1,67,0,165,0,0,17856496,14525639,65.64297372910524,4279,8483,8453,4309,50369,812411,704539,3341,7680,3401,7515,11854,64.37390775772433,5.483301264452448,4339,1,900581,5100,4144,0,938,773
5834,0,1,0,1,67,0,140,0,0,17484224,14354752,65.20736154760442,4162,8454,8364,4252,51728,823744,715712,3286,7628,3466,7488,11830,64.1248781675256,9.505517133991825,4342,1,901424,15300,4112,0,876,736
5835,0,1,0,1,67,0,91,0,0,16762860,13943520,64.34283176858165,3990,8339,8189,4140,49053,663496,838632,3218,7508,3518,7417,11707,63.631753079732135,13.66030228366151,4290,1,1030860,9450,4049,0,772,681
5836,0,1,0,1,67,0,177,0,0,13693270,12183036,60.108235708594876,3271,7745,7403,3613,24156,667656,411384,3030,6985,3714,7162,11117,61.56297588648554,18.579946881464135,3955,1,440786,70794,3790,0,241,418
5837,0,1,1,0,61,0,1600,0,0,5806521,5361337,41.701318923986086,1397,5420,5078,1739,25531,650513,373043,2741,4822,3425,6422,8503,57.784080852774665,18.55616436325553,2081,1,210419,75924,3339,0,1344,256
5838,0,0,0,0,58,1,1728,1,0,1318473,6751134,47.968739820845826,2177,2998,2874,2301,53714,627876,736434,2810,5235,3058,3507,5932,23.93741840717165,11.363102531111466,2425,1,577551,9672,573,0,633,2361
5839,0,0,0,0,58,1,1828,1,0,1252629,6859972,48.569537778323564,2264,2985,2890,2359,52750,613588,727000,2813,5267,3003,3439,5893,23.043437243605826,9.773682308767459,2454,1,589750,7505,531,0,549,2377
5840,0,0,1,0,60,1,1102,0,0,4327503,8149545,51.99038372622383,2200,4807,4304,2703,49405,726615,618075,2512,5718,3518,4616,7822,40.01249804748511,22.646059941433194,3206,1,554115,88528,1601,0,312,1414
5841,1,0,0,0,48,0,7,0,1,875148,2255478,30.643106892089126,531,2279,1871,939,50996,502018,586088,1994,3341,2810,3334,4681,30.528675044947494,20.203376758370833,1347,1,229116,36312,932,0,1463,1470
5842,1,0,0,0,47,0,16,0,1,1198961,2626243,33.21144381083123,808,2485,2190,1103,54180,600012,511915,2086,3484,2676,3468,4866,32.96968304366907,17.59585963107912,1398,1,237145,48970,1087,0,1278,1294
5843,1,0,0,0,47,0,44,0,1,1229397,2694042,33.63034344160047,863,2486,2218,1131,56105,583590,545478,2114,3513,2650,3469,4868,32.96968304366907,16.862371888525946,1399,1,258999,38592,1087,0,1251,1295
5844,1,0,0,0,45,0,625,0,1,1115646,3233818,37.603191353926334,1414,2203,2203,1414,56350,526010,560315,2287,3701,2287,3076,4490,28.089143810376278,0.0,1414,1,346430,0,789,0,873,1498
5845,1,0,0,0,46,0,972,1,0,563040,3227820,37.14835124201342,1285,1883,1788,1380,39360,575394,374240,2244,3719,2434,2747,4222,20.199009876724155,9.874922862703322,1475,1,220800,20995,408,0,959,1931
5846,1,0,0,0,47,0,965,1,0,371700,2976120,35.4964786985977,1048,1767,1555,1260,37000,436970,472400,2150,3622,2574,2657,4129,17.175564037317667,14.59250857348724,1472,1,252000,23956,295,0,1102,2067
5847,1,0,0,0,49,0,482,0,1,201000,1851750,27.386127875258307,492,1276,1018,750,52364,523428,609843,2211,3219,2727,2737,3745,16.3707055437449,16.453497044727893,1008,1,185250,22704,268,0,1719,2201
5848,1,0,0,0,48,0,192,0,0,244800,1446600,24.49489742783178,399,1209,1008,600,42560,458090,540064,2210,3011,2612,2819,3620,20.199009876724155,14.545050792182467,801,1,134400,18492,408,0,1811,2003
5849,1,0,0,0,49,0,1622,0,1,565515,723340,17.175564037317667,205,2302,2212,295,48279,566412,512468,2362,2747,2542,4369,4754,43.78355855797927,9.510461639168101,385,1,61655,14400,1917,0,2157,535
5850,1,0,0,0,49,0,1289,0,1,478590,747383,17.349351572897472,301,1891,1891,301,49932,543777,566124,2483,2784,2483,4073,4374,39.87480407475377,0.0,301,1,68628,0,1590,0,2182,893
5851,1,0,0,0,47,0,272,0,1,893529,1927926,28.61817604250837,819,1910,1910,819,53320,506110,583792,2354,3173,2354,3445,4264,33.03028912982749,0.0,819,1,203112,0,1091,0,1535,1263
5852,1,0,0,0,46,0,251,0,0,885800,1931456,28.705400188814647,824,1899,1899,824,47936,501616,525056,2344,3168,2344,3419,4243,32.78719262151,0.0,824,0,184576,0,1075,0,1520,1269
5853,1,0,0,0,47,0,210,1,0,876339,1966950,28.930952282978865,795,1926,1884,837,32763,472350,383050,2308,3187,2392,3397,4276,32.357379374726875,6.678188844436455,879,1,136431,7266,1047,0,1513,1303
5854,1,0,0,0,46,0,6,1,0,902491,2210007,30.870698080866262,953,1900,1900,953,50007,549603,489309,2319,3272,2319,3266,4219,30.773365106858236,0.0,953,1,201083,0,947,0,1366,1372
5855,1,0,0,0,48,0,334,1,0,954192,2017152,28.705400188814647,394,2412,1982,824,32616,528768,369648,2018,3272,2878,3606,4860,34.02939905434711,20.741934495401743,1254,1,124424,86860,1158,0,1624,1290
5856,1,0,0,0,47,0,580,0,1,1204125,2013635,29.068883707497267,760,2355,2270,845,50225,488515,583835,2298,3228,2468,3808,4738,37.749172176353746,9.412769291411893,930,1,207025,6800,1425,0,1538,958
5857,1,0,0,0,48,0,359,0,1,1079750,2125375,29.58039891549808,365,2619,2109,875,51240,592676,510090,1919,3304,2939,3663,5048,35.12833614050059,22.904644105113274,1385,1,183750,87720,1234,0,1554,1195
5858,0,1,0,1,67,0,246,0,0,18552352,14962432,66.57326790837296,4432,8618,8618,4432,50621,766352,752848,3376,7808,3376,7562,11994,64.69930447848725,0.0,4432,1,988336,0,4186,0,1056,810
5859,0,1,0,1,67,0,212,0,0,17974845,14653737,65.93178292750773,4317,8512,8482,4347,51192,798927,728136,3341,7718,3401,7506,11883,64.3039656630911,5.483301264452448,4377,1,938952,4740,4135,0,976,764
5860,0,1,0,1,67,0,152,0,0,17059385,14207039,64.8613906727261,4054,8415,8262,4207,54918,820611,763202,3224,7584,3530,7432,11792,63.67888189973188,12.38000312170145,4360,1,950782,23103,4055,0,830,678
5861,0,1,0,1,67,0,128,0,0,16699473,13976417,64.42825467137845,4001,8324,8174,4151,52328,710437,835016,3217,7518,3517,7390,11691,63.42712353559792,13.531383308295037,4301,1,1029448,12450,4023,0,784,656
5862,0,1,1,0,60,0,1626,0,0,6329767,5564409,42.790185790669334,1597,5522,5288,1831,26865,604761,410265,2805,4870,3273,6496,8561,58.7962583843564,15.297128382228511,2065,0,247185,46098,3457,1,1208,418
5863,0,1,1,0,63,0,1029,0,0,1827652,2956304,30.528675044947494,597,3228,2893,932,56876,748592,764452,2837,4104,3507,5133,6400,44.28317965096906,18.48335216920125,1267,1,224612,39865,1961,0,2240,1211
5864,0,0,1,0,60,1,808,0,0,4442100,7708650,50.49752469181039,2066,4776,4292,2550,51754,683198,692267,2539,5573,3507,4765,7799,41.737273509418415,22.288779552388437,3034,1,583950,62920,1742,0,473,1281
5865,1,0,0,0,47,0,36,0,1,1214080,2657760,33.46640106136302,864,2460,2204,1120,55822,586131,536298,2117,3493,2629,3457,4833,32.92415526630866,16.433479630243024,1376,1,253120,38400,1084,0,1253,1289
5866,1,0,0,0,47,0,211,0,1,1197770,2848620,34.713109915419565,1030,2374,2199,1205,56088,538992,581544,2189,3569,2539,3358,4738,31.52776554086889,13.82718351554167,1380,1,296430,18025,994,0,1159,1370
5867,1,0,0,0,45,0,561,0,1,1121440,3152416,37.094473981982816,1376,2191,2191,1376,52920,481110,577332,2291,3667,2291,3106,4482,28.548204847240395,0.0,1376,1,346752,0,815,0,915,1476
5868,1,0,0,0,47,0,974,1,0,314880,2912640,35.07135583350036,1014,1702,1486,1230,37976,445184,478336,2152,3598,2584,2624,4070,16.0,14.749887706321637,1446,1,248460,24840,256,0,1138,2112
5869,1,0,0,0,47,0,960,1,0,166500,2649570,33.31666249791537,813,1557,1260,1110,38080,568106,381920,2090,3497,2684,2537,3944,12.24744871391589,17.237642888340194,1407,1,177600,64152,150,0,1277,2237
5870,1,0,0,0,48,0,865,1,0,91200,2344320,30.983866769659336,636,1379,1055,960,35708,551892,385836,2118,3402,2766,2537,3821,9.746794344808963,18.00210011254176,1284,1,151680,66744,95,0,1482,2347
5871,1,0,0,0,49,0,665,0,1,147000,2080680,28.982753492378876,563,1292,1015,840,41724,564756,453291,2200,3317,2754,2652,3769,13.228756555322953,16.95591470437829,1117,1,153720,50968,175,0,1637,2302
5872,1,0,0,0,49,0,435,0,1,205200,1769040,26.832815729997478,504,1221,1005,720,53105,528255,606879,2241,3177,2673,2742,3678,16.881943016134134,15.068492412224764,936,1,177840,19440,285,0,1737,2172
5873,1,0,0,0,49,0,1601,0,1,417012,563388,15.0996688705415,94,2191,2057,228,47670,518910,560917,2337,2699,2605,4300,4662,42.76680956068619,11.700176052913939,362,1,51756,15142,1829,0,2243,642
5874,1,0,0,0,49,0,1618,0,1,479744,630016,16.0,136,2250,2130,256,45570,516810,534037,2341,2717,2581,4335,4711,43.289721643826724,11.015556749295067,376,1,55552,15000,1874,0,2205,587
5875,1,0,0,0,47,0,244,1,0,864960,1933104,28.5657137141714,731,1961,1876,816,27885,461955,338767,2284,3185,2454,3429,4330,32.55764119219941,9.568061544601736,901,1,116688,15725,1060,0,1553,1309
5876,1,0,0,0,47,0,83,1,0,945980,2190200,30.528675044947494,782,2097,1947,932,45612,592200,425350,2200,3282,2500,3365,4447,31.85906464414798,13.02043424578037,1082,1,168692,30750,1015,0,1418,1335
5877,1,0,0,0,46,0,666,0,1,1281511,1989603,29.103264421710495,847,2360,2360,847,48777,537921,500337,2349,3196,2349,3862,4709,38.897300677553446,0.0,847,1,180411,0,1513,0,1502,836
5878,1,0,0,0,48,0,416,0,1,1469636,2470174,31.96873472629156,722,2760,2460,1022,56105,592165,553493,2117,3439,2717,3855,5177,37.92097045171708,17.57139571414826,1322,1,234038,43500,1438,0,1395,979
5879,1,0,0,0,48,0,384,0,1,1078272,2098656,29.393876913398138,354,2622,2112,864,51623,599963,507661,1919,3293,2939,3677,5051,35.32704346531139,22.904644105113274,1374,1,180576,89250,1248,0,1565,1181
5880,0,1,0,1,67,0,82,0,0,13732755,12420685,60.53924347066124,3364,7713,7412,3665,25482,630354,464293,3088,7054,3690,7136,11102,61.212743771211564,17.54219988156914,3966,1,502105,53879,3747,0,276,358
5881,1,0,0,0,48,0,8,0,1,685568,2021760,28.844410203711913,482,2006,1656,832,51948,539460,568620,2080,3262,2780,3254,4436,28.705400188814647,18.769078269221712,1182,1,194688,41300,824,0,1598,1606
5882,1,0,0,0,46,0,986,1,0,653760,3349440,37.94733192202055,1410,1924,1894,1440,43608,551262,427984,2296,3766,2356,2780,4250,21.307275752662516,5.5965095842615735,1470,1,264960,5790,454,0,886,1872
5883,1,0,0,0,47,0,985,1,0,492750,3177900,36.742346141747674,1242,1823,1715,1350,32660,541420,334268,2246,3704,2462,2719,4177,19.1049731745428,10.551011889467135,1458,1,191700,24192,365,0,1004,1989
5884,1,0,0,0,49,0,736,0,1,116580,2154990,29.49576240750525,614,1260,1004,870,38532,564756,418613,2221,3347,2733,2611,3737,11.575836902790225,16.181518938083777,1126,1,147030,50688,134,0,1607,2343
5885,1,0,0,0,46,0,333,0,1,218790,765270,18.16590212458495,300,1023,993,330,53520,517137,556560,2289,2649,2349,2982,3342,25.748786379167466,5.531194905403055,360,1,79200,3330,663,0,1989,1656
5886,1,0,0,0,49,0,1596,0,1,339340,471390,13.784048752090222,15,2151,1976,190,50388,548301,565668,2306,2671,2656,4267,4632,42.261093218230876,13.382010133418634,365,1,43320,21875,1786,0,2291,695
5887,1,0,0,0,49,0,1417,0,1,397680,598800,15.491933384829668,173,1964,1897,240,47088,538920,543910,2428,2735,2562,4152,4459,40.70626487409524,8.250220863768833,307,1,52320,8911,1657,0,2255,838
5888,1,0,0,0,49,0,1399,0,1,397122,603306,15.556349186104045,182,1943,1883,242,41516,533502,483642,2433,2735,2553,4134,4436,40.50925820105819,7.7992067098508295,302,1,46948,9480,1641,0,2251,852
5889,1,0,0,0,49,0,1379,1,0,401622,617006,15.716233645501712,187,1933,1873,247,37914,532074,444644,2438,2745,2558,4124,4431,40.32369030731191,7.864259938752337,307,1,43966,10440,1626,0,2251,872
5890,1,0,0,0,48,0,508,0,1,947520,1814576,27.422618401604176,602,2162,2012,752,52118,497078,610489,2263,3165,2563,3673,4575,35.4964786985977,12.360324274125283,902,1,190256,9600,1260,0,1661,1153
5891,1,0,0,0,47,0,421,0,1,882096,1774720,27.422618401604176,752,1925,1925,752,51948,523920,552240,2360,3112,2360,3533,4285,34.249087579087416,0.0,752,1,175968,0,1173,0,1608,1187
5892,1,0,0,0,48,0,164,1,0,847052,2025852,29.017236257093817,587,2103,1848,842,38407,464358,478794,2151,3248,2661,3412,4509,31.71750305430741,15.968780816855594,1097,1,167558,31620,1006,0,1564,1400
5893,1,0,0,0,47,0,133,1,0,852128,2045279,29.30870177950569,689,2021,1851,859,40205,445247,511915,2211,3240,2551,3373,4402,31.496031496047245,13.043927959432365,1029,1,184685,16660,992,0,1522,1389
5894,1,0,0,0,47,0,116,1,0,872732,2064178,29.631064780058107,793,1957,1872,878,41940,423180,547783,2266,3229,2436,3345,4308,31.52776554086889,9.265143265380413,963,1,204574,5440,994,0,1473,1357
5895,1,0,0,0,46,0,111,1,0,900370,2074610,29.916550603303182,895,1901,1901,895,40188,456646,472872,2318,3213,2318,3324,4219,31.71750305430741,0.0,895,1,182580,0,1006,0,1423,1312
5896,1,0,0,0,47,0,242,1,0,918515,2027155,29.068883707497267,575,2202,1932,845,28428,494194,331062,2129,3244,2669,3486,4601,32.96968304366907,17.56087982588034,1115,1,116610,54540,1087,0,1554,1312
5897,1,0,0,0,49,0,487,0,1,937710,1870135,27.477263328068172,394,2358,1997,755,48410,582095,510262,2116,3232,2838,3719,4835,35.24202037341219,19.067037578341814,1116,1,155530,60648,1242,0,1722,1235
5898,1,0,0,0,48,0,586,0,1,1006176,1837888,27.422618401604176,512,2330,2090,752,46366,474136,584116,2204,3196,2684,3782,4774,36.578682316343766,15.966938683214861,992,1,179728,18000,1338,0,1692,1106
5899,1,0,0,0,48,0,603,0,1,1025290,1835405,27.477263328068172,545,2323,2113,755,46648,476476,578578,2221,3186,2641,3789,4754,36.851051545376556,14.910611547535398,965,1,179690,16800,1358,0,1676,1073
5900,1,0,0,0,47,0,702,0,1,1220080,1905264,28.42534080710379,808,2318,2318,808,48672,490464,551772,2358,3166,2358,3868,4676,38.8587184554509,0.0,808,1,189072,0,1510,0,1550,848
5901,1,0,0,0,47,0,714,0,1,1255527,1928745,28.61817604250837,819,2352,2352,819,44325,529875,463935,2355,3174,2355,3888,4707,39.153543900903784,0.0,819,1,161343,0,1533,0,1536,822
5902,1,0,0,0,47,0,438,0,1,467563,1191612,22.338307903688676,66,1869,1436,499,43875,465660,537300,1955,2887,2821,3325,4257,30.610455730027933,21.20350680726268,932,1,112275,41568,937,0,1889,1451
5903,1,0,0,0,45,0,449,0,1,244992,731467,17.86057109949175,64,1342,1087,319,49490,463186,561785,2038,2612,2548,3061,3635,27.712812921102035,16.171360672227685,574,1,78155,19890,768,0,1974,1525
5904,0,1,0,1,67,0,236,0,0,17109120,14342720,65.23802572120036,4106,8426,8276,4256,54273,798690,771730,3220,7626,3520,7390,11796,63.40346993658943,12.247584794411392,4406,1,974624,21300,4020,0,886,650
5905,0,1,0,1,66,0,163,0,0,16053414,13657260,63.94528911499267,4004,8100,8015,4089,41952,614560,761520,3255,7429,3425,7266,11440,62.65780079128216,9.714504923012402,4174,1,932292,6460,3926,0,749,586
5906,1,0,0,0,45,0,609,0,0,1085590,3180320,37.282703764614496,1360,2201,2171,1390,47400,542256,457600,2258,3678,2318,3069,4489,27.94637722496424,5.477225575051661,1420,0,278000,5310,781,0,898,1507
5907,1,0,0,0,45,0,668,1,0,1065669,3255186,37.66961640367472,1359,2230,2170,1419,43498,548266,417508,2234,3713,2354,3045,4524,27.40437921208944,7.750803389552748,1479,1,258258,11820,751,0,875,1543
5908,1,0,0,0,46,0,989,0,0,649440,3348000,37.94733192202055,1410,1921,1891,1440,44585,560325,430125,2295,3765,2355,2776,4246,21.236760581595302,5.514871952411144,1470,0,266400,5850,451,0,885,1874
5909,1,0,0,0,47,0,989,1,0,436920,3132360,36.3318042491699,1212,1759,1651,1320,34428,541044,358323,2265,3693,2481,2704,4132,18.193405398660254,10.60004836173973,1428,1,199320,23112,331,0,1053,2042
5910,1,0,0,0,47,0,988,1,0,342720,3011400,35.4964786985977,1098,1694,1532,1260,40809,532970,437370,2228,3650,2552,2662,4084,16.492422502470642,12.842872840790493,1422,1,230580,28836,272,0,1130,2118
5911,1,0,0,0,47,0,30,0,0,245791,1211581,22.60530911091463,426,1077,992,511,51500,488426,592750,2286,2882,2456,2852,3448,21.93171219946131,9.428020440933057,596,1,127750,6290,481,0,1860,1890
5912,1,0,0,0,46,0,330,0,1,218791,767920,18.193405398660254,331,992,992,331,51700,510400,545200,2320,2651,2320,2981,3312,25.709920264364882,0.0,331,1,77785,0,661,0,1989,1659
5913,1,0,0,0,48,0,1314,1,0,330480,525096,14.696938456699069,4,1958,1746,216,26624,505648,311168,2219,2647,2643,3961,4389,39.11521443121589,15.38108197761382,428,1,27648,45156,1530,0,2215,901
5914,1,0,0,0,49,0,1644,0,1,401760,533952,14.696938456699069,36,2256,2076,216,45980,543840,516648,2292,2688,2652,4332,4728,43.12771730569565,13.502634751615815,396,1,45144,26640,1860,0,2256,612
5915,1,0,0,0,50,0,1488,0,1,356580,525840,14.491376746189438,102,2016,1908,210,46438,535856,543368,2396,2714,2612,4202,4520,41.20679555607303,10.489171794062365,318,1,45570,14148,1698,0,2294,806
5916,1,0,0,0,49,0,1092,0,1,646668,1064148,20.639767440550294,396,1974,1944,426,45320,549560,514588,2468,2924,2528,4016,4472,38.961519477556315,5.477225575051661,456,1,87756,4560,1518,0,2072,980
5917,1,0,0,0,47,0,438,1,0,852640,1730100,27.018512172212592,688,1940,1898,730,35870,500070,402900,2328,3100,2412,3538,4310,34.17601498127012,6.589126398255297,772,1,124100,7476,1168,0,1640,1202
5918,1,0,0,0,48,0,208,1,0,841113,1974609,28.61817604250837,627,2038,1846,819,39618,448446,513543,2219,3230,2603,3438,4449,32.046840717924134,13.905851183659104,1011,1,174447,19008,1027,0,1592,1384
5919,1,0,0,0,48,0,671,0,1,1022730,1769520,27.018512172212592,550,2311,2131,730,49852,499344,586608,2244,3154,2604,3825,4735,37.429934544425805,13.846246556523738,910,1,176660,15660,1401,0,1694,1023
5920,1,0,0,0,47,0,750,0,1,1193400,1842360,27.92848008753788,780,2310,2310,780,48108,498382,538536,2362,3142,2362,3892,4672,39.11521443121589,0.0,780,1,177840,0,1530,0,1582,832
5921,1,0,0,0,47,0,760,0,1,1229184,1869912,28.142494558940577,792,2344,2344,792,45571,540669,469839,2361,3153,2361,3913,4705,39.395431207184416,0.0,792,1,157608,0,1552,0,1569,809
5922,1,0,0,0,48,0,437,0,1,963288,1905327,28.053520278211074,214,2584,2011,787,55695,573777,568935,1848,3208,2994,3645,5005,34.9857113690718,24.17490877611208,1360,1,184945,76209,1224,0,1634,1197
5923,1,0,0,0,48,0,440,0,1,910041,1833744,27.54995462791182,156,2561,1958,759,55696,570176,570176,1813,3175,3019,3615,4977,34.62657938636157,24.75784842035259,1362,1,179124,78993,1199,0,1657,1217
5924,1,0,0,0,48,0,449,0,1,756902,1624340,25.96150997149434,70,2401,1797,674,49946,544660,532610,1806,3084,3014,3533,4811,33.51119216023208,24.727017285487907,1278,1,148954,85164,1123,0,1736,1287
5925,0,1,0,1,68,0,2,0,0,13623480,12605040,60.74537019394976,3390,7682,7382,3690,34680,696864,580720,3116,7106,3716,7108,11098,60.76183012385325,17.705874911261695,3990,1,627300,51000,3692,0,274,276
5926,0,0,1,0,60,1,2311,0,0,2330130,9252980,55.40758070878027,2620,4279,3829,3070,45269,672122,611842,2564,6084,3464,3773,7293,27.54995462791182,21.426827099192923,3520,1,623210,71100,759,0,56,2255
5927,1,0,0,0,47,0,71,0,1,1177050,2641076,33.481338085566414,911,2381,2171,1121,56069,534812,581932,2146,3477,2566,3406,4737,32.4037034920393,14.867590397823843,1331,1,276887,21000,1050,0,1235,1306
5928,1,0,0,0,46,0,840,1,0,990000,3472500,38.72983346207417,1366,2294,2160,1500,37910,516245,393550,2181,3815,2449,2975,4609,25.69046515733026,11.700176052913939,1634,1,255000,25728,660,0,815,1655
5929,1,0,0,0,46,0,991,1,0,706080,3420075,38.353617821530214,1471,1951,1951,1471,44220,511500,467325,2325,3796,2325,2805,4276,21.908902300206645,0.0,1471,1,295671,0,480,0,854,1845
5930,1,0,0,0,48,0,992,1,0,210960,2812800,34.23448553724738,980,1544,1352,1172,40352,499200,465600,2208,3572,2592,2580,3944,13.416407864998739,13.901665601458292,1364,1,227368,28608,180,0,1228,2220
5931,1,0,0,0,47,0,992,1,0,171300,2737374,33.793490497431605,930,1504,1292,1142,41128,508164,465018,2185,3539,2609,2547,3901,12.24744871391589,14.56151545997796,1354,1,221548,32648,150,0,1255,2247
5932,1,0,0,0,49,0,572,0,1,164220,1930758,27.964262908219126,607,1167,992,782,55056,548118,612312,2294,3251,2644,2679,3636,14.491376746189438,13.461112333209106,957,1,193936,16625,210,0,1687,2259
5933,1,0,0,0,46,0,205,0,1,237000,920745,19.87460691435179,395,995,995,395,50576,508158,540792,2331,2726,2331,2931,3326,24.49489742783178,0.0,395,1,91640,0,600,0,1936,1731
5934,1,0,0,0,50,0,1612,0,1,386688,538268,14.560219778561036,56,2304,2036,212,52614,601743,563658,2271,2751,2807,4363,4843,42.708313008125245,16.5465476561838,480,1,47064,40468,1824,0,2327,715
5935,1,0,0,0,50,0,1138,0,1,630768,1022040,20.199009876724155,378,1984,1954,408,47424,571140,521040,2475,2913,2535,4051,4489,39.319206502675,5.514871952411144,438,1,84864,4740,1546,0,2097,959
5936,1,0,0,0,48,0,297,1,0,840060,1892280,27.92848008753788,512,2125,1857,780,40392,494904,480348,2158,3206,2694,3503,4551,32.817678162843876,16.370933467052748,1048,1,154440,37788,1077,0,1646,1349
5937,1,0,0,0,48,0,276,1,0,832885,1903625,28.0178514522438,593,2038,1846,785,42210,487425,509250,2233,3210,2617,3486,4463,32.57299494980466,13.893842384028202,977,1,164850,23616,1061,0,1640,1364
5938,1,0,0,0,48,0,260,1,0,836876,1912746,28.178005607210743,644,1998,1848,794,40112,443256,525162,2259,3203,2559,3463,4407,32.46536616149585,12.30702509692623,944,1,173092,13500,1054,0,1615,1355
5939,1,0,0,0,47,0,237,1,0,857380,1934810,28.548204847240395,755,1927,1867,815,43660,439190,560264,2314,3189,2434,3426,4301,32.43454948045371,7.745966692414834,875,1,192340,4080,1052,0,1559,1322
5940,1,0,0,0,48,0,349,1,0,905606,1918267,28.160255680657446,523,2205,1935,793,26250,507990,302375,2149,3212,2689,3561,4624,33.793490497431605,17.687063730426697,1063,1,99125,59130,1142,0,1626,1277
5941,1,0,0,0,49,0,478,1,0,883779,1797529,27.03701166919155,381,2290,1940,731,37275,523767,430325,2109,3190,2809,3668,4749,34.77067730142742,18.732104024653903,1081,1,127925,61250,1209,0,1728,1250
5942,1,0,0,0,47,0,787,0,1,1132248,1760616,27.2213151776324,699,2311,2269,741,46031,453816,572616,2334,3117,2418,3904,4687,39.08964057138413,6.653712290320142,783,1,178581,2856,1528,0,1635,848
5943,1,0,0,0,47,0,807,1,0,1202580,1809225,27.65863337187866,765,2337,2337,765,49560,558140,496650,2365,3130,2365,3937,4702,39.64845520319802,0.0,765,1,160650,0,1572,0,1600,793
5944,1,0,0,0,48,0,448,1,0,1201985,2162320,29.916550603303182,436,2697,2238,895,44312,560512,461456,1957,3311,2875,3759,5113,36.64696440361739,21.55487745196087,1354,1,170945,83079,1343,0,1521,1073
5945,1,0,0,0,46,0,537,0,1,247698,684288,17.233687939614086,63,1365,1131,297,52416,479232,580608,2070,2601,2538,3138,3669,28.879058156387302,15.583967466582514,531,1,74844,16380,834,0,2007,1470
5946,0,1,0,1,67,0,298,0,0,16804203,14304615,65.19969325081216,4039,8416,8204,4251,52899,777315,770585,3153,7616,3577,7318,11781,62.8728876384726,14.56151545997796,4463,1,973479,29044,3953,0,886,588
5947,1,0,0,0,47,0,31,0,1,1141452,2547400,32.92415526630866,844,2377,2137,1084,56635,566350,552250,2110,3434,2590,3403,4727,32.449961479175904,15.75217489050406,1324,1,254740,30720,1053,0,1266,1297
5948,1,0,0,0,46,0,992,0,0,650793,3369405,37.986839826445156,1443,1894,1894,1443,39201,511365,417965,2335,3778,2335,2786,4229,21.236760581595302,0.0,1443,0,258297,0,451,0,892,1884
5949,1,0,0,0,47,0,992,1,0,389193,3091563,35.958309192730404,1198,1689,1594,1293,40869,571449,408861,2296,3684,2486,2692,4080,17.349351572897472,10.012227554748348,1388,1,221103,19665,301,0,1098,2090
5950,1,0,0,0,48,0,991,1,0,255036,2893215,34.68429039204925,1053,1565,1415,1203,42211,531505,459355,2255,3608,2555,2617,3970,14.560219778561036,12.345470001201512,1353,1,229773,25200,212,0,1202,2193
5951,1,0,0,0,48,0,989,1,0,102980,2615692,32.92415526630866,850,1413,1179,1084,39843,562229,412623,2179,3497,2647,2508,3826,9.746794344808963,15.300479647433411,1318,1,185364,47268,95,0,1329,2318
5952,1,0,0,0,49,0,633,0,1,148330,2013050,28.548204847240395,662,1150,997,815,56169,585390,585390,2317,3285,2623,2652,3620,13.490737563232042,12.663046086100817,968,1,193155,19737,182,0,1655,2288
5953,1,0,0,0,46,0,82,0,1,248319,1076355,21.42428528562855,459,1000,1000,459,52800,515900,562800,2345,2804,2345,2886,3345,23.259406699226016,0.0,459,1,110160,0,541,0,1886,1804
5954,1,0,0,0,50,0,1631,0,1,267150,378000,12.24744871391589,42,2123,1931,150,49268,549360,569520,2328,2670,2712,4301,4643,42.20189569201838,13.98329739283976,342,1,33900,24000,1781,0,2370,739
5955,1,0,0,0,50,0,1350,0,1,450679,696655,16.64331697709324,235,1946,1904,277,53808,593540,573420,2473,2792,2557,4142,4461,40.33608806019741,6.488991180673202,319,1,63156,5964,1627,0,2238,888
5956,1,0,0,0,47,0,638,1,0,856680,1582020,25.69046515733026,600,2018,1958,660,34475,419475,472209,2337,3057,2457,3695,4415,36.02776706930364,7.83531632499182,720,1,130020,6180,1298,0,1737,1099
5957,1,0,0,0,47,0,605,0,0,836826,1575824,25.709920264364882,661,1927,1927,661,40170,464880,491104,2384,3045,2384,3650,4311,35.58089374931439,0.0,661,0,136166,0,1266,0,1723,1118
5958,1,0,0,0,47,0,299,1,0,843480,1871276,27.94637722496424,714,1928,1861,781,49140,503160,560664,2329,3177,2463,3476,4324,32.863353450309965,8.397588990243326,848,1,182754,6901,1080,0,1615,1316
5959,1,0,0,0,47,0,298,1,0,844560,1869762,27.964262908219126,740,1904,1862,782,50787,499719,581013,2349,3173,2433,3471,4295,32.863353450309965,6.73127350780198,824,1,190026,3738,1080,0,1609,1311
5960,1,0,0,0,47,0,297,1,0,849370,1867515,28.0178514522438,755,1897,1867,785,49200,475800,585234,2349,3164,2409,3461,4276,32.89376840679705,5.514871952411144,815,1,193110,2160,1082,0,1594,1297
5961,1,0,0,0,47,0,293,1,0,863078,1869076,28.178005607210743,794,1881,1881,794,43811,454322,534358,2354,3148,2354,3441,4235,32.96968304366907,0.0,794,1,180238,0,1087,0,1560,1267
5962,1,0,0,0,49,0,533,1,0,866970,1732536,26.49528259898354,379,2260,1937,702,41140,542960,461516,2145,3170,2791,3703,4728,35.14256678161116,18.021779711427715,1025,1,131274,55233,1235,0,1766,1233
5963,1,0,0,0,49,0,627,0,1,870958,1661396,25.903667693977237,394,2246,1969,671,54731,591764,567004,2199,3147,2753,3774,4722,36.02776706930364,16.738160657857883,948,1,153659,39611,1298,0,1805,1178
5964,1,0,0,0,49,0,689,0,1,892350,1634653,25.709920264364882,391,2281,2011,661,54044,566317,583628,2203,3134,2743,3823,4754,36.742346141747674,16.516722619558088,931,1,155996,33480,1350,0,1812,1123
5965,1,0,0,0,47,0,825,0,1,1071954,1679184,26.49528259898354,617,2314,2229,702,48462,471224,588432,2307,3094,2477,3919,4706,39.07684736515984,9.494144610579708,787,1,172692,5780,1527,0,1690,865
5966,1,0,0,0,47,0,836,0,1,1104437,1695514,26.70205984563738,653,2322,2262,713,48068,468466,580232,2318,3091,2438,3927,4700,39.35733730830886,7.880145860644973,773,1,173972,4320,1549,0,1665,829
5967,1,0,0,0,47,0,829,1,0,1156446,1744632,27.16615541441225,738,2305,2305,738,50760,555540,510624,2364,3102,2364,3931,4669,39.585350825778974,0.0,738,1,159408,0,1567,0,1626,797
5968,1,0,0,0,47,0,604,1,0,1382592,2186976,30.199337741083,617,2723,2428,912,46530,563530,474804,2103,3310,2693,3914,5121,38.93584466786357,17.317668738766237,1207,1,180576,52215,1516,0,1486,882
5969,1,0,0,0,48,0,466,1,0,1270512,2216970,30.298514815086232,481,2739,2302,918,44128,540960,475755,1978,3333,2852,3799,5154,37.20215047547655,21.041154106377075,1355,1,180846,72105,1384,0,1497,1031
5970,1,0,0,0,48,0,494,0,1,860591,1721182,26.70205984563738,89,2544,1920,713,51282,557634,535908,1790,3127,3038,3621,4958,34.741905532080416,25.120517724568764,1337,1,158286,90480,1207,0,1701,1207
5971,1,0,0,0,48,0,534,0,1,494215,1164000,22.02271554554524,68,1921,1504,485,54934,544800,580800,1983,2885,2817,3419,4321,31.921779399024736,20.742746885678333,902,1,117370,46704,1019,0,1915,1381
5972,1,0,0,0,46,0,576,0,1,262800,693600,17.320508075688775,66,1410,1176,300,51106,467024,584936,2078,2612,2546,3188,3722,29.597297173897484,15.550568514571738,534,1,75900,13806,876,0,2012,1436
5973,0,1,0,1,67,0,299,0,0,16214520,14058156,64.64518543557594,3997,8241,8059,4179,48319,770356,709804,3182,7543,3546,7244,11605,62.289646009589745,13.901758655477392,4361,1,881769,28392,3880,0,815,516
5974,0,1,1,0,63,0,1082,0,0,2140919,3213926,31.921779399024736,829,3310,3120,1019,56635,741190,760114,2964,4173,3344,5255,6464,45.83666654546336,14.007737751789053,1209,1,245579,22420,2101,0,2135,1053
5975,0,0,1,0,59,1,1705,0,0,219000,5407475,42.720018726587654,1717,2053,1945,1825,50380,651860,678527,2855,4788,3071,3083,5016,10.954451150103322,10.435690064413366,1933,1,417925,13284,120,0,1138,2843
5976,0,0,1,0,60,1,2391,0,0,2213152,9383392,55.71355310873648,2593,4328,3817,3104,48351,686221,643899,2512,6127,3534,3736,7351,26.70205984563738,22.798151500710016,3615,1,661152,77161,713,0,81,2310
5977,1,0,0,0,46,0,32,0,1,1005753,2392612,31.921779399024736,791,2234,2006,1019,54225,528300,565868,2120,3367,2576,3335,4582,31.416556144810016,15.220284956002983,1247,1,245579,25536,987,0,1329,1361
5978,1,0,0,0,46,0,173,0,1,1155680,2698140,34.132096331752024,1015,2307,2157,1165,54145,511836,567420,2166,3481,2466,3308,4623,31.496031496047245,12.360324274125283,1315,1,285425,15000,992,0,1151,1324
5979,1,0,0,0,46,0,708,1,0,1032460,3304730,37.815340802378074,1340,2242,2152,1430,33972,526908,344339,2221,3741,2401,3033,4553,26.870057685088806,9.740037464252968,1520,1,213070,19440,722,0,881,1589
5980,1,0,0,0,47,0,990,1,0,494575,3204575,36.810324638611924,1313,1762,1720,1355,37510,572330,366575,2323,3720,2407,2730,4127,19.1049731745428,6.5135556243263055,1397,1,210025,9324,365,0,1010,2000
5981,1,0,0,0,48,0,979,1,0,117396,2629453,32.96968304366907,875,1407,1195,1087,39240,527342,435420,2207,3506,2631,2527,3826,10.392304845413264,14.560300768783835,1299,1,195660,37524,108,0,1332,2311
5982,1,0,0,0,49,0,800,0,1,98064,2232772,30.133038346638727,738,1186,1016,908,49949,617209,489341,2289,3367,2629,2567,3645,10.392304845413264,13.047531130373535,1078,1,180692,31960,108,0,1551,2351
5983,1,0,0,0,49,0,687,0,1,137538,2094483,29.13760456866693,715,1145,1011,849,52890,606882,530405,2333,3316,2601,2629,3612,12.727922061357855,11.622136368289254,983,1,182535,22512,162,0,1618,2305
5984,1,0,0,0,48,0,453,0,0,202210,1784850,27.018512172212592,635,1102,1007,730,53250,520785,611250,2350,3175,2540,2722,3547,16.64331697709324,9.886585106410566,825,1,182500,7695,277,0,1715,2168
5985,1,0,0,0,47,0,19,0,1,254430,1163745,22.24859546128699,495,1009,1009,495,49434,503114,543081,2351,2846,2351,2865,3360,22.67156809750927,0.0,495,1,114345,0,514,0,1856,1837
5986,1,0,0,0,50,0,1737,0,1,289170,388008,12.36931687685298,171,2367,2043,153,49608,593424,537632,2212,2689,2860,4426,4903,43.474130238568314,18.119223478368507,477,1,32436,51840,1890,0,2383,646
5987,1,0,0,0,50,0,1400,0,1,422025,640560,15.968719422671311,225,1940,1910,255,53820,587808,577760,2482,2767,2542,4167,4452,40.681691213615984,5.477225575051661,285,1,58650,4140,1655,0,2257,857
5988,1,0,0,0,50,0,1298,0,1,525528,811620,18.0,294,1976,1946,324,49796,591180,528555,2475,2829,2535,4127,4481,40.27406113120453,5.501408174353464,354,1,68364,4920,1622,0,2181,883
5989,1,0,0,0,48,0,502,0,1,813095,1676195,26.1725046566048,475,2082,1872,685,38472,560363,411096,2237,3132,2657,3634,4529,34.45286635390443,15.181851383554056,895,1,115080,42210,1187,0,1762,1260
5990,1,0,0,0,47,0,354,1,0,846640,1798920,27.568097504180443,760,1874,1874,760,46487,480501,542043,2367,3127,2367,3481,4241,33.37663853655727,0.0,760,1,174040,0,1114,0,1607,1253
5991,1,0,0,0,47,0,351,1,0,853740,1806165,27.65863337187866,765,1881,1881,765,40950,460395,495810,2361,3126,2361,3477,4242,33.406586176980134,0.0,765,1,160650,0,1116,0,1596,1245
5992,1,0,0,0,49,0,724,0,1,858981,1563510,25.15949125081825,393,2230,1990,633,54340,610090,543400,2230,3103,2710,3827,4700,36.837480912787726,15.578349751943568,873,1,139260,38400,1357,0,1837,1113
5993,1,0,0,0,47,0,826,1,0,1092807,1682937,26.664583251946766,711,2248,2248,711,47443,537309,494703,2367,3078,2367,3904,4615,39.20459156782532,0.0,711,1,148599,0,1537,0,1656,830
5994,1,0,0,0,48,0,495,1,0,1149844,2068525,29.206163733020468,350,2704,2201,853,44880,533500,494700,1922,3278,2928,3773,5129,36.71511950137164,22.571666469015753,1356,1,174012,76959,1348,0,1572,1077
5995,1,0,0,0,47,0,579,0,1,416746,991914,20.445048300260872,68,1765,1415,418,53676,505449,597996,2023,2791,2723,3370,4138,31.575306807693888,18.942147738489204,768,1,105336,24150,997,0,1955,1376
5996,1,0,0,0,47,0,587,0,1,381030,920790,19.748417658131498,67,1690,1367,390,52920,495810,594972,2038,2751,2684,3338,4051,31.25699921617557,18.162481498374515,713,1,98280,20672,977,0,1971,1384
5997,0,1,0,1,67,0,405,0,0,17218864,14709232,66.007575322837,4139,8527,8309,4357,49896,779856,729216,3158,7733,3594,7328,11903,62.864934582006846,14.764900729971618,4575,1,941112,33136,3952,0,981,576
5998,0,1,1,0,61,0,1192,0,0,7010580,6489552,46.021733996015406,2076,5470,5428,2118,37515,628120,560712,3022,5182,3106,6374,8534,57.532599454570104,6.73127350780198,2160,0,387594,6594,3310,1,946,246
5999,0,0,1,0,57,1,2249,0,0,581022,7153523,49.82971001320397,2453,2747,2717,2483,47897,653987,607891,2851,5364,2911,3115,5628,15.297058540778355,5.501408174353464,2513,0,523913,4590,234,1,398,2647
6000,1,0,0,0,46,0,35,0,1,988724,2377188,31.811947441173732,811,2190,1989,1012,50032,497988,554364,2148,3361,2550,3326,4539,31.25699921617557,14.329730615185033,1213,1,238832,20904,977,0,1337,1372
6001,1,0,0,0,47,0,989,1,0,664632,3411488,38.05259518088089,1418,1937,1907,1448,33908,461776,407588,2326,3804,2386,2815,4293,21.42428528562855,5.623413251903491,1478,1,250504,4710,459,0,908,1897
6002,1,0,0,0,48,0,984,1,0,361665,3046869,35.62302626111375,1202,1621,1554,1269,42066,590646,410571,2334,3670,2468,2686,4022,16.881943016134134,8.416522024785497,1336,1,216999,14137,285,0,1132,2116
6003,1,0,0,0,48,0,975,0,1,201250,2792200,33.91164991562634,1000,1475,1325,1150,40683,517164,463748,2278,3578,2578,2603,3903,13.228756555322953,12.312788037888811,1300,1,219650,24000,175,0,1278,2253
6004,1,0,0,0,48,0,970,0,1,168000,2718240,33.46640106136302,950,1440,1270,1120,38709,502389,453849,2257,3547,2597,2577,3867,12.24744871391589,13.042463317936507,1290,1,209440,26520,150,0,1307,2277
6005,1,0,0,0,47,0,159,0,0,253270,1398875,24.269322199023193,589,1019,1019,589,51062,501125,574750,2375,2964,2375,2805,3394,20.73644135332772,0.0,589,1,142538,0,430,0,1786,1945
6006,1,0,0,0,49,0,1649,0,1,114972,167098,8.18535277187245,239,2089,1783,67,48816,563644,538704,2188,2561,2800,4210,4583,41.42463035441596,17.613088572002617,373,1,14472,44982,1716,0,2427,778
6007,1,0,0,0,50,0,1760,0,1,225600,303720,10.954451150103322,177,2297,2000,120,53352,577068,592254,2234,2651,2828,4411,4828,43.3589667773576,17.345137217244712,417,1,28080,37125,1880,0,2411,651
6008,1,0,0,0,50,0,1753,0,1,175560,239970,9.746794344808963,163,2201,1943,95,52851,598662,563298,2268,2621,2784,4374,4727,42.988370520409354,16.172779254130177,353,1,21185,38958,1848,0,2431,678
6009,1,0,0,0,50,0,1482,0,1,359128,533604,14.560219778561036,145,1973,1906,212,52441,576393,576393,2450,2729,2584,4211,4490,41.15823125451335,8.19672545160342,279,1,48548,8911,1694,0,2305,823
6010,1,0,0,0,47,0,418,1,0,823080,1724136,26.870057685088806,722,1862,1862,722,45162,460884,558792,2388,3110,2388,3528,4250,33.76388603226827,0.0,722,1,168948,0,1140,0,1666,1248
6011,1,0,0,0,47,0,416,1,0,829092,1727154,26.94438717061496,726,1868,1868,726,43382,473421,518622,2379,3105,2379,3521,4247,33.793490497431605,0.0,726,1,158268,0,1142,0,1653,1237
6012,1,0,0,0,47,0,414,1,0,835120,1734480,27.018512172212592,700,1904,1874,730,39179,458568,482328,2346,3106,2406,3520,4280,33.823069050575526,5.483301264452448,760,1,148190,3630,1144,0,1646,1232
6013,1,0,0,0,47,0,396,1,0,895885,1828682,27.730849247724095,661,2042,1934,769,36064,532672,382858,2270,3147,2486,3543,4420,34.132096331752024,10.715687343984417,877,1,123809,21708,1165,0,1609,1213
6014,1,0,0,0,49,0,758,0,1,828555,1496255,24.63736998950984,395,2184,1972,607,55632,601460,562020,2253,3072,2677,3830,4649,36.945906403822335,14.637435620327073,819,1,138396,31376,1365,0,1858,1100
6015,1,0,0,0,47,0,822,1,0,1032295,1625505,26.1725046566048,685,2192,2192,685,44522,536298,467481,2373,3058,2373,3880,4565,38.82009788756334,0.0,685,1,134945,0,1507,0,1688,866
6016,1,0,0,0,47,0,811,1,0,1057700,1663200,26.457513110645905,670,2241,2211,700,42020,522720,453816,2346,3076,2406,3887,4617,38.87158345115362,5.5965095842615735,730,1,133700,5040,1511,0,1676,865
6017,1,0,0,0,47,0,787,1,0,1111908,1744356,27.055498516937366,642,2341,2251,732,35997,507579,402727,2293,3115,2473,3902,4724,38.97435053981015,9.580310602724222,822,1,123708,16380,1519,0,1651,864
6018,1,0,0,0,48,0,749,1,0,1208832,1889587,28.053520278211074,607,2503,2323,787,37664,513814,422576,2221,3188,2581,3937,4904,39.191835884530846,13.687973365625968,967,1,138512,31500,1536,0,1614,865
6019,1,0,0,0,48,0,578,1,0,1363688,2215536,30.23243291566195,554,2766,2406,914,38586,528432,429048,2064,3338,2784,3916,5190,38.62641583165593,19.203691788083756,1274,1,161778,64440,1492,0,1510,932
6020,0,1,1,0,64,0,1436,0,0,6027840,5957920,42.89522117905443,1359,5597,5116,1840,31524,718836,459796,2757,5078,3719,6514,8835,57.23635208501674,22.142532598589526,2321,1,261280,104377,3276,0,1398,38
6021,0,1,0,1,66,0,1124,0,0,4787237,5615373,41.19465984809196,1391,4824,4518,1697,41961,704817,651873,3003,5006,3615,6130,8133,53.113086899558006,17.79877705424555,2003,1,334309,46818,2821,0,1612,488
6022,0,0,1,0,57,1,2355,0,0,429250,7294725,50.24937810560445,2495,2725,2695,2525,43710,678915,537354,2859,5414,2919,3059,5614,13.038404810405298,5.572104574801163,2555,0,469650,5670,170,1,364,2719
6023,1,0,0,0,48,0,34,0,1,708675,2068472,29.30870177950569,576,1967,1684,859,53352,520128,594776,2125,3267,2691,3233,4375,28.722813232690143,17.424879201536484,1142,1,212173,25753,825,0,1549,1583
6024,1,0,0,0,45,0,513,0,0,1090908,3044952,36.49657518178932,1332,2151,2151,1332,48380,468630,539496,2286,3618,2286,3105,4437,28.61817604250837,0.0,1332,0,314352,0,819,0,954,1467
6025,1,0,0,0,47,0,870,1,0,968551,3553872,38.87158345115362,1358,2305,2152,1511,38368,512736,413952,2199,3863,2505,2993,4657,25.317977802344327,12.987350689587542,1664,1,265936,27693,641,0,841,1711
6026,1,0,0,0,47,0,987,1,0,791764,3570493,38.87158345115362,1416,2130,2035,1511,32928,463148,396984,2268,3874,2458,2887,4493,22.891046284519195,9.951904129305408,1606,1,253848,15390,524,0,852,1839
6027,1,0,0,0,47,0,979,1,0,420546,3107874,36.08323710533743,1272,1655,1625,1302,41693,575267,412951,2357,3689,2417,2710,4042,17.97220075561143,5.5965095842615735,1332,1,225246,6210,323,0,1085,2064
6028,1,0,0,0,48,0,853,0,1,121148,2384857,31.25699921617557,787,1291,1101,977,46031,588281,466231,2251,3418,2631,2565,3732,11.135528725660043,13.790153968403581,1167,1,186607,35910,124,0,1464,2317
6029,1,0,0,0,48,0,276,0,0,248245,1572000,25.592967784139454,655,1034,1034,655,46728,475200,566400,2400,3055,2400,2779,3434,19.467922333931785,0.0,655,1,154580,0,379,0,1745,2021
6030,1,0,0,0,47,0,218,0,0,255408,1496140,25.019992006393608,626,1034,1034,626,43320,454100,544920,2390,3016,2390,2798,3424,20.199009876724155,0.0,626,1,142728,0,408,0,1764,1982
6031,1,0,0,0,49,0,1656,0,1,71316,104916,6.48074069840786,293,2075,1740,42,50504,589528,534572,2163,2540,2833,4196,4573,41.20679555607303,18.42511611728293,377,1,8988,53600,1698,0,2456,800
6032,1,0,0,0,50,0,1806,0,1,125491,169108,8.18535277187245,216,2223,1940,67,50794,588092,550232,2241,2591,2807,4397,4747,43.278170016764804,16.910190473258453,350,1,14606,43016,1873,0,2457,651
6033,1,0,0,0,47,0,477,1,0,810810,1658349,26.324893162176366,693,1863,1863,693,43680,466635,536032,2393,3086,2393,3563,4256,34.20526275297414,0.0,693,1,155232,0,1170,0,1700,1223
6034,1,0,0,0,47,0,463,1,0,853664,1718143,26.851443164195103,636,1990,1905,721,36096,457536,448004,2298,3104,2468,3567,4373,34.40930106817051,9.370214040084857,806,1,135548,11475,1184,0,1662,1199
6035,1,0,0,0,48,0,755,1,0,1117500,1792470,27.294688127912362,592,2398,2245,745,37195,517290,416238,2253,3151,2559,3906,4804,38.72983346207417,12.628555195271712,898,1,128885,27540,1500,0,1661,906
6036,1,0,0,0,48,0,564,1,0,1360476,2236248,30.298514815086232,527,2791,2400,918,40232,521304,457968,2045,3354,2827,3918,5227,38.49675310984031,20.04189939903847,1309,1,172584,64124,1482,0,1518,954
6037,1,0,0,0,48,0,553,1,0,987540,1835405,27.477263328068172,154,2664,2063,755,47722,520234,542113,1830,3186,3032,3739,5095,36.16628264005025,24.64273437731013,1356,1,168365,74524,1308,0,1676,1123
6038,1,0,0,0,45,0,715,0,1,184116,456873,14.177446878757825,67,1251,1117,201,51543,470511,565977,2139,2474,2407,3189,3524,30.265491900843113,11.65306661673843,335,1,50049,10184,916,0,2072,1357
6039,0,1,0,1,67,0,456,0,0,16733425,14605525,65.76473218982953,4030,8489,8194,4325,46870,736186,726055,3082,7702,3672,7246,11866,62.20128616033595,17.175564037317667,4620,1,929875,40710,3869,0,948,492
6040,0,1,0,1,67,0,446,0,0,16555896,14510048,65.55913361233506,4003,8445,8150,4298,45100,742720,692080,3081,7674,3671,7228,11821,62.0644825967316,17.460915907820823,4593,1,881090,44840,3852,0,922,476
6041,0,1,0,1,66,0,1243,0,0,5290044,5842998,41.96427051671457,1353,5173,4765,1761,42218,693462,670236,2910,5079,3726,6322,8491,54.80875842417888,20.445662592894642,2169,1,355722,58344,3004,0,1557,314
6042,0,0,1,0,57,1,2257,0,0,494058,7093788,49.57822102496216,2428,2689,2659,2458,49032,655122,623376,2856,5344,2916,3087,5575,14.177446878757825,5.478746393072713,2488,0,530928,4440,201,1,428,2685
6043,1,0,0,0,47,0,980,1,0,635996,3401010,37.76241517699841,1384,1914,1872,1426,32178,443610,412605,2343,3811,2427,2831,4299,21.118712081942874,6.653712290320142,1468,1,246698,6048,446,0,959,1939
6044,1,0,0,0,48,0,965,1,0,353184,3006432,35.32704346531139,1206,1573,1531,1248,39508,573342,399894,2367,3657,2451,2692,3982,16.822603841260722,6.488991180673202,1290,1,207168,8820,283,0,1161,2126
6045,1,0,0,0,48,0,909,0,1,173502,2622879,32.72613634390714,896,1408,1233,1071,41790,514290,487351,2274,3520,2624,2611,3857,12.727922061357855,13.241804011448092,1246,1,213129,25725,162,0,1378,2287
6046,1,0,0,0,48,0,328,0,0,249780,1665660,26.267851073127396,690,1052,1052,690,43095,470730,533494,2414,3104,2414,2776,3466,19.026297590440446,0.0,690,1,152490,0,362,0,1724,2052
6047,1,0,0,0,48,0,270,0,0,257400,1589940,25.69046515733026,660,1050,1050,660,39008,443256,510708,2409,3069,2409,2799,3459,19.748417658131498,0.0,660,1,139920,0,390,0,1749,2019
6048,1,0,0,0,50,0,1938,0,1,119880,152100,7.745966692414834,271,2389,2058,60,50369,610935,529815,2204,2595,2866,4533,4924,44.69899327725402,18.2331701097493,391,1,12540,56270,1998,0,2475,537
6049,1,0,0,0,48,0,539,1,0,793200,1592349,25.709920264364882,661,1861,1861,661,45864,472164,563706,2409,3070,2409,3609,4270,34.64101615137755,0.0,661,1,154674,0,1200,0,1748,1209
6050,1,0,0,0,49,0,643,1,0,838508,1600434,25.475478405713993,402,2188,1941,649,39375,554850,431550,2219,3115,2713,3758,4654,35.94440151122286,15.728841120111328,896,1,113575,46930,1292,0,1817,1174
6051,1,0,0,0,48,0,871,0,1,819360,1369583,23.853720883753127,484,2094,2009,569,53410,524726,589715,2322,2976,2492,3847,4501,37.94733192202055,9.383858473517451,654,1,139405,8330,1440,0,1838,967
6052,1,0,0,0,48,0,749,1,0,1062062,1742186,26.870057685088806,560,2355,2193,722,42550,554990,446405,2251,3135,2575,3884,4768,38.353617821530214,12.998520457496102,884,1,133570,29970,1471,0,1691,942
6053,1,0,0,0,46,0,713,0,1,274230,638208,16.64331697709324,76,1468,1267,277,51832,481536,571392,2103,2581,2505,3294,3772,31.464265445104548,14.186211702904327,478,1,68696,16080,990,0,2027,1314
6054,1,0,0,0,45,0,752,0,1,178980,432250,13.784048752090222,66,1256,1132,190,48039,457275,543725,2151,2465,2399,3217,3531,30.692018506445613,11.147098121756736,314,1,45410,10540,942,0,2085,1333
6055,0,1,1,0,61,0,1143,0,0,6837040,6485505,45.880278987817846,2075,5383,5353,2105,37053,637767,551499,3051,5186,3111,6329,8464,56.991227395100026,5.753771868478424,2135,0,376795,4950,3248,1,976,167
6056,0,0,1,0,59,1,1722,0,0,725200,1043700,18.708286933869708,108,2664,2422,350,52731,647094,724626,2740,3332,3224,5054,5646,45.51922670696417,15.677709056199316,592,1,85050,23958,2072,0,2632,910
6057,1,0,0,0,46,0,45,0,1,1069684,2477608,32.51153641401772,962,2164,2069,1057,54492,534432,560216,2249,3401,2439,3356,4508,31.811947441173732,10.097077230934874,1152,1,252623,11305,1012,0,1287,1332
6058,1,0,0,0,48,0,959,1,0,415692,3086898,35.81898937714463,1283,1607,1607,1283,37324,522102,413832,2406,3689,2406,2730,4013,18.0,0.0,1283,1,220676,0,324,0,1123,2082
6059,1,0,0,0,48,0,953,1,0,375900,3023489,35.397740040855716,1223,1583,1553,1253,36064,540512,388493,2383,3666,2443,2713,3996,17.320508075688775,5.5503012171862105,1283,1,201733,6030,300,0,1160,2113
6060,1,0,0,0,48,0,931,1,0,272610,2847260,34.132096331752024,1080,1484,1399,1165,40248,571896,420368,2359,3609,2529,2678,3928,15.297058540778355,9.231007614073922,1250,1,200380,17085,234,0,1279,2210
6061,1,0,0,0,49,0,808,0,1,180180,2430450,31.464265445104548,810,1352,1172,990,40492,520460,468905,2275,3445,2635,2637,3807,13.490737563232042,13.418995158121604,1170,1,189090,28440,182,0,1465,2273
6062,1,0,0,0,48,0,480,0,0,234000,1906320,27.92848008753788,780,1080,1080,780,49770,513240,579228,2444,3224,2444,2744,3524,17.320508075688775,0.0,780,1,184860,0,300,0,1664,2144
6063,1,0,0,0,49,0,668,1,0,841020,1582530,25.337718918639855,414,2180,1952,642,34615,529975,396865,2237,3107,2693,3775,4645,36.193922141707716,15.111926194470948,870,1,103362,43776,1310,0,1823,1155
6064,1,0,0,0,49,0,779,0,1,782412,1430383,24.020824298928627,387,2123,1933,577,50151,567691,542901,2289,3056,2669,3835,4602,36.823905279043935,13.899524843087859,767,1,126363,27930,1356,0,1902,1123
6065,1,0,0,0,47,0,836,0,1,815301,1373837,24.020824298928627,577,1990,1990,577,50820,550011,523820,2381,2958,2381,3794,4371,37.589892258425,0.0,577,1,126940,0,1413,0,1804,968
6066,1,0,0,0,47,0,823,1,0,837680,1412512,24.331050121192877,592,2007,2007,592,44325,536850,470042,2386,2978,2386,3801,4393,37.61648574760805,0.0,592,1,116624,0,1415,0,1794,971
6067,1,0,0,0,49,0,575,0,1,1190856,2065496,29.0,323,2775,2257,841,40804,496112,496112,1938,3297,2974,3872,5231,37.62977544445356,23.0210731822158,1359,1,169882,69412,1416,0,1615,1040
6068,0,0,1,0,59,1,1165,0,0,409784,4286080,38.05259518088089,1321,1858,1731,1448,50032,698560,627520,2833,4408,3087,3243,4818,16.822603841260722,11.30350933966113,1575,0,306976,20574,283,1,1512,2677
6069,1,0,0,0,47,0,975,1,0,899766,3710952,39.42080668885405,1384,2303,2133,1554,38304,534912,408348,2218,3942,2558,2967,4691,24.06241883103193,13.14546904636285,1724,1,265734,32810,579,0,834,1809
6070,1,0,0,0,49,0,778,0,1,209880,2438370,31.464265445104548,808,1384,1202,990,40337,514767,475359,2281,3453,2645,2675,3847,14.560219778561036,13.507912311643002,1172,1,191070,27664,212,0,1473,2251
6071,1,0,0,0,50,0,1659,0,1,157410,226710,9.486832980505138,292,2221,1839,90,42090,579370,460977,2137,2609,2901,4268,4740,41.82104733265297,19.552349965718946,472,1,16470,71434,1749,0,2429,770
6072,1,0,0,0,50,0,1789,0,1,169110,227790,9.486832980505138,205,2264,1969,90,44884,579599,496076,2236,2621,2826,4410,4795,43.347433603386484,17.211421103174878,385,1,17640,51035,1879,0,2441,652
6073,1,0,0,0,48,0,618,1,0,864919,1629188,25.903667693977237,459,2172,1960,671,33165,488028,400620,2216,3099,2640,3717,4600,35.90264614203248,14.910913195537242,883,1,110715,36252,1289,0,1757,1139
6074,1,0,0,0,48,0,610,1,0,887075,1666605,26.1725046566048,451,2214,1980,685,32706,503631,384414,2199,3118,2667,3728,4647,35.98610843089316,15.71546077299101,919,1,108230,43290,1295,0,1748,1138
6075,1,0,0,0,48,0,917,0,1,678084,1180476,22.0,394,1975,1885,484,55860,556092,597555,2349,2923,2529,3840,4414,37.429934544425805,9.494144610579708,574,1,118580,9630,1401,0,1955,1038
6076,1,0,0,0,48,0,912,0,1,668160,1167840,21.908902300206645,390,1962,1872,480,54500,608250,530394,2343,2913,2523,3825,4395,37.30951621235526,9.486832980505138,570,1,104640,14760,1392,0,1953,1041
6077,1,0,0,0,48,0,901,0,1,670340,1177088,22.0,394,1959,1869,484,56640,573952,583680,2342,2916,2522,3817,4391,37.21558813185679,9.488003977624334,574,1,116160,10800,1385,0,1948,1047
6078,1,0,0,0,47,0,844,0,1,741597,1280208,23.173260452512935,537,1918,1918,537,51302,538784,541168,2384,2921,2384,3765,4302,37.16180835212409,0.0,537,1,121899,0,1381,0,1847,1003
6079,1,0,0,0,47,0,832,1,0,762033,1313584,23.473389188611005,551,1934,1934,551,45144,543552,472032,2384,2935,2384,3767,4318,37.1887079635741,0.0,551,1,109098,0,1383,0,1833,1001
6080,1,0,0,0,47,0,763,1,0,893838,1530562,25.25866188063018,514,2163,2039,638,44268,570962,446214,2275,3037,2523,3800,4562,37.429934544425805,11.274838741931772,762,1,118668,23684,1401,0,1761,998
6081,1,0,0,0,49,0,582,0,1,1333800,2221200,30.0,434,2848,2382,900,36080,505940,434368,2002,3368,2934,3950,5316,38.49675310984031,21.95941072438411,1366,1,158400,77356,1482,0,1568,986
6082,1,0,0,0,47,0,679,0,1,606390,1212780,22.58317958127243,134,2075,1699,510,55125,535050,582610,2002,2888,2754,3567,4453,34.48187929913333,19.505053329598628,886,1,124950,39480,1189,0,1868,1189
6083,0,0,1,0,59,1,725,0,0,134334,2603270,29.631064780058107,783,1126,1031,878,52122,649335,705670,2870,3843,3060,3118,4091,12.36931687685298,9.773682308767459,973,1,208964,10355,153,0,2087,2812
6084,1,0,0,0,46,0,50,0,1,934464,2323264,31.496031496047245,897,2029,1934,992,56350,538660,573790,2247,3334,2437,3284,4371,30.692018506445613,10.06192246325636,1087,1,243040,10165,942,0,1350,1400
6085,1,0,0,0,46,0,769,1,0,1032642,3455379,38.353617821530214,1376,2268,2173,1471,35574,568458,345303,2254,3820,2444,3051,4617,26.49528259898354,10.172010733280942,1566,1,216237,21660,702,0,878,1647
6086,1,0,0,0,48,0,947,1,0,597540,3336840,37.14835124201342,1295,1898,1813,1380,39083,505362,452166,2333,3798,2503,2851,4316,20.808652046684813,9.290499583346438,1465,1,258060,13515,433,0,1038,1985
6087,1,0,0,0,48,0,936,1,0,506880,3198360,36.3318042491699,1278,1746,1704,1320,36108,494292,428871,2381,3743,2465,2807,4169,19.595917942265423,6.538739683827756,1362,1,233640,6804,384,0,1103,2039
6088,1,0,0,0,49,0,808,0,1,254100,2592450,32.4037034920393,870,1472,1292,1050,39831,525897,461703,2289,3519,2649,2711,3941,15.556349186104045,13.514804416149667,1230,1,196350,29520,242,0,1419,2227
6089,1,0,0,0,49,0,780,0,1,244800,2521440,31.937438845342623,810,1470,1260,1020,39104,514176,464736,2262,3492,2682,2712,3942,15.491933384829668,14.585423422348626,1230,1,191760,32760,240,0,1452,2232
6090,1,0,0,0,49,0,541,0,1,252300,2073906,29.0,774,1208,1141,841,42848,507996,512928,2399,3307,2533,2766,3674,17.320508075688775,8.299636160530056,908,1,174928,8844,300,0,1625,2166
6091,1,0,0,0,48,0,695,1,0,790314,1473796,24.63736998950984,425,2091,1909,607,35223,483172,429756,2246,3035,2610,3730,4519,36.08323710533743,13.650779037925874,789,1,107439,28574,1302,0,1821,1126
6092,1,0,0,0,48,0,689,1,0,807726,1504830,24.859605789312106,417,2126,1925,618,32835,484565,401775,2234,3053,2636,3742,4561,36.15245496505044,14.444902838139441,819,1,101970,33969,1307,0,1817,1128
6093,1,0,0,0,49,0,741,1,0,835912,1525216,24.819347291981714,424,2165,1973,616,38233,547196,428348,2284,3092,2668,3833,4641,36.837480912787726,13.857909732226029,808,1,106568,35904,1357,0,1860,1119
6094,1,0,0,0,47,0,853,0,1,670950,1188824,22.293496809607955,497,1847,1847,497,45998,504712,521456,2392,2889,2392,3742,4239,36.742346141747674,0.0,497,1,108346,0,1350,0,1895,1042
6095,1,0,0,0,47,0,814,1,0,733055,1296777,23.259406699226016,499,1938,1896,541,43232,536928,462621,2355,2938,2439,3752,4335,36.810324638611924,6.63067838716079,583,1,104413,7140,1355,0,1856,1042
6096,1,0,0,0,48,0,655,1,0,869876,1598959,25.709920264364882,177,2461,1977,661,48400,483800,585398,1935,3080,2903,3735,4880,36.27671429443411,22.17162877421657,1145,1,159962,37752,1316,0,1758,1103
6097,0,1,1,0,64,0,1148,0,0,3034080,4047120,35.4964786985977,930,3998,3668,1260,47040,629552,770880,2882,4472,3542,5620,7210,49.07137658554119,18.625614993757807,1590,1,302400,25080,2408,0,1952,804
6098,1,0,0,0,46,0,53,0,1,1109160,2491560,32.863353450309965,1080,2107,2107,1080,55615,523689,565215,2307,3387,2307,3334,4414,32.046840717924134,0.0,1080,1,264600,0,1027,0,1227,1280
6099,1,0,0,0,45,0,55,0,1,1171050,2550780,33.31666249791537,1110,2165,2165,1110,56635,553818,540030,2298,3408,2298,3353,4463,32.48076353782343,0.0,1110,1,260850,0,1055,0,1188,1243
6100,1,0,0,0,45,0,173,0,0,1166490,2686320,34.20526275297414,1170,2167,2167,1170,55000,574000,505120,2296,3466,2296,3293,4463,31.575306807693888,0.0,1170,0,257400,0,997,0,1126,1299
6101,1,0,0,0,46,0,232,0,1,1161600,2762400,34.64101615137755,1170,2198,2168,1200,52624,582406,478816,2272,3502,2332,3270,4500,31.11269837220809,5.531194905403055,1230,1,249600,5100,968,0,1102,1334
6102,1,0,0,0,46,0,290,0,1,1156200,2838840,35.07135583350036,1188,2212,2170,1230,52961,579308,486988,2266,3538,2350,3248,4520,30.659419433511783,6.609134537568676,1272,1,259530,6888,940,0,1078,1368
6103,1,0,0,0,46,0,349,0,1,1147860,2911860,35.4964786985977,1218,2213,2171,1260,55822,570817,522286,2269,3571,2353,3222,4524,30.18277654557314,6.63067838716079,1302,1,284760,6048,911,0,1051,1400
6104,1,0,0,0,46,0,466,0,1,1127280,3037320,36.3318042491699,1320,2174,2174,1320,53110,520026,540735,2301,3621,2301,3155,4475,29.223278392404914,0.0,1320,1,310200,0,854,0,981,1447
6105,1,0,0,0,49,0,863,1,0,362148,2879604,34.23448553724738,1105,1548,1481,1172,38060,540540,425061,2390,3629,2524,2766,4005,17.578395831246947,8.345174736691893,1239,1,202756,12462,309,0,1285,2148
6106,1,0,0,0,48,0,916,0,1,562877,1023451,20.518284528683193,391,1788,1758,421,52650,546975,568854,2401,2852,2461,3768,4219,36.565010597564445,5.483301264452448,451,1,98514,3660,1337,0,2010,1094
6107,1,0,0,0,48,0,907,0,1,559088,1019662,20.518284528683193,391,1779,1749,421,54054,566748,559482,2392,2843,2452,3750,4201,36.4417343165772,5.501408174353464,451,1,97251,4080,1328,0,2001,1094
6108,1,0,0,0,48,0,874,0,1,588720,1074860,21.118712081942874,446,1766,1766,446,51051,532610,556710,2410,2856,2410,3730,4176,36.3318042491699,0.0,446,1,103026,0,1320,0,1964,1090
6109,1,0,0,0,48,0,850,1,0,620400,1128470,21.6794833886788,440,1820,1790,470,41616,489804,489804,2371,2871,2431,3721,4221,36.3318042491699,5.490867587491313,500,1,95880,3990,1320,0,1931,1081
6110,1,0,0,0,48,0,700,1,0,899621,1600942,25.709920264364882,433,2250,2022,661,47671,598234,467446,2194,3083,2650,3783,4672,36.89173349139343,15.271081087865298,889,1,127573,43776,1361,0,1761,1061
6111,1,0,0,0,49,0,607,0,1,1143320,1994952,28.42534080710379,408,2623,2223,808,37800,555525,414792,2069,3277,2869,3884,5092,37.61648574760805,20.435563617292818,1208,1,135744,78400,1415,0,1661,1054
6112,1,0,0,0,49,0,636,0,1,1175776,2007264,28.495613697550013,260,2812,2260,812,45342,489456,566088,1920,3284,3024,3920,5284,38.05259518088089,23.818721056641014,1364,1,185948,52440,1448,0,1660,1024
6113,0,1,1,0,62,0,328,0,0,8388905,8523018,52.316345438113316,2495,6044,5802,2737,51706,641484,781614,2872,5851,3356,6179,9158,55.362442142665635,15.994931674296774,2979,1,686987,17182,3065,0,377,49
6114,0,1,1,0,61,0,368,0,0,8249028,8316378,51.90375708944392,2502,5948,5756,2694,53928,660618,777924,2895,5781,3279,6149,9035,55.33534132902769,14.152112943504028,2886,1,678888,14016,3062,0,393,25
6115,1,0,0,0,46,0,56,0,1,1043700,2421300,32.4037034920393,1020,2074,2044,1050,55822,521156,569582,2276,3356,2336,3300,4380,31.52776554086889,5.477225575051661,1080,1,259350,2880,994,0,1256,1312
6116,1,0,0,0,45,0,281,0,0,1167270,2822850,35.07135583350036,1200,2209,2179,1230,54612,564570,509490,2265,3525,2325,3244,4504,30.805843601498726,5.477225575051661,1260,0,273060,4740,949,0,1065,1346
6117,1,0,0,0,45,0,340,0,0,1159200,2895480,35.4964786985977,1230,2210,2180,1260,55304,569904,512454,2268,3558,2328,3218,4508,30.331501776206203,5.477225575051661,1290,0,280980,4680,920,0,1038,1378
6118,1,0,0,0,45,0,398,0,0,1150680,2964420,35.91656999213594,1290,2182,2182,1290,55370,563010,519348,2298,3588,2298,3190,4480,29.866369046136157,0.0,1290,0,291540,0,892,0,1008,1406
6119,1,0,0,0,46,0,514,0,0,1128600,3107700,36.742346141747674,1350,2186,2186,1350,47235,540970,462702,2302,3652,2302,3138,4488,28.91366458960192,0.0,1350,0,271350,0,836,0,952,1466
6120,1,0,0,0,46,0,616,1,0,1088880,3227552,37.36308338453881,1366,2206,2176,1396,40180,566440,379168,2282,3708,2342,3092,4518,27.92848008753788,5.501408174353464,1426,1,228944,6510,780,0,916,1532
6121,1,0,0,0,48,0,932,1,0,796893,3561714,38.379682124790975,1283,2204,2014,1473,38376,565812,396552,2228,3891,2608,2959,4622,23.259406699226016,13.86916870676514,1663,1,241572,39710,541,0,945,1877
6122,1,0,0,0,49,0,853,1,0,421050,2959380,34.68429039204925,1136,1620,1553,1203,35811,509220,425580,2393,3663,2527,2810,4080,18.708286933869708,8.544404542961196,1270,1,208119,11457,350,0,1257,2110
6123,1,0,0,0,49,0,867,0,1,742338,1319535,23.043437243605826,423,2037,1929,531,54280,586460,571550,2377,3016,2593,3883,4522,37.389838191679836,10.429745618880121,639,1,122130,15012,1398,0,1954,1087
6124,1,0,0,0,49,0,905,0,1,597164,1089780,21.047565179849187,383,1851,1791,443,55695,578100,583020,2400,2903,2520,3808,4311,36.71511950137164,7.780166052320878,503,1,104991,7680,1348,0,2017,1112
6125,1,0,0,0,49,0,909,0,1,575770,1056510,20.73644135332772,370,1829,1769,430,55454,572481,584766,2397,2887,2517,3796,4286,36.59234892706397,7.759379671981613,490,1,102340,7440,1339,0,2027,1118
6126,1,0,0,0,48,0,918,0,1,527200,975200,20.0,370,1748,1718,400,52650,548550,570492,2408,2838,2468,3756,4186,36.30426972134269,5.501408174353464,430,1,93600,3690,1318,0,2038,1120
6127,1,0,0,0,48,0,912,0,1,507780,946530,19.748417658131498,390,1692,1692,390,48178,529086,536367,2427,2817,2427,3729,4119,36.08323710533743,0.0,390,1,86190,0,1302,0,2037,1125
6128,1,0,0,0,48,0,893,0,1,517200,965600,20.0,400,1693,1693,400,49284,535908,535908,2414,2814,2414,3707,4107,35.958309192730404,0.0,400,1,88800,0,1293,0,2014,1121
6129,1,0,0,0,48,0,860,1,0,554700,1036300,20.73644135332772,400,1750,1720,430,41200,496460,482000,2380,2840,2440,3700,4160,35.91656999213594,5.477225575051661,460,1,86000,4200,1290,0,1980,1120
6130,1,0,0,0,49,0,609,0,1,1055392,1889888,27.694764848252458,388,2522,2143,767,37513,574112,396704,2085,3231,2843,3840,4986,37.094473981982816,19.817838876454456,1146,1,123487,79969,1376,0,1697,1088
6131,1,0,0,0,49,0,604,0,1,1224405,2099825,29.068883707497267,293,2846,2294,845,53550,559125,591430,1933,3330,3037,3934,5331,38.06573262134856,23.868883870093114,1397,1,201110,64032,1449,0,1640,1036
6132,1,0,0,0,48,0,675,1,0,1017126,1775796,26.94438717061496,257,2596,2127,726,47236,479416,589486,1977,3172,2915,3847,5042,37.429934544425805,21.922819823772954,1195,1,174966,35175,1401,0,1720,1045
6133,1,0,0,0,47,0,794,1,0,432215,874076,19.261360284258224,170,1737,1536,371,38295,435860,487692,2155,2727,2557,3521,4093,34.132096331752024,14.289801709712407,572,1,76797,21105,1165,0,1985,1191
6134,1,0,0,0,45,0,916,0,0,124320,274080,10.954451150103322,120,1156,1156,120,42680,443096,502480,2284,2404,2284,3320,3440,32.18695387886216,0.0,120,0,26400,0,1036,0,2164,1248
6135,0,0,1,0,60,1,2366,0,0,3082200,10051800,57.445626465380286,2846,4688,4234,3300,48972,703626,645752,2592,6346,3500,3980,7734,30.56141357987225,21.308206068227395,3754,1,699600,70824,934,0,254,2112
6136,1,0,0,0,46,0,495,0,0,1136674,3095994,36.6333181680284,1342,2189,2189,1342,38915,496005,417567,2307,3649,2307,3154,4496,29.103264421710495,0.0,1342,0,242902,0,847,0,965,1460
6137,1,0,0,0,46,0,536,0,0,1109745,3127340,36.810324638611924,1355,2174,2174,1355,39528,498528,422364,2308,3663,2308,3127,4482,28.61817604250837,0.0,1355,0,247965,0,819,0,953,1489
6138,1,0,0,0,47,0,832,1,0,927345,3486700,38.27531841800928,1357,2206,2098,1465,36450,578340,357000,2272,3845,2488,3013,4586,25.15949125081825,10.715687343984417,1573,1,219750,24516,633,0,915,1747
6139,1,0,0,0,49,0,830,1,0,821784,1441032,24.124676163629637,370,2206,1994,582,37904,510056,455584,2264,3058,2688,3888,4682,37.57658845611187,14.56151545997796,794,1,107088,33496,1412,0,1894,1064
6140,1,0,0,0,48,0,912,0,1,507780,954720,19.748417658131498,360,1722,1692,390,54756,572832,572832,2418,2838,2478,3750,4170,36.08323710533743,5.501408174353464,420,1,91260,3960,1302,0,2058,1146
6141,1,0,0,0,48,0,918,0,1,478219,904869,19.261360284258224,371,1660,1660,371,48399,539019,534141,2439,2810,2439,3728,4099,35.90264614203248,0.0,371,1,81249,0,1289,0,2068,1150
6142,1,0,0,0,48,0,764,1,0,647957,1229744,22.561028345356956,359,1932,1782,509,41370,507360,475952,2266,2925,2566,3689,4348,35.679125549822544,12.384480471957746,659,1,100273,22350,1273,0,1907,1143
6143,1,0,0,0,48,0,691,1,0,1037330,1786310,27.018512172212592,284,2597,2151,730,48076,494294,582386,2001,3177,2893,3868,5044,37.69615364994153,21.41082401713824,1176,1,173740,39248,1421,0,1717,1026
6144,1,0,0,0,47,0,787,1,0,534888,1037875,20.904544960366874,195,1903,1661,437,42016,479750,494000,2133,2812,2617,3599,4278,34.9857113690718,15.677709056199316,679,1,90896,30492,1224,0,1938,1151
6145,0,0,1,0,59,1,803,0,0,118110,2771400,30.495901363953813,796,1191,1057,930,46431,688380,598980,2846,3910,3114,3107,4171,11.269427669584644,11.639773040550214,1064,1,186930,22646,127,0,2050,2853
6146,0,0,1,0,62,1,383,0,0,188478,885507,16.822603841260722,101,1333,949,283,52371,791637,647703,2745,3412,3513,3795,4462,25.80697580112788,19.706737610150405,667,1,58581,68352,666,0,2846,2463
6147,1,0,0,0,46,0,62,0,0,981120,2351622,31.96873472629156,1022,1982,1982,1022,53325,545337,517725,2301,3323,2301,3261,4283,30.983866769659336,0.0,1022,0,229950,0,960,0,1279,1341
6148,1,0,0,0,46,0,252,1,0,1183149,2821731,34.942810419312295,1191,2220,2190,1221,35376,406736,464511,2281,3532,2341,3280,4531,31.12876483254676,5.514871952411144,1251,1,245421,2970,969,0,1090,1342
6149,1,0,0,0,49,0,749,1,0,415520,2793280,33.46640106136302,950,1661,1491,1120,39376,533716,458896,2324,3614,2664,2865,4155,19.261360284258224,13.378566177832475,1290,1,206080,28560,371,0,1374,2123
6150,1,0,0,0,50,0,533,0,1,345648,2281824,30.199337741083,711,1492,1291,912,39710,522918,475380,2301,3414,2703,2881,3994,19.467922333931785,14.40893599983394,1113,1,173280,31356,379,0,1590,2123
6151,1,0,0,0,47,0,254,0,1,312200,1050776,21.118712081942874,276,1316,1146,446,52756,513608,570152,2186,2802,2526,3056,3672,26.457513110645905,13.087862625269288,616,1,107932,17170,700,0,1910,1656
6152,1,0,0,0,49,0,892,0,1,530400,1003680,20.199009876724155,378,1738,1708,408,52102,536280,587940,2430,2868,2490,3760,4198,36.05551275463989,5.572104574801163,438,1,97512,3210,1300,0,2052,1160
6153,1,0,0,0,49,0,899,0,1,504390,958732,19.77371993328519,391,1681,1681,391,52864,549248,578672,2452,2843,2452,3742,4133,35.91656999213594,0.0,391,1,92276,0,1290,0,2061,1162
6154,1,0,0,0,48,0,906,0,1,482032,920072,19.390719429665317,376,1658,1658,376,52206,565257,553022,2447,2823,2447,3729,4105,35.805027579936315,0.0,376,1,84976,0,1282,0,2071,1165
6155,1,0,0,0,48,0,911,0,1,460826,885814,19.026297590440446,362,1635,1635,362,49235,560363,526105,2447,2809,2447,3720,4082,35.679125549822544,0.0,362,1,77830,0,1273,0,2085,1174
6156,1,0,0,0,48,0,918,1,0,419755,820080,18.303005217723125,305,1618,1588,335,43878,521424,504288,2418,2783,2478,3701,4066,35.397740040855716,5.5965095842615735,365,1,69010,4320,1253,0,2113,1195
6157,1,0,0,0,48,0,908,1,0,410109,805654,18.193405398660254,271,1630,1570,331,48180,533046,535480,2374,2765,2494,3673,4064,35.199431813596085,7.754559014766193,391,1,72820,7980,1239,0,2103,1195
6158,1,0,0,0,48,0,772,1,0,578613,1132942,21.61018278497431,317,1856,1706,467,38208,482774,465792,2276,2893,2576,3665,4282,35.199431813596085,12.401817263524045,617,1,89664,21150,1239,0,1959,1187
6159,1,0,0,0,48,0,755,1,0,606584,1183400,22.090722034374522,318,1901,1731,488,37430,477725,460750,2255,2913,2595,3668,4326,35.25620512760839,13.166877513752253,658,1,92720,23800,1243,0,1937,1182
6160,1,0,0,0,49,0,507,0,1,1209250,2166500,29.58039891549808,344,2788,2257,875,53040,594240,547196,1945,3351,3007,3858,5264,37.17526059088221,23.332177027752724,1406,1,193375,82305,1382,0,1601,1094
6161,1,0,0,0,49,0,586,0,1,1161840,2040224,28.705400188814647,336,2722,2234,824,50344,537292,574432,1988,3300,2964,3886,5198,37.54996671103717,22.4841574867528,1312,1,191168,56120,1410,0,1652,1066
6162,1,0,0,0,48,0,732,1,0,894240,1572696,25.45584412271571,282,2394,2028,648,42336,458703,543648,2061,3075,2793,3807,4821,37.14835124201342,19.42017530493211,1014,1,145152,32940,1380,0,1779,1047
6163,1,0,0,0,47,0,781,1,0,645852,1201667,22.427661492005804,220,2070,1787,503,45552,496912,523191,2106,2892,2672,3673,4459,35.832945734337834,17.002492836528845,786,1,110157,33960,1284,0,1886,1105
6164,1,0,0,0,46,0,925,1,0,211850,438900,13.784048752090222,160,1335,1305,190,52779,505890,556710,2280,2500,2340,3425,3645,33.391615714128,5.652706486041966,220,1,45790,3120,1115,0,2120,1195
6165,1,0,0,0,46,0,941,0,0,178686,373086,12.727922061357855,162,1265,1265,162,50976,497448,543508,2303,2465,2303,3406,3568,33.21144381083123,0.0,162,0,38232,0,1103,0,2141,1200
6166,0,1,0,1,65,0,1012,0,0,6597888,6910464,45.95650117230423,1815,5533,5236,2112,34510,664216,556240,2975,5384,3569,6396,8805,55.89275444992848,17.35934837752686,2409,1,359040,50193,3124,0,1160,148
6167,0,0,1,0,59,1,1584,0,0,1131012,1594524,23.108440016582687,234,2952,2652,534,49259,647962,677822,2686,3520,3286,5104,5938,46.021733996015406,17.425824187477687,834,1,121218,36600,2118,0,2452,868
6168,1,0,0,0,46,0,64,0,1,812580,2161276,30.56141357987225,892,1846,1804,934,55304,516022,573872,2272,3248,2356,3184,4160,29.49576240750525,6.589126398255297,976,1,231632,3738,870,0,1380,1444
6169,1,0,0,0,46,0,113,1,0,1034150,2501525,32.78719262151,1033,2079,2037,1075,25610,458419,302510,2285,3402,2369,3289,4406,31.016124838541646,6.885715530322088,1117,1,139750,8358,962,0,1252,1365
6170,1,0,0,0,47,0,750,1,0,943056,3367248,37.62977544445356,1349,2149,2082,1416,29125,554074,297250,2311,3794,2445,3044,4527,25.80697580112788,8.456490803821907,1483,1,177000,15946,666,0,962,1712
6171,1,0,0,0,49,0,851,1,0,695982,3358692,36.90528417449187,1187,2048,1873,1362,39324,557316,429084,2291,3828,2641,2977,4514,22.60530911091463,13.359104871799886,1537,1,236988,33600,511,0,1104,1955
6172,1,0,0,0,50,0,724,1,0,449600,2813372,33.52610922848042,932,1716,1524,1124,38502,518121,465558,2311,3627,2695,2903,4219,20.0,14.319779673152123,1316,1,209064,30336,400,0,1379,2103
6173,1,0,0,0,50,0,646,0,1,404040,2600360,32.18695387886216,778,1684,1426,1036,40723,529610,484430,2252,3546,2768,2900,4194,19.748417658131498,16.366373190985122,1294,1,199948,39990,390,0,1474,2120
6174,1,0,0,0,49,0,887,0,1,488064,944640,19.595917942265423,384,1655,1655,384,49680,531360,565800,2460,2844,2460,3731,4115,35.651086939951774,0.0,384,1,88320,0,1271,0,2076,1189
6175,1,0,0,0,49,0,918,1,0,374544,750312,17.4928556845359,246,1590,1530,306,44943,522276,517372,2392,2758,2512,3676,4042,34.9857113690718,7.780166052320878,366,1,64566,8220,1224,0,2146,1228
6176,1,0,0,0,48,0,900,1,0,369036,746028,17.4928556845359,216,1602,1512,306,44200,538798,487600,2348,2744,2528,3644,4040,34.72751070837067,9.505517133991825,396,1,61200,14310,1206,0,2132,1232
6177,1,0,0,0,48,0,757,1,0,865758,1518676,25.019992006393608,302,2333,2009,626,48175,497330,570110,2102,3052,2750,3809,4759,37.1887079635741,18.337604817992162,950,1,147110,31428,1383,0,1800,1043
6178,1,0,0,0,48,0,785,1,0,717366,1298941,23.259406699226016,258,2150,1867,541,51863,521017,573839,2118,2942,2684,3727,4551,36.41428291206625,17.06033345584145,824,1,129299,29998,1326,0,1860,1075
6179,1,0,0,0,46,0,941,0,0,229542,463707,14.177446878757825,201,1343,1343,201,52628,514461,544452,2307,2508,2307,3449,3650,33.793490497431605,0.0,201,0,47436,0,1142,0,2106,1165
6180,0,1,1,0,62,0,596,0,0,7125792,7405188,48.86716689148246,2238,5522,5372,2388,45668,722533,607796,2951,5489,3251,6085,8623,54.62600113499065,12.247584794411392,2538,0,468048,26550,2984,1,713,117
6181,0,0,1,0,60,1,1580,0,0,3878784,8835008,53.96295025292817,2552,4604,4244,2912,51060,697820,673548,2674,5946,3394,4366,7638,36.49657518178932,18.978093064054832,3272,1,646464,51840,1332,0,122,1702
6182,0,0,1,0,62,1,170,0,0,265259,1369558,20.904544960366874,98,1383,1044,437,53816,680078,777232,2795,3571,3473,3741,4517,24.63736998950984,18.66310912114718,776,1,108376,30510,607,0,2697,2527
6183,1,0,0,0,46,0,75,0,0,182206,1082518,21.587033144922902,466,857,857,466,39432,432078,492476,2323,2789,2323,2714,3180,19.77371993328519,0.0,466,0,98792,0,391,0,1857,1932
6184,1,0,0,0,46,0,78,1,0,937440,2335536,31.74901573277509,978,1968,1938,1008,27462,461083,319746,2287,3325,2347,3247,4285,30.495901363953813,5.91487205010149,1038,1,139104,5850,930,0,1309,1387
6185,1,0,0,0,47,0,457,1,0,1076694,3041596,35.93048844644336,1224,2192,2125,1291,31752,461776,381672,2289,3647,2423,3190,4548,28.879058156387302,8.567952416355485,1358,1,209142,11256,834,0,1065,1522
6186,1,0,0,0,47,0,749,1,0,932010,3379770,37.54996671103717,1325,2156,2071,1410,28892,558501,297228,2312,3807,2482,3058,4553,25.709920264364882,9.412769291411893,1495,1,174840,20230,661,0,987,1736
6187,1,0,0,0,48,0,791,1,0,911702,3451035,37.8021163428716,1321,2175,2067,1429,30785,567525,316365,2307,3844,2523,3053,4590,25.25866188063018,10.781717396486519,1537,1,187199,25380,638,0,986,1777
6188,1,0,0,0,50,0,761,0,1,556626,3049872,34.899856733230294,1036,1857,1675,1218,41070,555888,463240,2322,3722,2686,2961,4361,21.37755832643195,14.00336977441059,1400,1,225330,32032,457,0,1286,2047
6189,1,0,0,0,50,0,559,0,1,416792,2474211,31.352830813181765,700,1690,1407,983,40590,515985,498366,2234,3500,2800,2941,4207,20.591260281974,17.053532484707173,1266,1,194634,40186,424,0,1534,2093
6190,1,0,0,0,49,0,861,0,1,511060,997880,20.09975124224178,404,1669,1669,404,51296,553280,565630,2470,2874,2470,3735,4139,35.566838487557476,0.0,404,1,92516,0,1265,0,2066,1205
6191,1,0,0,0,49,0,907,1,0,375744,760140,17.578395831246947,249,1585,1525,309,41109,523980,474780,2400,2769,2520,3676,4045,34.87119154832539,7.780166052320878,369,1,59637,9420,1216,0,2151,1244
6192,1,0,0,0,49,0,877,1,0,345740,723340,17.175564037317667,175,1587,1467,295,37062,522276,426648,2332,2747,2572,3624,4039,34.23448553724738,11.07142749248319,415,1,51330,21120,1172,0,2157,1280
6193,1,0,0,0,48,0,780,0,0,841909,1466512,24.63736998950984,324,2277,1994,607,54531,529104,601584,2133,3023,2699,3803,4693,37.242448899072144,17.149056016045467,890,1,151143,25753,1387,0,1809,1029
6194,1,0,0,0,47,0,798,0,0,745200,1323144,23.49468024894146,296,2158,1902,552,54720,546516,575280,2141,2949,2653,3747,4555,36.742346141747674,16.222430372858152,808,1,132480,29952,1350,0,1845,1047
6195,1,0,0,0,46,0,940,0,0,286044,559988,15.556349186104045,242,1424,1424,242,53550,520650,550732,2314,2556,2314,3496,3738,34.38022687534217,0.0,242,1,57596,0,1182,0,2072,1132
6196,0,1,0,1,64,0,162,0,0,9271555,10122099,55.91958512006326,2776,6443,6092,3127,46805,598845,818961,2886,6364,3588,6202,9680,54.45181356024793,18.79857638203741,3478,1,791131,9126,2965,0,110,272
6197,0,0,1,0,58,1,2076,0,0,651781,6842524,48.507731342539614,2353,2630,2630,2353,51940,712460,616496,2908,5261,2908,3185,5538,16.64331697709324,0.0,2353,0,498836,0,277,1,555,2631
6198,0,0,1,0,62,1,196,0,0,276621,1354700,20.904544960366874,221,1286,1070,437,55216,719200,737800,2884,3537,3316,3733,4386,25.15949125081825,14.875115696189704,653,1,104006,26784,633,0,2663,2467
6199,1,0,0,0,46,0,78,0,0,241528,1232112,23.065125189341593,532,986,986,532,44928,481728,500256,2316,2848,2316,2770,3302,21.307275752662516,0.0,532,0,114912,0,454,0,1784,1862
6200,1,0,0,0,46,0,48,0,1,749380,2051450,29.832867780352597,890,1732,1732,890,55692,539370,548590,2305,3195,2305,3147,4037,29.017236257093817,0.0,890,1,211820,0,842,0,1415,1463
6201,1,0,0,0,46,0,44,0,0,798752,2110464,30.265491900843113,916,1788,1788,916,45571,527616,458496,2304,3220,2304,3176,4092,29.5296461204668,0.0,916,0,182284,0,872,0,1388,1432
6202,1,0,0,0,50,0,720,0,1,565956,2999328,34.55430508634199,976,1886,1668,1194,42222,570224,467232,2294,3706,2730,2986,4398,21.77154105707724,15.249977696322132,1412,1,222084,39240,474,0,1318,2038
6203,1,0,0,0,48,0,172,0,0,407340,1781200,27.018512172212592,458,1560,1288,730,48070,463600,617320,2168,3170,2712,2998,4000,23.62202362203543,16.78947592936195,1002,1,184690,12512,558,0,1710,1882
6204,1,0,0,0,47,0,76,0,0,382956,1383996,24.124676163629637,392,1430,1240,582,52002,508892,577854,2188,2960,2568,3036,3808,25.65151067676132,13.863636472175683,772,1,141426,18240,658,0,1796,1720
6205,1,0,0,0,47,0,231,0,1,359370,1166220,22.24859546128699,368,1348,1221,495,53502,523032,567796,2229,2851,2483,3082,3704,26.94438717061496,11.294497304567454,622,1,119295,13843,726,0,1861,1630
6206,1,0,0,0,49,0,828,0,1,546013,1072108,20.808652046684813,433,1694,1694,433,52182,579384,552148,2476,2909,2476,3737,4170,35.510561809129406,0.0,433,1,96559,0,1261,0,2043,1215
6207,1,0,0,0,49,0,886,1,0,384395,789206,17.86057109949175,259,1584,1524,319,41800,517066,494800,2414,2793,2534,3679,4058,34.713109915419565,7.765259411425052,379,1,63800,8640,1205,0,2155,1269
6208,1,0,0,0,49,0,857,1,0,322620,697595,16.822603841260722,133,1573,1423,283,38402,520115,448630,2315,2748,2615,3605,4038,33.76388603226827,12.439392632724381,433,1,51506,24900,1140,0,2182,1325
6209,1,0,0,0,49,0,840,1,0,342000,739800,17.320508075688775,147,1593,1440,300,38570,500598,468540,2313,2766,2619,3606,4059,33.76388603226827,12.596031671368893,453,1,57000,22491,1140,0,2166,1326
6210,1,0,0,0,49,0,762,1,0,440064,941184,19.595917942265423,172,1742,1530,384,41006,495102,497553,2239,2835,2663,3597,4193,33.85262175962151,14.68187375456548,596,1,77952,27984,1146,0,2067,1305
6211,1,0,0,0,49,0,701,1,0,530822,1123932,21.400934559032695,200,1875,1617,458,43860,500616,527610,2196,2912,2712,3613,4329,34.044089061098404,16.248309932078527,716,1,98470,31218,1159,0,1996,1295
6212,1,0,0,0,49,0,642,1,0,633123,1316187,23.173260452512935,218,2035,1716,537,40400,495102,490200,2132,2988,2770,3630,4486,34.336569426778794,18.054365684236387,856,1,107400,43065,1179,0,1914,1272
6213,1,0,0,0,48,0,623,1,0,669468,1379544,23.748684174075834,225,2090,1751,564,40194,484308,496538,2107,3010,2785,3633,4536,34.45286635390443,18.564023874217273,903,1,114492,43053,1187,0,1882,1259
6214,1,0,0,0,48,0,587,1,0,744690,1510392,24.859605789312106,236,2205,1823,618,39856,518128,459472,2062,3062,2826,3649,4649,34.713109915419565,19.656501550554704,1000,1,116184,61884,1205,0,1826,1239
6215,1,0,0,0,49,0,552,1,0,826324,1651300,25.96150997149434,248,2326,1900,674,44969,570850,472850,2024,3124,2876,3676,4776,35.014282800023196,20.806320949236934,1100,1,130082,76254,1226,0,1776,1224
6216,1,0,0,0,48,0,760,0,0,966516,1635798,25.96150997149434,377,2405,2108,674,56069,550929,599469,2130,3101,2724,3861,4832,37.86819245752297,17.58410026549352,971,1,166478,29700,1434,0,1753,993
6217,1,0,0,0,47,0,873,0,0,539638,989406,20.445048300260872,284,1843,1709,418,55800,532575,587016,2233,2785,2501,3658,4210,35.93048844644336,11.768410567748846,552,1,103664,12864,1291,0,1949,1076
6218,1,0,0,0,46,0,939,0,0,345826,656560,16.822603841260722,283,1505,1505,283,48552,473280,552160,2320,2603,2320,3542,3825,34.95711658589707,0.0,283,1,67354,0,1222,0,2037,1098
6219,1,0,0,0,46,0,951,0,0,311922,596238,16.06237840420901,258,1467,1467,258,49494,506109,522286,2311,2569,2311,3520,3778,34.77067730142742,0.0,258,0,58308,0,1209,0,2053,1102
6220,0,1,1,0,60,0,1228,0,0,1365404,2151182,26.570660511172846,586,2760,2640,706,50778,661199,712998,2927,3753,3167,4981,5807,43.977266854592045,10.95920259392275,826,1,165204,13680,1934,0,2341,1113
6221,0,0,1,0,58,1,1697,0,0,1971288,2307096,28.142494558940577,602,3471,3281,792,55418,667077,704946,2723,3705,3103,5402,6384,49.889878733065686,13.818380397184647,982,1,191664,21660,2489,0,2121,424
6222,0,0,0,0,57,1,1350,0,0,2520000,3004050,32.4037034920393,1020,3480,3450,1050,55454,680918,666613,2831,3911,2891,5261,6341,48.98979485566356,5.490867587491313,1080,0,244650,4080,2400,0,1811,461
6223,1,0,0,0,46,0,34,0,0,691935,1956945,29.13760456866693,849,1664,1664,849,55458,546285,539370,2305,3154,2305,3120,3969,28.548204847240395,0.0,849,0,198666,0,815,0,1456,1490
6224,1,0,0,0,46,0,82,1,0,830063,2225255,30.870698080866262,911,1866,1824,953,24123,436645,301215,2293,3288,2377,3206,4201,29.512709126747414,6.955109380145743,995,1,122937,7896,871,0,1382,1464
6225,1,0,0,0,47,0,623,1,0,971090,3202445,36.6742416417845,1315,2097,2067,1345,35264,552392,361912,2351,3726,2411,3103,4478,26.870057685088806,5.5965095842615735,1375,1,204440,6540,722,0,1036,1659
6226,1,0,0,0,49,0,806,1,0,843600,3462978,37.49666651850535,1279,2133,2006,1406,41574,605898,416247,2336,3869,2590,3063,4596,24.49489742783178,11.714665076908231,1533,1,237614,27051,600,0,1057,1863
6227,1,0,0,0,48,0,10,0,0,413424,1555200,25.45584412271571,456,1478,1286,648,50635,492000,592800,2208,3048,2592,3038,3878,25.25866188063018,13.963780973135522,840,1,160056,14976,638,0,1752,1762
6228,1,0,0,0,49,0,805,0,1,552864,1099083,21.047565179849187,443,1691,1691,443,50621,553263,563187,2481,2924,2481,3729,4172,35.32704346531139,0.0,443,1,100561,0,1248,0,2038,1233
6229,1,0,0,0,49,0,817,0,1,514578,1033743,20.42057785666214,417,1651,1651,417,47460,560254,520590,2479,2896,2479,3713,4130,35.12833614050059,0.0,417,1,87570,0,1234,0,2062,1245
6230,1,0,0,0,49,0,886,1,0,253992,560652,15.0996688705415,48,1522,1342,228,41268,560652,445079,2279,2687,2639,3573,3981,33.37663853655727,13.45762619345434,408,1,41268,33480,1114,0,2231,1345
6231,1,0,0,0,49,0,440,0,1,1066736,2059904,28.91366458960192,378,2570,2112,836,51250,616000,505120,2006,3300,2922,3740,5034,35.7211421989835,21.69242648668027,1294,1,171380,82898,1276,0,1628,1188
6232,1,0,0,0,49,0,427,0,1,1115424,2134080,29.393876913398138,431,2588,2155,864,53382,607620,535990,2037,3334,2903,3761,5058,35.93048844644336,21.16023425308805,1297,1,187488,71012,1291,0,1606,1179
6233,1,0,0,0,46,0,949,0,0,374700,697800,17.320508075688775,300,1549,1549,300,46487,472178,532654,2326,2626,2326,3575,3875,35.34119409414458,0.0,300,0,68700,0,1249,0,2026,1077
6234,0,1,1,0,58,0,1248,0,0,721540,1263340,20.73644135332772,388,2150,2108,430,38631,478894,696306,2896,3368,2980,4616,5088,40.963398296528084,6.538739683827756,472,1,101910,1344,1678,0,2508,1260
6235,0,0,1,0,58,1,1966,0,0,789336,6716280,48.041648597857254,2266,2692,2650,2308,47008,657660,605280,2868,5218,2952,3252,5602,18.49324200890693,6.484411467763075,2350,0,480064,6552,342,1,602,2568
6236,0,0,1,0,62,1,444,0,0,429580,1468280,21.6794833886788,62,1792,1384,470,46550,765380,593560,2716,3594,3532,4038,4916,30.23243291566195,20.346040176234563,878,1,89300,79152,914,0,2654,2210
6237,1,0,0,0,47,0,87,1,0,228988,1231924,22.891046284519195,482,1003,961,524,39201,420829,514869,2309,2875,2393,2788,3354,20.904544960366874,6.919919043981043,566,1,114756,3444,437,0,1827,1914
6238,1,0,0,0,46,0,266,1,0,996360,2658480,33.76388603226827,1110,2044,2014,1140,42624,447744,517704,2302,3472,2362,3206,4376,29.563490998188964,5.5965095842615735,1170,1,253080,2910,874,0,1192,1458
6239,1,0,0,0,46,0,281,1,0,1067066,2771769,34.39476704383968,1141,2127,2085,1183,42579,583407,400653,2301,3526,2385,3245,4470,30.033314835362415,6.570697549716149,1225,1,202293,8946,902,0,1160,1441
6240,1,0,0,0,47,0,497,1,0,1010508,3061056,35.832945734337834,1254,2101,2071,1284,37611,450576,474416,2354,3668,2414,3171,4485,28.053520278211074,5.684275577662207,1314,1,255516,3570,787,0,1100,1597
6241,1,0,0,0,50,0,655,0,1,617796,2982870,34.336569426778794,894,1988,1703,1179,40860,574310,455400,2245,3709,2815,3054,4518,22.891046284519195,17.369661887399854,1464,1,212220,53295,524,0,1351,2006
6242,1,0,0,0,49,0,628,1,0,539805,1196980,22.02271554554524,143,1940,1598,485,44220,542960,496068,2126,2953,2810,3581,4408,33.36165463522455,18.683956920617533,827,1,97485,53694,1113,0,1983,1355
6243,1,0,0,0,49,0,588,1,0,610789,1333024,23.259406699226016,159,2052,1670,541,41961,524832,485408,2082,3005,2846,3593,4516,33.60059523282288,19.720866780635053,923,1,106577,58446,1129,0,1923,1335
6244,1,0,0,0,49,0,418,0,1,1107648,2129760,29.393876913398138,473,2537,2146,864,56153,574345,594065,2074,3329,2856,3747,5002,35.805027579936315,20.14717987125415,1255,1,208224,46529,1282,0,1601,1183
6245,1,0,0,0,46,0,900,0,0,594949,1040607,21.047565179849187,335,1894,1786,443,55800,528525,582552,2241,2792,2457,3692,4243,36.64696440361739,10.471798365004291,551,1,109864,10368,1343,0,1906,1006
6246,1,0,0,0,46,0,957,0,0,407044,743908,17.86057109949175,319,1595,1595,319,52884,527032,545688,2332,2651,2332,3608,3927,35.7211421989835,0.0,319,0,74646,0,1276,0,2013,1056
6247,1,0,0,0,46,0,977,1,0,347358,643194,16.64331697709324,217,1591,1531,277,48090,531738,487620,2262,2599,2382,3576,3913,35.41186241925155,7.748117453886108,337,1,58170,9420,1254,0,2045,1068
6248,0,1,0,1,66,0,1191,0,0,5020822,5689346,41.50903516103452,1400,4960,4637,1723,50451,663702,828802,2979,5025,3625,6216,8262,53.98147830506312,18.420918072792958,2046,1,432473,20995,2914,0,1579,388
6249,1,0,0,0,46,0,2,0,0,586755,1767168,27.694764848252458,767,1532,1532,767,54273,546048,527616,2304,3071,2304,3069,3836,27.65863337187866,0.0,767,0,175643,0,765,0,1537,1539
6250,1,0,0,0,49,0,743,1,0,841098,3364392,36.89173349139343,1211,2129,1979,1361,42168,620472,415296,2322,3833,2622,3090,4601,24.859605789312106,12.5999078163187,1511,1,228648,32100,618,0,1111,1854
6251,1,0,0,0,50,0,676,1,0,708405,3134910,35.2845575287547,1003,2056,1814,1245,38957,601802,410434,2276,3763,2760,3087,4574,23.853720883753127,16.07930347135006,1487,1,202935,51788,569,0,1273,1949
6252,1,0,0,0,50,0,656,0,1,680960,3075264,34.87119154832539,948,2044,1776,1216,39884,596844,427401,2261,3745,2797,3089,4573,23.664319132398465,16.933819716368244,1484,1,205504,55476,560,0,1313,1969
6253,1,0,0,0,49,0,436,0,1,907005,1866381,27.54995462791182,274,2439,1954,759,49920,590160,511472,1974,3218,2944,3654,4898,34.56877203488721,22.26693733573704,1244,1,157872,82450,1195,0,1700,1264
6254,1,0,0,0,49,0,408,0,1,998784,2007360,28.5657137141714,386,2470,2040,816,53655,602700,538740,2030,3276,2890,3684,4930,34.9857113690718,21.033259634337178,1246,1,178704,69660,1224,0,1644,1236
6255,1,0,0,0,49,0,395,0,1,1047800,2078700,29.068883707497267,443,2487,2085,845,55842,605160,558420,2058,3305,2862,3700,4947,35.21363372331802,20.37731271033109,1247,1,191815,60300,1240,0,1615,1220
6256,1,0,0,0,48,0,614,0,0,983195,1766096,27.03701166919155,476,2331,2076,731,55632,550848,589504,2161,3147,2671,3761,4747,36.6742416417845,16.1852938789691,986,1,178364,27795,1345,0,1685,1071
6257,1,0,0,0,48,0,662,0,0,957528,1692522,26.49528259898354,468,2300,2066,702,55596,544886,593106,2177,3113,2645,3775,4711,36.932370625238775,15.601376800644807,936,1,172692,24102,1364,0,1709,1047
6258,1,0,0,0,48,0,709,0,0,932142,1618274,25.96150997149434,462,2269,2057,674,56088,547428,590646,2189,3075,2613,3784,4670,37.1887079635741,14.816512456006526,886,1,165804,22048,1383,0,1727,1018
6259,1,0,0,0,47,0,878,0,0,759855,1271616,23.173260452512935,413,2076,1952,537,54750,518592,592000,2244,2905,2492,3783,4444,37.61648574760805,11.316469623900245,661,1,134250,11036,1415,0,1831,953
6260,1,0,0,0,46,0,955,0,0,475076,841491,19.0,361,1677,1677,361,53550,554778,524475,2331,2692,2331,3647,4008,36.27671429443411,0.0,361,0,81225,0,1316,0,1970,1015
6261,1,0,0,0,46,0,982,1,0,384600,698100,17.320508075688775,233,1649,1582,300,46308,528229,474708,2260,2627,2394,3609,3976,35.805027579936315,8.185808589931957,367,1,61200,10787,1282,0,2027,1045
6262,0,1,1,0,64,0,1202,0,0,4261299,4997074,39.35733730830886,1307,4542,4300,1549,55029,712946,803274,2984,4775,3468,5977,7768,52.44997616777342,15.82149788931899,1791,1,385701,22264,2751,0,1677,475
6263,1,0,0,0,46,0,2,0,0,358800,1387800,24.49489742783178,600,1198,1198,600,48462,568998,455661,2313,2913,2313,2911,3511,24.454038521274967,0.0,600,0,118200,0,598,0,1713,1715
6264,1,0,0,0,47,0,293,1,0,1015880,2738915,34.132096331752024,1135,2067,2037,1165,42921,590101,402021,2321,3516,2381,3223,4418,29.5296461204668,5.490867587491313,1195,1,199215,6390,872,0,1186,1479
6265,1,0,0,0,48,0,688,1,0,952889,3355107,37.134889255254286,1319,2130,2070,1379,45974,617982,440373,2373,3812,2493,3124,4563,26.28687885618983,7.994134176674909,1439,1,249599,12060,691,0,1054,1742
6266,1,0,0,0,50,0,588,0,1,672205,2963760,34.132096331752024,852,2055,1742,1165,43737,608016,465552,2231,3709,2857,3121,4599,24.020824298928627,18.279842989562773,1478,1,213195,61035,577,0,1379,1967
6267,1,0,0,0,51,0,563,0,1,650928,2899072,33.704599092705436,794,2051,1709,1136,42897,604824,461912,2210,3688,2894,3125,4603,23.93741840717165,19.082131035183334,1478,1,205616,67032,573,0,1416,1979
6268,1,0,0,0,51,0,535,0,1,631526,2830254,33.25657829663178,735,2048,1677,1106,45162,598806,493887,2188,3665,2930,3130,4607,23.895606290697042,19.810607993290063,1477,1,213458,66780,571,0,1453,1988
6269,1,0,0,0,49,0,185,0,0,514896,2014704,28.5657137141714,561,1702,1447,816,45816,454296,614781,2214,3285,2724,3100,4171,25.11971337416094,16.269598335428185,1071,1,203184,11475,631,0,1653,1838
6270,1,0,0,0,47,0,174,0,1,452115,1398306,24.310491562286437,524,1423,1356,591,50718,506324,560742,2299,2957,2433,3131,3789,27.65863337187866,8.18535277187245,658,1,140067,7035,765,0,1775,1601
6271,1,0,0,0,47,0,318,0,1,422280,1200030,22.58317958127243,480,1368,1338,510,51528,531778,536484,2323,2863,2383,3181,3721,28.77498913987632,5.501408174353464,540,1,116280,3960,828,0,1843,1525
6272,1,0,0,0,46,0,366,0,1,411400,1136916,22.0,484,1334,1334,484,50621,523827,533223,2349,2833,2349,3199,3683,29.154759474226502,0.0,484,1,109868,0,850,0,1865,1499
6273,1,0,0,0,49,0,433,0,1,832034,1770055,26.851443164195103,218,2378,1875,721,50808,569560,537645,1952,3176,2958,3609,4833,33.97057550292606,22.64177506414201,1224,1,157899,74947,1154,0,1734,1301
6274,1,0,0,0,49,0,418,0,1,876000,1842750,27.386127875258307,276,2392,1918,750,52320,589680,535626,1983,3207,2931,3625,4849,34.17601498127012,22.01456573097915,1224,1,163500,74892,1168,0,1707,1289
6275,1,0,0,0,47,0,770,0,0,884031,1504304,25.11971337416094,481,2182,2032,631,55647,545936,579312,2234,3015,2534,3785,4566,37.429934544425805,12.491663664368078,781,1,153333,16800,1401,0,1753,983
6276,1,0,0,0,47,0,865,0,0,832034,1367490,24.020824298928627,469,2127,2019,577,55552,530880,587760,2262,2947,2478,3812,4497,37.97367509209505,10.57476984710039,685,1,143096,10152,1442,0,1793,928
6277,1,0,0,0,47,0,900,0,0,748125,1234800,22.9128784747792,440,2035,1950,525,55056,522144,583296,2267,2877,2437,3777,4387,37.749172176353746,9.300149152818726,610,1,130200,7990,1425,0,1827,927
6278,1,0,0,0,46,0,954,0,0,545112,936660,20.049937655763422,402,1758,1758,402,52170,547550,517260,2330,2732,2330,3686,4088,36.823905279043935,0.0,402,0,89244,0,1356,0,1928,974
6279,1,0,0,0,46,0,967,0,0,504968,875328,19.390719429665317,376,1719,1719,376,50112,540096,502848,2328,2704,2328,3671,4047,36.64696440361739,0.0,376,0,81216,0,1343,0,1952,985
6280,0,1,1,0,61,0,81,0,0,7448530,8317077,51.85556864985669,2455,5693,5459,2689,25074,615507,389718,2859,5782,3327,5863,8786,52.630789467763066,15.567029784806499,2923,1,338814,48204,2770,0,404,323
6281,1,0,0,0,46,0,25,0,0,353274,1349076,24.124676163629637,582,1189,1189,582,42224,537776,421876,2318,2900,2318,2925,3507,24.63736998950984,0.0,582,0,105924,0,607,0,1736,1711
6282,1,0,0,0,46,0,36,0,0,493885,1581665,26.1725046566048,685,1406,1406,685,53808,526452,544924,2309,2994,2309,3030,3715,26.851443164195103,0.0,685,0,161660,0,721,0,1624,1588
6283,1,0,0,0,46,0,41,1,0,574902,1712898,27.16615541441225,708,1547,1517,738,26467,461879,308693,2291,3059,2351,3100,3868,27.910571473905726,5.791460926441345,768,1,98154,5970,779,0,1583,1542
6284,1,0,0,0,47,0,202,1,0,715703,2272905,30.870698080866262,778,1879,1704,953,44496,515160,491310,2210,3338,2560,3136,4264,27.40437921208944,13.871510878377256,1128,1,196318,25725,751,0,1432,1634
6285,1,0,0,0,48,0,526,1,0,993792,3122422,35.9722114972099,1264,2092,2062,1294,35890,468122,446405,2383,3707,2443,3181,4505,27.712812921102035,5.652706486041966,1324,1,239390,4230,768,0,1119,1645
6286,1,0,0,0,49,0,672,1,0,851428,3275230,36.30426972134269,1156,2126,1964,1318,37544,613795,377720,2323,3803,2647,3131,4611,25.41653005427767,13.117536098593346,1480,1,200336,36450,646,0,1167,1839
6287,1,0,0,0,50,0,589,0,1,735012,3048138,34.655446902326915,924,2090,1813,1201,43719,626886,449226,2261,3739,2815,3150,4628,24.73863375370596,17.274619134080364,1478,1,212577,57339,612,0,1337,1926
6288,1,0,0,0,50,0,565,0,1,711404,2983912,34.23448553724738,866,2085,1779,1172,44408,621224,463372,2240,3718,2852,3153,4631,24.63736998950984,18.11972777303995,1478,1,213304,61506,607,0,1374,1939
6289,1,0,0,0,50,0,285,0,0,570286,2291165,30.18277654557314,643,1805,1537,911,47559,480365,626235,2247,3426,2783,3141,4320,25.019992006393608,16.658425890078547,1179,1,226839,14740,626,0,1604,1889
6290,1,0,0,0,47,0,277,0,1,456228,1299809,23.473389188611005,521,1409,1379,551,50398,526057,533134,2329,2910,2389,3187,3768,28.77498913987632,5.490867587491313,581,1,124526,3960,828,0,1808,1531
6291,1,0,0,0,47,0,324,0,1,445725,1236900,22.9128784747792,525,1374,1374,525,50176,527744,527744,2356,2881,2356,3205,3730,29.13760456866693,0.0,525,1,117600,0,849,0,1831,1507
6292,1,0,0,0,49,0,512,0,1,569673,1341680,23.259406699226016,72,2063,1594,541,47064,550560,525760,2011,3021,2949,3533,4543,32.449961479175904,21.820047709190973,1010,1,114692,69412,1053,0,1939,1427
6293,1,0,0,0,49,0,400,0,1,847364,1822352,27.23967694375247,276,2350,1884,742,53345,577160,557512,1990,3198,2922,3598,4806,33.793490497431605,21.831373165767214,1208,1,168434,66638,1142,0,1714,1314
6294,1,0,0,0,46,0,966,0,0,624187,1036177,21.047565179849187,413,1882,1852,443,52425,544987,526275,2309,2782,2369,3748,4221,37.53664875824692,5.531194905403055,473,1,99675,4290,1409,0,1896,930
6295,1,0,0,0,46,0,979,0,0,582132,972861,20.42057785666214,417,1813,1813,417,51528,527258,531924,2333,2750,2333,3729,4146,37.36308338453881,0.0,417,0,95076,0,1396,0,1916,937
6296,1,0,0,0,46,0,1024,1,0,455265,782560,18.303005217723125,293,1736,1694,335,46161,520928,483552,2294,2671,2378,3695,4072,36.864617182333525,6.538739683827756,377,1,69345,6426,1359,0,2001,977
6297,0,0,1,0,62,1,174,0,0,522415,1992869,25.317977802344327,399,1698,1456,641,56144,721288,752378,2867,3750,3351,3924,4807,28.548204847240395,15.753453964097096,883,1,155122,28072,815,0,2468,2294
6298,0,0,1,0,59,1,1442,0,0,1571075,2140200,26.92582403567252,245,3372,2892,725,56619,717336,687816,2472,3677,3432,5119,6324,46.551047249229526,22.21152406873786,1205,1,168925,65760,2167,0,2227,785
6299,1,0,0,0,47,0,38,1,0,215864,1053452,21.118712081942874,351,1025,930,446,47871,465314,573966,2267,2808,2457,2846,3387,22.0,10.172010733280942,541,1,108378,6935,484,0,1916,1878
6300,1,0,0,0,46,0,52,0,1,349788,1316516,23.790754506740637,536,1214,1184,566,44103,560566,425658,2296,2892,2356,2944,3540,24.859605789312106,5.623413251903491,596,1,103578,5910,618,0,1760,1708
6301,1,0,0,0,46,0,58,0,0,452088,1490216,25.37715508089904,644,1346,1346,644,55388,525278,564616,2314,2958,2314,3016,3660,26.49528259898354,0.0,644,0,157136,0,702,0,1670,1612
6302,1,0,0,0,47,0,221,1,0,679182,2251380,30.692018506445613,741,1864,1663,942,44254,521020,485170,2189,3332,2591,3111,4254,26.851443164195103,14.74661454265269,1143,1,191226,30552,721,0,1448,1669
6303,1,0,0,0,47,0,270,1,0,765000,2435760,31.937438845342623,912,1878,1770,1020,37611,451332,475212,2280,3408,2496,3138,4266,27.386127875258307,10.948360265819424,1128,1,202980,12960,750,0,1368,1638
6304,1,0,0,0,48,0,481,1,0,1008216,3092117,35.679125549822544,1243,2095,2065,1273,35910,461510,459081,2399,3702,2459,3221,4524,28.142494558940577,5.830951894845301,1303,1,240597,3990,792,0,1156,1637
6305,1,0,0,0,49,0,151,0,0,572660,2065756,28.91366458960192,635,1722,1521,836,46305,467019,605395,2270,3307,2672,3156,4193,26.1725046566048,14.435687001794188,1037,1,204820,12060,685,0,1635,1786
6306,1,0,0,0,49,0,459,0,1,617272,1461309,24.269322199023193,58,2168,1637,589,47700,525972,558225,1950,3070,3012,3529,4649,32.37282811247729,23.203596904720097,1120,1,132525,63189,1048,0,1892,1433
6307,1,0,0,0,49,0,367,0,1,865980,1875780,27.65863337187866,335,2327,1897,765,53572,556604,578672,2022,3217,2882,3584,4779,33.645207682521445,20.990139910181558,1195,1,180540,52030,1132,0,1687,1320
6308,1,0,0,0,48,0,341,0,1,959960,2009736,28.705400188814647,453,2360,1989,824,54990,573165,570726,2068,3263,2810,3604,4799,34.132096331752024,19.497974616616236,1195,1,192816,48972,1165,0,1615,1274
6309,1,0,0,0,48,0,437,0,1,989600,1937600,28.284271247461902,544,2293,2037,800,54168,537684,590968,2166,3222,2678,3659,4715,35.17101079013795,16.259488045619545,1056,1,195200,26368,1237,0,1622,1185
6310,1,0,0,0,47,0,632,0,1,900144,1640232,26.153393661244042,534,2150,2000,684,50995,520366,563530,2248,3082,2548,3714,4548,36.27671429443411,12.480747566911448,834,1,160740,16800,1316,0,1714,1082
6311,1,0,0,0,47,0,781,0,0,824642,1419054,24.454038521274967,513,2062,1977,598,53286,507822,590877,2288,2971,2458,3752,4435,37.134889255254286,9.476861953055495,683,1,148902,7140,1379,0,1775,994
6312,1,0,0,0,46,0,1006,0,0,617480,1005340,20.73644135332772,430,1866,1866,430,51714,547092,516698,2338,2768,2338,3774,4204,37.89459064299283,0.0,430,0,95030,0,1436,0,1908,902
6313,1,0,0,0,46,0,1021,0,0,572046,938670,20.049937655763422,402,1825,1825,402,50388,532380,516035,2335,2737,2335,3758,4160,37.72267222772003,0.0,402,0,88842,0,1423,0,1933,912
6314,1,0,0,0,46,0,1115,1,0,328394,565554,15.556349186104045,108,1733,1599,242,49665,539847,502455,2203,2579,2471,3694,4070,36.837480912787726,11.579864037853417,376,1,52030,20368,1357,0,2095,980
6315,0,0,1,0,59,1,1383,0,0,1494448,2106202,26.70205984563738,263,3259,2809,713,56882,706006,703052,2504,3667,3404,5050,6213,45.78209256903839,21.557148760234295,1163,1,169694,56700,2096,0,2241,858
6316,0,0,1,0,58,1,1482,0,0,1850320,2376328,28.42534080710379,349,3557,3098,808,55209,702899,679371,2482,3749,3400,5231,6498,47.853944456021594,21.689045867772357,1267,1,186648,64260,2290,0,2133,651
6317,1,0,0,0,47,0,73,1,0,212574,1007490,20.639767440550294,336,1015,925,426,46222,451715,572330,2275,2791,2455,2864,3380,22.338307903688676,10.008987875452021,516,1,103092,5940,499,0,1939,1866
6318,1,0,0,0,46,0,79,0,0,317100,1214850,22.9128784747792,525,1129,1129,525,52858,571558,495196,2314,2839,2314,2918,3443,24.576411454889016,0.0,525,0,112350,0,604,0,1789,1710
6319,1,0,0,0,46,0,10,1,0,512631,1667295,26.664583251946766,644,1499,1432,711,24480,478380,281400,2278,3056,2412,3066,3844,26.851443164195103,8.721191861163568,778,1,85320,14472,721,0,1634,1624
6320,1,0,0,0,47,0,92,1,0,554400,1883376,28.142494558940577,665,1619,1492,792,35424,513648,389992,2251,3170,2505,3078,3997,26.457513110645905,12.062302470545765,919,1,129888,24130,700,0,1586,1678
6321,1,0,0,0,47,0,246,1,0,655632,2257032,30.692018506445613,726,1854,1638,942,40170,493576,467220,2180,3338,2612,3092,4250,26.38181191654584,15.099741486923206,1158,1,183690,31536,696,0,1454,1700
6322,1,0,0,0,48,0,260,1,0,681996,2319366,31.080540535840107,796,1842,1672,966,37925,492205,444185,2231,3367,2571,3107,4243,26.570660511172846,13.490839382040427,1136,1,178710,26350,706,0,1435,1695
6323,1,0,0,0,47,0,299,1,0,865956,2586948,33.04542328371661,1062,1915,1885,1092,31265,400361,438265,2339,3461,2399,3162,4284,28.160255680657446,5.753771868478424,1122,1,202020,3240,793,0,1277,1576
6324,1,0,0,0,48,0,317,1,0,1036808,2857167,34.48187929913333,1122,2128,2061,1189,33916,586332,334017,2336,3592,2470,3275,4531,29.5296461204668,8.436161057888377,1256,1,165271,15477,872,0,1214,1531
6325,1,0,0,0,48,0,436,1,0,1021632,3054880,35.38361202590826,1210,2110,2068,1252,41340,517280,475800,2398,3692,2482,3256,4550,28.5657137141714,6.7040592262067955,1294,1,244140,6468,816,0,1188,1624
6326,1,0,0,0,47,0,201,0,1,527922,1502742,25.15949125081825,633,1467,1467,633,48952,500914,550768,2374,3007,2374,3208,3841,28.879058156387302,0.0,633,1,146856,0,834,0,1741,1540
6327,1,0,0,0,47,0,246,0,1,517771,1437376,24.63736998950984,607,1460,1460,607,48319,499648,542272,2368,2975,2368,3221,3828,29.206163733020468,0.0,607,1,139003,0,853,0,1761,1515
6328,1,0,0,0,49,0,473,0,1,522428,1305284,22.891046284519195,8,2037,1521,524,48168,538056,555493,1975,3015,3007,3488,4528,31.575306807693888,22.854296491591956,1040,1,116852,65016,997,0,1967,1494
6329,1,0,0,0,49,0,438,0,1,593640,1445688,24.124676163629637,29,2155,1602,582,52425,558900,578772,1931,3066,3037,3504,4639,31.937438845342623,23.65686391521628,1135,1,135606,68572,1020,0,1902,1464
6330,1,0,0,0,48,0,420,0,1,963916,1920686,28.178005607210743,547,2255,2008,794,55161,549113,587817,2172,3213,2666,3633,4674,34.84250278036869,15.965833096913972,1041,1,192942,27170,1214,0,1625,1205
6331,1,0,0,0,48,0,518,0,1,920955,1770615,27.110883423451916,545,2178,1988,735,53808,549252,568524,2219,3144,2599,3662,4587,35.397740040855716,14.044701627992035,925,1,173460,23180,1253,0,1674,1156
6332,1,0,0,0,48,0,567,0,1,898738,1695812,26.570660511172846,544,2141,1979,706,53312,538048,571676,2240,3108,2564,3675,4543,35.679125549822544,12.97706729119361,868,1,168028,18630,1273,0,1696,1129
6333,1,0,0,0,47,0,617,0,0,876038,1622769,26.019223662515376,543,2105,1971,677,53760,536928,575280,2263,3074,2531,3691,4502,35.9722114972099,11.837739672445862,811,1,162480,14874,1294,0,1720,1103
6334,1,0,0,0,47,0,719,0,0,826266,1469604,24.859605789312106,533,2040,1955,618,53250,506514,594500,2293,2996,2463,3715,4418,36.565010597564445,9.370214040084857,703,1,154500,6970,1337,0,1760,1041
6335,1,0,0,0,46,0,974,0,0,686352,1109160,21.77154105707724,474,1922,1922,474,49056,524160,512460,2340,2814,2340,3788,4262,38.05259518088089,0.0,474,1,103806,0,1448,0,1866,892
6336,1,0,0,0,46,0,1025,0,0,656066,1042748,21.118712081942874,446,1917,1917,446,47925,526050,497994,2338,2784,2338,3809,4255,38.353617821530214,0.0,446,0,94998,0,1471,0,1892,867
6337,0,1,1,0,63,0,1227,0,0,3665728,4428490,37.376463182061514,1337,4081,4021,1397,56394,741780,763970,3110,4567,3230,5794,7251,51.22499389946279,7.780166052320878,1457,1,336677,7200,2624,0,1773,546
6338,0,1,1,0,60,0,1250,0,0,1577784,2362786,27.892651361962706,693,2891,2806,778,53568,655992,753176,2952,3815,3122,5065,5928,45.033320996790806,9.443791641391353,863,1,192944,7480,2028,0,2259,1009
6339,0,0,1,0,58,1,1440,0,0,1807225,2367505,28.372521918222215,384,3471,3050,805,54900,717604,661725,2520,3746,3362,5186,6412,47.38143096192854,20.81866130795606,1226,1,181125,63992,2245,0,2136,696
6340,1,0,0,0,46,0,108,0,0,286528,1120460,22.0,484,1076,1076,484,50922,479205,569490,2315,2799,2315,2907,3391,24.331050121192877,0.0,484,0,119064,0,592,0,1831,1723
6341,1,0,0,0,46,0,107,0,0,345828,1244766,23.173260452512935,507,1211,1181,537,53286,577182,496052,2288,2855,2348,2962,3529,25.37715508089904,5.501408174353464,567,0,114918,5100,644,0,1781,1674
6342,1,0,0,0,46,0,69,1,0,459172,1499232,25.37715508089904,602,1399,1357,644,25527,467928,295656,2286,2972,2370,3041,3727,26.70205984563738,6.78953034358522,686,1,81788,8694,713,0,1684,1615
6343,1,0,0,0,47,0,173,1,0,554268,2004728,28.91366458960192,644,1691,1499,836,40700,527560,443630,2206,3234,2590,3061,4089,25.748786379167466,14.621066420214344,1028,1,154660,33216,663,0,1562,1735
6344,1,0,0,0,48,0,222,1,0,582120,2119446,29.698484809834994,648,1776,1542,882,41829,526257,458973,2169,3285,2637,3063,4179,25.69046515733026,15.939908903217605,1116,1,168462,39078,660,0,1521,1743
6345,1,0,0,0,48,0,290,1,0,735875,2442090,31.85906464414798,920,1835,1740,1015,31806,411426,447516,2311,3421,2501,3131,4241,26.92582403567252,10.50128202411823,1110,1,188790,10450,725,0,1391,1681
6346,1,0,0,0,51,0,420,0,1,765900,2838270,33.31666249791537,775,2135,1800,1110,55081,631579,570211,2222,3667,2892,3247,4692,26.267851073127396,18.610895034301322,1445,1,247530,52595,690,0,1447,1867
6347,1,0,0,0,49,0,510,0,1,404200,1072850,20.73644135332772,62,1862,1370,430,41764,528940,491515,2003,2925,2987,3435,4357,30.659419433511783,22.312223424282628,922,1,84710,74292,940,0,2065,1555
6348,1,0,0,0,49,0,434,0,1,536607,1359295,23.388031127053,11,2086,1528,547,52377,549185,588945,1927,3032,3043,3466,4571,31.32091952673165,23.727995315853523,1105,1,129639,63054,981,0,1938,1504
6349,1,0,0,0,49,0,399,0,1,610642,1505360,24.63736998950984,36,2184,1613,607,53312,555520,590240,1909,3087,3051,3486,4664,31.71750305430741,24.172484224804478,1178,1,144466,65665,1006,0,1873,1474
6350,1,0,0,0,47,0,602,0,0,854183,1606374,25.903667693977237,547,2068,1944,671,55596,541044,588924,2270,3065,2518,3667,4462,35.679125549822544,11.388237031910945,795,1,165066,12896,1273,0,1723,1121
6351,0,1,0,1,65,0,840,0,0,10529584,12069148,60.76183012385325,3502,6734,6544,3692,42639,598227,761677,3079,6961,3459,6121,10003,53.40411969127476,13.874881522629007,3882,1,860236,13300,2852,0,423,417
6352,0,0,1,0,63,1,454,0,0,312080,1193800,19.390719429665317,78,1660,1206,376,52538,692150,765175,2721,3551,3629,4005,4835,28.809720581775867,21.581464144974976,830,1,90616,47216,830,0,2799,2345
6353,0,0,1,0,61,1,172,0,0,607260,2140068,26.419689627245813,578,1688,1568,698,55056,680652,760368,2946,3764,3186,3936,4754,29.49576240750525,10.981735174982626,818,1,173104,11280,870,0,2368,2196
6354,0,0,1,0,58,1,1383,0,0,1722600,2320560,28.142494558940577,402,3357,2967,792,55278,729570,650460,2540,3722,3320,5105,6287,46.636895265444075,20.017601749743942,1182,1,175824,61230,2175,0,2138,755
6355,0,0,0,0,56,1,1667,1,0,2085834,2367726,28.879058156387302,726,3443,3335,834,48174,616063,630258,2731,3673,2947,5340,6282,50.00999900019995,10.44206354473662,942,1,185148,13824,2501,0,2005,338
6356,1,0,0,0,46,0,135,0,0,345316,1212536,22.891046284519195,524,1183,1183,524,48548,529906,490568,2314,2838,2314,2973,3497,25.67099530598687,0.0,524,0,111088,0,659,0,1790,1655
6357,1,0,0,0,46,0,54,1,0,432235,1477802,25.11971337416094,564,1383,1316,631,23324,459032,278698,2275,2973,2409,3027,3725,26.1725046566048,8.47749576439433,698,1,75089,13936,685,0,1711,1657
6358,1,0,0,0,47,0,128,1,0,492929,1841755,27.730849247724095,599,1580,1410,769,35524,512530,397570,2225,3164,2565,3036,3975,25.317977802344327,13.802720429891991,939,1,127654,31450,641,0,1626,1754
6359,1,0,0,0,48,0,292,1,0,691020,2395800,31.464265445104548,866,1812,1688,990,30960,416240,435600,2296,3410,2544,3118,4232,26.419689627245813,11.83231048371444,1114,1,178200,14508,698,0,1430,1722
6360,1,0,0,0,48,0,297,1,0,716688,2435328,31.74901573277509,900,1827,1719,1008,29666,393808,439712,2308,3424,2524,3127,4243,26.664583251946766,11.137157851700797,1116,1,183456,11124,711,0,1408,1705
6361,0,0,1,0,60,1,1817,0,0,3946668,9390348,55.614746245937326,2959,4503,4369,3093,54189,737748,677028,2902,6129,3170,4312,7539,35.7211421989835,11.586137991427458,3227,1,689739,20770,1276,0,57,1760
6362,0,0,1,0,64,1,618,0,0,298903,1022714,17.86057109949175,124,1699,1256,319,56160,769440,750204,2763,3525,3649,4143,4905,30.610455730027933,21.19287765750318,762,1,74646,60248,937,0,2887,2269
6363,0,0,1,0,59,1,1092,0,0,1381500,2235750,27.386127875258307,431,2911,2592,750,56635,718421,700535,2662,3731,3300,4823,5892,42.91852746774987,18.10879194843846,1069,1,176250,40513,1842,0,2231,1139
6364,0,0,1,0,58,1,1369,0,0,1791972,2393937,28.61817604250837,459,3367,3007,819,53714,733673,625522,2563,3742,3283,5111,6290,46.776062254106,19.232749017330665,1179,1,175266,60840,2188,0,2104,735
6365,0,0,1,0,57,1,1554,0,0,2625480,2944740,31.937438845342623,574,4040,3594,1020,52900,664010,664010,2441,3907,3333,5461,6927,50.73460357586329,21.120410580967924,1466,1,234600,59764,2574,0,1867,313
6366,1,0,0,0,48,0,268,1,0,547548,2154752,29.765752132274432,652,1738,1504,886,36616,483968,447488,2198,3318,2666,3050,4170,24.859605789312106,15.822570894840952,1120,1,163024,34866,618,0,1546,1814
6367,1,0,0,0,48,0,295,1,0,648186,2353176,31.080540535840107,816,1787,1637,966,29750,414120,426300,2286,3402,2586,3107,4223,25.903667693977237,13.056526021193557,1116,1,169050,18000,671,0,1470,1765
6368,1,0,0,0,48,0,24,0,0,672256,1965056,28.42534080710379,748,1700,1640,808,43554,445056,578816,2372,3240,2492,3264,4132,28.844410203711913,7.7992067098508295,868,1,192304,3660,832,0,1624,1600
6369,1,0,0,0,47,0,143,0,0,640500,1755336,27.055498516937366,732,1607,1607,732,45310,472406,551540,2398,3130,2398,3273,4005,29.58039891549808,0.0,732,1,168360,0,875,0,1666,1523
6370,1,0,0,0,47,0,178,0,0,627288,1692828,26.60826939130014,708,1594,1594,708,47560,490155,554712,2391,3099,2391,3277,3985,29.765752132274432,0.0,708,1,164256,0,886,0,1683,1505
6371,0,1,0,1,67,0,642,0,0,5992920,7275276,46.34652090502587,1813,5273,4938,2148,51920,799332,745140,3052,5535,3722,6177,8660,52.820450584977024,18.73685655681975,2483,1,472560,51255,2790,0,1239,597
6372,0,0,1,0,62,1,224,0,0,342672,1520244,22.0,133,1543,1192,484,55615,713007,769545,2790,3625,3492,3849,4684,26.60826939130014,18.918562322693283,835,1,118580,37206,708,0,2657,2433
6373,0,0,1,0,62,1,178,0,0,316979,1499758,21.93171219946131,213,1408,1140,481,54918,704668,757674,2850,3599,3386,3777,4526,25.67099530598687,16.495152579479317,749,1,116883,29212,659,0,2637,2459
6374,0,0,1,0,58,1,1337,0,0,1816628,2436940,28.91366458960192,506,3339,3009,836,55800,722920,655875,2585,3751,3245,5088,6254,46.61544808322666,18.408266610859535,1166,1,188100,49830,2173,0,2079,742
6375,0,0,0,0,54,1,678,0,0,21240,81210,5.477225575051661,210,978,738,30,50140,622610,590126,2467,2737,2947,3415,3685,26.60826939130014,15.496234907772216,270,0,6540,35520,708,0,2677,1999
6376,0,0,0,0,54,1,700,1,0,66725,229585,9.219544457292887,35,990,870,85,53118,632034,613127,2581,2786,2821,3486,3691,28.0178514522438,10.955211796648204,205,1,19295,17040,785,0,2616,1916
6377,0,0,0,0,53,1,790,1,0,51000,161580,7.745966692414834,30,940,910,60,53580,632855,614004,2663,2753,2723,3543,3633,29.154759474226502,5.477225575051661,90,1,13680,4230,850,0,2633,1843
6378,1,0,0,0,48,0,246,1,0,469287,1993446,28.61817604250837,500,1711,1392,819,36018,503838,423516,2115,3253,2753,3007,4145,23.93741840717165,18.26783920894375,1138,1,142506,54230,573,0,1615,1861
6379,1,0,0,0,49,0,293,1,0,583044,2267496,30.397368307141328,734,1745,1555,924,31020,461352,404910,2264,3378,2644,3085,4199,25.11971337416094,14.637116746262372,1114,1,152460,29260,631,0,1530,1823
6380,1,0,0,0,48,0,308,1,0,690309,2436561,31.606961258558215,909,1780,1690,999,36256,429264,502434,2349,3438,2529,3130,4219,26.28687885618983,10.50882969403483,1089,1,205794,8460,691,0,1440,1748
6381,1,0,0,0,48,0,150,0,0,675000,1805250,27.386127875258307,750,1650,1650,750,42262,450109,543982,2407,3157,2407,3307,4057,30.0,0.0,750,1,169500,0,900,0,1657,1507
6382,0,0,1,0,59,1,1233,0,0,1473610,5888506,44.474711915874174,1616,3085,2723,1978,53128,681733,690664,2615,4955,3339,3722,6062,27.294688127912362,19.07579542641156,2340,1,458896,46698,745,0,999,2232
6383,0,0,1,0,60,1,1687,0,0,4126308,9220290,55.163393659201205,2948,4494,4399,3043,53352,709020,690840,2935,6073,3125,4386,7524,36.823905279043935,9.759997214798725,3138,1,693804,13395,1356,0,13,1674
6384,0,0,1,0,61,1,12,0,0,298080,1683600,23.49468024894146,485,1159,1092,552,48697,637450,710650,2983,3602,3117,3590,4209,23.2379000772445,8.185808589931957,619,1,128616,7035,540,0,2498,2510
6385,0,0,1,0,58,1,1306,0,0,1844640,2481724,29.223278392404914,554,3314,3014,854,56350,711970,668380,2606,3760,3206,5066,6220,46.475800154489,17.53881817214849,1154,1,196420,42000,2160,0,2052,746
6386,0,0,1,0,57,1,1575,0,0,3064324,3261292,33.645207682521445,686,4285,3839,1132,48618,639582,630939,2435,4013,3327,5588,7166,52.028838157314254,21.132738950733557,1578,1,247908,61994,2707,0,1749,174
6387,0,0,0,0,54,1,686,0,0,21480,81300,5.477225575051661,242,1018,746,30,49259,615170,588070,2438,2740,2982,3426,3728,26.758176320519304,16.499161663578043,302,0,6510,39984,716,0,2680,1994
6388,0,0,0,0,54,1,683,0,0,50250,181436,8.18535277187245,145,1029,817,67,49932,617424,593052,2496,2775,2920,3458,3737,27.386127875258307,14.566775612304511,279,0,14673,30740,750,0,2641,1958
6389,1,0,0,0,48,0,311,1,0,650682,2390719,31.25699921617557,882,1738,1643,977,41810,452695,553022,2352,3424,2542,3113,4185,25.80697580112788,10.525591954947746,1072,1,220802,7790,666,0,1470,1781
6390,1,0,0,0,48,0,320,1,0,828176,2616776,32.92415526630866,1054,1878,1848,1084,34602,572118,352444,2384,3498,2444,3178,4292,27.640549922170507,5.830951894845301,1114,1,158264,6780,764,0,1330,1650
6391,1,0,0,0,48,0,321,1,0,868210,2688686,33.25657829663178,1046,1951,1891,1106,34177,581009,347633,2371,3537,2491,3216,4382,28.0178514522438,8.275039169881914,1166,1,158158,13740,785,0,1325,1646
6392,1,0,0,0,50,0,130,1,0,809379,2424269,31.096623610932426,872,1899,1804,967,44180,471316,589145,2412,3474,2602,3344,4406,28.930952282978865,10.115242524801646,1062,1,227245,7030,837,0,1540,1670
6393,1,0,0,0,48,0,119,1,0,643680,1790980,27.294688127912362,703,1651,1609,745,42336,454356,538496,2362,3149,2446,3268,4055,29.393876913398138,6.484411467763075,787,1,166880,3738,864,0,1659,1540
6394,0,1,0,1,66,0,102,0,0,6721048,8485196,50.41825066382212,2408,5320,5186,2542,34040,614192,617530,3204,5880,3472,5982,8658,51.419840528729765,11.889245776390416,2676,1,470270,17286,2644,0,796,694
6395,0,0,1,0,63,1,500,0,0,336924,1218580,19.544820285692065,110,1756,1264,382,54752,740080,752840,2698,3572,3682,4072,4946,29.698484809834994,22.2577380581274,874,1,90152,62484,882,0,2808,2308
6396,0,0,1,0,57,1,1309,0,0,1963292,2585908,29.866369046136157,622,3363,3093,892,55000,724750,637780,2629,3791,3169,5100,6262,46.9148164229596,16.637457302852365,1162,1,196240,42930,2201,0,2007,698
6397,0,0,0,0,53,1,750,1,0,104400,323520,10.954451150103322,35,1075,990,120,50175,601208,606600,2611,2816,2781,3566,3771,29.49576240750525,9.227509513928014,205,1,27000,11220,870,0,2576,1826
6398,1,0,0,0,47,0,12,1,0,339853,1401231,24.269322199023193,547,1208,1166,589,36873,573339,363987,2337,2968,2421,2956,3587,24.020824298928627,6.538739683827756,631,1,90117,9408,577,0,1790,1802
6399,1,0,0,0,49,0,20,0,0,795564,2167956,29.698484809834994,882,1784,1784,882,43197,459646,567798,2458,3340,2458,3360,4242,30.033314835362415,0.0,882,1,203742,0,902,0,1576,1556
6400,0,1,1,0,61,0,774,0,0,8300880,10132344,57.39337940912697,3160,5948,5814,3294,55328,689024,759772,2942,6370,3210,5596,9024,50.19960159204453,11.64626725886957,3428,1,813618,13132,2520,0,218,556
6401,0,1,1,0,56,0,1110,0,0,157099,361188,11.269427669584644,19,1472,1364,127,45120,546048,668340,2736,2971,2952,4081,4316,35.17101079013795,10.89017689082249,235,1,29845,8424,1237,0,2717,1607
6402,0,0,1,0,59,1,581,0,0,1292712,2629574,29.715315916207253,756,2474,2347,883,55860,678984,729610,2851,3861,3105,4442,5452,38.262252939417984,11.269602342001788,1010,1,216335,13716,1464,0,2095,1514
6403,0,0,1,0,58,1,1135,0,0,1750104,2554088,29.5296461204668,587,3164,2879,872,56870,708818,688315,2644,3801,3214,4936,6093,44.799553569204235,17.05998101278399,1157,1,204920,37905,2007,0,2057,922
6404,0,0,0,0,54,1,682,0,0,65195,231030,9.219544457292887,200,1137,852,85,47952,603396,587088,2433,2803,3003,3485,3855,27.694764848252458,16.900669548544084,370,0,18360,40755,767,0,2633,1951
6405,0,0,0,0,54,1,687,1,0,74290,258020,9.746794344808963,161,1133,877,95,47952,602952,586656,2460,2811,2972,3498,3849,27.964262908219126,16.01761006559187,351,1,20520,36352,782,0,2621,1934
6406,0,0,0,0,54,1,689,1,0,103632,344551,11.269427669584644,74,1144,943,127,49056,607712,594147,2512,2840,2914,3529,3857,28.5657137141714,14.194610677421545,328,1,27813,28341,816,0,2586,1897
6407,0,0,0,0,54,1,719,1,0,133416,413712,12.36931687685298,26,1152,1025,153,49280,594880,605696,2577,2857,2831,3576,3856,29.5296461204668,11.298832705339896,280,1,34272,16510,872,0,2551,1832
6408,1,0,0,0,48,0,250,1,0,268464,979200,20.199009876724155,323,1151,1066,408,30772,376800,470400,2315,2808,2485,3058,3551,25.65151067676132,10.00848918394426,493,1,79968,6630,658,0,1992,1742
6409,1,0,0,0,47,0,105,1,0,297000,1177605,22.24859546128699,465,1125,1095,495,27612,371124,421083,2349,2874,2409,2979,3504,24.49489742783178,6.004624280888846,525,1,87615,2970,600,0,1884,1779
6410,1,0,0,0,49,0,286,1,0,409887,1975927,28.26658805020514,514,1597,1312,799,36839,487181,462451,2188,3272,2758,2986,4070,22.64950330581225,16.986193244075324,1084,1,149413,40755,513,0,1674,1960
6411,1,0,0,0,49,0,306,1,0,493552,2167792,29.5296461204668,697,1613,1438,872,44290,512116,534490,2311,3358,2661,3052,4099,23.790754506740637,13.57796224751577,1047,1,187480,21700,566,0,1614,1920
6412,1,0,0,0,48,0,322,1,0,715400,2463020,31.96873472629156,1022,1722,1722,1022,48837,527790,537430,2410,3432,2410,3110,4132,26.457513110645905,0.0,1022,1,227906,0,700,0,1388,1710
6413,0,1,1,0,63,0,504,0,0,7329457,9379447,54.506880299646575,2851,5558,5438,2971,29394,672441,435666,3037,6128,3277,5624,8715,49.66890375275057,11.180339887498949,3091,1,409998,25320,2467,0,186,690
6414,0,0,1,0,60,1,127,0,0,4869024,6874317,47.65501022977542,1947,4739,4415,2271,46440,653832,650805,2703,5298,3351,5171,7766,46.3033476111609,18.128294347542088,2595,1,488265,44388,2144,0,756,883
6415,0,0,1,0,57,1,1263,0,0,2070820,2710960,30.659419433511783,730,3353,3143,940,56635,695044,677740,2674,3824,3094,5087,6237,46.93612681080534,14.662164531492765,1150,1,220900,28140,2203,0,1944,681
6416,0,0,0,0,54,1,683,1,0,21390,81930,5.477225575051661,465,1238,743,30,48825,614475,592627,2236,2761,3226,3444,3969,26.70205984563738,22.271804260399453,525,1,6510,71280,713,0,2701,2018
6417,0,0,0,0,54,1,698,0,0,51255,182508,8.18535277187245,284,1183,832,67,48590,615624,585660,2373,2791,3075,3489,3907,27.65863337187866,18.75870963320733,418,0,14405,51948,765,0,2657,1959
6418,0,0,0,0,54,1,693,1,0,66130,231455,9.219544457292887,238,1186,863,85,49032,618121,588168,2400,2808,3046,3501,3909,27.892651361962706,17.996955674948754,408,1,18360,47804,778,0,2638,1945
6419,1,0,0,0,48,0,236,0,1,254400,965600,20.0,292,1144,1036,400,36312,429692,492456,2306,2814,2522,3050,3558,25.219040425836983,11.273617567818544,508,1,81600,10692,636,0,2014,1778
6420,1,0,0,0,48,0,196,1,0,300645,1598855,25.592967784139454,475,1294,1114,655,35420,537020,393001,2261,3096,2621,2900,3735,21.42428528562855,13.809655350650639,835,1,105455,35640,459,0,1786,1982
6421,1,0,0,0,48,0,45,1,0,760750,2080800,29.154759474226502,765,1830,1745,850,39516,435744,543456,2363,3298,2533,3343,4278,29.916550603303182,9.219544457292887,935,1,188700,6460,895,0,1598,1553
6422,0,0,1,0,61,1,211,0,0,275630,1972998,25.317977802344327,440,1272,1071,641,54520,714096,723330,2877,3719,3279,3508,4350,20.73644135332772,14.289801709712407,842,1,150635,25929,430,0,2437,2648
6423,0,0,0,0,54,1,690,1,0,70200,245610,9.486832980505138,300,1260,870,90,49050,614025,594922,2339,2819,3119,3509,3989,27.92848008753788,19.777566693406925,480,1,19620,56160,780,0,2639,1949
6424,0,0,0,0,54,1,697,1,0,75240,259065,9.746794344808963,267,1249,887,95,49940,619029,599940,2365,2822,3089,3519,3976,28.142494558940577,19.054691236615497,457,1,20900,51404,792,0,2632,1935
6425,0,0,0,0,54,1,684,1,0,125100,408300,12.24744871391589,133,1267,984,150,51290,626060,607006,2439,2872,3005,3556,3989,28.879058156387302,16.850314261454166,433,1,33450,40469,834,0,2572,1888
6426,0,0,0,0,54,1,727,1,0,196770,567840,14.491376746189438,60,1297,1147,210,51983,613808,619216,2554,2914,2854,3641,4001,30.610455730027933,12.27795318108085,360,1,48090,19650,937,0,2494,1767
6427,0,0,0,0,53,1,767,0,0,205170,566370,14.491376746189438,102,1295,1187,210,52440,614916,620310,2589,2907,2805,3674,3992,31.25699921617557,10.414507905016443,318,0,48300,14256,977,0,2487,1720
6428,0,0,0,0,53,1,935,1,0,134874,341376,11.269427669584644,67,1249,1189,127,52206,620928,607488,2628,2815,2748,3750,3937,32.58834147360065,7.754559014766193,187,1,28702,8460,1062,0,2561,1626
6429,1,0,0,0,48,0,83,1,0,259910,1130820,21.6794833886788,403,1090,1023,470,41230,457140,522102,2339,2876,2473,2959,3496,23.515952032609693,8.592096094735382,537,1,101990,6633,553,0,1936,1853
6430,1,0,0,0,48,0,196,1,0,269180,1533074,25.019992006393608,446,1236,1056,626,36320,555923,391840,2269,3075,2629,2879,3685,20.73644135332772,13.910311642766361,806,1,100160,37080,430,0,1823,2019
6431,1,0,0,0,49,0,270,1,0,301000,1747200,26.457513110645905,340,1490,1130,700,34020,524160,404352,2136,3196,2856,2926,3986,20.73644135332772,19.46395681750655,1060,1,113400,66600,430,0,1796,2066
6432,1,0,0,0,50,0,197,0,1,1048110,2860326,33.57082066318904,915,2269,2057,1127,49086,616734,512676,2326,3665,2750,3468,4807,30.495901363953813,14.669851868889596,1339,1,227654,37948,930,0,1411,1608
6433,0,0,1,0,60,1,313,0,0,800880,3232275,32.63433774416144,890,1992,1817,1065,51493,707155,670735,2860,4100,3210,3787,5027,27.422618401604176,13.246969194075609,1240,1,235365,26075,752,0,1970,2283
6434,0,0,1,0,60,1,1536,0,0,4450201,9117338,54.89080068645383,2863,4640,4490,3013,50561,656642,705058,2876,6039,3176,4503,7666,38.43175770115127,12.30152264982736,3163,1,702029,17250,1477,0,13,1549
6435,0,0,1,0,60,1,161,0,0,4941920,6479168,46.3033476111609,1835,4758,4449,2144,46866,646708,661818,2713,5166,3331,5327,7780,48.010415536631214,17.97981862241828,2453,1,469536,39552,2305,0,878,717
6436,0,0,1,0,60,1,204,0,0,658720,2778400,30.331501776206203,786,1770,1636,920,56635,727820,709700,2886,3940,3154,3736,4790,26.758176320519304,11.579864037853417,1054,1,216200,17688,716,0,2100,2304
6437,0,0,0,0,57,1,1080,1,0,270900,603540,14.491376746189438,501,2211,1500,210,40385,589170,566178,2163,3084,3585,4164,5085,35.91656999213594,26.93391414425165,921,1,41370,100962,1290,0,2664,1584
6438,0,0,0,0,55,1,660,0,0,67500,247950,9.486832980505138,409,1339,840,90,47952,595080,611610,2256,2845,3254,3505,4094,27.386127875258307,22.364189575272714,589,0,19980,63373,750,0,2665,2005
6439,0,0,0,0,54,1,665,1,0,67950,247050,9.486832980505138,463,1398,845,90,48841,606645,606645,2192,2835,3298,3500,4143,27.477263328068172,23.532103088301252,643,1,19890,74655,755,0,2655,1990
6440,0,0,0,0,54,1,689,1,0,70110,246240,9.486832980505138,395,1354,869,90,49268,618336,596448,2251,2826,3221,3515,4090,27.910571473905726,22.054688677793425,575,1,19620,69355,779,0,2646,1957
6441,0,0,0,0,54,1,695,1,0,101556,338396,11.135528725660043,252,1319,943,124,50850,616754,614025,2353,2853,3105,3548,4048,28.61817604250837,19.42150637380626,500,1,27900,51136,819,0,2605,1910
6442,0,0,0,0,54,1,690,1,0,146200,462910,13.038404810405298,130,1330,1030,170,52658,634459,615398,2423,2893,3023,3583,4053,29.32575659723036,17.358105696309828,470,1,38420,42900,860,0,2553,1863
6443,0,0,0,0,54,1,700,1,0,227964,655578,15.556349186104045,50,1376,1184,242,51076,612234,612234,2517,2951,2901,3651,4085,30.692018506445613,13.893842384028202,434,1,54692,25728,942,0,2467,1767
6444,1,0,0,0,48,0,74,1,0,242667,1103655,21.37755832643195,372,1073,988,457,44748,478170,545790,2330,2872,2500,2946,3488,23.043437243605826,9.649220942233358,542,1,103282,8500,531,0,1958,1884
6445,1,0,0,0,49,0,198,1,0,239200,1466296,24.454038521274967,418,1178,998,598,38232,578672,397224,2272,3050,2632,2852,3630,20.0,13.950540266179848,778,1,96876,38340,400,0,1854,2052
6446,1,0,0,0,48,0,40,1,0,615825,1948100,28.372521918222215,604,1771,1570,805,41952,445280,551760,2219,3225,2621,3185,4191,27.65863337187866,14.188050253419588,1006,1,183540,15276,765,0,1615,1655
6447,0,1,1,0,62,0,1092,0,0,8689888,11043104,59.531504264548865,3514,6026,5996,3544,55278,691752,775884,3086,6660,3146,5568,9142,49.51767361255979,5.531194905403055,3574,1,882456,2670,2452,0,428,664
6448,0,1,1,0,58,0,1026,0,0,467856,1006506,18.49324200890693,18,2034,1710,342,44180,553284,691605,2619,3285,3267,4311,4977,36.98648401781386,18.81897769113125,666,1,80370,23652,1368,0,2601,1575
6449,0,0,1,0,59,1,1865,0,0,2059676,7836816,51.419840528729765,2644,3423,3423,2644,45441,720252,554268,2964,5608,2964,3743,6387,27.910571473905726,0.0,2644,1,494428,0,779,0,320,2185
6450,0,0,0,0,55,1,665,0,0,94200,332520,10.954451150103322,354,1379,905,120,49280,609620,620704,2297,2891,3245,3556,4150,28.0178514522438,21.804630235575054,594,0,26880,61146,785,0,2651,1986
6451,0,0,0,0,54,1,665,1,0,94200,329760,10.954451150103322,456,1481,905,120,48620,607308,604560,2172,2868,3324,3533,4229,28.0178514522438,24.015194620840177,696,1,26400,78912,785,0,2628,1963
6452,0,0,0,0,54,1,694,1,0,129591,417843,12.36931687685298,238,1391,1000,153,50624,611744,617206,2340,2884,3122,3578,4122,29.103264421710495,19.806748282496446,544,1,34578,51612,847,0,2578,1884
6453,0,0,0,0,54,1,688,1,0,190800,576640,14.560219778561036,85,1409,1112,212,51975,628320,612000,2423,2932,3017,3620,4129,30.0,17.274619134080364,509,1,47700,41877,900,0,2508,1820
6454,1,0,0,0,48,0,162,1,0,215280,1342464,23.49468024894146,432,1062,942,552,41990,600704,413440,2312,2984,2552,2822,3494,19.748417658131498,11.471280364317135,672,1,93840,25560,390,0,1880,2042
6455,0,1,0,1,67,0,400,0,0,6803456,9532160,53.0659966456864,2561,5487,5232,2816,24003,639765,429895,3130,6201,3640,5801,8872,49.15282290977803,16.0273953799475,3071,1,357632,49215,2416,0,569,969
6456,0,1,0,1,66,0,703,0,0,5201004,6486096,44.22668877499196,1822,4749,4615,1956,45320,683096,729520,3182,5272,3450,5975,8065,51.56549233741495,11.757812605679836,2090,1,430320,15678,2659,0,1360,657
6457,0,1,1,0,60,0,1028,0,0,840405,1621740,23.173260452512935,87,2552,2102,537,42365,558700,691580,2570,3557,3470,4585,5572,39.56008088970496,21.224743426301266,987,1,122973,35100,1565,0,2483,1455
6458,0,0,1,0,60,1,372,0,0,1197504,3926880,36.0,1188,2328,2220,1296,44694,709020,578730,2922,4326,3138,3954,5358,30.397368307141328,10.419152549993726,1404,1,247536,19764,924,0,1734,2106
6459,0,0,1,0,59,1,1214,0,0,1780707,6194124,45.53020975132884,1801,3204,2932,2073,55221,708156,696204,2716,5061,3260,3847,6192,29.30870177950569,16.641093199989466,2345,1,483009,36720,859,0,915,2129
6460,0,0,1,0,57,1,1304,0,0,2697185,3188900,33.391615714128,1007,3642,3534,1115,55575,706420,643500,2752,3975,2968,5279,6502,49.18333050943175,10.655033166942168,1223,1,250875,15876,2419,0,1745,441
6461,0,0,0,0,55,1,669,0,0,122850,416550,12.24744871391589,334,1453,969,150,49922,605386,635933,2293,2927,3261,3596,4230,28.61817604250837,22.043284001745985,634,0,34350,58564,819,0,2627,1958
6462,0,0,0,0,55,1,662,1,0,121800,415650,12.24744871391589,366,1478,962,150,48840,609620,615162,2255,2921,3287,3583,4249,28.495613697550013,22.74477631428357,666,1,33300,68628,812,0,2621,1959
6463,0,0,0,0,55,1,669,1,0,122850,412500,12.24744871391589,441,1560,969,150,46652,599500,588500,2159,2900,3341,3569,4310,28.61817604250837,24.355624117489107,741,1,32100,82740,819,0,2600,1931
6464,0,0,0,0,54,1,693,1,0,216918,636948,15.297058540778355,85,1480,1161,234,50394,617894,604284,2403,2956,3041,3649,4202,30.44667469527666,17.90259003880658,553,1,51948,44660,927,0,2488,1795
6465,0,0,0,0,54,1,687,1,0,240210,693345,15.968719422671311,42,1494,1197,255,51300,619932,611775,2422,2974,3016,3661,4213,30.692018506445613,17.27747974441116,552,1,57375,40689,942,0,2464,1777
6466,0,0,0,0,54,1,768,1,0,289465,748454,16.64331697709324,87,1512,1322,277,50838,599844,618758,2512,2979,2892,3747,4214,32.32645975048923,13.814873398238463,467,1,63433,23750,1045,0,2425,1657
6467,1,0,0,0,47,0,48,1,0,201924,1136178,21.77154105707724,474,900,900,474,47722,534531,512958,2397,2871,2397,2823,3297,20.639767440550294,0.0,474,1,101436,0,426,0,1923,1971
6468,1,0,0,0,49,0,247,1,0,190410,1436153,24.020824298928627,322,1162,907,577,39360,612294,398240,2234,3066,2744,2819,3651,18.16590212458495,16.294791930224218,832,1,92320,56100,330,0,1912,2159
6469,0,1,0,1,67,0,509,0,0,6833732,9746423,53.67494760127857,2689,5445,5253,2881,16740,629238,304470,3191,6264,3575,5755,8828,48.703182647543684,14.237423152114085,3073,1,259290,42624,2372,0,502,1011
6470,0,0,1,0,59,1,1680,0,0,2023504,7363860,49.91993589739474,2402,3394,3304,2492,42075,664875,552585,2865,5447,3045,3767,6349,28.495613697550013,9.52871847115494,2582,1,466004,16020,812,0,463,2143
6471,0,0,1,0,60,1,1237,0,0,4772628,8736336,53.749418601506754,2709,4721,4541,2889,44550,680400,598752,2844,5913,3204,4676,7745,40.64480286580315,13.480646069601503,3069,1,572022,29880,1652,0,135,1372
6472,0,0,1,0,59,1,611,0,0,4993950,5791500,44.15880433163923,1883,4578,4511,1950,50429,626670,709830,2903,4920,3037,5531,7548,50.60632371551998,8.2143728690235,2017,0,466050,6633,2561,1,1020,409
6473,0,0,0,0,57,1,1440,1,0,238500,428850,12.24744871391589,588,2478,1740,150,39900,651852,500325,2121,3009,3597,4449,5337,39.87480407475377,27.36508325576893,888,1,26250,141696,1590,0,2709,1269
6474,0,0,0,0,55,1,665,1,0,152100,499860,13.416407864998739,345,1550,1025,180,48620,613717,610940,2252,2957,3302,3622,4327,29.068883707497267,22.951209313599893,705,1,39600,71400,845,0,2597,1932
6475,0,0,0,0,55,1,660,1,0,151200,498060,13.416407864998739,396,1596,1020,180,47736,597672,611507,2191,2947,3343,3607,4363,28.982753492378876,24.019669815848193,756,1,39780,73728,840,0,2587,1927
6476,0,0,0,0,55,1,669,1,0,152820,496080,13.416407864998739,424,1633,1029,180,44096,584272,573248,2152,2936,3360,3605,4389,29.13760456866693,24.63094817139745,784,1,37440,83956,849,0,2576,1907
6477,1,0,0,0,48,0,5,1,0,483714,1691254,26.419689627245813,401,1688,1391,698,39150,421602,545175,2126,3121,2720,3116,4111,26.324893162176366,17.406895185529212,995,1,157050,19602,693,0,1725,1730
6478,0,1,1,0,61,0,1082,0,0,7755888,10353570,58.12056434688156,3348,5704,5674,3378,47355,708015,628325,3035,6443,3095,5361,8769,47.916594202843754,5.501408174353464,3408,0,692490,4950,2296,1,313,769
6479,0,1,1,0,61,0,1052,0,0,2549085,3571260,33.98529093593286,1113,3404,3362,1155,34038,565836,575112,3050,4247,3134,5299,6496,46.97871858618538,6.538739683827756,1197,1,214830,5250,2207,0,1937,885
6480,0,0,1,0,60,1,304,0,0,1206777,3813264,35.510561809129406,1219,2260,2218,1261,50430,743904,619920,2982,4285,3066,3981,5284,30.93541659651604,6.495386533491135,1303,1,258505,7518,957,0,1763,2067
6481,0,0,1,0,61,1,622,0,0,5056179,7890117,50.80354318352215,2286,4835,4540,2581,45540,703110,605286,2762,5638,3352,5016,7892,44.26059195266146,17.399306263874642,2876,1,511038,50445,1959,0,476,1098
6482,0,0,1,0,60,1,218,0,0,5118344,6521900,46.4327470649756,1909,4777,4530,2156,52056,653400,729025,2778,5181,3272,5399,7802,48.72371086031933,15.914415857597147,2403,1,519596,24947,2374,0,869,651
6483,0,0,0,0,56,1,2135,1,0,1151126,1249692,21.118712081942874,326,3147,3027,446,53297,624846,669678,2682,3248,2922,5383,5949,50.80354318352215,10.991537949000206,566,1,106594,13440,2581,0,2356,221
6484,0,0,0,0,55,1,661,1,0,182910,581280,14.491376746189438,408,1699,1081,210,46440,595120,597888,2150,2978,3386,3639,4467,29.512709126747414,24.878395616114684,828,1,45360,82194,871,0,2558,1897
6485,0,0,0,0,54,1,697,1,0,380520,975960,18.973665961010276,92,1685,1417,360,51528,612686,618108,2443,3071,2979,3768,4396,32.51153641401772,16.412088255480956,628,1,82080,35376,1057,0,2351,1654
6486,0,0,0,0,54,1,735,1,0,364086,918012,18.411952639521967,83,1669,1413,339,51754,612008,620132,2452,3047,2964,3782,4377,32.77193921634788,16.0350409690718,595,1,77631,33536,1074,0,2369,1634
6487,1,0,0,0,48,0,179,1,0,139830,1154664,21.77154105707724,350,893,769,474,39360,584640,399504,2312,2910,2560,2731,3329,17.175564037317667,11.214528750203367,598,1,77736,26536,295,0,1962,2141
6488,0,1,0,1,68,0,473,0,0,6566970,9688880,53.009433122794285,2598,5359,5147,2810,20130,630984,379280,3236,6258,3660,5785,8807,48.342527861087284,14.799265660112745,3022,1,309100,42612,2337,0,638,1111
6489,0,0,0,0,57,1,1381,0,1,3553266,3792960,36.29049462324811,1127,4205,4015,1317,49276,731520,558720,2690,4197,3070,5578,7085,51.94227565288221,14.241925542717267,1507,1,255498,36480,2698,0,1563,182
6490,0,0,0,0,57,1,1938,1,0,3045055,2963922,32.046840717924134,757,4262,3992,1027,56364,704184,666666,2616,3913,3156,5851,7148,54.45181356024793,16.999389342224802,1297,1,237237,37800,2965,0,1859,79
6491,0,0,0,0,57,1,2036,1,0,2789612,2699564,30.62678566222711,666,4184,3912,938,56643,682086,687842,2606,3816,3150,5852,7062,54.53439281774392,16.973886565026337,1210,1,224182,33456,2974,0,1940,96
6492,0,0,0,0,55,1,662,1,0,216480,667920,15.491933384829668,352,1734,1142,240,48618,617826,609477,2191,3023,3375,3685,4517,30.033314835362415,24.372615991576364,832,1,52560,82288,902,0,2543,1881
6493,1,0,0,0,50,0,297,1,0,141568,1390795,23.515952032609693,270,1092,809,553,41480,613660,427550,2232,3068,2798,2771,3607,16.0,17.16509419912103,836,1,94010,59713,256,0,1962,2259
6494,1,0,0,0,50,0,305,0,1,153564,1447398,23.93741840717165,264,1150,841,573,39674,603714,419316,2217,3099,2835,2794,3676,16.3707055437449,17.963624451334884,882,1,95118,65508,268,0,1953,2258
6495,0,1,1,0,61,0,1359,0,0,8511300,11352075,60.6217782649107,3580,6086,5991,3675,56640,741360,729004,2994,6764,3184,5405,9175,48.12483766206386,9.82390283601982,3770,1,867300,12445,2316,0,586,773
6496,0,0,0,1,65,1,494,0,0,524216,1693342,22.759613353482084,58,2106,1530,518,54692,738794,791098,2693,3787,3845,4281,5375,31.811947441173732,24.31369260031735,1094,1,125356,63360,1012,0,2751,2257
6497,0,0,1,0,60,1,635,0,0,185954,2588855,29.206163733020468,853,1071,1071,853,56400,728400,713225,3035,3888,3035,3253,4106,14.7648230602334,0.0,853,0,200455,0,218,1,2182,2817
6498,0,0,0,0,57,1,2110,1,0,2496975,2415010,29.068883707497267,577,4068,3800,845,56406,677346,680204,2590,3703,3126,5813,6926,54.35991169970753,16.698570277407985,1113,1,201110,33768,2955,0,2013,97
6499,0,0,0,0,52,1,815,0,0,25350,79440,5.477225575051661,30,875,875,30,54466,638168,598448,2648,2678,2648,3493,3523,29.068883707497267,0.0,30,0,6780,0,845,0,2618,1803
6500,1,0,0,0,46,0,771,0,0,0,0,0.0,30,801,771,0,50370,536360,510708,2302,2332,2362,3103,3133,27.76688675382964,5.514871952411144,30,0,0,4410,771,0,2332,1561
6501,0,1,0,1,69,0,275,0,0,6040076,9062713,50.98038838612354,2209,5313,4923,2599,31304,599764,634634,3097,6086,3877,5811,8800,48.2078831727758,19.838971914323803,2989,1,473018,44850,2324,0,888,1163
6502,0,0,0,1,65,1,424,0,0,540281,1800015,23.515952032609693,19,2064,1530,553,52948,706335,794220,2721,3808,3789,4232,5319,31.25699921617557,23.390141328897467,1087,1,134932,52332,977,0,2702,2278
6503,0,0,0,0,57,1,2027,0,1,2994848,2844064,31.496031496047245,782,4221,4011,992,56364,699548,662277,2657,3859,3077,5886,7088,54.945427471264615,15.039179562052219,1202,1,229152,28980,3019,0,1875,152
6504,0,0,0,0,55,1,667,1,0,290100,837900,17.320508075688775,318,1885,1267,300,47952,620046,603288,2175,3093,3411,3760,4678,31.096623610932426,24.91605817173118,918,1,64800,87756,967,0,2493,1826
6505,0,0,0,0,53,1,903,1,0,356400,798039,17.233687939614086,42,1752,1497,297,52440,612636,618010,2432,2984,2942,3887,4439,34.64101615137755,15.982515305448514,552,1,68310,33660,1200,0,2390,1487
6506,1,0,0,0,49,0,318,1,0,464719,2111422,29.30870177950569,829,1430,1400,859,41125,577630,430150,2428,3317,2488,2999,3888,23.259406699226016,5.531194905403055,889,1,150325,6000,541,0,1599,1917
6507,1,0,0,0,49,0,128,1,0,469248,1551264,24.979991993593593,356,1644,1376,624,40356,425106,586696,2218,3110,2754,3238,4130,27.422618401604176,17.12401793006818,892,1,147264,12328,752,0,1862,1734
6508,0,0,1,0,60,1,461,0,0,1877580,4882680,40.24922359499622,1229,3170,2779,1620,52998,660066,729388,2623,4634,3405,4173,6184,34.044089061098404,19.77452826245464,2011,1,392040,40664,1159,0,1394,1855
6509,0,0,1,0,60,1,1556,0,0,2429280,7575120,50.19960159204453,2338,3666,3484,2520,33072,637272,468936,2824,5526,3188,3970,6672,31.04834939252005,13.877875589972929,2702,1,393120,35126,964,0,486,2042
6510,0,0,0,1,65,1,530,0,0,610400,1836800,23.664319132398465,22,2232,1650,560,52851,731440,777360,2698,3840,3862,4370,5512,33.015148038438355,24.3488901356674,1142,1,132720,67512,1090,0,2720,2190
6511,0,0,0,0,56,1,1422,0,1,3619440,3752760,36.3318042491699,1196,4186,4062,1320,47124,716436,531641,2719,4163,2967,5585,7029,52.364109846344185,11.515574071079046,1444,1,246840,22940,2742,0,1523,101
6512,0,0,0,0,57,1,2136,1,0,2732400,2565000,30.0,710,4126,3936,900,56608,695400,661200,2660,3750,3040,5886,6976,55.09990925582364,14.217631303092665,1090,1,208800,25840,3036,0,1950,186
6513,0,0,0,0,58,1,840,1,0,499284,1176654,20.049937655763422,257,2303,1644,402,45173,582473,664429,2268,3329,3586,4169,5230,35.24202037341219,26.20458777722384,1061,1,91254,65900,1242,0,2525,1685
6514,0,0,0,0,55,1,667,1,0,329010,923340,18.16590212458495,314,1971,1327,330,47080,615560,598772,2154,3128,3442,3795,4769,31.575306807693888,25.439581578779233,974,1,70620,91448,997,0,2468,1801
6515,0,0,0,0,55,1,664,1,0,328020,922350,18.16590212458495,328,1982,1324,330,46216,609310,592540,2137,3125,3453,3789,4777,31.52776554086889,25.70644779990725,988,1,69960,93436,994,0,2465,1801
6516,1,0,0,0,50,0,120,0,1,939241,2289343,30.18277654557314,826,2027,1942,911,46320,603120,485009,2428,3424,2598,3544,4540,32.109188716004645,9.227509513928014,996,1,175823,15895,1031,0,1602,1482
6517,1,0,0,0,51,0,253,0,1,736554,1901406,27.2213151776324,411,2065,1735,741,49494,579916,561954,2236,3307,2896,3560,4631,31.52776554086889,18.48758696350051,1071,1,162279,47190,994,0,1825,1572
6518,1,0,0,0,51,0,204,0,1,632800,1788500,26.457513110645905,358,1946,1604,700,49712,531440,610645,2213,3255,2897,3459,4501,30.066592756745816,18.72917466344535,1042,1,167300,32148,904,0,1855,1651
6519,1,0,0,0,49,0,155,1,0,453000,1495200,24.49489742783178,344,1611,1355,600,44772,453544,613032,2236,3092,2748,3247,4103,27.477263328068172,16.878616565704107,856,1,147600,12032,755,0,1892,1737
6520,0,1,1,0,61,0,1323,0,0,7410820,10697207,58.84725991921799,3343,5723,5603,3463,43650,695025,599266,2969,6552,3209,5229,8812,46.26013402488151,11.045361017187261,3583,0,671822,20280,2140,1,374,949
6521,0,0,1,0,61,1,1782,0,0,4454800,9813288,56.40921910468182,2822,4942,4582,3182,51884,733992,672312,2724,6266,3444,4484,8026,37.416573867739416,19.02357469072349,3542,1,693676,56160,1400,0,98,1684
6522,0,0,0,1,65,1,498,0,0,640243,1931331,24.269322199023193,31,2234,1676,589,52360,721380,780402,2721,3868,3837,4366,5513,32.96968304366907,23.85642805053363,1147,1,140182,61380,1087,0,2690,2192
6523,0,0,0,1,65,1,424,0,0,619281,1970001,24.55605831561735,78,2155,1630,603,53775,735075,780813,2742,3870,3792,4294,5422,32.046840717924134,23.151532780994827,1128,1,144117,59850,1027,0,2664,2240
6524,0,0,1,0,64,1,203,0,0,548454,2082704,25.41653005427767,229,1912,1495,646,53924,712504,786656,2807,3870,3641,4073,5136,29.13760456866693,20.691378805111135,1063,1,157624,42951,849,0,2578,2375
6525,0,0,1,0,61,1,635,0,0,274350,2843940,30.495901363953813,900,1255,1225,930,50175,681934,688050,3028,3988,3088,3353,4313,17.175564037317667,5.501408174353464,960,0,209250,3990,295,1,2128,2763
6526,0,0,0,0,56,1,1494,0,1,3591360,3659730,35.91656999213594,1182,4182,4074,1290,47628,714924,536193,2729,4127,2945,5621,7019,52.76362383309168,10.748049169056976,1398,1,243810,19764,2784,0,1547,53
6527,0,0,0,0,57,1,1605,0,1,3487050,3505500,35.07135583350036,1106,4189,4065,1230,50796,709650,581400,2726,4080,2974,5685,7039,53.24471804789655,11.612569503520847,1354,1,250920,20212,2835,0,1620,15
6528,0,0,0,0,57,1,1662,0,1,3434400,3422400,34.64101615137755,1066,4196,4062,1200,53105,704444,613180,2718,4052,2986,5714,7048,53.49766350038102,12.08361278705801,1334,1,258000,19832,2862,0,1652,10
6529,0,0,0,0,57,1,1774,0,1,3321960,3250140,33.76388603226827,990,4204,4054,1140,54900,695644,641475,2701,3991,3001,5765,7055,53.98147830506312,12.833302576044929,1290,1,256500,20400,2914,0,1711,63
6530,0,0,0,0,56,1,2162,1,0,2755800,2556900,30.0,738,4124,3962,900,56105,696045,650589,2679,3741,3003,5903,6965,55.33534132902769,13.156899899811384,1062,1,206100,22842,3062,0,1941,221
6531,0,0,0,0,57,1,792,1,0,462553,1131945,19.77371993328519,235,2200,1574,391,52425,651375,674535,2269,3286,3521,4078,5095,34.39476704383968,25.42385068803388,1017,1,91103,76998,1183,0,2504,1712
6532,1,0,0,0,46,0,730,0,0,22800,70020,5.477225575051661,30,790,790,30,48279,539154,487806,2334,2364,2334,3094,3124,27.568097504180443,0.0,30,0,6270,0,760,0,2304,1574
6533,0,0,1,0,60,1,780,0,0,2188800,5763840,43.81780460041329,1569,3411,3060,1920,50190,717478,630420,2651,4922,3353,4142,6413,33.76388603226827,18.745971294341032,2271,1,403200,58968,1140,0,1082,1862
6534,0,0,0,1,64,1,286,0,0,605232,2103408,25.45584412271571,202,2028,1582,648,53460,714120,788778,2800,3894,3692,4180,5274,30.56141357987225,21.316805716230956,1094,1,157464,45938,934,0,2598,2312
6535,0,0,0,0,56,1,1565,0,1,3559500,3564540,35.4964786985977,1170,4175,4085,1260,49698,710079,560142,2739,4089,2919,5654,7004,53.150729063673246,9.773414525644373,1350,1,249480,15480,2825,0,1569,4
6536,0,0,0,0,56,1,2194,1,0,2669615,2464930,29.512709126747414,721,4086,3936,871,56088,696180,645240,2680,3701,2980,5895,6916,55.362442142665635,12.574334296829354,1021,1,198588,21300,3065,0,1959,235
6537,0,0,0,0,57,1,788,1,0,508989,1219216,20.518284528683193,212,2263,1630,421,52851,645808,686352,2263,3317,3529,4105,5159,34.77067730142742,25.2235437773971,1054,1,99777,72795,1209,0,2475,1687
6538,0,0,0,0,53,1,624,0,0,116100,398400,12.24744871391589,26,1048,924,150,51072,605568,594944,2532,2806,2780,3430,3704,27.820855486487112,11.161509396993736,274,0,33600,17236,774,0,2506,1882
6539,1,0,0,0,47,0,629,1,0,46632,157450,8.18535277187245,7,823,763,67,44319,556950,439450,2290,2417,2410,3046,3173,26.38181191654584,7.896951773353783,127,1,12529,11460,696,0,2283,1654
6540,1,0,0,0,49,0,143,0,1,84588,561564,15.0996688705415,78,749,599,228,48204,576342,507378,2313,2691,2613,2834,3212,19.261360284258224,12.574334296829354,378,1,46968,24900,371,0,2235,2092
6541,0,1,1,0,64,0,944,0,0,1790777,3062598,30.773365106858236,545,3240,2838,947,32508,611226,556248,2832,4181,3636,5125,6474,43.485629810317796,20.83664720922846,1349,1,162884,59898,1891,0,2287,1343
6542,0,0,0,0,56,1,1635,0,1,3528046,3468958,35.08560958569767,1164,4164,4097,1231,52041,701682,588962,2751,4049,2885,5684,6982,53.53503525729669,8.456490803821907,1298,1,257279,10519,2866,0,1587,48
6543,0,0,0,0,56,1,2082,0,1,3049408,2796448,31.496031496047245,902,4156,4066,992,53628,693474,614542,2729,3811,2909,5893,6975,55.44366510251645,9.883997062654284,1082,1,216256,13140,3074,0,1827,255
6544,0,0,0,0,52,1,538,0,0,78960,317640,10.954451150103322,30,868,778,120,51296,606163,592928,2557,2767,2737,3305,3515,25.65151067676132,9.494144610579708,210,0,26880,12600,658,0,2527,1989
6545,1,0,0,0,48,0,350,1,0,64856,324414,11.575836902790225,134,886,618,134,42500,605250,411570,2153,2555,2689,2905,3307,22.0,16.383511463652106,402,1,22780,57352,484,0,2287,1937
6546,0,1,0,1,67,0,33,0,0,5218668,7645428,47.62352359916263,1769,5068,4569,2268,55404,768588,819153,2872,5639,3870,5672,8439,47.968739820845826,22.5138787857121,2767,1,551124,54890,2301,0,1103,1070
6547,0,0,0,1,65,1,439,0,0,744810,2208261,25.903667693977237,162,2290,1781,671,51012,717438,770094,2782,3962,3800,4401,5581,33.31666249791537,22.792896284156612,1180,1,157014,58535,1110,0,2620,2181
6548,0,0,0,1,65,1,366,0,0,718200,2241468,26.153393661244042,215,2203,1734,684,50007,691447,776649,2808,3961,3746,4327,5480,32.4037034920393,21.853085054558385,1153,1,162108,47838,1050,0,2593,2227
6549,0,0,1,0,64,1,70,0,0,600951,2380092,27.2213151776324,417,1876,1552,741,52779,703428,774092,2888,3953,3536,4023,5088,28.478061731796284,18.24264867608933,1065,1,178581,34020,811,0,2471,2401
6550,0,0,1,0,60,1,964,0,0,69077,3143519,32.109188716004645,904,1225,1098,1031,42586,606751,652486,2922,4080,3176,3116,4274,8.18535277187245,11.269427669584644,1158,1,220634,14732,67,0,2018,2982
6551,0,0,0,0,56,1,2151,0,1,3002860,2704984,31.04834939252005,904,4139,4079,964,53599,693082,608902,2746,3770,2866,5921,6945,55.812185049503306,8.086478275311649,1024,1,209188,8880,3115,0,1842,309
6552,0,0,0,0,59,1,970,1,0,809259,1591668,23.173260452512935,208,2789,2044,537,52320,711360,646152,2219,3501,3709,4471,5753,38.82009788756334,27.506428249081306,1282,1,117066,117710,1507,0,2427,1457
6553,1,0,0,0,48,0,229,1,0,63342,396414,12.727922061357855,50,765,553,162,43092,616644,418437,2235,2609,2659,2838,3212,19.77371993328519,14.623305456495757,374,1,27702,44944,391,0,2285,2056
6554,0,1,1,0,61,0,1619,0,0,7504302,11349936,60.54750201288241,3606,5773,5713,3666,42550,712080,572760,3036,6762,3156,5143,8869,45.24378410345447,7.772191019407321,3726,0,678210,11100,2047,1,570,1049
6555,0,1,1,0,62,0,916,0,0,1071660,2103554,25.96150997149434,133,2805,2264,674,48438,646047,730314,2580,3795,3662,4711,5926,39.87480407475377,23.660866072464273,1215,1,157716,54641,1590,0,2447,1531
6556,0,1,1,0,57,0,865,0,0,91200,271795,9.746794344808963,10,1140,1055,95,40120,486370,675196,2776,2956,2946,3821,4001,30.983866769659336,9.714504923012402,180,1,22420,3825,960,0,2766,1901
6557,0,0,0,1,65,1,444,0,0,793440,2294712,26.38181191654584,185,2347,1836,696,50561,715449,768201,2786,3993,3808,4437,5644,33.76388603226827,22.862752721305625,1207,1,162168,58254,1140,0,2601,2157
6558,0,0,0,1,63,1,85,0,0,579600,2565535,28.372521918222215,550,1780,1525,805,53072,682018,790376,2932,3992,3442,3907,4967,26.832815729997478,16.1852938789691,1060,1,199640,22440,720,0,2382,2467
6559,0,0,1,0,63,1,172,0,0,549120,2634112,28.844410203711913,620,1704,1492,832,51106,639532,800998,2954,3998,3378,3826,4870,25.69046515733026,14.701031829420534,1044,1,210496,12508,660,0,2334,2506
6560,0,0,1,0,61,1,780,0,0,283500,3226650,32.4037034920393,1008,1362,1320,1050,33124,602308,519337,3031,4123,3115,3343,4435,16.431676725154983,6.553889165207866,1092,0,177450,6762,270,1,2023,2803
6561,0,0,1,0,60,1,867,0,0,350100,3553515,34.161381705077446,899,1735,1467,1167,46438,660765,651630,2777,4212,3313,3345,4780,17.320508075688775,16.51133803132169,1435,1,249738,36984,300,0,1878,2745
6562,0,0,1,0,60,1,390,0,0,1096200,3787560,35.4964786985977,1080,2310,2130,1260,41600,625248,601200,2826,4266,3186,3876,5316,29.49576240750525,13.508622280193736,1440,1,252000,25740,870,0,1746,2136
6563,0,0,0,0,59,1,966,0,1,862920,1670004,23.748684174075834,158,2816,2094,564,55104,728406,663264,2239,3525,3683,4491,5777,39.11521443121589,27.08198119141618,1286,1,126336,111188,1530,0,2397,1431
6564,0,0,0,0,59,1,899,0,1,880590,1748769,24.310491562286437,93,2765,2081,591,55902,716078,683529,2275,3550,3643,4449,5724,38.600518131237564,26.37594177771653,1275,1,136521,97128,1490,0,2368,1469
6565,0,0,0,0,59,1,845,0,1,881364,1794292,24.63736998950984,42,2708,2059,607,55056,733088,656232,2307,3563,3605,4408,5664,38.1051177665153,25.704858236557854,1256,1,134754,102542,1452,0,2349,1504
6566,0,0,0,0,56,1,673,1,0,555074,1359787,21.93171219946131,168,2284,1635,481,46989,641729,585189,2178,3308,3476,3981,5111,33.97057550292606,25.475720334061894,1130,1,99567,102542,1154,0,2346,1673
6567,0,0,0,0,53,1,591,1,0,278100,827811,17.578395831246947,41,1477,1209,309,48840,594738,589380,2411,2988,2947,3579,4156,30.0,16.398215419476347,577,1,67980,36448,900,0,2370,1779
6568,1,0,0,0,50,0,26,0,1,677160,2120096,28.91366458960192,578,1904,1646,836,46368,568064,524952,2278,3372,2794,3346,4440,28.460498941515414,16.109467158568854,1094,1,173052,39990,810,0,1700,1726
6569,0,1,0,1,70,0,624,0,0,5749380,9656010,52.24940191045253,2424,5142,4836,2730,56165,831195,845343,3231,6267,3843,5643,8679,45.89117562233506,17.968582104780914,3036,1,652470,37638,2106,0,807,1431
6570,0,0,1,0,59,1,1165,0,0,2648406,6905268,48.07286136688766,2281,3487,3457,2311,43920,717120,546804,2958,5299,3018,4134,6475,33.85262175962151,5.531194905403055,2341,0,422913,5880,1146,0,677,1842
6571,0,0,0,1,64,1,92,0,0,678509,2516170,27.910571473905726,460,1969,1650,779,50544,671840,784890,2911,4009,3549,4101,5199,29.512709126747414,18.077769572138735,1098,1,189297,28391,871,0,2451,2359
6572,0,0,0,1,64,1,54,0,0,661867,2533353,28.053520278211074,490,1925,1628,787,51273,679209,782217,2922,4006,3516,4060,5144,29.0,17.406895185529212,1084,1,191241,27324,841,0,2432,2378
6573,1,0,0,0,49,0,241,1,0,11886,695331,16.822603841260722,193,415,325,283,36190,577395,378378,2367,2740,2547,2499,2872,6.48074069840786,9.65116822864259,373,1,43582,19620,42,0,2174,2415
6574,1,0,0,0,49,0,276,1,0,200917,1513858,24.63736998950984,487,1058,938,607,50225,511270,611030,2374,3101,2614,2825,3552,18.193405398660254,11.045361017187261,727,1,148715,9600,331,0,1887,2163
6575,0,0,1,0,60,1,93,0,0,5626594,7356179,49.18333050943175,2028,5136,4745,2419,54516,702471,717676,2650,5460,3432,5367,8177,48.228622207149975,19.925901724577926,2810,1,570884,49266,2326,0,622,715
6576,0,0,0,1,66,1,420,0,0,881344,2487616,27.422618401604176,253,2423,1924,752,49704,721144,754224,2809,4060,3807,4480,5731,34.23448553724738,22.53389725832691,1251,1,171456,60878,1172,0,2556,2136
6577,0,0,0,1,66,1,387,0,0,862210,2494520,27.477263328068172,281,2371,1897,755,49910,716968,759920,2830,4059,3778,4446,5675,33.793490497431605,22.02896229208574,1229,1,173650,55932,1142,0,2549,2162
6578,0,0,0,1,65,1,352,0,0,845120,2506480,27.568097504180443,310,2322,1872,760,50095,709070,768434,2848,4058,3748,4410,5620,33.34666400106613,21.460370459631648,1210,1,177080,50400,1112,0,2538,2186
6579,0,0,0,1,65,1,243,0,0,796138,2550446,27.910571473905726,397,2183,1801,779,48314,664622,779212,2892,4053,3656,4296,5457,31.96873472629156,19.79347940715656,1161,1,185402,34380,1022,0,2495,2252
6580,0,0,0,1,64,1,138,0,0,740008,2577324,28.178005607210743,470,2050,1726,794,51092,688152,782286,2922,4040,3570,4178,5296,30.528675044947494,18.22421371551603,1118,1,191354,31428,932,0,2452,2314
6581,0,0,1,0,61,1,823,0,0,632588,3986350,36.15245496505044,1030,2068,1791,1307,41356,597800,643550,2773,4357,3327,3534,5118,22.0,16.940303019898575,1584,1,275777,31855,484,0,1743,2566
6582,0,0,1,0,60,1,479,0,0,1112282,3994704,36.345563690772494,1111,2373,2163,1321,41205,607824,619920,2814,4345,3234,3866,5397,29.017236257093817,14.491705337660376,1531,1,270805,26880,842,0,1703,2182
6583,0,0,1,0,58,1,56,0,0,2081465,4128970,37.61648574760805,1415,2886,2886,1415,50167,644878,662386,2918,4333,2918,4389,5804,38.353617821530214,0.0,1415,0,321205,0,1471,1,1503,1447
6584,0,0,1,0,55,1,1577,0,0,3748458,3641694,36.08323710533743,1260,4223,4181,1302,46224,598558,604152,2755,4099,2839,5676,7020,53.65631370118525,6.5252844928085345,1344,1,281232,5586,2879,0,1495,82
6585,0,0,0,0,58,1,830,0,1,894864,1815684,24.859605789312106,67,2617,2066,618,56880,696306,705120,2387,3556,3489,4386,5555,38.05259518088089,23.687620760313514,1169,1,148320,65569,1448,0,2320,1490
6586,1,0,0,0,47,0,621,1,0,27846,99414,6.48074069840786,78,825,705,42,41586,565713,411858,2247,2409,2487,3030,3192,25.748786379167466,11.080810612286749,162,1,7308,24480,663,0,2325,1704
6587,0,0,0,1,64,1,38,0,0,732375,2703510,28.930952282978865,569,1980,1712,837,50094,668610,781660,2962,4067,3498,4105,5210,29.58039891549808,16.59232609047777,1105,1,202554,23852,875,0,2393,2355
6588,0,0,0,1,62,1,246,0,0,607392,2871888,30.199337741083,762,1728,1578,912,50904,636098,793548,2999,4061,3299,3815,4877,25.80697580112788,12.312788037888811,1062,1,229824,9450,666,0,2237,2483
6589,0,0,1,0,61,1,987,0,0,277020,3723975,34.85685011586675,880,1778,1443,1215,42833,646715,622195,2730,4280,3400,3293,4843,15.0996688705415,18.347246363109615,1550,1,246645,48240,228,0,1850,2837
6590,0,0,1,0,61,1,936,0,0,390937,3829434,35.34119409414458,943,1868,1562,1249,40800,625464,613200,2760,4315,3372,3379,4934,17.69180601295413,17.52935753011993,1555,1,249800,42228,313,0,1817,2753
6591,0,0,1,0,55,1,2248,0,0,1933568,1832640,25.768197453450252,664,3576,3576,664,53562,654120,623760,2760,3424,2760,5672,6336,53.96295025292817,0.0,664,0,150064,0,2912,0,2096,152
6592,0,0,1,0,55,1,2254,0,0,1280280,1297670,21.6794833886788,385,3279,3194,470,48048,637791,574288,2676,3231,2846,5485,6040,52.191953402799555,9.265143265380413,555,1,97760,13770,2724,0,2291,37
6593,0,0,0,0,58,1,1050,0,1,1005799,1778510,24.63736998950984,31,2902,2264,607,54560,726640,644600,2292,3537,3568,4587,5832,40.70626487409524,26.016256935610286,1245,1,133540,96338,1657,0,2323,1273
6594,0,0,0,0,58,1,1019,0,1,1011666,1811358,24.859605789312106,40,2913,2255,618,54250,732750,636027,2273,3549,3589,4568,5844,40.45985664828782,26.40150476184406,1276,1,134106,101990,1637,0,2313,1294
6595,0,0,0,0,53,1,473,1,0,351750,1084998,20.049937655763422,40,1639,1277,402,45540,558693,593780,2337,3101,3061,3574,4338,29.58039891549808,19.090005747156503,764,1,88440,42716,875,0,2297,1824
6596,1,0,0,0,48,0,777,0,1,477124,978488,20.09975124224178,284,1705,1585,404,52208,607922,503776,2302,2826,2542,3603,4127,34.36568055487916,11.621977114038057,524,1,84032,19680,1181,0,2018,1241
6597,1,0,0,0,50,0,420,0,1,719776,1682576,25.768197453450252,392,2020,1748,664,49932,577752,554946,2262,3198,2806,3618,4554,32.92415526630866,16.49598804640447,936,1,145416,39440,1084,0,1870,1450
6598,0,1,0,1,65,0,521,0,0,4565396,6162244,43.497126341863094,1542,4655,4305,1892,47897,687227,739339,2907,5149,3607,5670,7912,49.122296363260546,18.77527610280064,2242,1,429484,39900,2413,0,1365,844
6599,0,1,1,0,63,0,916,0,0,3231261,4424299,37.376463182061514,1277,3830,3710,1397,42920,734744,585895,3047,4564,3287,5480,6997,48.093658625644196,11.06238981080611,1517,1,258445,22440,2313,0,1770,854
6600,0,0,1,0,60,1,251,0,0,2422532,5081244,41.0731055558257,1147,3663,3123,1687,52650,704808,677700,2472,4699,3552,4448,6675,37.89459064299283,23.238876230673014,2227,1,379575,77760,1436,0,1325,1576
6601,0,0,1,0,61,1,1548,0,0,4449933,9244260,54.96362433464518,2954,4561,4494,3021,51660,752760,642600,2993,6081,3127,4533,7621,38.379682124790975,8.222029866439447,3088,1,634410,11658,1473,0,39,1587
6602,0,0,0,1,66,1,426,0,0,1001160,2690820,28.460498941515414,311,2545,2046,810,50380,730840,760738,2823,4132,3821,4558,5867,35.156791662493895,22.480483538185556,1309,1,185490,61377,1236,0,2512,2086
6603,0,0,0,1,66,1,395,0,0,978066,2692520,28.478061731796284,327,2501,2017,811,50167,733720,753640,2836,4131,3804,4526,5821,34.72751070837067,22.187759204800283,1295,1,184097,61468,1206,0,2509,2114
6604,0,0,0,1,63,1,103,0,0,703788,2851724,29.866369046136157,700,1873,1681,892,53000,677764,799250,3005,4089,3389,3986,5070,28.089143810376278,13.990149959375703,1084,1,223000,15552,789,0,2305,2408
6605,0,0,1,0,61,1,1001,0,0,300806,3819739,35.25620512760839,934,1794,1485,1243,42016,639184,620746,2764,4316,3382,3315,4867,15.556349186104045,17.631361899585805,1552,1,251086,43260,242,0,1830,2831
6606,0,0,0,0,56,1,1536,1,0,883972,1261734,21.118712081942874,80,2794,2428,446,45000,707250,509220,2463,3275,3195,4811,5623,44.51965857910413,19.579151878442513,812,1,80280,75396,1982,0,2383,847
6607,0,0,0,0,58,1,1115,0,1,1038276,1762472,24.576411454889016,28,2899,2323,604,54282,726582,636124,2342,3522,3494,4637,5817,41.46082488325576,24.788482735893616,1180,1,131672,88128,1719,0,2314,1199
6608,1,0,0,0,48,0,682,0,1,570960,1179984,22.090722034374522,398,1748,1658,488,50500,604500,488436,2328,2906,2508,3588,4166,34.20526275297414,10.347466864628917,578,1,98576,14940,1170,0,1930,1248
6609,1,0,0,0,48,0,628,0,1,539805,1178065,22.02271554554524,335,1748,1598,485,52920,595105,524664,2279,2914,2579,3542,4177,33.36165463522455,12.882345016608866,635,1,104760,21450,1113,0,1944,1316
6610,0,0,1,0,61,1,1441,0,0,3543120,8399520,52.306787322488084,2451,4316,4031,2736,46487,703030,623210,2785,5806,3355,4365,7386,35.98610843089316,16.97720843011836,3021,1,555408,47025,1295,0,334,1775
6611,0,0,0,1,65,1,237,0,0,929770,2813194,29.206163733020468,477,2319,1943,853,50032,699176,778328,2922,4151,3674,4388,5617,33.015148038438355,19.628263738214645,1229,1,201308,39104,1090,0,2445,2208
6612,0,0,0,1,65,1,127,0,0,874874,2858854,29.563490998188964,574,2175,1875,874,50578,683639,791582,2971,4145,3571,4272,5446,31.63858403911275,17.650442477681178,1174,1,211508,27300,1001,0,2397,2270
6613,0,0,0,1,64,1,24,0,0,809856,2878008,29.79932885150268,654,2034,1800,888,51376,674128,800527,3007,4129,3475,4153,5275,30.199337741083,15.496772346339544,1122,1,219336,19188,912,0,2353,2329
6614,0,0,1,0,62,1,1011,0,0,230976,3766593,34.68429039204925,948,1650,1395,1203,42612,629331,663772,2876,4334,3386,3323,4781,13.856406460551018,16.237459090193344,1458,1,255036,30600,192,0,1928,2939
6615,0,0,0,0,58,1,1144,0,1,1088916,1794672,24.859605789312106,84,2914,2380,618,53037,723096,618552,2370,3522,3438,4666,5818,41.97618372363071,23.879374304742452,1152,1,131634,83304,1762,0,2286,1142
6616,0,0,0,0,57,1,773,1,0,952068,1922037,25.748786379167466,263,2499,2099,663,49060,646477,637780,2499,3562,3299,4335,5398,37.89459064299283,20.138829036484722,1063,1,145860,55200,1436,0,2236,1463
6617,0,0,0,0,53,1,117,1,0,125818,802466,17.349351572897472,59,961,719,301,44726,557194,570524,2424,2967,2908,3084,3627,20.445048300260872,15.623909053749601,543,1,64414,30976,418,0,2365,2248
6618,0,0,0,0,52,1,163,1,0,89148,603972,15.0996688705415,38,809,619,228,47294,585429,566886,2459,2877,2839,3040,3458,19.77371993328519,13.838706257176828,418,1,48792,27170,391,0,2421,2258
6619,0,0,0,0,52,1,188,1,0,84800,560740,14.560219778561036,32,792,612,212,48178,576610,584545,2465,2857,2825,3045,3437,20.0,13.45762619345434,392,1,46852,23580,400,0,2433,2245
6620,1,0,0,0,48,0,832,0,1,463748,920238,19.544820285692065,274,1704,1596,382,54720,549252,578160,2301,2791,2517,3623,4113,34.84250278036869,10.89017689082249,490,1,91680,10476,1214,0,2027,1195
6621,1,0,0,0,48,0,626,0,1,602600,1262316,22.891046284519195,404,1794,1674,524,51840,578160,520344,2289,2933,2529,3559,4203,33.91164991562634,11.418751370995183,644,1,113184,15960,1150,0,1885,1259
6622,1,0,0,0,48,0,707,0,1,468708,1003302,20.42057785666214,309,1649,1541,417,49742,572628,502854,2298,2823,2514,3530,4055,33.52610922848042,10.909289819896376,525,1,87153,14472,1124,0,1989,1282
6623,1,0,0,0,48,0,719,0,1,362862,825246,18.49324200890693,247,1498,1403,342,49815,586359,494665,2318,2755,2508,3474,3911,32.57299494980466,10.525591954947746,437,1,70110,14155,1061,0,2071,1352
6624,1,0,0,0,49,0,305,0,1,10050,74070,5.477225575051661,104,499,365,30,39498,560463,429606,2335,2499,2603,2804,2968,18.303005217723125,11.581634647011523,164,1,5220,25728,335,0,2439,2134
6625,1,0,0,0,50,0,603,0,1,680860,1467888,24.020824298928627,335,1999,1757,577,47436,600384,511344,2302,3121,2786,3724,4543,34.351128074635334,15.577820712846412,819,1,115977,42350,1180,0,1967,1364
6626,0,1,1,0,63,0,909,0,0,3961152,5056182,39.83716857408418,1557,4113,4083,1587,46209,672246,697734,3156,4773,3216,5682,7299,49.95998398718719,5.501408174353464,1617,1,347553,3780,2496,0,1599,690
6627,0,0,0,1,66,1,279,0,0,1009750,2899750,29.58039891549808,473,2431,2029,875,50328,715824,772162,2912,4189,3716,4468,5745,33.97057550292606,20.265299381147628,1277,1,203875,45426,1154,0,2439,2160
6628,0,0,0,1,63,1,188,0,0,739389,3050579,30.967725134404045,832,1857,1730,959,50840,652105,788888,3054,4140,3308,3952,5038,27.76688675382964,11.30350933966113,1086,1,237832,9779,771,0,2222,2410
6629,0,0,0,0,55,1,1800,1,0,838656,1063296,19.595917942265423,192,2760,2568,384,49447,695019,545493,2577,3153,2961,4953,5529,46.73328578219169,14.132314290900673,576,1,75648,36480,2184,0,2385,585
6630,0,0,0,0,56,1,1380,0,1,1063981,1567595,23.473389188611005,149,2884,2482,551,48514,722630,543395,2443,3396,3247,4776,5729,43.94314508543966,20.569808095709973,953,1,105241,75978,1931,0,2294,914
6631,0,0,0,0,57,1,1073,0,1,1170224,1939190,25.903667693977237,119,2967,2415,671,53410,708050,630020,2338,3561,3442,4634,5857,41.7612260356422,24.1549065442883,1223,1,146278,79488,1744,0,2219,1146
6632,0,0,0,0,57,1,974,0,1,1202831,2064135,26.70205984563738,109,3004,2400,713,52500,723750,607950,2291,3608,3499,4582,5899,41.0731055558257,25.199315700770576,1317,1,149730,97848,1687,0,2182,1208
6633,0,0,0,0,58,1,850,0,1,1235475,2220030,27.65863337187866,234,2911,2380,765,55278,722598,644244,2371,3667,3433,4517,5813,40.18706259482024,23.142905234660464,1296,1,169830,81774,1615,0,2137,1287
6634,0,0,0,0,57,1,715,1,0,969450,1989270,26.267851073127396,325,2460,2095,690,49922,628494,660207,2518,3573,3248,4288,5343,37.48332962798263,19.197546481605983,1055,1,158010,44165,1405,0,2193,1478
6635,0,0,0,0,57,1,705,1,0,962550,1985820,26.267851073127396,319,2456,2085,690,49268,627404,650428,2507,3568,3249,4273,5334,37.3496987939662,19.334965095384067,1061,1,155940,46004,1395,0,2188,1483
6636,0,0,0,0,56,1,661,1,0,871860,1876380,25.69046515733026,31,2672,1981,660,53808,670948,648204,2152,3503,3534,4164,5515,36.345563690772494,26.290855550712582,1351,1,150480,98122,1321,0,2183,1522
6637,0,1,0,1,68,0,1345,0,0,5870454,10956906,56.45352070508977,2931,5285,5029,3187,22230,670410,391932,3182,6625,3694,5280,8723,42.91852746774987,16.0350409690718,3443,1,363318,54016,1842,0,251,1596
6638,0,1,0,1,66,0,146,0,0,4865520,7619760,47.74934554525329,1603,5091,4414,2280,50400,701820,802080,2665,5622,4019,5476,8433,46.195237849804386,26.070166632272933,2957,1,547200,64315,2134,0,1062,1208
6639,0,0,0,0,57,1,815,0,1,1194666,2199582,27.54995462791182,333,2759,2333,759,52750,724500,611478,2472,3657,3324,4472,5657,39.67366884975475,20.762522937265246,1185,1,160149,73698,1574,0,2139,1324
6640,0,0,0,0,57,1,713,1,0,1031760,2077200,26.832815729997478,385,2488,2153,720,51980,652010,663550,2550,3605,3220,4318,5373,37.8549864614954,18.416477016971058,1055,1,165600,42880,1433,0,2165,1452
6641,1,0,0,0,47,0,670,0,1,712239,1358010,23.93741840717165,543,1846,1816,573,51414,583020,495330,2340,2943,2400,3613,4216,35.25620512760839,5.490867587491313,603,1,119757,4560,1243,0,1797,1127
6642,1,0,0,0,46,0,609,0,0,190836,534204,15.0996688705415,228,1065,1065,228,52170,520146,550605,2343,2571,2343,3180,3408,28.930952282978865,0.0,228,0,53580,0,837,0,2115,1506
6643,0,1,0,1,69,0,1282,0,0,5714744,10837448,55.82114294781145,2860,5206,4950,3116,39600,834720,573870,3222,6594,3734,5312,8684,42.82522621072771,16.611557267908257,3372,1,514140,54528,1834,0,362,1644
6644,0,0,1,0,60,1,270,0,0,1467736,3278016,32.92415526630866,647,2875,2438,1084,53562,683424,716688,2587,4108,3461,4378,5899,36.796738985948195,20.904791253717775,1521,1,256908,52003,1354,0,1940,1670
6645,0,0,1,0,60,1,356,0,0,5824716,6793260,47.34976240700686,1974,5108,4840,2242,45426,684780,609030,2762,5272,3298,5628,8138,50.97057974949863,16.559115417025907,2510,0,450642,43952,2598,1,788,432
6646,0,0,1,0,63,1,266,0,0,777975,3251300,32.01562118716424,958,1851,1784,1025,49324,662948,748592,3105,4197,3239,3931,5023,27.54995462791182,8.19672545160342,1092,1,241900,6700,759,0,2147,2413
6647,0,0,0,0,56,1,1231,0,1,1242962,1874642,25.65151067676132,250,2955,2547,658,49588,720797,558404,2441,3507,3257,4738,5804,43.46262762420146,20.808652046684813,1066,1,128968,73032,1889,0,2191,960
6648,0,0,0,0,57,1,906,0,1,1344816,2277000,28.142494558940577,251,3031,2490,792,51957,721625,595125,2334,3667,3416,4573,5906,41.20679555607303,23.296055074142686,1333,1,163944,89806,1698,0,2083,1177
6649,0,0,0,0,57,1,823,0,1,1317848,2332696,28.42534080710379,362,2885,2439,808,52961,724637,609157,2441,3695,3333,4518,5772,40.38564101261734,21.198548527030937,1254,1,170488,77604,1631,0,2079,1256
6650,0,0,0,0,57,1,819,0,1,1287952,2304127,28.231188426986208,373,2837,2413,797,51294,719859,595546,2467,3688,3315,4507,5728,40.19950248448356,20.690221648869066,1221,1,164182,76320,1616,0,2094,1275
6651,0,0,0,0,58,1,792,1,0,1191105,2221560,27.65863337187866,415,2672,2322,765,52756,702768,633072,2554,3669,3254,4461,5576,39.45883931389772,18.903147358918446,1115,1,166770,56000,1557,0,2139,1347
6652,0,0,0,0,53,1,34,1,0,100835,892775,18.303005217723125,40,931,636,335,45156,564980,567645,2370,3000,2960,2966,3596,17.349351572897472,17.253970932283497,630,1,71355,39235,301,0,2330,2364
6653,1,0,0,0,51,0,352,0,1,539049,1481082,24.06241883103193,387,1702,1510,579,55696,603688,603688,2366,3137,2750,3489,4260,30.512292604784715,13.951645099039146,771,1,136644,25152,931,0,1979,1627
6654,1,0,0,0,50,0,545,0,1,572964,1355004,23.065125189341593,412,1729,1609,532,53562,603639,575622,2427,3079,2667,3624,4276,32.817678162843876,11.037374824906587,652,1,120232,17400,1077,0,2015,1470
6655,0,1,0,1,70,0,960,0,0,5296801,9959458,53.207142377692115,2407,5126,4702,2831,51666,766924,833766,3094,6349,3942,5389,8644,43.255057507764334,20.790398594045072,3255,1,670947,46640,1871,0,687,1647
6656,0,1,0,1,66,0,183,0,0,4772410,7608520,47.7283982551269,1617,5034,4373,2278,47792,688040,774880,2679,5618,4001,5435,8374,45.77116996538323,25.936757565576716,2939,1,528496,67422,2095,0,1062,1245
6657,0,0,0,1,66,1,299,0,0,1208640,3197760,30.983866769659336,578,2601,2219,960,54044,762799,786116,2949,4291,3713,4590,5932,35.482389998420345,19.70686827280534,1342,1,226560,47368,1259,0,2371,2072
6658,0,0,0,0,56,1,1160,0,1,1330281,2023506,26.664583251946766,287,3006,2582,711,52710,714346,597660,2422,3557,3270,4717,5852,43.255057507764334,21.16856740196131,1135,1,149310,69112,1871,0,2135,975
6659,0,0,0,0,57,1,998,0,1,1381728,2217300,27.892651361962706,268,3064,2554,778,52000,712500,592800,2340,3628,3360,4626,5914,42.14261501141095,23.068791603438452,1288,1,161824,83130,1776,0,2072,1074
6660,0,0,0,0,57,1,932,0,1,1405920,2309264,28.42534080710379,271,3085,2548,808,51408,720216,583032,2321,3666,3395,4598,5943,41.71330722922842,23.683406322913175,1345,1,164832,90753,1740,0,2050,1118
6661,1,0,0,0,48,0,443,1,0,77318,325888,11.575836902790225,143,988,711,134,39935,595840,396416,2155,2566,2709,3009,3420,24.020824298928627,17.075267028553355,411,1,21842,60386,577,0,2298,1855
6662,1,0,0,0,50,0,20,1,0,138284,908982,19.026297590440446,272,834,744,362,52819,554931,600129,2421,2873,2601,2893,3345,19.544820285692065,9.70850005632103,452,1,86518,9900,382,0,2149,2129
6663,1,0,0,0,49,0,57,1,0,197658,1036245,20.42057785666214,387,921,891,417,46400,576520,497000,2455,2902,2515,2959,3406,21.77154105707724,5.483301264452448,447,1,83400,5160,474,0,2068,2011
6664,0,1,0,1,69,0,728,0,0,5024945,9140815,51.332251070842396,2002,5175,4542,2635,47488,735428,777056,2836,6104,4102,5376,8644,43.669211121796096,25.178698856500016,3268,1,590240,75960,1907,0,834,1562
6665,0,0,1,0,60,1,982,0,0,3376523,7217288,48.91829923454004,2269,3928,3804,2393,41707,702728,539864,2892,5409,3140,4427,6944,37.5632799419859,11.214528750203367,2517,1,428347,23932,1411,0,623,1605
6666,0,0,1,0,61,1,1292,0,0,4551125,8783125,53.61902647381804,2785,4548,4458,2875,51754,690430,699595,2965,5930,3145,4638,7603,39.786932528155525,9.486832980505138,2965,1,658375,11700,1583,0,180,1472
6667,0,0,0,1,66,1,364,0,0,1340460,3311550,31.464265445104548,573,2761,2344,990,52170,742590,786075,2928,4335,3762,4699,6106,36.796738985948195,20.588081104424617,1407,1,232650,48789,1354,0,2355,1991
6668,0,0,1,0,63,1,771,0,0,581560,3933280,35.21363372331802,1048,1901,1709,1240,39711,688324,580476,2980,4412,3364,3641,5073,21.656407827707714,14.068015852622846,1432,1,226920,33024,469,0,1932,2703
6669,0,0,1,0,61,1,853,0,0,1144050,4847616,39.72404813208241,1548,2333,2303,1578,48620,678912,675840,3042,4650,3102,3797,5405,26.92582403567252,5.477225575051661,1608,1,347160,4080,725,0,1494,2347
6670,0,0,1,0,57,1,1570,0,0,4092675,3961100,37.21558813185679,1117,4608,4340,1385,45570,620620,600600,2592,4245,3128,5815,7468,54.35991169970753,16.658425890078547,1653,1,290850,38324,2955,0,1475,95
6671,0,0,0,0,56,1,1255,0,1,1363194,1968360,26.419689627245813,356,2993,2651,698,49276,716280,547080,2478,3518,3162,4773,5813,44.19275958796871,19.003607370243987,1040,1,135412,63954,1953,0,2122,867
6672,0,0,0,0,56,1,1090,0,1,1419075,2169540,27.65863337187866,319,3066,2620,765,55104,697656,635264,2390,3601,3282,4691,5902,43.069710934716056,21.60016785387076,1211,1,171360,63778,1855,0,2071,981
6673,0,0,0,0,57,1,739,1,0,1254690,2338470,28.460498941515414,568,2601,2359,810,56133,701541,666897,2645,3697,3129,4436,5488,39.35733730830886,15.753453964097096,1052,1,187110,34606,1549,0,2077,1338
6674,0,0,0,0,57,1,682,1,0,1208520,2340090,28.460498941515414,527,2585,2302,810,47216,655803,600912,2606,3699,3172,4381,5474,38.62641583165593,16.990680309670477,1093,1,168480,44431,1492,0,2079,1397
6675,0,0,0,0,57,1,676,1,0,1199072,2334312,28.42534080710379,508,2592,2292,808,47686,652914,609579,2589,3697,3189,4373,5481,38.52272056851645,17.474752997463312,1108,1,170488,45600,1484,0,2081,1405
6676,0,0,0,0,57,1,673,1,0,1137810,2246686,27.964262908219126,378,2641,2237,782,50167,634933,652171,2469,3655,3277,4328,5514,38.144462245521304,20.16741735155756,1186,1,177514,51308,1455,0,2091,1418
6677,1,0,0,0,47,0,810,0,1,626296,1147564,22.0,417,1845,1778,484,54960,542959,569040,2304,2855,2438,3665,4216,35.9722114972099,8.20759886765899,551,1,116160,7906,1294,0,1887,1077
6678,1,0,0,0,50,0,464,0,1,501201,1304559,22.64950330581225,379,1624,1490,513,56400,610320,597605,2409,3056,2677,3520,4167,31.25699921617557,11.622136368289254,647,1,120555,17956,977,0,2030,1566
6679,0,0,1,0,59,1,102,0,0,2265435,4357725,38.144462245521304,914,3553,3012,1455,53816,742760,649915,2454,4450,3536,4552,6548,39.45883931389772,23.271813980984682,1996,1,315735,89265,1557,0,1540,1438
6680,0,0,1,0,60,1,305,0,0,2909400,5630435,43.18564576337837,1526,3764,3425,1865,47436,712484,606819,2680,4884,3358,4579,6783,39.496835316262995,18.412313110426933,2204,1,374865,58986,1560,0,1154,1459
6681,0,0,0,1,66,1,282,0,0,1328040,3401700,31.937438845342623,659,2683,2322,1020,52405,743705,783725,2974,4355,3696,4637,6018,36.08323710533743,19.18619393981722,1381,1,239700,42959,1302,0,2315,2033
6682,0,0,0,1,65,1,98,0,0,1163999,3395083,32.109188716004645,789,2402,2160,1031,52961,694823,826543,3051,4324,3535,4422,5695,33.60059523282288,15.672191580845361,1273,1,258781,18634,1129,0,2262,2164
6683,0,0,1,0,57,1,1214,0,0,4353480,4519476,39.57271787481876,1224,4688,4346,1566,48160,620490,646464,2544,4452,3228,5666,7574,52.72570530585627,18.550057553798098,1908,1,350784,42066,2780,0,1320,106
6684,0,0,1,0,57,1,1563,0,0,4126410,3996675,37.3496987939662,1100,4648,4353,1395,48160,641760,615975,2570,4260,3160,5823,7513,54.38749856354859,17.460915907820823,1690,1,299925,42775,2958,0,1470,93
6685,0,0,0,0,56,1,1251,0,1,1432600,2037975,26.92582403567252,406,3020,2701,725,49022,713994,542523,2492,3536,3130,4787,5831,44.45222154178574,18.36934828195914,1044,1,139925,61248,1976,0,2086,835
6686,0,0,0,0,56,1,1218,0,1,1443528,2078946,27.16615541441225,399,3033,2694,738,51562,715518,571851,2478,3555,3156,4773,5850,44.22668877499196,18.928744346512946,1077,1,149814,61359,1956,0,2079,861
6687,0,0,0,0,56,1,1152,0,1,1466505,2159595,27.65863337187866,383,3064,2682,765,54500,705750,615414,2441,3588,3205,4740,5887,43.78355855797927,20.0405018041082,1147,1,166770,59974,1917,0,2058,906
6688,0,0,0,0,57,1,870,0,1,1555816,2525100,29.765752132274432,416,3112,2642,886,46299,721050,521550,2380,3736,3320,4606,5962,41.90465367951393,21.687428491074904,1356,1,162138,95410,1756,0,1964,1094
6689,0,0,0,0,57,1,811,0,1,1493226,2545452,29.698484809834994,516,2941,2575,882,47918,712842,559884,2520,3768,3252,4579,5827,41.14608122288197,19.234400438465244,1248,1,171108,70272,1693,0,2004,1193
6690,1,0,0,0,48,0,402,1,0,104760,438840,13.416407864998739,126,1068,762,180,36270,570492,377890,2132,2618,2744,3020,3506,24.124676163629637,17.519695588059967,486,1,27900,66402,582,0,2258,1856
6691,1,0,0,0,50,0,462,0,1,476623,1264865,22.293496809607955,344,1609,1456,497,51465,557355,598075,2392,3042,2698,3504,4154,30.967725134404045,12.416731654814576,650,1,116795,17442,959,0,2048,1586
6692,0,1,1,0,63,0,2411,0,0,8751600,13904000,66.332495807108,4370,6419,6389,4400,52360,695200,752080,3130,7560,3190,5149,9579,44.598206241955516,5.514871952411144,4430,1,1047200,3300,1989,0,1240,1171
6693,0,1,1,0,62,0,2339,0,0,7314132,12825456,64.15605972938177,4031,5978,5893,4116,45365,669940,657476,3031,7232,3201,4893,9094,42.15447781671598,9.2729914971827,4201,0,868476,11900,1777,1,1000,1339
6694,0,0,1,0,61,1,1158,0,0,4633200,8584056,52.99056519796708,2741,4525,4458,2808,49932,696996,669483,2990,5865,3124,4707,7582,40.620192023179804,8.20171446926608,2875,1,614952,9715,1650,0,249,1407
6695,0,0,1,0,61,1,258,0,0,5454280,7603908,49.678969393496885,1688,5458,4678,2468,51246,674739,720954,2301,5549,3861,5291,8539,47.01063709417264,27.936842480695432,3248,1,577512,90480,2210,0,613,871
6696,0,0,1,0,57,1,597,0,0,3948988,4934524,41.36423575989287,1644,4086,4019,1711,39294,640248,510468,2817,4595,2951,5192,6970,48.041648597857254,8.230562448445415,1778,0,302847,12328,2308,1,1173,576
6697,0,0,0,0,54,1,2005,0,0,1261524,1378220,22.427661492005804,473,3041,3011,503,54984,635680,649380,2710,3243,2770,5248,5781,50.07993610219566,5.483301264452448,533,0,119211,3750,2508,0,2237,232
6698,0,0,0,0,54,1,1971,0,0,1188220,1319868,22.0,484,2939,2939,484,51076,616302,616302,2727,3211,2727,5182,5666,49.54795656734998,0.0,484,0,109384,0,2455,0,2243,272
6699,0,0,0,0,54,1,1925,0,0,1154400,1305600,21.908902300206645,480,2885,2885,480,48620,601120,598400,2720,3200,2720,5125,5605,49.040799340956916,0.0,480,0,105600,0,2405,0,2240,315
6700,0,0,0,0,56,1,1021,0,1,1576770,2377830,29.068883707497267,428,3128,2711,845,53424,709128,596568,2397,3659,3231,4680,5942,43.197222132910355,20.817636091865797,1262,1,179140,70473,1866,0,1969,948
6701,0,0,0,0,56,1,928,0,1,1607204,2507380,29.765752132274432,428,3158,2700,886,47628,713160,534870,2372,3716,3288,4644,5988,42.59107887809371,21.857850601570536,1344,1,167454,90684,1814,0,1944,1016
6702,0,0,0,0,57,1,677,1,0,1319424,2484228,29.30870177950569,582,2672,2395,859,51040,670944,636240,2615,3751,3169,4428,5564,39.191835884530846,16.8351926355429,1136,1,188980,41273,1536,0,2033,1356
6703,0,0,0,0,57,1,674,1,0,1283555,2436980,29.068883707497267,503,2706,2364,845,48608,625828,646016,2542,3729,3226,4403,5590,38.97435053981015,18.624802432973205,1187,1,189280,43434,1519,0,2039,1365
6704,0,0,0,0,54,1,208,1,0,172368,1449168,23.065125189341593,58,1330,856,532,47304,588384,596556,2250,3256,3198,3048,4054,18.0,22.005186933172943,1006,1,116508,62094,324,0,2192,2400
6705,1,0,0,0,48,0,469,1,0,212816,680049,16.822603841260722,113,1205,1035,283,38025,540675,406107,2233,2686,2573,3155,3608,27.422618401604176,13.087862625269288,453,1,47827,33150,752,0,2120,1651
6706,1,0,0,0,48,0,458,1,0,194568,645344,16.3707055437449,76,1186,994,268,39072,534576,423808,2216,2676,2600,3134,3594,26.94438717061496,13.919497812052477,460,1,47168,35520,726,0,2140,1682
6707,1,0,0,0,51,0,417,0,1,454258,1274308,22.293496809607955,287,1621,1411,497,47196,530748,584592,2354,3061,2774,3478,4185,30.23243291566195,14.608572919539682,707,1,113316,22890,914,0,2067,1650
6708,0,1,1,0,65,0,850,0,0,2084400,3516480,32.863353450309965,718,3372,3010,1080,52118,823768,670736,2894,4336,3618,5186,6628,43.93176527297759,19.72868512862116,1442,1,222480,62988,1930,0,2176,1326
6709,0,0,1,0,59,1,228,0,0,2066368,3958768,36.4417343165772,757,3455,2884,1328,54612,733326,661782,2410,4309,3552,4537,6436,39.44616584663204,23.923426263831463,1899,1,294816,90218,1556,0,1653,1425
6710,0,0,0,1,66,1,296,0,0,1486080,3612600,32.863353450309965,750,2786,2456,1080,51700,735900,786075,3015,4425,3675,4721,6131,37.094473981982816,18.309362494715007,1410,1,253800,38280,1376,0,2265,1969
6711,0,0,1,0,63,1,786,0,0,699327,4207815,36.29049462324811,1062,2103,1848,1317,40330,696510,591075,2940,4512,3450,3726,5298,23.043437243605826,16.199661663980073,1572,1,243645,43605,531,0,1878,2664
6712,0,0,0,0,55,1,1275,0,1,1560600,2133585,27.65863337187866,510,3060,2805,765,47498,708406,521543,2534,3554,3044,4829,5849,45.16635916254486,16.4242898880206,1020,1,143055,50490,2040,0,2024,749
6713,0,0,0,0,56,1,1177,0,1,1595510,2255610,28.372521918222215,486,3106,2787,805,55056,694896,622044,2483,3607,3121,4784,5908,44.51965857910413,18.308914442151718,1124,1,178710,47850,1982,0,1997,820
6714,0,0,0,0,57,1,676,1,0,1376597,2554519,29.715315916207253,606,2719,2442,883,49910,665390,627781,2616,3776,3170,4452,5612,39.48417404479927,16.881579281383758,1160,1,191611,41550,1559,0,2010,1334
6715,0,0,0,0,54,1,208,1,0,206340,1558950,23.874672772626646,46,1456,932,570,50621,609905,620845,2211,3305,3259,3097,4191,19.026297590440446,23.100757846744134,1094,1,129390,68644,362,0,2165,2373
6716,0,0,0,0,54,1,289,1,0,141126,1487840,23.388031127053,59,1293,805,547,50624,609280,614720,2232,3267,3208,2978,4013,16.06237840420901,22.29710608435144,1035,1,123622,64416,258,0,2173,2462
6717,1,0,0,0,47,0,784,0,0,709377,1273227,23.173260452512935,507,1888,1858,537,55926,554814,566669,2341,2908,2401,3692,4259,36.345563690772494,5.490867587491313,567,0,128343,3660,1321,0,1834,1050
6718,1,0,0,0,48,0,458,1,0,237003,744072,17.578395831246947,159,1226,1076,309,38250,541800,409360,2258,2717,2558,3175,3634,27.694764848252458,12.338422017092807,459,1,52530,29250,767,0,2099,1641
6719,1,0,0,0,51,0,496,0,1,435521,1171291,21.37755832643195,277,1590,1410,457,46782,530541,579238,2383,3020,2743,3516,4153,30.870698080866262,13.555937255793266,637,1,103282,19980,953,0,2106,1610
6720,0,1,1,0,65,0,852,0,0,2564173,4008136,35.08560958569767,774,3771,3314,1231,48380,768416,667480,2799,4487,3713,5339,7027,45.639894828976104,21.669981942690022,1688,1,252355,77690,2083,0,2025,1173
6721,0,0,1,0,61,1,398,0,0,6076128,6947070,47.686476070265456,1974,5246,4946,2274,46440,656825,659880,2755,5329,3355,5727,8301,51.69139193328034,17.53255916735398,2574,1,491184,39900,2672,0,781,383
6722,0,0,0,1,67,1,332,0,0,1600620,3721830,33.31666249791537,810,2852,2552,1110,53128,767837,777896,3053,4463,3653,4795,6205,37.97367509209505,17.355476067782114,1410,1,257520,38700,1442,0,2243,1911
6723,0,0,1,0,60,1,268,0,0,2558069,5217000,41.701318923986086,1483,3466,3210,1739,44304,624000,639000,2744,4739,3256,4471,6466,38.353617821530214,16.007380146096207,1995,1,370407,32768,1471,0,1261,1529
6724,0,0,0,0,54,1,1910,0,0,1410551,1560198,23.853720883753127,569,3048,3048,569,50621,622434,611466,2742,3311,2742,5221,5790,49.78955713801841,0.0,569,0,126887,0,2479,0,2173,263
6725,0,0,0,0,55,1,1205,0,1,1657656,2285010,28.61817604250837,542,3120,2843,819,54000,697500,602640,2513,3609,3067,4814,5910,44.98888751680797,17.075267028553355,1096,1,176904,43489,2024,0,1971,766
6726,0,0,0,0,56,1,985,0,1,1730064,2558160,30.199337741083,536,3185,2809,912,48132,706860,535755,2429,3717,3181,4702,5990,43.55456348076513,19.800052767028852,1288,1,174192,74072,1897,0,1893,908
6727,0,0,0,0,57,1,667,1,0,1410300,2596500,30.0,510,2857,2467,900,44091,597195,614505,2495,3785,3275,4452,5742,39.585350825778974,19.860452519393114,1290,1,191700,49530,1567,0,1985,1318
6728,0,0,0,0,54,1,222,1,0,227779,1646740,24.515301344262525,113,1468,980,601,51959,611020,638420,2252,3341,3228,3119,4208,19.467922333931785,22.095938051152622,1089,1,140033,59048,379,0,2139,2361
6729,1,0,0,0,47,0,536,1,0,453801,1085375,21.37755832643195,397,1510,1450,457,40110,498750,453625,2315,2832,2435,3368,3885,31.51190251317746,7.9332512824338455,517,1,87287,9300,993,0,1918,1382
6730,0,1,1,0,64,0,2283,0,0,6092658,12405393,62.13694553162394,3686,5614,5439,3861,26162,661878,408051,3038,7074,3388,4791,8827,39.72404813208241,13.406666223469482,4036,1,490347,37275,1578,0,648,1635
6731,0,0,1,0,61,1,143,0,0,5656908,7078636,48.041648597857254,1707,5360,4759,2308,47264,687008,647137,2466,5375,3668,5518,8427,49.50757517794625,24.620518742864775,2909,1,486988,90150,2451,0,759,616
6732,0,0,0,0,54,1,1857,0,0,1468090,1641510,24.454038521274967,568,3083,3053,598,46860,603900,584685,2715,3343,2775,5200,5828,49.54795656734998,5.478746393072713,628,0,127374,4320,2455,0,2147,290
6733,0,0,0,0,55,1,1264,0,1,1642617,2197329,28.231188426986208,627,3028,2858,797,47752,700278,518316,2587,3554,2927,4818,5785,45.39823785126467,13.378566177832475,967,1,149836,33660,2061,0,1960,696
6734,0,0,0,0,55,1,1198,0,1,1688960,2308800,28.844410203711913,598,3096,2862,832,52710,696525,582750,2541,3607,3009,4805,5871,45.05552130427524,15.685423748689471,1066,1,174720,38376,2030,0,1943,745
6735,0,0,0,0,55,1,1176,0,1,1707745,2346565,29.068883707497267,590,3121,2866,845,54033,691473,602609,2522,3622,3032,4798,5898,44.955533585978046,16.338816522758744,1100,1,183365,39015,2021,0,1932,756
6736,0,0,0,0,55,1,1075,0,1,1774626,2501917,29.9833287011299,590,3182,2873,899,52164,701316,576081,2474,3682,3092,4757,5965,44.429719783046124,17.924465864520116,1208,1,186093,55311,1974,0,1884,809
6737,0,0,0,0,56,1,923,0,1,1824774,2726052,31.080540535840107,582,3239,2855,966,39609,685746,459986,2438,3788,3206,4711,6061,43.46262762420146,20.111102041943646,1350,1,157458,83328,1889,0,1856,933
6738,0,0,0,0,57,1,806,0,1,1822872,2895268,31.71750305430741,664,3160,2818,1006,43365,705110,509406,2536,3884,3220,4690,6038,42.567593307585526,18.576320974261375,1348,1,178062,70452,1812,0,1872,1066
6739,0,0,0,0,54,1,288,0,1,215460,1722420,25.099800796022265,164,1438,972,630,54492,623352,653426,2268,3364,3200,3076,4172,18.49324200890693,21.591902486754325,1096,1,150570,54988,342,0,2104,2392
6740,0,1,1,0,64,0,853,0,0,3784170,5073730,39.56008088970496,1373,4175,3983,1565,43560,641916,713240,3050,4807,3434,5660,7417,49.17316341257699,13.886752829940423,1757,1,344300,20544,2418,0,1677,824
6741,0,0,0,1,67,1,263,0,0,1676610,3920670,34.20526275297414,930,2843,2603,1170,53815,767379,787485,3111,4521,3591,4784,6194,37.8549864614954,15.533788019677399,1410,1,274950,30000,1433,0,2181,1918
6742,0,0,0,0,55,1,1853,1,0,1839404,1980456,26.758176320519304,686,3315,3285,716,53820,647244,636180,2736,3482,2796,5335,6081,50.68530358989675,5.478746393072713,746,1,164680,4140,2569,0,2050,197
6743,0,0,0,0,55,1,1186,0,1,1690392,2304016,28.91366458960192,666,3028,2858,836,51308,700024,556712,2586,3592,2926,4778,5784,44.96665431183423,13.390348098230834,1006,1,168872,30600,2022,0,1920,734
6744,0,0,0,0,55,1,990,0,1,1851679,2660776,30.870698080866262,644,3205,2896,953,44164,681248,505352,2483,3745,3101,4735,5997,44.07947368106838,18.004670678319812,1262,1,172493,62418,1943,0,1839,849
6745,0,0,0,0,57,1,834,0,1,1931512,2954138,32.155870381627054,639,3297,2902,1034,41405,699965,482833,2462,3891,3252,4725,6154,43.22036556994862,19.894480353687705,1429,1,174746,84135,1868,0,1823,989
6746,0,0,0,0,57,1,805,0,1,1901526,2973784,32.155870381627054,699,3208,2873,1034,47188,721876,540688,2541,3910,3211,4715,6084,42.883563284783136,18.381436195962216,1369,1,194392,66665,1839,0,1842,1037
6747,0,0,0,0,53,1,493,0,1,37520,1511440,23.664319132398465,117,1070,627,560,56144,653158,626168,2256,3259,3142,2766,3769,8.18535277187245,21.266168693515176,1003,1,129920,62463,67,0,2139,2632
6748,0,0,0,0,53,1,322,1,0,78408,1298088,22.0,189,941,646,484,51975,603450,619542,2387,3166,2977,2844,3623,12.727922061357855,17.439603507543996,779,1,111804,37170,162,0,2198,2520
6749,1,0,0,0,49,0,627,1,0,971908,1784475,26.851443164195103,511,2279,2069,721,36815,457875,492525,2265,3196,2685,3823,4754,36.71511950137164,15.396927999526204,931,1,143479,23940,1348,0,1754,1127
6750,1,0,0,0,48,0,591,1,0,747162,1491234,24.859605789312106,417,2028,1827,618,40275,431927,542925,2212,3031,2614,3622,4441,34.77067730142742,14.503273933035656,819,1,139050,14874,1209,0,1795,1204
6751,1,0,0,0,48,0,573,1,0,672210,1397964,24.124676163629637,407,1912,1737,582,35532,453978,451576,2227,2984,2577,3557,4314,33.98529093593286,13.501111227926843,757,1,109416,23100,1155,0,1820,1247
6752,1,0,0,0,47,0,536,1,0,576201,1285041,23.173260452512935,413,1734,1610,537,41616,488172,488172,2269,2930,2517,3466,4127,32.7566787083184,11.375520776142816,661,1,109548,16492,1073,0,1856,1320
6753,1,0,0,0,47,0,507,1,0,523260,1226583,22.64950330581225,446,1600,1533,513,41004,487764,480591,2324,2904,2458,3411,3991,31.937438845342623,8.436161057888377,580,1,103113,9179,1020,0,1878,1371
6754,1,0,0,0,51,0,534,0,1,384336,1055496,20.199009876724155,152,1606,1350,408,47488,579488,548444,2331,2995,2843,3529,4193,30.692018506445613,16.222430372858152,664,1,86496,38144,942,0,2179,1645
6755,0,1,0,1,68,0,1730,0,0,5122704,11264688,57.3410847473258,3246,4888,4846,3288,35882,798258,527604,3384,6714,3468,4984,8314,39.4715087119811,6.653712290320142,3330,1,506352,9072,1558,0,138,1868
6756,0,1,1,0,59,0,884,0,0,697661,1506988,22.427661492005804,503,1890,1890,503,39852,491344,728028,2996,3499,2996,4383,4886,37.242448899072144,0.0,503,1,122229,0,1387,0,2493,1609
6757,0,0,1,0,64,1,635,0,0,977676,4367676,36.823905279043935,1101,2332,2077,1356,36225,666747,563675,2966,4577,3476,3942,5553,26.851443164195103,16.081047146859216,1611,1,237300,43095,721,0,1865,2500
6758,0,0,0,0,55,1,1065,0,1,1765636,2474048,29.9833287011299,687,3075,2863,899,52624,696256,572416,2540,3651,2964,4716,5827,44.31703961232068,14.807819595695104,1111,1,186992,36888,1964,0,1853,788
6759,0,0,0,0,55,1,935,0,1,1873806,2735326,31.28897569432403,696,3176,2893,979,40698,664972,477774,2511,3773,3077,4708,5970,43.749285708454714,17.315213270817324,1262,1,167409,58298,1914,0,1815,880
6760,0,0,0,0,56,1,837,0,1,1972548,2979762,32.357379374726875,685,3293,2931,1047,42237,702962,486666,2484,3893,3208,4730,6139,43.40506882842141,19.874065523351426,1409,1,179037,76744,1884,0,1799,962
6761,0,0,0,0,57,1,803,0,1,2010000,3070208,32.7414110874898,711,3308,2947,1072,48070,724592,544160,2503,3936,3225,4739,6172,43.30127018922193,19.037213750821895,1433,1,203680,71117,1875,0,1792,989
6762,0,0,0,0,57,1,802,0,1,1982495,3050810,32.60368077380221,732,3259,2928,1063,50292,728980,568260,2539,3933,3201,4735,6129,43.18564576337837,18.253058062896436,1394,1,210474,62228,1865,0,1807,1005
6763,1,0,0,0,48,0,560,1,0,708369,1465905,24.63736998950984,406,1975,1774,607,36288,456435,463680,2214,3022,2616,3582,4390,34.161381705077446,14.523881034196602,808,1,116544,25527,1167,0,1808,1248
6764,0,1,1,0,65,0,2360,0,0,5688521,12506296,61.97580172938467,3640,5523,5322,3841,42300,765160,586080,3055,7097,3457,4737,8779,38.48376280978771,14.344321818363715,4042,1,691380,39195,1481,0,585,1775
6765,0,0,1,0,59,1,518,0,0,1834560,3310720,33.46640106136302,378,3500,2758,1120,54780,736044,650320,2214,4076,3698,4594,6456,40.47221268969612,27.29019958280992,1862,1,246400,118720,1638,0,1836,1318
6766,0,0,1,0,61,1,32,0,0,5368233,7121595,47.968739820845826,1521,5414,4634,2301,47520,668520,680900,2315,5396,3875,5428,8509,48.30113870293329,27.947751623444393,3081,1,506220,100620,2333,0,794,762
6767,0,0,0,0,54,1,1423,0,0,1491750,1901016,26.49528259898354,702,2827,2827,702,51983,614716,620132,2708,3410,2708,4833,5535,46.09772228646444,0.0,702,0,160758,0,2125,0,2006,583
6768,0,0,0,0,54,1,1009,0,1,1791810,2541870,30.430248109405877,744,3043,2861,926,50600,694485,549000,2563,3671,2927,4680,5788,43.98863489584554,13.728829820844442,1108,1,185200,34034,1935,0,1819,810
6769,0,0,0,0,55,1,879,0,1,1896310,2813782,31.71750305430741,748,3149,2891,1006,39816,662889,469896,2539,3803,3055,4682,5946,43.41658669218482,16.65626226140563,1264,1,169008,53664,1885,0,1791,912
6770,0,0,0,0,56,1,858,0,1,1915560,2863140,31.937438845342623,743,3175,2898,1020,40222,668066,474383,2530,3827,3084,4685,5982,43.3358973600409,17.329402039507904,1297,1,172380,57616,1878,0,1787,929
6771,0,0,0,0,54,1,458,0,1,167520,1889486,26.419689627245813,290,1346,938,698,54280,622610,638852,2299,3405,3115,2947,4053,15.491933384829668,20.211133119050313,1106,1,164728,50592,240,0,2009,2467
6772,0,1,0,1,65,0,2030,0,0,9839984,14095928,65.66582063752801,4312,6594,6594,4312,50838,725718,748601,3269,7581,3269,5551,9863,47.77028364998475,0.0,4312,1,987448,0,2282,0,1043,987
6773,0,1,0,1,67,0,1983,0,0,5051320,11640448,58.71967302361279,3388,4973,4913,3448,25830,692080,425376,3316,6824,3436,4841,8349,38.27531841800928,8.06225774829855,3508,1,434448,12720,1465,0,72,1911
6774,0,0,1,0,60,1,56,0,0,3282560,5375192,42.23742416388575,1442,3966,3624,1784,46134,702029,596574,2671,4797,3355,4853,6979,42.89522117905443,18.510649104167545,2126,1,353232,59850,1840,0,1229,1173
6775,0,0,0,0,54,1,1025,0,1,1772246,2490650,30.23243291566195,806,2961,2853,914,52624,689425,566800,2617,3639,2833,4664,5686,44.034077712607996,10.551011889467135,1022,1,190112,18900,1939,0,1811,786
6776,0,0,0,0,54,1,998,0,1,1793040,2537970,30.495901363953813,803,2985,2858,930,52118,690437,562174,2602,3659,2856,4657,5714,43.9089968002003,11.45501536000853,1057,1,191580,22733,1928,0,1799,801
6777,0,0,0,0,55,1,909,0,1,1848352,2699103,31.28897569432403,804,3042,2867,979,44073,686493,487989,2582,3736,2932,4645,5799,43.45112196480086,13.637984586375287,1154,1,173283,36575,1888,0,1778,869
6778,0,0,0,0,56,1,763,0,1,1970028,3028006,32.7566787083184,790,3192,2909,1073,49335,713966,550290,2539,3895,3105,4658,6014,42.8485705712571,17.695236144641566,1356,1,209235,54336,1836,0,1749,986
6779,0,0,0,0,56,1,173,1,0,1300110,2969113,32.51153641401772,772,2572,2287,1057,49725,632025,620789,2524,3866,3094,4039,5381,35.07135583350036,16.904811057762124,1342,1,233597,39900,1230,0,1752,1579
6780,0,0,0,0,53,1,532,0,1,104805,1842650,26.1725046566048,268,1255,838,685,55216,624080,640220,2273,3375,3107,2843,3945,12.36931687685298,20.448733225828477,1102,1,163030,51708,153,0,2005,2537
6781,1,0,0,0,48,0,507,1,0,318280,881840,19.1049731745428,305,1297,1237,365,39245,567760,403472,2356,2781,2476,3288,3713,29.5296461204668,7.994134176674909,425,1,60955,12420,872,0,2051,1544
6782,0,1,0,1,65,0,525,0,0,3889204,5688738,41.557189510360296,1487,4219,3979,1727,41356,645624,695034,3054,5021,3534,5546,7513,47.45524207081869,15.728519877504674,1967,1,364397,27600,2252,0,1567,1042
6783,0,0,1,0,61,1,800,0,0,4292100,7688130,50.0999001995014,2255,4475,4220,2510,40053,725931,517647,2808,5573,3318,4773,7538,41.352146256270665,16.144811684344592,2765,1,424190,52785,1710,0,553,1353
6784,0,0,1,0,61,1,678,0,0,2201563,5707687,43.139309220245984,1526,3379,3044,1861,49720,674740,693142,2732,4928,3402,4250,6446,34.39476704383968,18.304024457889557,2196,1,420586,42545,1183,0,1206,1884
6785,0,0,1,0,60,1,196,0,0,3427712,5857952,44.181444068749045,1590,4070,3708,1952,48375,645215,675225,2639,4953,3363,4757,7071,41.90465367951393,19.21173533917419,2314,1,439200,44526,1756,0,1049,1245
6786,0,0,0,0,54,1,1004,0,1,1764396,2489616,30.298514815086232,851,2907,2840,918,51054,688848,545112,2645,3630,2779,4634,5619,43.840620433565945,8.2732738280919,985,1,184518,12261,1922,0,1794,790
6787,0,0,0,0,54,1,943,0,1,1818300,2604954,30.93541659651604,849,2965,2857,957,51308,691388,549844,2614,3679,2830,4622,5687,43.58898943540674,10.539713118296461,1065,1,193314,19872,1900,0,1765,822
6788,0,0,0,0,54,1,898,0,1,1843299,2683035,31.32091952673165,857,2984,2860,981,48514,694690,522385,2611,3716,2859,4614,5719,43.347433603386484,11.41455123074134,1105,1,187371,24180,1879,0,1754,856
6789,0,0,0,0,55,1,854,0,1,1871160,2769518,31.71750305430741,856,3016,2866,1006,45034,696509,490034,2603,3759,2903,4613,5769,43.12771730569565,12.69591381900158,1156,1,179068,31050,1860,0,1747,893
6790,0,0,0,0,55,1,831,0,1,1888020,2818260,31.937438845342623,858,3033,2871,1020,44022,699039,480762,2601,3783,2925,4614,5796,43.02324952859791,13.254920366232327,1182,1,177480,33858,1851,0,1743,912
6791,0,0,0,0,55,1,787,0,1,1920198,2914848,32.357379374726875,855,3073,2881,1047,44528,704352,489984,2592,3831,2976,4618,5857,42.82522621072771,14.606086415283606,1239,1,184272,39744,1834,0,1737,950
6792,0,0,0,0,55,1,766,0,1,1935560,2961640,32.55764119219941,848,3098,2886,1060,46228,709676,508508,2582,3854,3006,4620,5892,42.731721238442994,15.352421280735559,1272,1,192920,42824,1826,0,1734,968
6793,0,0,0,0,56,1,746,0,1,1951787,3006546,32.7566787083184,845,3120,2892,1073,47498,711708,523974,2574,3875,3030,4621,5922,42.649736224272246,15.924330614127864,1301,1,200651,44916,1819,0,1729,983
6794,0,0,0,0,54,1,416,1,0,285065,2134473,27.94637722496424,468,1459,1146,781,50112,590328,634056,2420,3514,3046,3098,4192,19.1049731745428,17.691986595946105,1094,1,181192,35682,365,0,1952,2368
6795,0,0,0,0,54,1,444,1,0,260965,2124333,27.910571473905726,456,1437,1114,779,48792,583578,621756,2404,3506,3050,3062,4164,18.303005217723125,17.973277313064298,1102,1,177612,37791,335,0,1948,2392
6796,0,0,0,0,54,1,505,1,0,185744,2037168,27.422618401604176,401,1350,999,752,48720,568890,628488,2358,3461,3060,2956,4059,15.716233645501712,18.742440911524458,1103,1,174464,37557,247,0,1957,2462
6797,0,0,0,0,53,1,391,0,1,89586,1468768,23.515952032609693,192,1076,715,553,56870,642752,624160,2295,3209,3017,2818,3732,12.727922061357855,19.097798943771966,914,1,129955,47652,162,0,2103,2494
6798,0,0,0,0,52,1,192,0,1,129913,1239098,21.656407827707714,211,1004,746,469,56628,618228,639364,2384,3111,2900,2919,3646,16.64331697709324,16.162841330949874,727,1,113498,29154,277,0,2173,2365
6799,1,0,0,0,48,0,751,0,1,846042,1488144,24.859605789312106,523,2082,1987,618,46848,462336,587552,2313,3026,2503,3777,4490,37.0,10.012227554748348,713,1,150792,6080,1369,0,1790,1039
6800,1,0,0,0,47,0,751,0,0,960450,1604120,25.96150997149434,674,2099,2099,674,51516,578340,504560,2380,3054,2380,3805,4479,37.749172176353746,0.0,674,0,142888,0,1425,0,1706,955
6801,1,0,0,0,48,0,769,1,0,1112166,1802934,27.16615541441225,618,2365,2245,738,34336,566776,361564,2323,3181,2563,3950,4808,38.82009788756334,11.526037434995047,858,1,109224,26520,1507,0,1705,936
6802,1,0,0,0,49,0,535,1,0,864500,1723400,26.457513110645905,417,2218,1935,700,36764,497324,448084,2179,3162,2745,3697,4680,35.14256678161116,17.38390821205725,983,1,127400,43865,1235,0,1762,1227
6803,1,0,0,0,48,0,521,1,0,330932,897078,19.261360284258224,329,1305,1263,371,38305,568230,394134,2376,2789,2460,3310,3723,29.866369046136157,6.495386533491135,413,1,60473,8862,892,0,2047,1526
6804,1,0,0,0,50,0,589,1,0,90932,318770,11.269427669584644,174,1144,843,127,36349,559730,409130,2209,2637,2811,3226,3654,26.758176320519304,17.77465288304594,428,1,20701,59899,716,0,2383,1794
6805,0,0,1,0,57,1,937,0,0,1344258,2254506,27.964262908219126,283,3000,2501,782,46299,729399,527589,2384,3665,3382,4602,5883,41.46082488325576,23.711003856819215,1281,1,143106,101297,1719,0,2101,1164
6806,0,0,1,0,61,1,461,0,0,2814812,5870124,43.86342439892262,1500,3811,3387,1924,41382,637659,604098,2627,4975,3475,4514,6862,38.24918299781056,20.605105461539555,2348,1,380952,62328,1463,0,1127,1588
6807,0,0,1,0,59,1,45,0,0,3831300,5868720,44.49719092257398,1790,4105,3915,1980,52538,646152,714324,2774,4944,3154,4899,7069,43.98863489584554,13.899524843087859,2170,1,477180,19760,1935,0,984,1029
6808,0,0,0,0,55,1,753,0,1,1921780,2928780,32.55764119219941,910,3023,2873,1060,44100,696276,483525,2613,3823,2913,4576,5786,42.579337712087536,12.899034672654562,1210,1,185500,29850,1813,0,1703,950
6809,0,0,0,0,55,1,732,0,1,1936765,2975429,32.7566787083184,903,3048,2878,1073,44352,698796,488048,2603,3846,2943,4578,5821,42.485291572496,13.738384613864339,1243,1,188848,33830,1805,0,1700,968
6810,0,0,0,0,56,1,650,0,1,2002679,3157854,33.57082066318904,899,3132,2904,1127,51408,706104,571608,2574,3929,3030,4579,5934,42.15447781671598,16.022656907477867,1355,1,229908,38760,1777,0,1675,1025
6811,0,0,0,0,56,1,612,0,1,2037964,3243894,33.97057550292606,898,3176,2920,1154,50347,711183,559389,2555,3965,3067,4577,5987,42.02380277890139,16.917940215049025,1410,1,229646,45056,1766,0,1657,1045
6812,0,0,0,0,56,1,596,1,0,1990560,3247816,33.823069050575526,1010,3018,2884,1144,55860,647292,695555,2705,3983,2973,4579,5857,41.71330722922842,11.583726138680884,1278,1,280280,14204,1740,0,1695,1099
6813,0,0,0,0,56,1,35,0,1,905046,2722890,31.12876483254676,729,2143,1903,969,50808,651920,615390,2570,3779,3050,3744,4953,30.56141357987225,15.524375156057674,1209,1,212211,36000,934,0,1841,1876
6814,1,0,0,0,49,0,501,1,0,836902,1720570,26.419689627245813,443,2152,1897,698,33562,426445,478210,2210,3163,2720,3664,4617,34.62657938636157,16.46476681947849,953,1,135412,26520,1199,0,1767,1266
6815,1,0,0,0,49,0,477,1,0,770308,1649318,25.903667693977237,470,2020,1819,671,35340,457188,467020,2257,3129,2659,3606,4478,33.88214869219483,14.70834415446928,872,1,127490,25326,1148,0,1787,1310
6816,1,0,0,0,48,0,540,1,0,312741,853632,18.734993995195193,291,1302,1242,351,37600,571520,389120,2372,2783,2492,3323,3734,29.8496231131986,7.914659756013729,411,1,56160,12780,891,0,2081,1541
6817,0,1,1,0,64,0,2596,0,0,5470821,12816898,63.0317380372777,3906,5417,5350,3973,39032,767788,529064,3159,7199,3293,4603,8643,37.107950630558946,8.2732738280919,4040,1,651572,14204,1377,0,747,1849
6818,0,1,0,1,68,0,2114,0,0,4807107,11911292,59.08468498688979,3341,5018,4868,3491,20176,661928,354848,3262,6903,3562,4789,8430,37.107950630558946,12.72513248597547,3641,1,363064,32700,1377,0,79,2035
6819,0,1,0,1,68,0,2048,0,0,4778820,11840472,58.63446085707619,3285,4981,4828,3438,24948,681912,433944,3291,6882,3597,4834,8425,37.282703764614496,13.380862443673848,3591,1,433188,31059,1390,0,6,2054
6820,0,1,0,1,70,0,1770,0,0,4659664,11398156,56.72741841473134,2963,4921,4666,3218,24552,701316,439208,3287,6760,3797,4990,8463,38.05259518088089,16.918198356421826,3473,1,399032,52530,1448,0,324,2094
6821,0,1,1,0,65,0,874,0,0,3449495,4796931,38.353617821530214,1067,4220,3816,1471,46860,694593,717420,2857,4732,3665,5606,7481,48.425200051213004,20.12215750167547,1875,1,323620,50904,2345,0,1790,916
6822,0,0,1,0,60,1,942,0,0,5963328,6132672,44.8998886412873,1896,5094,4974,2016,48755,605358,745290,2922,5058,3162,6000,8136,54.38749856354859,11.261033825263985,2136,1,493920,8760,2958,0,1026,84
6823,0,0,0,0,55,1,1595,1,0,2355164,2600280,30.528675044947494,932,3459,3459,932,49950,627750,619380,2790,3722,2790,5317,6249,50.269274910227224,0.0,932,1,206904,0,2527,0,1858,263
6824,0,0,0,0,55,1,634,0,1,1984647,3129679,33.57082066318904,952,3063,2888,1127,46937,697027,519299,2602,3904,2952,4538,5840,41.96427051671457,14.011829022829035,1302,1,210749,31850,1761,0,1650,1016
6825,0,0,0,0,55,1,575,0,1,2032914,3259431,34.161381705077446,951,3125,2909,1167,50400,703836,558600,2577,3960,3009,4535,5918,41.737273509418415,15.569083775539836,1383,1,233400,37368,1742,0,1626,1051
6826,0,0,0,0,55,1,270,1,0,539784,2445786,29.698484809834994,642,1734,1494,882,56406,659974,657201,2533,3655,3013,3385,4507,24.73863375370596,15.511329085692061,1122,1,209034,30960,612,0,1891,2161
6827,1,0,0,0,49,0,554,1,0,1117920,2039184,28.5657137141714,426,2576,2186,816,42222,464814,567273,2109,3315,2889,3869,5075,37.013511046643494,20.32320561225201,1206,1,185232,31590,1370,0,1683,1129
6828,1,0,0,0,48,0,550,1,0,330144,881470,19.026297590440446,302,1334,1274,362,36888,564920,387165,2375,2797,2495,3347,3769,30.199337741083,7.9730082341141015,422,1,57558,12660,912,0,2073,1523
6829,0,1,0,1,64,0,2718,0,0,5633344,13108988,63.984373092185564,4064,5500,5470,4094,38612,627592,630794,3172,7296,3232,4578,8702,37.094473981982816,5.572104574801163,4124,1,806518,3930,1376,0,892,1826
6830,0,1,1,0,61,0,939,0,0,990670,1947897,25.11971337416094,481,2351,2201,631,45162,595791,722358,2937,3718,3237,4657,5438,39.6232255123179,12.331628572798303,781,1,147654,12300,1570,0,2456,1517
6831,0,0,0,0,55,1,1556,1,0,2460717,2718562,31.192947920964443,973,3502,3502,973,51300,637032,628650,2794,3767,2794,5323,6296,50.28916384272063,0.0,973,1,218925,0,2529,0,1821,265
6832,0,0,0,0,54,1,730,0,1,1908816,2880248,32.61901286060018,1022,2900,2858,1064,52371,684871,560349,2665,3771,2749,4501,5607,42.35563716909474,6.609134537568676,1106,1,220248,7308,1794,0,1643,913
6833,0,0,0,0,54,1,687,0,1,1928338,2952292,32.96968304366907,1020,2928,2861,1087,49588,687148,532336,2649,3803,2783,4490,5644,42.118879377305376,8.456490803821907,1154,1,213052,11993,1774,0,1629,942
6834,0,0,0,0,54,1,665,0,1,1941500,2995300,33.166247903554,1015,2950,2865,1100,46872,686196,506478,2638,3823,2808,4488,5673,42.01190307520001,9.53016293865306,1185,1,204600,15725,1765,0,1623,958
6835,0,0,0,0,55,1,481,0,1,2078142,3407811,34.942810419312295,1005,3139,2923,1221,49896,703332,552618,2575,4012,3007,4493,5930,41.255302689472536,15.554555874239535,1437,1,241758,38016,1702,0,1570,1089
6836,1,0,0,0,48,0,546,1,0,419680,1046190,20.73644135332772,430,1406,1406,430,42218,508497,491466,2433,2863,2433,3409,3839,31.240998703626616,0.0,430,1,86860,0,976,0,2003,1457
6837,1,0,0,0,49,0,581,1,0,237666,690284,16.64331697709324,97,1315,1135,277,25413,490924,321468,2312,2769,2672,3350,3807,29.29163703175362,14.006191227141723,457,1,35733,36000,858,0,2215,1634
6838,0,1,0,1,66,0,1596,0,0,10010365,13551557,63.72597586541927,3871,6716,6526,4061,55671,804217,770847,3147,7398,3527,5802,10053,49.64876634922564,13.834270577215369,4251,1,938091,26790,2465,0,724,872
6839,0,1,0,1,64,0,2659,0,0,5209952,12877953,63.0158710167526,3929,5325,5283,3971,34717,755619,483207,3201,7214,3285,4555,8568,36.22154055254967,6.5252844928085345,4013,1,591679,9240,1312,0,728,1931
6840,0,0,1,0,57,1,817,0,0,1769400,2845785,31.352830813181765,430,3336,2783,983,55527,720855,645585,2342,3878,3448,4695,6231,42.42640687119285,24.728488838966367,1536,1,219209,86268,1800,0,1912,1095
6841,0,0,1,0,61,1,686,0,0,2575232,6102784,44.54211490264017,1518,3748,3282,1984,44928,664416,639808,2610,5060,3542,4374,6824,36.02776706930364,21.587132552187885,2450,1,412672,67104,1298,0,1092,1778
6842,0,0,0,0,54,1,1123,1,0,1722474,2379768,29.427877939124322,758,2963,2855,866,40158,568836,533112,2640,3614,2856,4737,5711,44.598206241955516,10.448863694758844,974,1,168004,15984,1989,0,1882,759
6843,0,0,0,0,55,1,462,0,1,2054943,3376065,34.942810419312295,1059,3066,2904,1221,48636,696780,533645,2603,3986,2927,4448,5831,41.02438299353203,13.491653849526754,1383,1,235653,29322,1683,0,1544,1082
6844,0,0,0,0,55,1,314,0,1,588440,2596280,30.659419433511783,760,1746,1566,940,55890,671166,635260,2582,3702,2942,3388,4508,25.019992006393608,13.433868909381221,1120,1,216200,25920,626,0,1822,2136
6845,1,0,0,0,49,0,543,1,0,516880,1220135,22.293496809607955,437,1597,1537,497,35358,407530,522915,2395,2952,2515,3495,4052,32.2490309931942,8.1903625881272,557,1,105861,4260,1040,0,1958,1415
6846,1,0,0,0,49,0,581,1,0,287100,796224,17.86057109949175,169,1369,1219,319,21018,464256,282048,2346,2815,2646,3396,3865,30.0,13.07479579843849,469,1,36047,30300,900,0,2177,1596
6847,0,1,0,1,66,0,1548,0,0,9956925,13408659,63.42712353559792,3795,6726,6498,4023,56120,813252,766590,3105,7356,3561,5808,10059,49.749371855331,15.125815581219204,4251,1,925290,32832,2475,0,690,858
6848,0,1,1,0,64,0,2860,0,0,7263701,14352643,66.94027188471824,4361,6222,6102,4481,45173,727081,637397,3083,7684,3323,4824,9425,40.26164427839479,11.06238981080611,4601,0,891719,20040,1621,1,1278,1582
6849,0,1,0,1,64,0,2764,0,0,5293932,13120982,63.76519426771944,4036,5398,5368,4066,38613,680897,590541,3197,7293,3257,4529,8625,36.08323710533743,5.5965095842615735,4096,1,744078,4920,1302,0,839,1925
6850,0,0,1,0,55,1,1042,0,0,1044168,1746540,25.019992006393608,320,2600,2294,626,46482,708660,510570,2484,3416,3096,4458,5390,40.84115571332428,18.696707594142797,932,1,114558,59976,1668,0,2164,1122
6851,0,0,1,0,60,1,242,0,0,3614384,5396600,42.23742416388575,1384,4210,3810,1784,45548,713900,583825,2625,4809,3425,5051,7235,45.0111097397076,20.00253076959987,2184,1,344312,73200,2026,0,1241,999
6852,0,0,0,0,55,1,387,0,1,2078128,3479099,35.510561809129406,1111,3059,2909,1261,48829,698027,532487,2609,4020,2909,4407,5818,40.59556626036888,13.038404810405298,1411,1,243373,27300,1648,0,1498,1111
6853,0,0,0,0,55,1,91,0,1,1116236,3086194,33.21144381083123,983,2235,2115,1103,56364,682712,646338,2678,3901,2918,3810,5033,31.811947441173732,10.996993508431213,1223,1,254793,17040,1012,0,1695,1786
6854,1,0,0,0,50,0,585,1,0,313236,851229,18.411952639521967,189,1413,1263,339,21660,477090,286254,2361,2850,2661,3435,3924,30.397368307141328,13.365287291378097,489,1,38646,30750,924,0,2172,1587
6855,0,1,0,1,66,0,1605,0,0,9663304,13351251,63.34824385884742,3795,6639,6421,4013,56153,801807,775191,3109,7340,3545,5735,9966,49.07137658554119,14.83890484760179,4231,1,935029,30084,2408,0,686,919
6856,0,1,0,1,65,0,2925,0,0,5731924,13930752,65.3299318842443,4067,5812,5611,4268,35854,594048,643008,3063,7532,3465,4607,9076,36.64696440361739,14.70834415446928,4469,1,840796,22512,1343,0,1004,1921
6857,0,1,0,1,64,0,2806,0,0,5192567,13199644,63.86704940734306,4037,5394,5352,4079,37386,650436,601896,3194,7315,3278,4509,8630,35.679125549822544,6.553889165207866,4121,1,758694,6258,1273,0,843,1963
6858,0,1,0,1,69,0,386,0,0,3950760,7555500,46.79743582719036,1574,4610,3994,2190,43442,700350,738300,2834,5640,4066,5254,8060,42.473521163190604,25.61541280630721,2806,1,468660,73920,1804,0,1260,1646
6859,0,0,1,0,61,1,671,0,0,4840290,7867392,50.60632371551998,2200,4812,4451,2561,46320,737280,592896,2711,5633,3433,4962,7884,43.474130238568314,19.152157198945847,2922,1,494273,67146,1890,0,511,1182
6860,0,0,1,0,62,1,681,0,0,5324616,6189144,44.63182720884279,1401,5256,4665,1992,45980,683540,649363,2516,5099,3698,5780,8363,51.70106381884226,24.325112089061523,2583,1,416328,86877,2673,0,1115,434
6861,0,0,1,0,62,1,889,0,0,5469200,6001600,44.0,1546,5151,4761,1936,49946,700600,685100,2710,5036,3490,5925,8251,53.150729063673246,20.059143386901496,2326,1,427856,54600,2825,0,1164,275
6862,0,0,0,0,53,1,546,0,0,1958947,3099264,33.95585369269929,1153,2852,2852,1153,53088,637056,602112,2688,3841,2688,4387,5540,41.2189276910499,0.0,1153,0,258272,0,1699,0,1535,989
6863,0,0,0,0,55,1,45,0,1,1341616,3303257,34.36568055487916,1121,2377,2317,1181,55596,688062,632122,2737,3978,2857,3933,5174,33.704599092705436,7.789174875971784,1241,1,266906,9060,1136,0,1616,1661
6864,0,0,0,0,55,1,94,0,1,1196816,3189606,33.793490497431605,1057,2275,2190,1142,56608,681492,647976,2708,3935,2878,3841,5068,32.37282811247729,9.251281740554573,1227,1,264944,11900,1048,0,1651,1745
6865,0,0,0,0,54,1,575,1,0,309846,2497962,30.23243291566195,724,1443,1253,914,52432,617658,634056,2543,3647,2923,3072,4176,18.411952639521967,13.814873398238463,1104,1,212048,23940,339,0,1819,2394
6866,0,1,0,1,64,0,2866,0,0,5161107,13374393,64.17943595888016,4034,5457,5372,4119,33672,594201,597448,3162,7366,3332,4500,8704,35.397740040855716,9.344583777936014,4204,1,757896,10965,1253,0,872,1994
6867,0,1,0,1,69,0,2319,0,0,4365270,12258246,59.57348403442592,3249,5079,4779,3549,31590,808236,466290,3154,7003,3754,4684,8533,35.07135583350036,17.809806792204206,3849,1,479115,69600,1230,0,95,2224
6868,0,0,1,0,62,1,413,0,0,5185440,6487520,45.60701700396552,1315,5338,4573,2080,48510,720489,654990,2354,5199,3884,5612,8457,49.92995093127971,27.708418789349956,2845,1,436800,122400,2493,0,1039,626
6869,0,0,1,0,62,1,880,0,0,5380721,5968547,43.829214001622255,1478,5165,4722,1921,49476,708396,674219,2664,5028,3550,5908,8272,52.92447448959697,21.074967437327796,2364,1,416857,65564,2801,0,1186,306
6870,0,0,0,0,54,1,313,0,1,2062088,3498208,35.888716889852724,1221,2956,2889,1288,45864,684432,494312,2649,4004,2783,4317,5672,40.01249804748511,8.748575453901612,1355,1,234416,12797,1601,0,1428,1115
6871,0,0,0,0,54,1,274,0,1,2089535,3593895,36.26292872893749,1207,3012,2904,1315,47880,688716,519270,2625,4048,2841,4322,5745,39.8622628559895,10.909289819896376,1423,1,249850,19872,1589,0,1418,1144
6872,0,0,0,0,56,1,107,1,0,1826394,3680067,36.0416425818802,1057,2947,2705,1299,47034,569433,662922,2591,4132,3075,4239,5780,37.49666651850535,15.689114993048518,1541,1,303966,22506,1406,0,1534,1427
6873,0,0,0,0,55,1,210,0,1,1021231,3111896,33.481338085566414,1054,2099,2032,1121,56619,674568,646808,2709,3897,2843,3687,4875,30.18277654557314,8.239962426314323,1188,1,261193,9112,911,0,1655,1865
6874,0,0,0,0,54,1,408,0,1,611248,2773892,31.811947441173732,922,1706,1616,1012,56088,674286,624948,2651,3753,2831,3345,4447,24.576411454889016,9.505517133991825,1102,1,230736,13230,604,0,1729,2137
6875,1,0,0,0,51,0,591,1,0,350262,933666,19.131126469708992,184,1505,1323,366,23432,515302,295916,2369,2917,2733,3508,4056,30.93541659651604,15.093056389776708,548,1,42456,39494,957,0,2185,1594
6876,0,1,0,1,66,0,1402,0,0,9812699,12980609,62.53798845501828,3683,6648,6420,3911,56120,809836,763370,3091,7230,3547,5828,9967,50.08991914547278,15.12061154588234,4139,1,899530,32832,2509,0,592,810
6877,0,1,0,1,65,0,3094,0,0,6232760,14644744,66.96267617113283,4089,6269,5874,4484,44319,774042,610742,2871,7750,3661,4656,9535,37.282703764614496,20.11137865071615,4879,1,838508,75050,1390,0,1218,1876
6878,0,1,0,1,65,0,3033,0,0,5717620,14283180,65.93936608733814,4065,5946,5663,4348,36668,676710,584730,3002,7633,3568,4600,9231,36.26292872893749,17.334443879383905,4631,1,773944,46412,1315,0,1063,1970
6879,0,1,1,0,67,0,2617,0,0,4430790,12701598,61.538605769061746,3575,5169,4957,3787,39688,811668,550056,3142,7141,3566,4524,8523,34.20526275297414,14.714547143680289,3999,1,621068,45792,1170,0,433,2184
6880,0,0,1,0,59,1,460,0,0,3090629,4602769,39.28103868280471,830,4259,3546,1543,45030,706971,566770,2270,4526,3696,4986,7242,44.75488800120049,26.736148864025512,2256,1,293170,132618,2003,0,1440,980
6881,0,0,1,0,59,1,149,0,0,4469790,6475830,46.79743582719036,2095,4326,4231,2190,54948,674196,712637,2862,5147,3052,4998,7283,45.17742799230607,9.842833472037558,2285,1,527790,10925,2041,0,767,916
6882,0,0,0,0,53,1,427,1,0,242250,2016000,27.386127875258307,348,1475,1073,750,49050,585984,604800,2286,3438,3090,3011,4163,17.97220075561143,20.0504339106405,1152,1,168750,50652,323,0,1938,2365
6883,1,0,0,0,52,0,591,1,0,310210,873010,18.303005217723125,29,1567,1261,335,33128,526412,427384,2300,2941,2912,3532,4173,30.430248109405877,19.00652091687926,641,1,54940,52938,926,0,2271,1680
6884,0,1,0,1,68,0,1075,0,0,10446546,13024810,61.75759062657804,3754,6613,6553,3814,49784,867410,669340,3355,7229,3475,6154,10028,52.3354564325181,8.016064826688304,3874,1,747544,11400,2739,0,399,676
6885,0,1,0,1,66,0,1352,0,0,9770228,12850058,62.24146527838174,3658,6612,6396,3874,55440,796080,766227,3101,7191,3533,5839,9929,50.21951811795888,14.697647169827432,4090,1,894894,30456,2522,0,557,795
6886,0,1,0,1,65,0,3121,0,0,6024212,14649382,66.85057965343307,4067,6219,5817,4469,39200,734272,573650,2876,7747,3680,4626,9497,36.71511950137164,20.448119209900927,4871,1,782075,75576,1348,0,1191,1930
6887,0,0,0,0,53,1,962,1,0,671139,1243319,21.656407827707714,384,1985,1900,469,39000,662750,413556,2566,3120,2736,4082,4636,37.82856063875548,9.568061544601736,554,1,73164,18530,1431,0,2182,1220
6888,0,0,1,0,64,1,1070,0,0,1724499,6253506,44.19275958796871,1630,3159,2836,1953,49725,720450,707642,2879,5155,3525,4085,6361,29.715315916207253,17.972889774666918,2276,1,431613,44897,883,0,1249,2319
6889,0,0,1,0,59,1,555,0,0,5358886,6100380,45.32107677449864,1597,5120,4663,2054,50820,623700,718740,2513,5024,3427,5579,8090,51.07837115648854,21.560092904526964,2511,1,497068,42501,2609,0,916,361
6890,0,0,0,0,55,1,1103,0,0,2093700,2775648,31.575306807693888,955,3139,3097,997,43382,606912,554016,2742,3781,2826,4884,5923,45.8257569495584,6.503581472166948,1039,0,198403,6594,2100,0,1787,684
6891,0,0,0,0,53,1,363,1,0,1993410,3347190,35.24202037341219,1182,2907,2847,1242,44051,547085,584815,2635,3937,2755,4300,5602,40.06245124802026,7.789174875971784,1302,1,269514,7020,1605,0,1453,1090
6892,0,0,0,0,54,1,161,0,1,2094570,3703145,37.0,1302,2966,2899,1369,48829,684365,522065,2638,4074,2772,4235,5671,39.11521443121589,8.436161057888377,1436,1,264217,12127,1530,0,1336,1175
6893,0,0,0,0,54,1,574,0,1,454920,2781540,31.937438845342623,935,1551,1466,1020,56105,668115,624483,2642,3747,2812,3173,4278,21.118712081942874,9.2729914971827,1105,1,233580,12410,446,0,1707,2281
6894,0,0,0,0,54,1,499,1,0,274730,2242660,28.809720581775867,521,1470,1161,830,51754,618758,610652,2393,3532,3011,3033,4172,18.193405398660254,17.5932892842364,1139,1,187580,42333,331,0,1872,2371
6895,1,0,0,0,51,0,295,1,0,991286,2213643,29.30870177950569,553,2319,2013,859,31512,520554,402012,2271,3436,2883,3731,4896,33.97057550292606,17.859474030330464,1165,1,134004,55080,1154,0,1718,1423
6896,1,0,0,0,52,0,590,1,0,363216,981736,19.390719429665317,91,1627,1342,376,33790,569198,404705,2326,2987,2896,3577,4238,31.080540535840107,18.61341539887345,661,1,58280,57285,966,0,2235,1645
6897,1,0,0,0,52,0,591,0,1,344986,947716,19.026297590440446,49,1628,1315,362,39928,568106,481712,2305,2980,2931,3571,4246,30.870698080866262,19.3290134258414,675,1,66608,53523,953,0,2256,1665
6898,0,1,0,1,64,0,2954,0,0,6374096,14258078,66.34756966159348,4160,6092,5850,4402,36612,732014,524718,2997,7641,3481,4687,9331,38.05259518088089,15.790094819097714,4644,1,713124,49126,1448,0,1163,1791
6899,0,1,0,1,65,0,3159,0,0,5929686,14718888,66.94774081326419,4065,6222,5805,4482,33496,696208,518872,2867,7766,3701,4607,9506,36.373066958946424,20.760790946127436,4899,1,708156,79647,1323,0,1198,1961
6900,0,1,0,1,65,0,2832,0,0,4405968,13008660,62.83311228962003,3888,5124,5064,3948,36348,767735,514020,3235,7243,3355,4411,8419,33.406586176980134,7.914659756013729,4008,1,615888,12900,1116,0,653,2179
6901,0,0,0,0,53,1,888,1,0,907465,1636472,24.63736998950984,473,2236,2102,607,43500,674000,469104,2562,3303,2830,4191,4932,38.66522985836241,12.333627810115374,741,1,105618,25728,1495,0,2089,1201
6902,0,0,0,0,55,1,63,0,1,2076930,3884550,37.54996671103717,1350,2943,2883,1410,56862,644670,669465,2695,4165,2815,4228,5698,38.379682124790975,7.780166052320878,1470,1,342630,6780,1473,0,1345,1282
6903,0,0,0,0,55,1,280,1,0,1091316,3290664,34.55430508634199,1194,2108,2108,1194,55225,647660,647660,2756,3950,2756,3670,4864,30.23243291566195,0.0,1194,1,280590,0,914,0,1562,1842
6904,0,0,0,0,54,1,413,1,0,779100,3036264,33.36165463522455,1113,1813,1813,1113,51754,616528,624712,2728,3841,2728,3428,4541,26.457513110645905,0.0,1113,1,254877,0,700,0,1615,2028
6905,0,0,0,0,54,1,451,1,0,713900,2996400,33.166247903554,1100,1749,1749,1100,52405,640140,607452,2724,3824,2724,3373,4473,25.475478405713993,0.0,1100,1,245300,0,649,0,1624,2075
6906,1,0,0,0,51,0,277,1,0,1059300,2299500,30.0,389,2588,2077,900,40950,536550,498225,2044,3455,3066,3732,5143,34.307433596816885,23.199593620160346,1411,1,175500,77672,1177,0,1655,1378
6907,0,1,1,0,64,0,2806,0,0,6493872,13841520,65.66582063752801,4162,5968,5818,4312,39884,757560,542490,3060,7522,3360,4716,9178,38.80721582386451,12.312788037888811,4462,0,728728,30900,1506,1,1102,1704
6908,0,0,0,0,56,1,673,1,0,1927380,3059784,33.04542328371661,762,3187,2857,1092,44928,582816,605232,2472,3894,3132,4567,5989,42.01190307520001,18.314207507423532,1422,1,235872,41250,1765,0,1710,1037
6909,0,0,0,0,54,1,429,1,0,1940680,3283860,34.56877203488721,994,3020,2819,1195,41447,524868,596316,2547,3943,2949,4372,5768,40.29888335921977,14.483236975101944,1396,1,259315,20100,1624,0,1553,1124
6910,0,0,0,0,53,1,29,0,1,2103740,3855660,37.89459064299283,1369,2968,2901,1436,51106,679305,542370,2618,4121,2752,4150,5653,38.27531841800928,8.299636160530056,1503,1,290072,11658,1465,0,1249,1220
6911,0,0,0,0,54,1,458,0,1,336935,2303100,29.206163733020468,544,1557,1248,853,53357,629100,618300,2391,3553,3009,3095,4257,19.87460691435179,17.62246075341173,1162,1,195337,42642,395,0,1847,2305
6912,0,0,0,0,53,1,264,0,1,330676,1924130,26.870057685088806,276,1626,1180,722,55876,610285,650260,2219,3387,3111,3123,4291,21.400934559032695,21.130407494933557,1168,1,176168,49060,458,0,1943,2207
6913,0,1,0,1,65,0,1893,0,0,8131158,12892113,62.85698051927089,3921,6039,6009,3951,54520,757016,766805,3233,7214,3293,5321,9302,45.36518488885502,5.490867587491313,3981,1,928485,3870,2058,0,688,1205
6914,0,1,0,1,64,0,2159,0,0,7593320,13054048,63.55312738174259,4009,5949,5919,4039,54988,753056,762752,3202,7271,3262,5112,9181,43.3589667773576,5.490867587491313,4069,1,953204,3840,1880,0,807,1352
6915,0,1,0,1,65,0,3128,0,0,5802288,14598876,66.60330322138685,4034,6146,5744,4436,30576,684528,483777,2889,7727,3693,4599,9437,36.16628264005025,20.42817750085841,4838,1,652092,79194,1308,0,1145,1983
6916,0,1,1,0,59,0,914,0,0,418415,992940,18.303005217723125,125,1794,1584,335,51205,619476,726180,2754,3299,3174,4213,4758,35.34119409414458,14.527470118487207,545,1,82075,18060,1249,0,2629,1715
6917,0,0,0,0,57,1,1222,1,0,3401928,3800196,36.49657518178932,1332,3886,3886,1332,46866,610542,624807,2853,4185,2853,5407,6739,50.53711507397311,0.0,1332,1,291708,0,2554,0,1521,299
6918,0,0,0,0,56,1,1035,0,0,2390724,3124191,33.36165463522455,1083,3291,3261,1113,50140,611926,645610,2777,3920,2837,4955,6098,46.34652090502587,5.572104574801163,1143,0,255990,3630,2148,0,1694,659
6919,0,0,0,0,55,1,541,1,0,1938972,3209808,33.88214869219483,871,3114,2837,1148,45747,578772,617916,2519,3944,3073,4485,5910,41.09744517606904,16.910190473258453,1425,1,253708,32686,1689,0,1648,1107
6920,0,0,0,0,54,1,567,0,1,653220,3093960,33.76388603226827,1110,1743,1713,1140,53824,629648,629648,2684,3854,2744,3287,4457,23.93741840717165,5.483301264452448,1170,1,264480,3960,573,0,1574,2141
6921,0,0,0,0,54,1,587,0,1,569148,2985821,33.21144381083123,1103,1619,1619,1103,55890,657801,622610,2707,3810,2707,3223,4326,22.715633383201094,0.0,1103,1,253690,0,516,0,1604,2191
6922,0,0,0,0,54,1,583,0,1,475280,2810080,32.2490309931942,955,1582,1497,1040,55575,667394,607950,2617,3742,2787,3159,4284,21.37755832643195,9.251281740554573,1125,1,234000,12920,457,0,1662,2245
6923,0,0,0,0,53,1,448,0,1,369728,2353528,29.5296461204668,577,1591,1296,872,54988,636964,628867,2404,3571,2994,3123,4290,20.591260281974,17.219799652250742,1167,1,203176,39825,424,0,1827,2275
6924,0,1,0,1,67,0,1076,0,0,9778485,12461538,60.91797764207213,3561,6496,6346,3711,51660,688390,846216,3208,7069,3508,5993,9854,51.332251070842396,12.393026621210916,3861,1,935172,10200,2635,0,353,723
6925,0,1,0,1,65,0,1654,0,0,8484855,12682950,62.08864630510155,3855,6056,6056,3855,50176,736960,736960,3290,7145,3290,5491,9346,46.9148164229596,0.0,3855,1,863520,0,2201,0,565,1089
6926,0,1,0,1,65,0,1843,0,0,8093928,12780504,62.545983084447556,3912,5981,5981,3912,53325,735075,774279,3267,7179,3267,5336,9248,45.48626166217664,0.0,3912,1,927144,0,2069,0,645,1198
6927,0,1,0,1,65,0,2033,0,0,7707620,12912250,63.0317380372777,3973,5913,5913,3973,51903,711750,770250,3250,7223,3250,5190,9163,44.04543109109048,0.0,3973,1,941601,0,1940,0,723,1310
6928,0,0,0,0,57,1,23,0,1,2194710,4196850,38.34057902536163,1070,3363,2963,1470,43344,719460,491060,2455,4325,3255,4348,6218,38.63935817272331,20.168971559500218,1870,1,252840,84800,1493,0,1385,1362
6929,0,0,0,0,53,1,463,0,1,412214,2465972,30.23243291566195,658,1621,1365,914,55200,647520,620540,2442,3612,2954,3149,4319,21.236760581595302,16.05108538429488,1170,1,210220,36352,451,0,1784,2247
6930,0,0,0,0,53,1,322,0,1,391395,2153883,28.407745422683583,446,1653,1292,807,55615,605863,653905,2308,3476,3030,3154,4322,22.02271554554524,19.022739433839604,1168,1,197715,38266,485,0,1862,2184
6931,0,0,0,0,53,1,255,0,1,390150,2031075,27.65863337187866,361,1679,1275,765,55596,600030,653130,2251,3420,3059,3165,4334,22.58317958127243,20.106674748541334,1169,1,188190,41612,510,0,1890,2145
6932,0,0,0,0,50,1,1357,0,1,137940,240825,9.746794344808963,95,1547,1547,95,53217,616005,555165,2535,2630,2535,3987,4082,38.1051177665153,0.0,95,1,20805,0,1452,0,2440,1083
6933,0,1,1,0,64,0,2717,0,0,6251348,13515860,64.8382603097893,4114,5781,5691,4204,44503,749095,614065,3125,7419,3305,4702,8996,38.561638969317684,9.535934250532243,4294,0,802964,16380,1487,1,989,1728
6934,0,1,0,1,64,0,2793,0,0,6112548,13656864,65.08456038109192,4086,5829,5679,4236,35680,718952,515840,3074,7460,3374,4667,9053,37.986839826445156,12.312788037888811,4386,1,677760,30150,1443,0,1012,1781
6935,0,1,1,0,58,0,859,0,0,247836,663936,15.0996688705415,78,1465,1315,228,51045,596960,725088,2762,3140,3062,3999,4377,32.96968304366907,12.30152264982736,378,1,56772,10950,1087,0,2684,1825
6936,0,0,0,0,53,1,79,1,0,2061972,3939444,38.41874542459709,1446,2903,2873,1476,50394,605863,592518,2639,4145,2699,4066,5572,37.376463182061514,5.483301264452448,1506,1,327672,4200,1397,0,1193,1272
6937,0,0,0,0,53,1,595,0,1,631446,3089616,33.85262175962151,1146,1697,1697,1146,55932,636256,638952,2696,3842,2696,3247,4393,23.473389188611005,0.0,1146,1,271602,0,551,0,1550,2145
6938,0,0,0,0,53,1,587,0,1,603588,3025808,33.52610922848042,1124,1661,1661,1124,55912,648772,624544,2692,3816,2692,3229,4353,23.173260452512935,0.0,1124,1,260768,0,537,0,1568,2155
6939,0,0,0,0,52,1,31,0,1,401082,1693890,25.475478405713993,139,1777,1267,649,54432,584640,634230,2100,3259,3120,3228,4387,24.859605789312106,22.606780661392698,1159,1,157707,54570,618,0,1961,1992
6940,0,0,0,0,51,1,488,1,0,357780,1040376,20.049937655763422,168,1526,1292,402,42387,551244,515012,2354,2990,2822,3478,4114,29.832867780352597,15.359532512939644,636,1,79998,35100,890,0,2186,1698
6941,0,0,0,0,51,1,776,1,0,437745,971756,19.467922333931785,312,1601,1534,379,43460,525620,543568,2497,2943,2631,3719,4165,33.98529093593286,8.239962426314323,446,1,80348,8375,1155,0,2185,1409
6942,0,0,0,0,51,1,959,0,0,387090,781830,17.4928556845359,264,1613,1571,306,44943,539105,544215,2513,2861,2597,3820,4168,35.566838487557476,6.5252844928085345,348,0,65178,5586,1265,0,2249,1290
6943,0,0,0,0,50,1,1353,0,1,157788,273780,10.392304845413264,78,1599,1569,108,51429,600795,550095,2505,2643,2565,3996,4134,38.22302970723278,5.478746393072713,138,1,23436,4710,1461,0,2427,1074
6944,1,0,0,0,51,0,318,1,0,835903,1994786,27.730849247724095,253,2372,1856,769,41552,549928,508424,2078,3363,3110,3681,4966,32.96968304366907,23.586971331006282,1285,1,150724,78948,1087,0,1825,1507
6945,1,0,0,0,51,0,244,1,0,802332,2029290,27.964262908219126,392,2198,1808,782,42387,552735,516405,2205,3377,2985,3621,4793,32.03123475609393,20.116601340534984,1172,1,155618,58500,1026,0,1813,1569
6946,1,0,0,0,51,0,239,1,0,794820,2024880,27.92848008753788,420,2159,1799,780,43875,584100,506220,2236,3376,2956,3615,4755,31.921779399024736,19.394318800716377,1140,1,152100,60840,1019,0,1816,1577
6947,0,1,0,1,66,0,1182,0,0,9217368,12278772,60.69596362197407,3599,6271,6186,3684,43680,693264,699930,3248,7017,3418,5835,9604,50.0199960015992,9.220820253968727,3769,1,773640,11135,2502,0,351,831
6948,0,1,0,1,66,0,1328,0,0,8892129,12332204,60.983604353957304,3689,6140,6110,3719,48825,746100,719572,3286,7035,3346,5707,9456,48.8978527135906,5.490867587491313,3749,1,807023,4320,2391,0,403,925
6949,0,1,0,1,69,0,427,0,0,3566318,7352492,45.9782557302906,1336,4579,3801,2114,43621,629518,838198,2700,5592,4256,5165,8057,41.0731055558257,28.554595934184967,2892,1,509474,42012,1687,0,1364,1791
6950,0,0,1,0,60,1,573,0,0,3598560,4904160,40.39801975344831,912,4557,3837,1632,48556,733220,597995,2285,4637,3725,5210,7562,46.95742752749558,26.884028613005505,2352,1,324768,133200,2205,0,1373,800
6951,0,0,1,0,62,1,1222,0,0,5004440,5325544,41.32795663954365,1317,5029,4638,1708,51360,748320,667252,2727,4826,3509,6048,8147,54.12947441089743,19.817838876454456,2099,1,365512,63733,2930,0,1410,188
6952,0,0,0,0,53,1,63,1,0,2033910,3910356,38.18376618407357,1458,2853,2853,1458,50794,584676,624906,2682,4140,2682,4077,5535,37.3496987939662,0.0,1458,1,339714,0,1395,0,1224,1287
6953,0,0,0,0,51,1,671,1,0,413790,1005810,19.748417658131498,256,1585,1451,390,43054,539011,531274,2445,2969,2713,3640,4164,32.57299494980466,11.639773040550214,524,1,80340,18492,1061,0,2189,1518
6954,0,0,0,0,50,1,1186,0,0,278787,511344,14.177446878757825,141,1648,1588,201,44690,521520,554592,2484,2745,2604,3931,4192,37.242448899072144,7.745966692414834,261,0,43818,7080,1387,0,2343,1157
6955,0,0,0,0,50,1,1344,0,1,186817,322072,11.269427669584644,85,1640,1598,127,50151,580744,555384,2494,2663,2578,4007,4176,38.353617821530214,6.481658975540136,169,1,27813,6174,1471,0,2409,1065
6956,0,1,0,1,68,0,882,0,0,9759544,12244380,59.9666574022598,3488,6418,6310,3596,40080,568635,817200,3297,7001,3513,6119,9823,52.09606511052442,10.429745618880121,3704,1,863040,3780,2714,0,191,691
6957,0,1,0,1,67,0,1057,0,0,9346194,12196529,60.25777958073132,3481,6355,6205,3631,42846,648287,745698,3209,6990,3509,5933,9714,50.73460357586329,12.24962545775264,3781,1,806082,14550,2574,0,272,785
6958,0,1,0,1,66,0,1311,0,0,8778510,12250800,60.74537019394976,3690,6069,6069,3690,44726,710480,693880,3320,7010,3320,5699,9389,48.774993593028796,0.0,3690,1,771210,0,2379,0,370,941
6959,0,0,1,0,62,1,354,0,0,4923747,6388782,45.2658811910251,1726,4775,4452,2049,47403,714022,645426,2795,5167,3441,5521,7893,49.02040391510457,18.051306284727975,2372,1,424143,52003,2403,0,1069,715
6960,0,0,0,0,53,1,169,1,0,2044916,4067077,38.948684188300895,1475,2907,2865,1517,43470,563010,554967,2639,4198,2723,4029,5588,36.71511950137164,6.495386533491135,1559,1,314019,5796,1348,0,1164,1333
6961,0,0,0,0,53,1,191,1,0,2048670,4098870,39.11521443121589,1463,2936,2869,1530,43888,565269,557232,2612,4209,2746,4018,5615,36.59234892706397,8.19263674150144,1597,1,318240,9246,1339,0,1149,1340
6962,0,0,0,0,57,1,111,0,1,2260440,4469400,39.496835316262995,1114,3455,3009,1560,51408,721980,584460,2419,4425,3311,4314,6320,38.06573262134856,22.370623642425493,2006,1,318240,81618,1449,0,1305,1416
6963,0,0,0,0,53,1,291,0,1,489340,2281580,29.32575659723036,560,1729,1429,860,56364,612843,647332,2353,3513,2953,3222,4382,23.853720883753127,17.328633372652778,1160,1,209840,33000,569,0,1793,2084
6964,0,0,0,0,52,1,59,0,1,459492,1851420,26.60826939130014,251,1814,1357,708,53874,572685,643290,2158,3323,3072,3264,4429,25.475478405713993,21.392282791186577,1165,1,174168,44786,649,0,1907,1966
6965,0,0,0,0,52,1,503,1,0,423254,1161384,21.118712081942874,191,1650,1395,446,41000,533820,520800,2349,3050,2859,3553,4254,30.805843601498726,16.108330850650685,701,1,89200,35445,949,0,2158,1655
6966,0,0,0,0,51,1,724,1,0,496220,1111980,20.73644135332772,296,1718,1584,430,39600,517200,512028,2452,3016,2720,3740,4304,33.97057550292606,11.747494334573807,564,1,85140,18224,1154,0,2156,1432
6967,0,0,0,0,51,1,1182,1,0,301968,551016,14.696938456699069,126,1704,1614,216,42570,505098,548465,2461,2767,2641,3949,4255,37.389838191679836,9.489467114586667,306,1,46440,10170,1398,0,2335,1153
6968,0,1,0,1,66,0,1294,0,0,8671616,12190798,60.51446108162907,3662,6030,6030,3662,40800,679116,665800,3329,6991,3329,5697,9359,48.662100242385755,0.0,3662,1,732400,0,2368,0,333,961
6969,0,0,1,0,61,1,10,0,0,5107575,6938635,47.486840282335066,2170,4605,4520,2255,47300,676940,661555,2992,5332,3162,5342,7682,47.59201613716318,9.257905235465769,2340,1,484825,11985,2265,0,822,812
6970,0,0,1,0,62,1,152,0,0,5311860,7393728,48.80573736764972,2063,4931,4612,2382,45276,717024,608384,2785,5486,3423,5334,8035,47.22287581247038,17.862150524018197,2701,1,466872,55825,2230,0,722,874
6971,0,0,1,0,64,1,1065,0,0,2638834,7216998,47.34976240700686,1676,3985,3419,2242,44935,692085,672771,2653,5461,3785,4396,7204,34.307433596816885,23.791664182313912,2808,1,468578,80372,1177,0,977,2042
6972,0,0,1,0,63,1,747,0,0,3894570,7505682,48.80573736764972,2154,4245,4017,2382,56882,753089,749938,2923,5533,3379,4786,7396,40.43513323831146,15.244617570879624,2610,1,566916,28272,1635,0,769,1516
6973,0,0,0,0,53,1,85,1,0,1996176,3929744,38.157568056677825,1456,2827,2827,1456,52614,599178,639663,2699,4155,2699,4070,5526,37.027017163147235,0.0,1456,1,345072,0,1371,0,1243,1328
6974,0,0,0,0,53,1,114,1,0,2001807,3969735,38.379682124790975,1473,2832,2832,1473,49062,598290,595595,2695,4168,2695,4054,5527,36.864617182333525,0.0,1473,1,325533,0,1359,0,1222,1336
6975,0,0,0,0,52,1,242,0,1,515343,2242209,29.13760456866693,540,1765,1456,849,56394,617994,636481,2332,3490,2950,3248,4406,24.63736998950984,17.57844185696618,1158,1,204609,36771,607,0,1792,2034
6976,0,0,0,0,51,1,68,0,0,477708,1708168,25.65151067676132,126,1916,1384,658,50838,594484,576312,2064,3254,3128,3322,4512,26.94438717061496,23.102704450983556,1190,0,146076,75544,726,0,1938,1870
6977,0,0,0,0,51,1,109,0,0,473820,1650420,25.219040425836983,126,1891,1381,636,48548,594255,550140,2085,3231,3105,3340,4486,27.294688127912362,22.60823029042032,1146,0,134832,78540,745,0,1959,1850
6978,0,0,0,0,51,1,1176,1,0,329940,599040,15.297058540778355,114,1764,1644,234,40492,488960,542720,2440,2794,2680,3970,4324,37.54996671103717,10.981735174982626,354,1,49608,12840,1410,0,2326,1150
6979,1,0,0,0,52,0,269,1,0,661710,1809180,26.267851073127396,236,2103,1649,690,47960,576840,571596,2168,3312,3076,3581,4725,30.967725134404045,21.618798359090096,1144,1,150420,62652,959,0,1932,1663
6980,0,1,0,1,67,0,949,0,0,9282822,12040272,59.648973168026956,3396,6329,6167,3558,41495,653112,727560,3222,6942,3546,5993,9713,51.07837115648854,12.803033322522062,3720,1,764970,17172,2609,0,174,775
6981,0,1,0,1,67,0,984,0,0,9201265,12046135,59.70762095411272,3431,6280,6146,3565,40964,662284,706211,3245,6944,3513,5960,9659,50.80354318352215,11.639773040550214,3699,1,745085,15812,2581,0,186,798
6982,0,1,0,1,67,0,1130,0,0,8879864,12064094,59.983331017875294,3556,6108,6066,3598,45114,690718,734307,3311,6951,3395,5821,9461,49.678969393496885,6.481658975540136,3640,1,787962,4956,2468,0,245,885
6983,0,1,0,1,73,0,1424,0,0,3291657,9779175,51.58488150611572,1616,4943,3898,2661,43758,727650,812175,2630,6336,4720,4912,8618,35.17101079013795,32.82662211449557,3706,1,588081,109725,1237,0,1014,2438
6984,0,1,0,1,69,0,494,0,0,3469632,7400606,46.10856753359401,1352,4532,3758,2126,47124,650947,877212,2707,5607,4255,5113,8013,40.39801975344831,28.25652068679935,2900,1,535752,33282,1632,0,1355,1849
6985,0,1,1,0,60,0,779,0,0,889710,1910037,25.11971337416094,589,2083,2041,631,55000,665940,756750,2985,3658,3069,4437,5110,37.54996671103717,6.481658975540136,673,1,157750,3570,1410,0,2396,1617
6986,0,0,0,0,54,1,221,1,0,2005610,4136762,39.1279950930277,1464,2908,2841,1531,38391,543102,516082,2635,4233,2769,4012,5610,36.193922141707716,8.2143728690235,1598,1,292421,9648,1310,0,1171,1392
6987,0,0,0,0,54,1,345,0,1,2085814,4469369,40.33608806019741,1417,3119,2909,1627,46299,694991,502701,2537,4374,2957,4029,5866,35.805027579936315,14.495400452462528,1837,1,297741,40320,1282,0,1120,1465
6988,0,0,0,0,53,1,546,0,1,733672,3136272,34.23448553724738,1142,1828,1798,1172,54750,669000,586044,2646,3848,2706,3302,4504,25.019992006393608,5.490867587491313,1202,1,256668,4860,626,0,1504,2050
6989,0,0,0,0,53,1,531,0,1,710082,3077022,33.896902513356586,1107,1809,1767,1149,54500,669500,583804,2636,3827,2720,3296,4487,24.859605789312106,6.553889165207866,1191,1,250482,6804,618,0,1529,2060
6990,0,0,0,0,52,1,121,0,1,531432,2075832,28.142494558940577,413,1842,1463,792,55430,602830,631661,2242,3413,3000,3292,4463,25.903667693977237,19.478891135494166,1171,1,190872,43585,671,0,1829,1950
6991,0,0,0,0,52,1,83,0,0,526080,2008320,27.712812921102035,360,1861,1453,768,55176,596220,632830,2207,3383,3023,3300,4476,26.1725046566048,20.216460441487616,1176,0,185856,46512,685,0,1847,1930
6992,0,0,0,0,52,1,32,0,0,512400,1820000,26.457513110645905,205,1927,1432,700,50848,590200,582400,2105,3300,3095,3332,4527,27.055498516937366,22.28304258291865,1195,0,156800,68310,732,0,1900,1868
6993,0,0,0,0,51,1,110,1,0,505344,1710142,25.65151067676132,133,1951,1426,658,46330,587374,532795,2074,3257,3124,3367,4550,27.712812921102035,22.94282985115971,1183,1,134890,84000,768,0,1941,1831
6994,0,0,0,0,52,1,513,1,0,498960,1295910,22.24859546128699,218,1780,1503,495,42642,539308,541926,2341,3113,2895,3626,4398,31.74901573277509,16.828954222814524,772,1,102465,36841,1008,0,2123,1610
6995,0,0,0,0,51,1,1069,1,0,410700,774900,17.320508075688775,150,1819,1669,300,37758,480438,524349,2433,2883,2733,3952,4402,37.0,12.410850817228189,450,1,60900,16650,1369,0,2283,1214
6996,1,0,0,0,52,0,321,1,0,644182,1725276,25.65151067676132,87,2208,1637,658,43680,550620,545376,2051,3280,3193,3601,4830,31.28897569432403,24.11822796766357,1229,1,136864,78227,979,0,1964,1643
6997,0,1,0,1,67,0,930,0,0,9171871,11977426,59.405386961116584,3376,6281,6128,3529,41925,661830,729710,3241,6923,3547,5993,9675,50.98038838612354,12.407318298018154,3682,1,758735,16677,2599,0,135,795
6998,0,1,0,1,66,0,1297,0,0,8379570,12106635,60.124870062229654,3548,6000,5933,3615,37422,663102,632961,3282,6964,3416,5667,9349,48.14561246884289,8.345174736691893,3682,1,683235,9514,2318,0,266,1031
6999,0,1,0,1,68,0,3284,0,0,3775772,14357980,64.69930447848725,3931,5343,5088,4186,33945,531650,751170,3175,7616,3685,4332,8773,30.033314835362415,16.838963772563712,4441,1,916734,11985,902,0,756,2528
7000,0,1,1,0,64,0,587,0,0,2485070,4239160,36.193922141707716,873,3644,3207,1310,56120,744280,789584,2799,4546,3673,5133,6880,43.55456348076513,21.060851505513554,1747,1,319640,47633,1897,0,1926,1339
7001,0,0,1,0,53,1,495,0,0,867076,1905276,26.758176320519304,592,2051,1927,716,37014,494946,529539,2537,3377,2785,3872,4712,34.79942528261063,11.375520776142816,840,1,142484,14384,1211,0,1945,1450
7002,0,0,1,0,61,1,1544,0,0,4616105,4650858,38.87158345115362,1481,4596,4566,1511,54366,680238,757188,3048,4589,3108,6133,7674,55.27205442174191,5.490867587491313,1541,0,371706,2940,3055,1,1567,23
7003,0,0,1,0,64,1,1041,0,0,3201712,7721776,48.82622246293481,2000,4111,3727,2384,44690,706102,663995,2855,5623,3623,4582,7350,36.64696440361739,19.665843340272662,2768,1,488720,57216,1343,0,855,1896
7004,0,0,0,0,54,1,61,0,1,2008376,3803154,37.242448899072144,1345,2877,2835,1387,55890,630660,666306,2700,4129,2784,4190,5619,38.05259518088089,6.73127350780198,1429,1,337041,4284,1448,0,1355,1294
7005,0,0,1,0,54,1,24,0,0,1990777,3871983,37.72267222772003,1393,2852,2822,1423,56635,639435,655761,2691,4144,2751,4120,5573,37.403208418530085,5.501408174353464,1453,0,342943,3480,1399,0,1298,1322
7006,0,0,0,0,54,1,108,1,0,1982365,3966193,38.24918299781056,1463,2818,2818,1463,53799,642507,615397,2711,4174,2711,4066,5529,36.810324638611924,0.0,1463,1,332101,0,1355,0,1248,1356
7007,0,0,0,0,53,1,403,0,1,652454,2745270,32.155870381627054,907,1792,1665,1034,56640,637200,626580,2528,3689,2782,3286,4447,25.11971337416094,11.308525934296243,1161,1,244024,16510,631,0,1621,2024
7008,0,0,0,0,52,1,532,1,0,543900,1359232,22.759613353482084,235,1851,1568,518,41820,537920,535296,2341,3142,2907,3674,4475,32.4037034920393,17.040209244575763,801,1,105672,37922,1050,0,2106,1574
7009,0,0,0,0,52,1,560,1,0,552036,1347194,22.67156809750927,246,1856,1588,514,40600,524200,532063,2353,3135,2889,3695,4477,32.77193921634788,16.628058050793765,782,1,104342,34840,1074,0,2107,1547
7010,0,0,0,0,52,1,859,1,0,532092,1087953,20.42057785666214,216,1894,1693,417,37632,500928,511364,2408,3026,2810,3885,4503,35.7211421989835,14.493183722744913,618,1,81732,25527,1276,0,2192,1333
7011,0,0,0,0,51,1,1063,1,0,440858,827486,17.86057109949175,139,1881,1701,319,36984,477296,521394,2414,2913,2774,3976,4475,37.17526059088221,13.630290597404818,499,1,64119,19800,1382,0,2275,1212
7012,0,1,0,1,68,0,803,0,0,9309804,11912096,58.98304841223451,3278,6356,6155,3479,48200,684800,825184,3223,6903,3625,6100,9780,51.73006862551025,14.21597824693016,3680,1,838439,16281,2676,0,55,748
7013,0,0,1,0,62,1,704,0,0,4880265,5890625,43.41658669218482,1348,5011,4474,1885,48530,718750,659375,2588,5010,3662,5714,8136,50.882216932834204,23.227393662814443,2422,1,397735,84309,2589,0,1240,536
7014,0,0,1,0,58,1,860,0,0,6050109,6093516,45.46427168667722,1570,5491,4994,2067,47897,622028,669196,2451,5015,3445,5875,8439,54.101755978895916,22.293857815973023,2564,0,469209,56658,2927,1,881,21
7015,0,0,0,0,54,1,160,1,0,1978881,4039657,38.58756276314948,1459,2848,2818,1489,46740,618564,556165,2683,4202,2743,4042,5561,36.45545226711637,5.477225575051661,1519,1,305245,4860,1329,0,1224,1384
7016,0,0,0,0,54,1,273,1,0,1976524,4214829,39.35733730830886,1482,2892,2825,1549,36490,557805,484338,2654,4270,2788,3997,5613,35.7211421989835,8.286047041568583,1616,1,275722,10921,1276,0,1172,1445
7017,0,0,0,0,52,1,333,0,1,665334,2638359,31.606961258558215,837,1827,1665,999,56168,623276,628558,2479,3640,2803,3307,4468,25.80697580112788,12.728043305644134,1161,1,237762,20250,666,0,1642,1975
7018,0,0,0,0,52,1,105,0,0,601750,2173770,28.809720581775867,465,1920,1555,830,51051,578799,604989,2254,3449,2984,3344,4539,26.92582403567252,19.119297438156163,1195,0,191730,44530,725,0,1789,1894
7019,0,0,0,0,52,1,223,1,0,565928,1699731,25.475478405713993,161,2009,1521,649,42074,570942,505467,2131,3268,3107,3491,4628,29.5296461204668,22.17651286037125,1137,1,125257,80032,872,0,1970,1747
7020,0,0,0,0,51,1,1310,1,0,384579,631085,15.716233645501712,180,1871,1804,247,45507,503335,590205,2488,2802,2622,4112,4426,39.45883931389772,8.329212945039274,314,1,57057,6097,1557,0,2308,998
7021,0,1,0,1,67,0,1073,0,0,8559818,11807493,59.253691868102194,3511,5949,5949,3511,47300,723045,739860,3363,6874,3363,5801,9312,49.37610758251404,0.0,3511,1,772420,0,2438,0,148,925
7022,0,1,0,1,67,0,1110,0,0,8483200,11834240,59.329587896765304,3490,5960,5930,3520,43632,726192,679124,3332,6882,3392,5772,9322,49.09175083453431,5.490867587491313,3550,1,711040,4530,2410,0,158,952
7023,0,1,0,1,72,0,1148,0,0,3250188,8914590,49.658836071740545,1441,4809,3784,2466,47040,694080,885675,2590,6081,4640,4933,8424,36.30426972134269,32.81482021334419,3491,1,604170,64575,1318,0,1149,2297
7024,0,0,0,1,64,1,1033,0,0,3565034,7966280,49.73932046178355,2191,4198,3915,2474,52920,695520,788900,2937,5694,3503,4661,7418,37.960505792204614,16.937422470776703,2757,1,606130,26885,1441,0,746,1779
7025,0,0,1,0,59,1,274,0,0,5949480,7711620,50.79370039680118,2513,4953,4886,2580,49050,651602,672525,2922,5569,3056,5295,7942,48.02082881417188,8.20171446926608,2647,0,580500,8442,2306,1,409,683
7026,0,0,1,0,59,1,854,0,0,6132840,6157872,45.67274898667694,1616,5496,5026,2086,48336,625824,673056,2482,5038,3422,5892,8448,54.22176684690383,21.6794833886788,2556,0,475608,54050,2940,1,866,12
7027,0,0,1,0,54,1,100,0,0,1999725,3981870,38.27531841800928,1465,2830,2830,1465,51302,616986,614268,2718,4183,2718,4083,5548,36.945906403822335,0.0,1465,0,331090,0,1365,0,1253,1353
7028,0,0,1,0,54,1,157,0,0,1986170,4046840,38.600518131237564,1460,2853,2823,1490,47475,611100,573076,2686,4206,2746,4049,5569,36.51027252705737,5.477225575051661,1520,0,314390,4530,1333,0,1226,1383
7029,0,0,0,0,54,1,186,1,0,1979451,4082148,38.768543949960254,1473,2850,2820,1503,45225,611100,545916,2686,4219,2746,4033,5566,36.29049462324811,5.490867587491313,1533,1,302103,4860,1317,0,1213,1399
7030,0,0,0,0,54,1,242,1,0,1970640,4164660,39.11521443121589,1470,2878,2818,1530,41172,596118,511736,2662,4252,2782,4010,5600,35.888716889852724,7.789174875971784,1590,1,287640,10140,1288,0,1192,1434
7031,0,0,0,0,54,1,298,1,0,1965899,4252952,39.48417404479927,1474,2905,2820,1559,37590,572880,488312,2643,4287,2813,3989,5633,35.510561809129406,9.321211371972165,1644,1,279061,14195,1261,0,1169,1467
7032,0,0,0,0,53,1,503,0,1,853554,3213522,34.77067730142742,1209,1915,1915,1209,55920,637920,619314,2658,3867,2658,3364,4573,26.570660511172846,0.0,1209,1,281697,0,706,0,1449,1952
7033,0,0,0,0,53,1,488,0,1,831600,3155328,34.46737587922817,1188,1888,1888,1188,56635,640096,624160,2656,3844,2656,3356,4544,26.457513110645905,0.0,1188,1,279180,0,700,0,1468,1956
7034,0,0,0,0,52,1,347,0,1,720720,2745600,32.2490309931942,916,1857,1733,1040,56168,628320,623040,2516,3680,2764,3333,4497,26.324893162176366,11.135528725660043,1164,1,245440,16368,693,0,1600,1947
7035,0,0,0,0,52,1,1002,1,0,528688,1001986,19.544820285692065,142,2006,1766,382,36630,485255,519354,2383,3005,2863,4007,4629,37.20215047547655,15.85704320526381,622,1,75636,27600,1384,0,2241,1239
7036,0,0,0,0,50,1,1354,1,0,438480,686610,16.431676725154983,240,1924,1894,270,48697,531487,592519,2513,2813,2573,4167,4467,40.29888335921977,5.5503012171862105,300,1,62910,3150,1624,0,2273,919
7037,0,1,0,1,68,0,726,0,0,9170731,11761198,58.42088667591412,3243,6270,6100,3413,37950,568590,792580,3276,6859,3616,6133,9716,51.836280730777744,13.047531130373535,3583,1,784990,7990,2687,0,33,759
7038,0,1,0,1,68,0,3274,0,0,3118695,13821765,63.60031446463138,3798,5063,4816,4045,49862,731238,796161,3170,7462,3664,4188,8480,27.76688675382964,16.32406626895984,4292,1,942485,27417,771,0,628,2646
7039,0,1,1,0,59,0,710,0,0,660744,1591744,23.065125189341593,472,1834,1774,532,40768,544544,670208,2932,3524,3052,4234,4826,35.24202037341219,7.765259411425052,592,1,119168,4800,1242,0,2460,1750
7040,0,0,1,0,62,1,424,0,0,4972656,6305052,45.033320996790806,1866,4642,4480,2028,46689,736833,612473,2947,5137,3271,5561,7751,49.51767361255979,12.748363342157862,2190,1,399516,29160,2452,0,1081,657
7041,0,0,1,0,62,1,775,0,0,4820514,5774670,42.91852746774987,1326,4975,4459,1842,51465,736725,686565,2619,4977,3651,5752,8110,51.15662224971465,22.794585103462612,2358,1,403398,78432,2617,0,1293,518
7042,0,0,0,0,55,1,322,1,0,2348760,3817080,37.14835124201342,1350,3112,3082,1380,56153,644478,666606,2736,4146,2796,4468,5878,41.255302689472536,5.490867587491313,1410,1,332580,3600,1702,0,1386,1064
7043,0,0,0,0,54,1,267,1,0,1968868,4204675,39.28103868280471,1476,2886,2819,1543,41292,604950,506850,2658,4268,2792,4001,5611,35.7211421989835,8.250220863768833,1610,1,286998,11725,1276,0,1182,1449
7044,0,0,0,0,54,1,323,1,0,1960608,4293543,39.63584236521283,1476,2914,2819,1571,38092,584862,486474,2638,4304,2828,3981,5647,35.32704346531139,9.85304212894363,1666,1,279638,16530,1248,0,1162,1485
7045,0,0,0,0,54,1,433,1,0,1953938,4478726,40.38564101261734,1481,2979,2829,1631,38556,560184,518994,2596,4377,2896,3944,5725,34.61213659975356,12.459604606992961,1781,1,308259,22500,1198,0,1115,1548
7046,0,0,0,0,54,1,567,0,1,2052688,4712288,41.7612260356422,1594,3071,2921,1744,41750,675500,451234,2552,4446,2852,3879,5773,34.307433596816885,12.72513248597547,1894,1,291248,30300,1177,0,958,1525
7047,0,0,0,0,55,1,227,0,1,2434778,4671552,40.963398296528084,1260,3547,3129,1678,54145,682080,615264,2366,4462,3202,4235,6331,38.09199390948182,21.296516588821344,2096,1,370838,59356,1451,0,1106,1333
7048,0,0,0,0,52,1,457,0,1,858858,3127852,34.39476704383968,1183,1909,1909,1183,56643,626628,631916,2644,3827,2644,3370,4553,26.94438717061496,0.0,1183,1,282737,0,726,0,1461,1918
7049,0,0,0,0,52,1,387,0,1,797040,2921373,33.27160951922825,1047,1887,1827,1107,55125,646555,593775,2579,3746,2699,3359,4526,26.832815729997478,7.745966692414834,1167,1,249075,9180,720,0,1532,1919
7050,0,0,0,0,52,1,361,0,1,780122,2854316,32.89376840679705,992,1893,1803,1082,55418,638396,604102,2548,3720,2728,3359,4531,26.851443164195103,9.48712577043745,1172,1,247778,13050,721,0,1556,1917
7051,0,0,0,0,52,1,249,0,0,723240,2588904,31.368774282716245,774,1929,1719,984,50976,620916,568296,2421,3615,2841,3366,4560,27.110883423451916,14.496631529664223,1194,0,212544,32970,735,0,1647,1896
7052,0,0,0,0,52,1,187,0,0,702750,2466184,30.610455730027933,667,1957,1687,937,49665,607992,565880,2362,3569,2902,3382,4589,27.386127875258307,16.43443718226862,1207,0,201455,41040,750,0,1695,1882
7053,0,0,0,0,52,1,123,1,0,685948,2345068,29.866369046136157,562,1991,1661,892,48178,581009,573122,2299,3521,2959,3398,4620,27.730849247724095,18.170071006586177,1222,1,194456,45540,769,0,1737,1860
7054,0,0,0,0,52,1,218,1,0,642600,1841700,26.457513110645905,169,2149,1618,700,44719,597237,518307,2100,3331,3162,3549,4780,30.298514815086232,23.154513895060518,1231,1,137900,89739,918,0,1931,1713
7055,0,0,0,0,52,1,658,0,1,692784,1497070,23.790754506740637,253,2103,1790,566,41790,555450,526355,2332,3211,2958,3869,4748,34.9857113690718,18.10209449603929,879,1,112634,46011,1224,0,2079,1421
7056,0,0,0,0,52,1,757,0,1,656868,1364820,22.715633383201094,215,2090,1789,516,42833,558095,536935,2344,3161,2946,3918,4735,35.679125549822544,17.783238653571342,817,1,104748,43344,1273,0,2129,1372
7057,0,1,0,1,68,0,777,0,0,8906158,11665334,58.29236656715869,3290,6127,6019,3398,40626,628239,762126,3325,6831,3541,6054,9560,51.19570294468082,10.394308954048586,3506,1,754356,9180,2621,0,35,812
7058,0,1,0,1,68,0,813,0,0,8825760,11658720,58.35237784358063,3310,6092,5997,3405,41400,630016,770400,3329,6829,3519,6016,9516,50.91168824543142,9.785443037298442,3500,1,766125,7695,2592,0,19,832
7059,0,1,0,1,69,0,3453,0,0,3575358,14888751,65.47518613948341,3883,5525,5121,4287,52002,743222,843939,3069,7760,3877,4307,8998,28.879058156387302,20.90826579879634,4691,1,1041741,38380,834,0,814,2639
7060,0,0,1,0,56,1,385,0,0,1902000,3390000,34.64101615137755,900,3085,2785,1200,20592,559350,293800,2525,4025,3125,4410,5910,39.81205847478876,18.690737554481935,1500,1,124800,66900,1585,0,1625,1240
7061,0,0,1,0,58,1,400,0,0,2600625,4193775,37.749172176353746,855,3820,3250,1425,38675,650403,515025,2373,4368,3513,4768,6763,42.720018726587654,25.352229880843677,1995,1,249375,105450,1825,0,1518,1118
7062,0,0,1,0,62,1,1612,0,0,4128960,4284900,37.14835124201342,1246,4506,4372,1380,44270,723465,589950,2971,4485,3239,6097,7611,54.699177324709375,11.747494334573807,1514,1,262200,24522,2992,0,1725,113
7063,0,0,1,0,63,1,889,0,0,4243976,8056664,50.51732376126036,2485,4282,4215,2552,55430,726110,760837,3090,5709,3224,4820,7439,40.779897008207364,8.299636160530056,2619,1,615032,7772,1663,0,605,1494
7064,0,0,1,0,59,1,926,0,0,5233187,5534418,43.255057507764334,1637,4902,4668,1871,45540,650760,612306,2724,4829,3192,5755,7860,52.88667128870941,15.359532512939644,2105,1,387297,35100,2797,0,1087,161
7065,0,0,0,0,54,1,291,1,0,1971162,4247496,39.45883931389772,1472,2908,2823,1557,42211,602888,521048,2643,4285,2813,3994,5636,35.58089374931439,9.265143265380413,1642,1,297387,14365,1266,0,1171,1462
7066,0,0,0,0,52,1,444,0,1,905245,3160564,34.62657938636157,1169,1984,1954,1199,56643,624732,630004,2606,3835,2666,3391,4620,27.477263328068172,5.684275577662207,1229,1,286561,3690,755,0,1437,1881
7067,0,0,0,0,52,1,421,0,1,882096,3088509,34.249087579087416,1173,1925,1925,1173,55615,645085,597691,2633,3806,2633,3385,4558,27.422618401604176,0.0,1173,1,266271,0,752,0,1460,1881
7068,0,0,0,0,52,1,208,0,0,754809,2579665,31.28897569432403,739,1990,1750,979,48488,611320,550715,2395,3614,2875,3406,4625,27.76688675382964,15.493009101489612,1219,0,204611,38640,771,0,1656,1864
7069,0,0,0,0,53,1,611,0,1,739326,1610978,24.63736998950984,256,2176,1825,607,46189,586534,554686,2303,3261,3005,3872,4830,34.899856733230294,19.148277076828194,958,1,126863,52299,1218,0,2047,1436
7070,0,0,0,0,50,1,1276,1,0,367356,605726,15.556349186104045,212,1790,1760,242,50616,570684,555666,2473,2745,2533,4021,4293,38.961519477556315,5.483301264452448,272,1,53724,4230,1518,0,2261,985
7071,0,1,0,1,68,0,829,0,0,8646120,11573280,58.172158288995945,3324,5999,5939,3384,40762,608760,783180,3360,6804,3480,5975,9419,50.547007824400445,7.880145860644973,3444,1,774936,4020,2555,0,36,865
7072,0,1,0,1,68,0,866,0,0,8568192,11556544,58.240879114244144,3350,5960,5918,3392,41400,613260,783610,3365,6799,3449,5933,9367,50.25932749251625,6.495386533491135,3434,1,780160,2856,2526,0,15,881
7073,0,0,1,0,60,1,438,0,0,5959440,8020680,51.67204273105525,2603,4969,4902,2670,49896,648864,693924,2937,5674,3071,5236,7973,47.24404724407086,8.2143728690235,2737,0,616770,7772,2232,1,334,772
7074,0,0,0,0,54,1,259,1,0,1998210,4238064,39.35733730830886,1459,2929,2839,1549,45582,582768,585504,2646,4285,2826,4026,5665,35.91656999213594,9.494144610579708,1639,1,331486,11970,1290,0,1187,1446
7075,0,0,0,0,54,1,316,1,0,1974432,4294704,39.64845520319802,1477,2923,2828,1572,45046,609236,551864,2637,4304,2827,3988,5655,35.4400902933387,9.773682308767459,1667,1,317544,15105,1256,0,1160,1476
7076,0,0,0,0,55,1,512,1,0,1925385,4607588,40.82891132518721,1477,3012,2822,1667,39804,591496,514104,2574,4431,2954,3919,5776,33.98529093593286,14.044701627992035,1857,1,310062,31540,1155,0,1097,1609
7077,0,0,0,0,54,1,502,1,0,1606263,4233992,39.28103868280471,1123,3004,2584,1543,53703,606424,666792,2324,4287,3164,3785,5748,32.264531609803356,20.50133291797657,1963,1,374949,43680,1041,0,1201,1703
7078,0,0,0,0,52,1,430,0,1,953775,3195450,34.85685011586675,1185,2030,2000,1215,56643,628570,623310,2600,3845,2660,3415,4660,28.0178514522438,5.483301264452448,1245,1,287955,3900,785,0,1415,1845
7079,0,0,0,0,52,1,408,0,0,930580,3128510,34.49637662132068,1190,1972,1972,1190,54340,649363,578380,2629,3819,2629,3411,4601,27.964262908219126,0.0,1190,0,261800,0,782,0,1439,1847
7080,0,0,0,0,52,1,360,0,0,889200,3002760,33.76388603226827,1080,1980,1920,1140,53410,645330,574212,2574,3774,2694,3414,4614,27.92848008753788,7.759379671981613,1200,0,248520,9780,780,0,1494,1854
7081,0,0,0,0,52,1,76,1,0,762432,2404944,30.199337741083,552,2108,1748,912,47960,580140,574866,2277,3549,2997,3473,4745,28.91366458960192,18.97381236105937,1272,1,198816,49320,836,0,1725,1801
7082,0,0,0,0,53,1,453,0,1,754204,1778150,25.903667693977237,241,2225,1795,671,49416,614800,564450,2220,3321,3080,3774,4875,33.52610922848042,20.995355332210885,1101,1,142923,67510,1124,0,1979,1526
7083,0,0,0,0,50,1,1211,1,0,602610,956596,19.467922333931785,349,1999,1969,379,47652,527516,575472,2494,2903,2554,4114,4523,39.87480407475377,5.490867587491313,409,1,86412,3330,1590,0,2145,934
7084,0,0,0,0,50,1,1220,1,0,490941,801009,17.86057109949175,289,1888,1858,319,52440,572508,577530,2481,2830,2541,4050,4399,39.230090491866065,5.501408174353464,349,1,73370,3960,1539,0,2192,972
7085,0,1,0,1,67,0,1186,0,0,7782255,11650990,58.69412236331676,3283,5866,5704,3445,49374,791388,713602,3220,6827,3544,5641,9248,47.52893855326458,12.79158200857479,3607,1,726895,26244,2259,0,63,1123
7086,0,0,1,0,61,1,713,0,0,5105564,8130300,51.419840528729765,2614,4605,4575,2644,54189,685725,747225,3045,5719,3105,5006,7680,43.94314508543966,5.7180036243905645,2674,1,642492,3210,1931,0,431,1144
7087,0,0,0,0,54,1,425,1,0,1947176,4457880,40.29888335921977,1474,2973,2823,1624,41132,620370,499590,2595,4369,2895,3944,5718,34.62657938636157,12.345470001201512,1774,1,295568,27450,1199,0,1121,1546
7088,0,0,0,0,55,1,482,1,0,1927200,4549050,40.620192023179804,1475,2993,2818,1650,40002,623082,487989,2582,4407,2932,3925,5750,34.17601498127012,13.406666223469482,1825,1,292050,32900,1168,0,1107,1589
7089,0,0,0,0,55,1,510,1,0,1920256,4595968,40.792156108742276,1474,3008,2818,1664,40096,618688,494398,2572,4426,2952,3916,5770,33.97057550292606,14.007737751789053,1854,1,297856,34960,1154,0,1098,1608
7090,0,0,0,0,54,1,520,1,0,1635425,4281840,39.56008088970496,1147,3028,2610,1565,53703,604656,664848,2318,4301,3154,3781,5764,32.32645975048923,21.130831453391355,1983,1,380295,43472,1045,0,1171,1691
7091,0,0,0,0,53,1,584,0,1,1474737,4152995,39.25557285278104,1191,2848,2498,1541,56120,619850,657580,2345,4236,3045,3652,5543,30.93541659651604,18.71290502511019,1891,1,376004,38150,957,0,1154,1738
7092,0,0,0,0,53,1,304,0,1,774345,1964391,27.2213151776324,287,2240,1786,741,47403,607079,548757,2197,3392,3105,3696,4891,32.32645975048923,21.68794315018385,1195,1,153387,72640,1045,0,1910,1606
7093,0,0,0,0,53,1,418,0,1,793544,1871606,26.570660511172846,236,2300,1830,706,51212,625636,575267,2181,3357,3121,3775,4951,33.52610922848042,21.911374240585094,1176,1,153202,73320,1124,0,1945,1527
7094,0,0,0,0,53,1,931,0,1,700116,1304784,22.181073012818835,142,2265,1915,492,51684,625872,580788,2302,3144,3002,4075,4917,37.72267222772003,19.226983277214995,842,1,107748,54250,1423,0,2160,1229
7095,0,1,0,1,67,0,974,0,0,8062992,11427624,58.034472514187634,3326,5804,5762,3368,44512,705744,726102,3351,6761,3435,5787,9197,48.92851929090027,6.488991180673202,3410,1,720752,5334,2394,0,25,999
7096,0,0,1,0,54,1,133,0,0,861408,2365632,29.393876913398138,540,2185,1861,864,54225,616050,659858,2414,3602,3062,3735,4923,31.575306807693888,18.489011100068954,1188,1,208224,36288,997,0,1874,1741
7097,0,0,1,0,53,1,201,0,0,1108206,2572416,30.93541659651604,837,2235,2115,957,52920,580608,658560,2568,3645,2808,3846,4923,34.02939905434711,11.40175425099138,1077,1,234465,11520,1158,0,1731,1530
7098,0,0,0,0,55,1,244,0,0,2625741,4196376,38.768543949960254,1473,3280,3250,1503,52538,608656,672872,2762,4295,2822,4539,6072,41.79712908801273,5.572104574801163,1533,0,362223,3090,1747,0,1289,1045
7099,0,0,0,0,54,1,363,1,0,1993410,4407330,40.06245124802026,1455,2997,2847,1605,46652,587644,598628,2596,4351,2896,3988,5743,35.24202037341219,12.270382205646603,1755,1,349890,19650,1242,0,1141,1504
7100,0,0,0,0,55,1,535,1,0,1915134,4631874,40.95119045888654,1476,3020,2819,1677,39424,618688,486112,2561,4439,2963,3904,5782,33.793490497431605,14.359544150663627,1878,1,295152,37587,1142,0,1085,1620
7101,0,0,0,0,55,1,563,1,0,1907448,4680688,41.12177038990418,1475,3035,2819,1691,39424,620032,487168,2552,4459,2984,3896,5803,33.58571124749333,14.905405235416481,1907,1,297616,40392,1128,0,1077,1640
7102,0,0,0,0,53,1,896,1,0,1878660,5027400,43.474130238568314,1823,2951,2884,1890,42025,545300,545300,2593,4550,2727,3654,5611,31.52776554086889,8.239962426314323,1957,1,387450,8911,994,0,770,1666
7103,0,0,0,0,55,1,430,0,1,2044691,4589343,40.755367744629666,1266,3287,2892,1661,56350,676935,635490,2368,4424,3158,3994,6050,35.08560958569767,20.82464333235138,2056,1,382030,55695,1231,0,1102,1532
7104,0,0,0,0,55,1,490,0,1,1819616,4444000,40.19950248448356,1226,3132,2742,1616,56168,654500,649000,2360,4366,3140,3876,5882,33.555923471125034,20.58782326871544,2006,1,381376,51090,1126,0,1134,1624
7105,0,0,0,0,52,1,404,0,1,1055405,3268633,35.34119409414458,1249,2094,2094,1249,55842,643782,594059,2617,3866,2617,3462,4711,29.068883707497267,0.0,1249,1,283523,0,845,0,1368,1772
7106,0,0,0,0,53,1,328,0,1,825033,2014386,27.54995462791182,329,2276,1846,759,50576,615728,578572,2224,3413,3084,3741,4930,32.96968304366907,21.167908492276098,1189,1,165462,64930,1087,0,1895,1567
7107,0,0,0,0,49,1,1217,1,0,52878,103446,6.48074069840786,42,1301,1301,42,52851,583731,549249,2463,2505,2463,3722,3764,35.482389998420345,0.0,42,1,9366,0,1259,0,2421,1204
7108,0,1,1,0,61,0,496,0,0,995280,2412540,27.92848008753788,695,2141,2056,780,45472,606228,717576,3008,3873,3178,4369,5234,35.7211421989835,9.222414255489701,865,1,180960,7565,1276,0,2313,1817
7109,0,0,0,0,55,1,221,0,0,2695460,4291860,39.179076048319466,1505,3321,3291,1535,55647,640284,679428,2766,4331,2826,4552,6117,41.90465367951393,5.490867587491313,1565,0,373005,3330,1756,0,1261,1040
7110,0,0,0,0,55,1,385,1,0,2006414,4471854,40.27406113120453,1447,3034,2859,1622,45156,587241,584484,2582,4379,2932,3994,5791,35.17101079013795,13.276125050940067,1797,1,343864,23800,1237,0,1135,1520
7111,0,0,0,0,55,1,449,0,1,2065170,4620608,40.97560249709576,1318,3270,2909,1679,56619,668736,641216,2391,4431,3113,3982,6022,35.07135583350036,19.95437536675912,2040,1,391207,49096,1230,0,1073,1522
7112,0,0,0,0,53,1,554,0,1,1436171,4007113,38.82009788756334,1210,2757,2460,1507,55860,606252,651455,2362,4166,2956,3612,5416,30.870698080866262,17.23446937986728,1804,1,369215,31185,953,0,1152,1706
7113,0,0,0,0,52,1,391,0,1,1107750,3305526,35.58089374931439,1266,2141,2141,1266,55800,647528,587475,2611,3877,2611,3486,4752,29.58039891549808,0.0,1266,1,284850,0,875,0,1345,1736
7114,0,0,0,0,51,1,1102,1,0,706424,1163148,21.307275752662516,330,2134,2010,454,42975,489342,576450,2438,3016,2686,4118,4696,39.44616584663204,11.33917216041645,578,1,102150,11284,1556,0,2108,1006
7115,0,0,0,0,51,1,1078,1,0,705483,1171827,21.42428528562855,339,2116,1996,459,42240,490176,561660,2433,3012,2673,4090,4669,39.20459156782532,11.07142749248319,579,1,100980,11760,1537,0,2094,1016
7116,0,0,0,0,50,1,1072,1,0,677028,1135516,21.118712081942874,326,2084,1964,446,41664,488832,552482,2426,2992,2666,4064,4630,38.961519477556315,11.015556749295067,566,1,96782,12120,1518,0,2100,1028
7117,0,1,0,1,68,0,894,0,0,7951216,11266424,57.463031594234565,3217,5795,5710,3302,39990,634632,733580,3327,6714,3497,5820,9207,49.07137658554119,9.219544457292887,3387,1,709930,8245,2408,0,110,1004
7118,0,1,1,0,60,0,506,0,0,593712,1682370,23.62202362203543,318,1862,1622,558,50218,636165,717570,2775,3573,3255,4079,4877,32.61901286060018,15.513673112502369,798,1,132804,24000,1064,0,2457,1951
7119,0,0,1,0,59,1,273,0,0,3017674,4813182,40.07492981902776,916,4175,3485,1606,42240,659340,575424,2307,4603,3687,4876,7172,43.347433603386484,26.474087470200544,2296,1,308352,114540,1879,0,1391,1118
7120,0,0,0,0,55,1,198,0,0,2765755,4379765,39.585350825778974,1537,3362,3332,1567,56643,662415,668005,2765,4362,2825,4560,6157,42.01190307520001,5.501408174353464,1597,0,374513,3750,1765,0,1228,1030
7121,0,0,0,0,55,1,640,1,0,1888521,4827759,41.60528812542944,1475,3078,2822,1731,35948,582901,479708,2533,4520,3045,3880,5867,33.03028912982749,16.267217723015353,1987,1,297732,44544,1091,0,1058,1698
7122,0,0,0,0,54,1,442,0,1,2660475,5042767,43.2087954009366,1639,3520,3292,1867,51045,672549,553705,2473,4568,2929,4126,6221,37.749172176353746,15.668098394597301,2095,1,382735,36480,1425,0,834,1276
7123,0,0,0,0,53,1,580,0,1,1668876,4327134,40.17461885320133,1314,2948,2648,1614,53928,573734,675612,2381,4295,2981,3715,5629,32.155870381627054,17.800727576036362,1914,1,406728,23100,1034,0,1067,1647
7124,0,0,0,0,52,1,475,0,1,1308986,3693562,37.49666651850535,1256,2487,2337,1406,53984,633107,588448,2477,4033,2777,3558,5114,30.512292604784715,12.24962545775264,1556,1,314944,19650,931,0,1221,1696
7125,0,0,0,0,53,1,318,0,1,925344,2168112,28.5657137141714,445,2321,1950,816,56350,650965,611110,2286,3473,3028,3791,4978,33.67491648096547,19.81886662607228,1187,1,187680,53424,1134,0,1841,1523
7126,0,0,0,0,49,1,1106,1,0,114095,234365,9.746794344808963,53,1338,1296,95,48837,550141,540273,2425,2562,2509,3668,3805,34.655446902326915,6.503581472166948,137,1,20805,5880,1201,0,2372,1266
7127,0,1,0,1,68,0,988,0,0,7640828,11243310,57.463031594234565,3152,5766,5616,3302,44154,674190,759315,3255,6707,3555,5719,9171,48.104053883222775,12.261034368426225,3452,1,736346,15450,2314,0,103,1091
7128,0,1,0,1,67,0,1106,0,0,7417032,11295480,57.723478758647246,3116,5774,5558,3332,49042,766140,735630,3174,6722,3606,5616,9164,47.18050444834179,14.710229436817905,3548,1,723044,31536,2226,0,58,1164
7129,0,1,1,0,59,0,478,0,0,471408,1451312,22.090722034374522,211,1731,1454,488,51000,606696,743500,2697,3462,3251,3940,4705,31.080540535840107,16.702059104098428,765,1,122000,19667,966,0,2486,2008
7130,0,0,1,0,61,1,285,0,0,4510206,6073188,44.56455991031439,1596,4647,4257,1986,40633,694166,547382,2668,5044,3448,5329,7705,47.65501022977542,19.87202694854532,2376,1,355494,72930,2271,0,1072,787
7131,0,0,0,1,65,1,1063,0,0,4117014,8578427,51.273774973177076,2439,4385,4195,2629,52864,730912,770068,3073,5892,3453,4829,7648,39.57271787481876,13.838706257176828,2819,1,620444,22420,1566,0,634,1697
7132,0,0,0,0,56,1,282,0,1,3095344,4605664,40.29888335921977,1582,3572,3530,1624,54289,660788,660788,2794,4460,2878,4742,6408,43.657759905886145,6.5252844928085345,1666,1,378392,5586,1906,0,1212,930
7133,0,0,0,0,55,1,152,0,0,2793153,4463615,39.96248240537617,1597,3346,3346,1597,49946,631670,617695,2795,4392,2795,4544,6141,41.82104733265297,0.0,1597,0,352937,0,1749,0,1198,1046
7134,0,0,0,0,55,1,129,0,0,2749780,4451645,39.93745109543172,1595,3319,3319,1595,49713,611229,633557,2791,4386,2791,4515,6110,41.52107898405339,0.0,1595,0,362065,0,1724,0,1196,1067
7135,0,0,0,0,55,1,861,1,0,1807002,5135496,42.91852746774987,1480,3185,2823,1842,48720,585480,646816,2426,4630,3150,3769,5973,31.32091952673165,19.232573309194525,2204,1,427344,38734,981,0,946,1807
7136,0,0,0,0,54,1,531,0,1,1955862,4592391,41.09744517606904,1383,3153,2847,1689,55932,641684,644403,2413,4408,3025,3877,5872,34.02939905434711,18.288145755355213,1995,1,400293,34884,1158,0,1030,1561
7137,0,0,0,0,52,1,182,0,1,1058808,2935888,33.52610922848042,884,2306,2066,1124,49644,658224,514564,2372,3736,2852,3554,4918,30.692018506445613,15.540719891657039,1364,1,221428,42480,942,0,1488,1670
7138,0,0,0,0,50,1,958,1,0,525720,989820,19.748417658131498,189,1939,1738,390,52664,576126,588816,2337,2928,2739,3886,4477,36.71511950137164,14.212409159636923,591,1,90480,25929,1348,0,2148,1190
7139,0,1,0,1,68,0,698,0,0,8063520,11071290,56.65686189686118,3210,5722,5722,3210,54056,800168,803617,3449,6659,3449,5961,9171,50.11985634456667,0.0,3210,1,747930,0,2512,0,239,937
7140,0,1,0,1,68,0,2687,0,0,2073938,11353651,57.55866572463264,2929,4323,3939,3313,38097,853323,524331,3043,6740,3811,4053,7750,25.019992006393608,20.51246486755388,3697,1,506889,84096,626,0,114,2801
7141,0,1,0,1,71,0,1252,0,0,2975349,8753777,49.60846701924985,1557,4574,3670,2461,52371,736299,899921,2653,6018,4461,4766,8131,34.77067730142742,30.725134624546005,3365,1,622633,56952,1209,0,1096,2348
7142,0,0,1,0,62,1,1276,0,0,3517317,4215677,36.64696440361739,833,4472,3962,1343,47073,668607,693719,2629,4482,3649,5758,7611,51.176166327695945,22.655847894887916,1853,1,296803,63240,2619,0,1796,520
7143,0,0,0,0,57,1,373,0,1,3554348,4898544,41.32795663954365,1648,3849,3789,1708,56404,676848,685452,2808,4576,2928,4949,6717,45.617978911828175,7.745966692414834,1768,1,408212,7500,2081,0,1160,787
7144,0,0,0,0,55,1,568,1,0,1972833,4752656,41.43669871020132,1449,3134,2866,1717,41748,589584,542528,2500,4485,3036,3917,5902,33.896902513356586,16.418418423627404,1985,1,336532,41272,1149,0,1051,1619
7145,0,0,0,0,55,1,599,1,0,1950912,4786560,41.569219381653056,1458,3127,2857,1728,39676,603860,504140,2500,4498,3040,3899,5897,33.60059523282288,16.49270114387531,1998,1,314496,47250,1129,0,1042,1641
7146,0,0,0,0,55,1,687,1,0,1891314,4911429,41.96427051671457,1476,3120,2835,1761,34440,585690,457396,2504,4550,3074,3863,5909,32.77193921634788,17.042583472079173,2046,1,288804,51870,1074,0,1028,1715
7147,0,0,0,0,56,1,831,1,0,1814050,5119125,42.720018726587654,1475,3169,2819,1825,42924,614295,549780,2455,4630,3155,3799,5974,31.52776554086889,18.990808319733226,2175,1,357700,56700,994,0,980,1811
7148,0,0,0,0,52,1,499,0,1,1536710,3953054,38.91015291668744,1298,2745,2529,1514,55328,584864,644917,2395,4125,2827,3626,5356,31.85906464414798,14.889980667658543,1730,1,373958,21384,1015,0,1097,1596
7149,0,0,0,0,51,1,433,0,1,1391928,3657528,37.62977544445356,1308,2507,2399,1416,55671,622503,596673,2475,3999,2691,3566,5090,31.352830813181765,10.480278705357403,1524,1,327096,13716,983,0,1167,1600
7150,0,1,0,1,68,0,750,0,0,7828704,11023506,56.55086206239477,3168,5676,5646,3198,52377,816939,761787,3417,6645,3477,5895,9123,49.47726750741192,5.478746393072713,3228,1,706758,4560,2448,0,249,999
7151,0,1,0,1,68,0,789,0,0,7754526,11054529,56.630380539071076,3165,5667,5625,3207,49056,772128,754893,3405,6654,3489,5865,9114,49.17316341257699,6.484411467763075,3249,1,702333,5880,2418,0,240,1029
7152,0,1,0,1,66,0,271,0,0,3255930,5537592,40.91454509095757,1566,3727,3619,1674,49059,684756,783996,3200,4982,3416,5253,7035,44.10215414239989,10.508183387917892,1782,1,396738,10368,1945,0,1634,1363
7153,0,1,0,1,64,0,334,0,0,2294687,4383110,36.837480912787726,1267,3138,3048,1357,54858,720290,794580,3140,4587,3320,4921,6368,41.12177038990418,9.494144610579708,1447,1,333822,9000,1691,0,1873,1539
7154,0,0,1,0,62,1,729,0,0,5177860,6043100,44.04543109109048,1873,4676,4609,1940,44421,688415,626115,3048,5055,3182,5784,7791,51.66236541235796,8.19672545160342,2007,1,389940,10586,2669,0,1175,446
7155,0,0,1,0,63,1,984,0,0,4067712,5049792,39.7994974842648,951,4785,4152,1584,50794,694984,742804,2555,4772,3821,5756,7973,50.67543783727971,25.357582660945912,2217,1,369072,72795,2568,0,1604,620
7156,0,0,0,1,64,1,1057,0,0,4536518,8830689,52.182372502598994,2656,4456,4389,2723,51465,710217,762105,3176,5966,3310,4909,7699,40.8166632639171,8.19263674150144,2790,1,639905,7638,1666,0,520,1577
7157,0,0,0,0,56,1,109,0,0,2946836,4669704,40.779897008207364,1633,3465,3435,1663,48375,603720,631800,2778,4471,2838,4580,6273,42.09513035969837,5.501408174353464,1693,0,374175,3690,1772,0,1145,1036
7158,0,0,0,0,56,1,797,1,0,1839180,5086284,42.567593307585526,1477,3162,2827,1812,39432,595084,522102,2472,4619,3142,3822,5969,31.85906464414798,18.510806767066157,2147,1,337032,54605,1015,0,995,1792
7159,0,0,0,0,51,1,326,0,1,1307456,3384624,36.30426972134269,1288,2340,2310,1318,49530,652272,500760,2538,3886,2598,3560,4908,31.496031496047245,5.501408174353464,1348,1,257010,5730,992,0,1250,1576
7160,0,0,0,0,52,1,91,0,1,1131090,2895990,33.31666249791537,810,2429,2129,1110,50292,662686,516582,2309,3719,2909,3628,5038,31.921779399024736,17.50256211949314,1410,1,219780,56400,1019,0,1499,1590
7161,0,0,0,0,52,1,279,0,1,1084090,2398663,30.18277654557314,634,2378,2101,911,51865,666149,539765,2356,3544,2910,3823,5011,34.49637662132068,17.211421103174878,1188,1,186755,50137,1190,0,1722,1443
7162,0,0,0,0,52,1,490,0,1,1091304,2169360,28.77498913987632,515,2459,2146,828,54216,657620,565920,2307,3448,2933,3938,5079,36.30426972134269,18.0621346656467,1141,1,178848,52271,1318,0,1792,1302
7163,0,0,0,0,51,1,936,0,1,858420,1476300,23.874672772626646,314,2332,2076,570,48464,538720,603470,2334,3160,2846,4096,4922,38.80721582386451,16.22962831460606,826,1,132810,26368,1506,0,2020,1084
7164,0,0,0,0,51,1,915,0,1,848506,1474322,23.895606290697042,324,2304,2057,571,48488,539638,599024,2335,3153,2829,4068,4886,38.54867053479276,15.900752736754654,818,1,132472,26182,1486,0,2011,1096
7165,0,0,0,0,50,1,897,1,0,395604,811296,18.0,134,1735,1545,324,50268,533352,590944,2314,2828,2694,3725,4239,34.942810419312295,13.814873398238463,514,1,76464,20140,1221,0,2180,1283
7166,0,1,0,1,68,0,883,0,0,7453068,11022459,56.630380539071076,3087,5651,5531,3207,45936,680526,797384,3317,6644,3557,5761,9088,48.2078831727758,10.963758173094375,3327,1,744024,10920,2324,0,230,1113
7167,0,0,1,0,62,1,1289,0,0,3272940,4013020,35.7211421989835,760,4357,3841,1276,48816,679320,710770,2629,4421,3661,5710,7502,50.6458290484024,22.802496444587305,1792,1,288376,62952,2565,0,1869,580
7168,0,0,0,1,65,1,1065,0,0,4484116,8862308,52.11525688318153,2608,4475,4367,2716,52392,724386,770068,3155,5979,3371,4914,7738,40.63249930782009,10.39586690415236,2824,1,640976,12528,1651,0,547,1612
7169,0,0,1,0,60,1,737,0,0,7054650,7017642,48.093658625644196,2123,5553,5363,2313,51788,649276,734228,2844,5347,3224,6084,8587,55.226805085936306,13.863636472175683,2503,1,559746,18620,3050,0,721,16
7170,0,0,0,0,56,1,6,0,0,2825752,4732040,41.036569057366385,1599,3447,3362,1684,44730,590100,598530,2725,4494,2895,4488,6257,40.963398296528084,9.251281740554573,1769,0,358692,11135,1678,0,1126,1132
7171,0,0,0,0,55,1,670,1,0,1958496,4937042,42.118879377305376,1451,3201,2878,1774,42612,589996,559383,2460,4557,3106,3887,5984,33.2264954516723,18.040713851564195,2097,1,356574,47804,1104,0,1009,1679
7172,0,0,0,0,52,1,943,0,1,940850,1584877,24.63736998950984,283,2481,2157,607,51600,561365,626640,2287,3218,2935,4161,5092,39.370039370059054,18.28830924308128,931,1,145680,33048,1550,0,2004,1061
7173,0,0,0,0,51,1,827,0,1,732468,1373646,23.173260452512935,267,2171,1901,537,47488,542296,572992,2288,3095,2828,3922,4729,36.932370625238775,16.482158661538314,807,1,120288,32400,1364,0,2021,1194
7174,0,1,0,1,67,0,2867,0,0,1776884,11454798,58.23229344616267,3114,4192,3915,3391,49000,844500,662088,3101,6769,3655,3902,7570,22.891046284519195,17.40921730865171,3668,1,664636,52907,524,0,13,2854
7175,0,1,1,0,63,0,292,0,0,1969605,4036615,35.566838487557476,1265,2822,2822,1265,53118,724357,746694,3191,4456,3191,4748,6013,39.45883931389772,0.0,1265,1,296010,0,1557,0,1926,1634
7176,0,1,1,0,59,0,365,0,0,416264,1449360,22.090722034374522,220,1609,1341,488,48348,605880,703890,2702,3458,3238,3823,4579,29.206163733020468,16.470309108515075,756,1,115656,24656,853,0,2482,2117
7177,0,0,1,0,62,1,1406,0,0,3013920,3664440,34.20526275297414,762,4154,3746,1170,42510,682776,610740,2724,4302,3540,5708,7286,50.75431016179808,20.27745410950857,1578,1,228150,65688,2576,0,1962,556
7178,0,0,0,1,66,1,1040,0,0,4240976,8838892,51.419840528729765,2388,4504,4248,2644,50400,702030,802320,3087,5987,3599,4947,7847,40.049968789001575,16.032190321965594,2900,1,634560,24576,1604,0,699,1739
7179,0,0,0,0,56,1,110,0,0,3226184,4929860,41.737273509418415,1682,3654,3594,1742,50394,642410,628260,2770,4572,2890,4682,6484,43.034869582700026,7.754559014766193,1802,0,386724,8400,1852,0,1088,978
7180,0,0,1,0,56,1,74,0,0,2804256,4815856,41.376321731154405,1588,3474,3350,1712,45144,587917,607608,2689,4525,2937,4451,6287,40.47221268969612,11.166001493285611,1836,1,369792,15624,1638,0,1101,1175
7181,0,0,0,0,56,1,841,1,0,1849532,5200080,42.941821107167776,1473,3218,2847,1844,36335,606300,476580,2449,4664,3191,3823,6038,31.670175244226233,19.497974616616236,2215,1,311636,68264,1003,0,976,1817
7182,0,0,0,0,56,1,930,1,0,1783171,5306296,43.347433603386484,1477,3230,2828,1879,43632,609984,570448,2422,4703,3226,3773,6054,30.805843601498726,20.30199697036189,2281,1,379558,60702,949,0,945,1875
7183,0,0,0,0,56,1,1046,1,0,1711752,5452104,43.95452195167182,1556,3194,2818,1932,48178,615196,623662,2446,4754,3198,3708,6016,29.765752132274432,19.497367510936833,2308,1,426972,49256,886,0,890,1936
7184,0,0,0,0,53,1,466,0,1,2622207,4995837,43.23193264243457,1668,3473,3272,1869,54978,636174,617463,2472,4542,2874,4076,6146,37.456641600656084,14.826417496929436,2070,1,431739,24321,1403,0,804,1270
7185,0,0,0,0,53,1,497,0,1,2477490,4908930,42.91852746774987,1662,3367,3187,1842,53680,650260,586300,2485,4507,2845,4010,6032,36.6742416417845,14.04939179449245,2022,1,405240,25020,1345,0,823,1320
7186,0,0,0,0,52,1,480,0,1,1764900,4153080,39.87480407475377,1440,2850,2700,1590,53724,579864,632104,2462,4202,2762,3722,5462,33.31666249791537,12.393026621210916,1740,1,384780,16050,1110,0,1022,1502
7187,0,0,0,0,52,1,450,0,1,1683864,4012284,39.26830783214372,1415,2761,2634,1542,52102,567236,621878,2475,4144,2729,3694,5363,33.04542328371661,11.552234068076439,1669,1,368538,13589,1092,0,1060,1510
7188,0,0,0,0,51,1,418,0,1,1610115,3852615,38.66522985836241,1400,2667,2572,1495,47616,494784,639096,2482,4072,2672,3654,5244,32.817678162843876,9.815189597405173,1590,1,370760,5510,1077,0,1082,1500
7189,0,0,0,0,51,1,326,0,0,1454520,3530040,37.14835124201342,1380,2434,2434,1380,54880,626710,572992,2558,3938,2558,3612,4992,32.46536616149585,0.0,1380,0,309120,0,1054,0,1178,1504
7190,0,0,0,0,52,1,454,0,1,1198395,2321946,29.8496231131986,644,2483,2236,891,56635,612410,628046,2359,3497,2853,3951,5089,36.6742416417845,16.094196624473884,1138,1,214731,29393,1345,0,1715,1261
7191,0,0,0,0,51,1,797,0,1,886704,1611168,24.979991993593593,323,2346,2045,624,49648,552548,599024,2281,3206,2883,4003,4928,37.69615364994153,17.487295209306694,925,1,144768,33411,1421,0,1958,1161
7192,0,0,0,0,50,1,765,0,1,604516,1228876,22.0,171,2046,1733,484,48822,523034,601743,2226,3023,2852,3788,4585,35.34119409414458,17.69726620382514,797,1,114708,29422,1249,0,2055,1290
7193,0,0,0,0,49,1,832,1,0,315545,705802,16.822603841260722,43,1638,1398,283,46420,548680,526234,2254,2777,2734,3609,4132,33.391615714128,15.548174625721817,523,1,59713,34800,1115,0,2211,1379
7194,0,1,0,1,64,0,268,0,0,2295485,4456431,37.242448899072144,1387,3042,3042,1387,51170,690795,764694,3213,4600,3213,4868,6255,40.681691213615984,0.0,1387,1,330106,0,1655,0,1826,1558
7195,0,0,1,0,59,1,67,0,0,2437160,4507600,39.08964057138413,1078,3573,3123,1528,20995,651950,280250,2500,4478,3400,4545,6523,39.93745109543172,23.449287309556297,1978,1,145160,111600,1595,0,1422,1355
7196,0,0,0,1,65,1,1071,0,0,4559842,9021152,52.316345438113316,2587,4553,4403,2737,52360,725120,784448,3146,6033,3446,4962,7849,40.8166632639171,12.263881625621906,2887,1,651406,16650,1666,0,559,1630
7197,0,0,0,1,65,1,1062,0,0,4821120,9081450,52.820450584977024,2760,4548,4518,2790,50380,716100,745395,3225,6045,3285,4983,7803,41.569219381653056,5.490867587491313,2820,1,638910,3690,1728,0,465,1527
7198,0,0,0,0,56,1,301,1,0,2510222,4912440,41.737273509418415,1474,3451,3183,1742,39639,617580,510420,2552,4562,3088,4261,6271,37.960505792204614,16.412088255480956,2010,1,315302,47168,1441,0,1078,1379
7199,0,0,0,0,56,1,740,1,0,1971404,5103422,42.68489194082609,1451,3275,2904,1822,43054,585409,577006,2430,4623,3172,3883,6076,32.89376840679705,19.35527010001121,2193,1,375332,51198,1082,0,979,1719
7200,0,0,0,0,56,1,983,1,0,1762068,5394903,43.669211121796096,1477,3261,2831,1907,45570,613893,594090,2399,4736,3259,3753,6090,30.397368307141328,20.979859826100537,2337,1,400470,61920,924,0,922,1905
7201,0,0,0,0,56,1,1012,1,0,1740533,5426932,43.80639222761902,1476,3269,2826,1919,47064,627816,599536,2385,4747,3271,3735,6097,30.116440692751194,21.285481865558804,2362,1,406828,65121,907,0,909,1921
7202,0,0,0,0,56,1,1099,1,0,1684740,5530257,44.26059195266146,1597,3181,2819,1959,51528,637998,643644,2461,4782,3185,3683,6004,29.32575659723036,19.143147424739666,2321,1,446652,47784,860,0,864,1963
7203,0,0,0,0,52,1,549,0,1,2119492,4644620,41.90465367951393,1632,3087,2963,1756,56394,637445,618930,2521,4401,2769,3852,5732,34.741905532080416,11.852030944155647,1880,1,410904,15996,1207,0,889,1438
7204,0,0,0,0,51,1,336,0,0,1546801,3635765,37.72267222772003,1393,2540,2510,1423,55161,620865,579985,2525,3978,2585,3642,5095,32.96968304366907,5.490867587491313,1453,0,323021,4470,1087,0,1132,1468
7205,0,0,0,0,52,1,456,0,1,1247616,2371200,30.199337741083,694,2498,2280,912,56120,598000,634400,2382,3512,2818,3968,5098,36.98648401781386,15.13151939123824,1130,1,222528,23762,1368,0,1688,1232
7206,0,0,0,0,51,1,751,0,1,908600,1677016,25.475478405713993,318,2380,2049,649,49680,558144,594320,2253,3233,2915,3984,4964,37.416573867739416,18.322219800999537,980,1,149270,39058,1400,0,1935,1184
7207,0,0,0,0,50,1,740,0,1,535500,1138050,21.213203435596427,141,1949,1640,450,47424,526032,576612,2220,2979,2838,3719,4478,34.49637662132068,17.662886607115617,759,1,102600,33990,1190,0,2079,1339
7208,0,0,0,0,50,1,778,1,0,335883,772500,17.578395831246947,41,1664,1396,309,45795,532500,537500,2232,2809,2768,3587,4164,32.96968304366907,16.45237440656764,577,1,66435,35644,1087,0,2191,1413
7209,0,1,0,1,64,0,246,0,0,2651560,4904480,38.8587184554509,1480,3296,3266,1510,47718,643104,782768,3218,4758,3278,5004,6544,41.90465367951393,5.572104574801163,1540,1,363910,2370,1756,0,1738,1492
7210,0,0,1,0,63,1,997,0,0,3517038,4595654,37.97367509209505,700,4623,3881,1442,43780,701140,634213,2445,4629,3929,5626,7810,49.38623289946298,27.341531818670866,2184,1,286958,117978,2439,0,1745,748
7211,0,0,0,1,65,1,1070,0,0,4722419,9134262,52.65928218272634,2665,4584,4476,2773,48805,708210,747738,3186,6067,3402,4997,7878,41.2674205639267,10.410300245868545,2881,1,629471,12852,1703,0,521,1591
7212,0,0,0,1,65,1,1064,0,0,4906260,9171840,53.009433122794285,2780,4586,4556,2810,47488,691968,731136,3234,6074,3294,5010,7850,41.78516483155236,5.514871952411144,2840,1,629440,3600,1746,0,454,1518
7213,0,0,0,1,65,1,1063,0,0,4950164,9187121,53.094255809833136,2819,4575,4575,2819,48364,697426,736534,3259,6078,3259,5015,7834,41.90465367951393,0.0,2819,1,637094,0,1756,0,440,1503
7214,0,0,0,1,64,1,1058,0,0,5088648,9232424,53.34791467339656,2816,4664,4634,2846,47686,684484,733144,3214,6090,3274,5032,7908,42.28474902373195,5.478746393072713,2876,1,643196,3480,1788,0,398,1456
7215,0,0,0,0,56,1,851,1,0,1902642,5253759,43.23193264243457,1451,3305,2887,1869,35571,598743,469437,2393,4680,3229,3829,6116,31.906112267087632,20.563830838744945,2287,1,312123,76912,1018,0,942,1793
7216,0,0,0,0,56,1,1094,1,0,1694535,5543970,44.26059195266146,1551,3232,2824,1959,49504,633920,625430,2422,4789,3238,3695,6062,29.410882339705484,20.322133351902053,2367,1,432939,56304,865,0,871,1965
7217,0,0,0,0,56,1,1152,1,0,1656324,5608464,44.56455991031439,1635,3171,2820,1986,51980,638224,649520,2473,4810,3175,3658,5995,28.879058156387302,18.8615945877711,2337,1,456780,44928,834,0,838,1990
7218,0,0,0,0,52,1,1212,1,0,1955340,5614680,46.151923036857305,2063,3115,3048,2130,39964,511384,543016,2569,4766,2703,3554,5751,30.298514815086232,8.329212945039274,2197,1,438780,7973,918,0,506,1718
7219,0,0,0,0,52,1,799,0,1,2637656,5420352,45.51922670696417,2042,3375,3345,2072,53383,661848,551976,2586,4688,2646,3889,5991,35.679125549822544,5.572104574801163,2102,1,437192,5130,1273,0,544,1343
7220,0,0,0,0,52,1,500,0,1,2034204,4440270,41.20679555607303,1608,2986,2896,1698,56144,606680,632830,2525,4313,2705,3813,5601,34.61213659975356,9.845454104733873,1788,1,410916,9450,1198,0,917,1417
7221,0,0,0,0,51,1,414,0,1,1776952,4039376,39.44616584663204,1489,2765,2698,1556,53750,558140,649000,2529,4152,2663,3738,5361,33.793490497431605,8.694308756644029,1623,1,389000,5628,1142,0,1040,1454
7222,0,0,0,0,51,1,307,0,0,1582994,3624971,37.69615364994153,1421,2535,2535,1421,50370,586730,558669,2551,3972,2551,3665,5086,33.37663853655727,0.0,1421,0,311199,0,1114,0,1130,1437
7223,0,0,0,0,51,1,147,0,1,1313650,2752000,32.78719262151,900,2472,2297,1075,53383,647680,540160,2385,3635,2735,3782,5032,34.95711658589707,13.337978041188823,1250,1,226825,29925,1222,0,1485,1338
7224,0,0,0,0,51,1,534,0,1,1278955,2317155,29.916550603303182,679,2540,2324,895,49784,657606,507444,2373,3484,2805,4018,5129,37.8021163428716,14.963720443328649,1111,1,175420,40608,1429,0,1694,1160
7225,0,0,0,0,51,1,678,0,1,800928,1590732,24.859605789312106,258,2274,1914,618,48180,563706,566280,2214,3192,2934,3870,4848,36.0,19.050642768760532,978,1,135960,48240,1296,0,1956,1278
7226,0,0,0,0,50,1,702,0,1,512008,1127042,21.118712081942874,123,1917,1594,446,47632,525616,578683,2204,2973,2850,3675,4444,33.88214869219483,18.044161630226263,769,1,102134,35207,1148,0,2081,1379
7227,0,0,0,0,50,1,725,0,1,355100,839510,18.303005217723125,58,1672,1395,335,47264,528766,561344,2229,2841,2783,3566,4178,32.55764119219941,16.89569571515248,612,1,75040,32686,1060,0,2171,1446
7228,0,1,1,0,59,0,336,0,0,283140,1151280,19.748417658131498,237,1269,1116,390,53325,664200,699624,2799,3342,3105,3678,4221,26.94438717061496,12.444714299239003,543,1,92430,18054,726,0,2562,2226
7229,0,0,0,1,67,1,1155,0,0,1404936,6444504,43.54308211415448,1520,3013,2637,1896,48822,805563,700194,3023,5295,3775,4140,6412,27.2213151776324,19.42150637380626,2272,1,390576,63920,741,0,1503,2658
7230,0,0,0,1,67,1,981,0,0,4453132,8972689,51.54609587543949,2402,4588,4333,2657,52628,753071,796972,3122,6034,3632,5053,7965,40.93897898091744,16.01663663177248,2912,1,627052,30090,1676,0,720,1701
7231,0,0,0,1,67,1,999,0,0,4518172,9044393,51.79768334587948,2467,4583,4367,2683,52425,758475,785443,3155,6054,3587,5055,7954,41.036569057366385,14.734906844635344,2899,1,625139,26784,1684,0,688,1687
7232,0,0,0,1,65,1,1070,0,0,4884851,9250037,53.0,2742,4615,4548,2809,47216,684944,747511,3226,6102,3360,5032,7908,41.701318923986086,8.2143728690235,2876,1,637643,7437,1739,0,484,1554
7233,0,0,0,0,56,1,900,1,0,1891309,5349540,43.55456348076513,1451,3340,2894,1897,35145,600660,465300,2374,4717,3266,3817,6160,31.575306807693888,21.251258487832157,2343,1,313005,82956,997,0,923,1823
7234,0,0,0,0,52,1,493,0,1,2824140,5105625,44.10215414239989,1837,3505,3397,1945,55225,616875,616875,2517,4570,2733,4077,6130,38.1051177665153,10.748049169056976,2053,1,457075,12096,1452,0,680,1173
7235,0,0,0,0,51,1,371,0,0,1773270,3918330,39.11521443121589,1530,2689,2689,1530,50218,540371,609518,2561,4091,2561,3720,5250,34.044089061098404,0.0,1530,0,364140,0,1159,0,1031,1402
7236,0,0,0,0,51,1,308,0,1,1401920,2692560,32.2490309931942,890,2538,2388,1040,51792,644661,538512,2439,3629,2739,3937,5127,36.71511950137164,12.72513248597547,1190,1,216320,24000,1348,0,1549,1241
7237,0,0,0,0,52,1,765,0,1,1091350,1905300,27.018512172212592,287,2668,2225,730,55926,623790,610740,2167,3340,3053,4105,5278,38.66522985836241,21.225580063097667,1173,1,170820,60248,1495,0,1880,1115
7238,0,0,0,0,52,1,704,0,1,1027425,1874600,26.851443164195103,313,2554,2146,721,54288,608400,603200,2192,3321,3008,4025,5154,37.749172176353746,20.354464769164768,1129,1,167272,55080,1425,0,1879,1175
7239,0,0,0,0,51,1,629,0,1,819812,1659588,25.37715508089904,254,2307,1917,644,49268,582402,561786,2187,3221,2967,3850,4884,35.679125549822544,19.82589599975852,1034,1,140392,56160,1273,0,1933,1304
7240,0,0,0,0,50,1,656,0,1,524441,1181977,21.61018278497431,116,1941,1590,467,47174,521386,579599,2180,2998,2882,3654,4472,33.51119216023208,18.811508672195195,818,1,106943,37206,1123,0,2064,1408
7241,0,0,0,0,50,1,661,0,1,493722,1126150,21.118712081942874,104,1895,1553,446,47499,537825,563075,2183,2971,2867,3632,4420,33.27160951922825,18.55307256596978,788,1,99458,41724,1107,0,2079,1418
7242,0,0,0,0,49,1,666,0,1,344736,852264,18.49324200890693,130,1562,1350,342,50960,518336,610540,2280,2834,2704,3500,4054,31.74901573277509,14.799265660112745,554,1,83790,18020,1008,0,2150,1484
7243,0,1,0,1,70,0,1440,0,0,2764944,8930364,50.3189825016365,1594,4562,3624,2532,53352,761832,871169,2589,6059,4465,4619,8089,33.04542328371661,31.124180507394588,3470,1,625404,86296,1092,0,995,2435
7244,0,1,0,1,64,0,203,0,0,2570540,4886735,38.79432948254165,1415,3303,3213,1505,48204,668882,759798,3157,4752,3337,4955,6550,41.32795663954365,9.601845894041878,1595,1,352170,8910,1708,0,1742,1539
7245,0,0,0,1,67,1,777,0,0,1390390,5504510,40.3732584763727,1429,2684,2483,1630,49440,810480,695662,3176,5007,3578,4230,6061,29.206163733020468,14.19224997275075,1831,1,335780,34572,853,0,1747,2524
7246,0,0,0,1,67,1,1012,0,0,1364493,6036147,42.17819341792628,1482,2843,2546,1779,47800,810927,678600,3096,5172,3690,4160,6236,27.694764848252458,17.2617530714587,2076,1,355800,52866,767,0,1614,2626
7247,0,0,0,1,68,1,1295,0,0,1353636,6748390,44.48595283907045,1509,3133,2663,1979,47235,801350,685410,2940,5389,3880,4094,6543,26.153393661244042,21.72061022665624,2449,1,397779,81780,684,0,1431,2726
7248,0,0,0,1,68,1,1310,0,0,1345199,6781631,44.57577817604534,1490,3161,2664,1987,46728,805468,675774,2916,5400,3910,4090,6574,26.019223662515376,22.33705183367547,2484,1,393426,88466,677,0,1426,2736
7249,0,0,0,1,68,1,1096,0,0,3873545,8837901,50.90186637049765,2145,4532,4086,2591,50167,774297,753831,2965,6002,3857,4906,7943,38.66522985836241,21.220009335968836,3037,1,572611,62886,1495,0,820,1916
7250,0,0,0,1,68,1,1089,0,0,3936826,8872820,51.0098029794274,2184,4533,4115,2602,50838,780890,757020,2992,6012,3828,4923,7943,38.897300677553446,20.55304134608687,3020,1,577644,59356,1513,0,808,1897
7251,0,0,0,1,68,1,1080,0,0,4005729,8902491,51.11751167652823,2223,4536,4146,2613,51980,769982,783610,3017,6020,3797,4940,7943,39.153543900903784,19.856717602331507,3003,1,600990,50310,1533,0,794,1874
7252,0,0,0,1,67,1,1029,0,0,4442020,9063868,51.807335387954474,2450,4573,4339,2684,51920,742940,796972,3143,6061,3611,5032,7950,40.681691213615984,15.351523043947623,2918,1,633424,26676,1655,0,693,1722
7253,0,0,0,1,66,1,1037,0,0,4773428,9223468,52.57375771237966,2630,4625,4491,2764,50820,700770,807554,3203,6101,3471,5064,7962,41.557189510360296,11.579864037853417,2898,1,668888,12328,1727,0,573,1610
7254,0,0,0,1,65,1,1070,0,0,5017584,9359724,53.27288240746881,2796,4648,4606,2838,46144,679388,738752,3256,6136,3340,5066,7946,42.04759208325728,6.481658975540136,2880,1,635712,4746,1768,0,460,1530
7255,0,0,0,1,65,1,1067,0,0,5127980,9380800,53.47896782848375,2860,4653,4653,2860,45320,675680,721600,3280,6140,3280,5073,7933,42.34383071948026,0.0,2860,1,629200,0,1793,0,420,1487
7256,0,0,0,0,52,1,469,0,1,3069066,5267262,44.74371464239419,1907,3630,3535,2002,56120,605130,641964,2536,4633,2726,4164,6261,39.153543900903784,9.924396939761625,2097,1,488488,9690,1533,0,629,1098
7257,0,0,0,0,52,1,508,0,1,2866428,5123396,44.339598554790726,1899,3491,3424,1966,55920,625440,607198,2539,4572,2673,4064,6097,38.18376618407357,8.397588990243326,2033,1,458078,8375,1458,0,640,1148
7258,0,0,0,0,51,1,361,0,0,1842950,3974200,39.370039370059054,1550,2739,2739,1550,50398,571772,579464,2564,4114,2564,3753,5303,34.48187929913333,0.0,1550,0,350300,0,1189,0,1014,1375
7259,0,0,0,0,51,1,150,0,1,1559376,3401190,36.41428291206625,1231,2597,2502,1326,49276,651510,497610,2470,3891,2660,3741,5162,34.292856398964496,9.874922862703322,1421,1,257244,18145,1176,0,1239,1389
7260,0,0,0,0,52,1,781,0,1,1342016,2173184,28.844410203711913,523,2754,2445,832,55596,590312,642552,2303,3444,2921,4225,5366,40.162171256046406,18.004670678319812,1141,1,204672,31827,1613,0,1780,999
7261,0,0,0,0,51,1,605,0,1,935676,1835802,26.664583251946766,291,2447,2027,711,55930,614516,606770,2162,3293,3002,3898,5029,36.27671429443411,20.578075705134662,1131,1,167085,55860,1316,0,1871,1266
7262,0,0,0,0,51,1,596,0,1,903212,1800142,26.419689627245813,278,2412,1992,698,55671,621539,595749,2159,3277,2999,3873,4991,35.9722114972099,20.56903249603931,1118,1,161238,59640,1294,0,1881,1285
7263,0,0,0,0,51,1,582,0,1,798919,1673122,25.475478405713993,229,2300,1880,649,49950,572316,580050,2158,3227,2998,3809,4878,35.08560958569767,20.566130400518517,1069,1,146025,54600,1231,0,1929,1347
7264,0,0,0,0,51,1,587,0,1,755664,1605552,24.979991993593593,204,2255,1835,624,49268,560914,581498,2153,3197,2993,3784,4828,34.79942528261063,20.552465428990793,1044,1,141024,52080,1211,0,1949,1362
7265,0,0,0,1,67,1,901,0,0,1340856,5725726,41.14608122288197,1435,2743,2485,1693,46728,798152,669636,3124,5075,3640,4174,6125,28.142494558940577,16.08411223554258,1951,1,335214,45666,792,0,1689,2590
7266,0,0,0,1,67,1,949,0,0,1333602,5835801,41.50903516103452,1446,2774,2497,1723,46410,806106,660465,3110,5110,3664,4161,6161,27.820855486487112,16.667179976285706,2000,1,335985,50414,774,0,1664,2613
7267,0,0,0,1,68,1,1157,0,0,3788268,8917562,51.07837115648854,2143,4527,4061,2609,50175,762214,769050,2952,6027,3884,4870,7945,38.1051177665153,21.704392930850666,3075,1,587025,61046,1452,0,809,1966
7268,0,0,0,1,67,1,1105,0,0,4199750,9086975,51.720402163943,2380,4540,4245,2675,52210,771119,781310,3102,6072,3692,4967,7937,39.6232255123179,17.288133919276305,2970,1,615250,38055,1570,0,722,1827
7269,0,0,0,1,67,1,1077,0,0,4429774,9157758,52.06726418777925,2495,4561,4345,2711,51684,739782,797208,3162,6089,3594,5012,7939,40.422765862815474,14.762725513818358,2927,1,639796,24192,1634,0,667,1744
7270,0,0,0,1,67,1,1069,0,0,4508220,9190776,52.191953402799555,2532,4571,4379,2724,52212,769272,772646,3182,6098,3566,5029,7945,40.681691213615984,13.914767815144769,2916,1,623796,25344,1655,0,650,1719
7271,0,0,0,1,67,1,1060,0,0,4589949,9226427,52.316345438113316,2567,4584,4414,2737,52416,755104,788814,3201,6108,3541,5048,7955,40.95119045888654,13.09265514316057,2907,1,640458,20570,1677,0,634,1694
7272,0,0,0,1,65,1,1069,0,0,5187570,9475578,53.60970061472084,2874,4679,4679,2874,48300,692370,758310,3297,6171,3297,5102,7976,42.485291572496,0.0,2874,1,661020,0,1805,0,423,1492
7273,0,0,1,0,64,1,1056,0,0,5592145,9587799,54.323107422164284,2824,4973,4846,2951,49268,708282,734274,3122,6200,3376,5144,8222,43.53159771935783,11.269427669584644,3078,1,666926,16002,1895,0,298,1354
7274,0,0,1,0,64,1,1053,0,0,5644720,9602240,54.405882034941776,2810,5017,4867,2960,49042,703948,733144,3094,6204,3394,5151,8261,43.669211121796096,12.247584794411392,3110,1,668960,18450,1907,0,284,1337
7275,0,0,1,0,62,1,169,0,0,7768592,9044204,53.600373133029585,2427,6023,5577,2873,46655,683116,676820,2702,6021,3594,5852,9171,52.0,21.161052181149273,3319,1,617695,61102,2704,0,275,444
7276,0,0,0,0,51,1,58,0,1,1569168,3294740,35.805027579936315,1162,2626,2506,1282,55328,634790,575680,2450,3852,2690,3794,5196,34.9857113690718,10.991537949000206,1402,1,287168,18480,1224,0,1288,1346
7277,0,0,0,0,52,1,709,0,1,1413170,2311574,29.765752132274432,631,2736,2481,886,52070,662686,534845,2354,3495,2864,4204,5345,39.93745109543172,16.496099432403877,1141,1,181630,45645,1595,0,1723,1014
7278,0,0,0,0,52,1,776,0,1,1404465,2239413,29.30870177950569,576,2777,2494,859,55876,597003,636108,2324,3466,2890,4242,5384,40.43513323831146,17.24154634033139,1142,1,209596,31130,1635,0,1748,972
7279,0,0,0,0,51,1,558,0,1,612720,1410360,23.49468024894146,134,2080,1662,552,47250,536550,574875,2137,3107,2973,3665,4635,33.31666249791537,20.77204114943481,970,1,124200,48488,1110,0,2003,1445
7280,0,1,1,0,62,0,175,0,0,912984,2713664,29.5296461204668,738,2053,1919,872,53714,665968,781112,2978,3984,3246,4159,5165,32.357379374726875,11.709062801829726,1006,1,218872,10586,1047,0,2240,2065
7281,0,1,1,0,61,0,197,0,0,616770,2126124,26.324893162176366,573,1703,1583,693,43896,570648,724048,2948,3761,3188,3958,4771,29.832867780352597,10.991537949000206,813,1,163548,8280,890,0,2375,2178
7282,0,0,0,1,67,1,627,0,0,1354948,5117511,38.97435053981015,1327,2603,2411,1519,47470,791715,680538,3177,4888,3561,4261,5972,29.866369046136157,13.877501437522838,1711,1,306838,33024,892,0,1850,2477
7283,0,0,0,1,68,1,1487,0,0,1252200,7193889,45.68369512200168,1429,3345,2687,2087,39150,775575,599778,2789,5534,4105,4047,6792,24.49489742783178,25.741153286046888,2745,1,363138,125020,600,0,1360,2847
7284,0,0,0,1,65,1,1066,0,0,5442360,9606058,54.092513345194085,2866,4846,4786,2926,49880,705845,761656,3223,6209,3343,5143,8129,43.12771730569565,7.746504550744806,2986,1,678832,6780,1860,0,357,1423
7285,0,0,1,0,63,1,617,0,0,7809360,9828000,55.85696017507576,2778,5965,5623,3120,38948,674100,573300,2808,6270,3492,5653,9115,50.02999100539596,18.72917466344535,3462,1,567840,58482,2503,0,30,647
7286,0,0,0,0,56,1,886,1,0,2053751,5502576,44.07947368106838,1433,3510,3000,1943,45920,634368,580560,2322,4775,3342,3889,6342,32.51153641401772,22.67433507442129,2453,1,398315,80070,1057,0,889,1775
7287,0,0,0,0,56,1,1420,1,0,1484000,5965680,46.04345773288535,1850,3090,2820,2120,54056,655662,652848,2544,4934,3084,3514,5904,26.457513110645905,16.559996291323092,2390,1,491840,35910,700,0,694,2114
7288,0,0,0,0,51,1,521,0,0,2587410,4866750,43.474130238568314,1890,3259,3259,1890,54510,610275,592250,2575,4465,2575,3944,5834,37.0,0.0,1890,0,434700,0,1369,0,685,1206
7289,0,0,0,0,52,1,659,0,1,1235870,2158830,28.809720581775867,470,2679,2319,830,56144,629442,603432,2241,3431,2961,4090,5280,38.58756276314948,19.30233645728518,1190,1,192560,50040,1489,0,1771,1112
7290,0,0,0,0,51,1,506,0,1,771387,1704719,25.709920264364882,181,2308,1828,661,50850,582854,580275,2099,3240,3059,3746,4887,34.161381705077446,22.28265845427802,1141,1,148725,65280,1167,0,1918,1412
7291,0,0,0,0,51,1,508,0,1,731148,1643488,25.25866188063018,171,2251,1784,638,50609,569296,589904,2109,3214,3043,3722,4827,33.85262175962151,21.981404874727758,1105,1,146102,58375,1146,0,1938,1430
7292,0,0,1,0,62,1,677,0,0,4972698,5981040,43.78355855797927,1755,4673,4511,1917,47970,767520,608400,2958,5037,3282,5714,7793,50.93132631298737,12.729861554299685,2079,1,373815,30618,2594,0,1203,526
7293,0,0,1,0,63,1,1136,0,0,2691072,3723584,34.17601498127012,457,4183,3472,1168,47286,679044,707736,2477,4356,3899,5492,7371,48.0,26.720123224562904,1879,1,259296,88164,2304,0,2020,884
7294,0,0,0,1,68,1,1511,0,0,1204776,7180632,45.69463863518345,1496,3257,2665,2088,41106,760019,639654,2847,5527,4031,4016,6696,24.020824298928627,24.415653752125017,2680,1,388368,103008,577,0,1351,2862
7295,0,0,0,1,68,1,1232,0,0,3951105,9194073,51.93264869039514,2332,4527,4162,2697,51983,773843,780661,3044,6106,3774,4874,7936,38.27531841800928,19.232749017330665,3062,1,617613,48180,1465,0,712,1944
7296,0,0,0,1,65,1,1066,0,0,5620811,9721603,54.433445601027316,2868,4955,4860,2963,49910,711977,754630,3186,6244,3376,5178,8236,43.55456348076513,9.749223385359247,3058,1,681490,11210,1897,0,318,1384
7297,0,0,0,0,56,1,1094,1,0,1847016,5718104,44.85532298401161,1452,3490,2930,2012,43659,656502,537138,2282,4854,3402,3760,6332,30.298514815086232,23.799457124639083,2572,1,380268,101920,918,0,830,1924
7298,0,0,0,0,56,1,1126,1,0,1808795,5757829,44.955533585978046,1452,3485,2916,2021,42406,663817,518518,2280,4870,3418,3744,6334,29.916550603303182,24.014833608983515,2590,1,367822,108679,895,0,828,1954
7299,0,0,0,0,51,1,50,0,1,1710239,3411147,36.51027252705737,1273,2676,2616,1333,55615,626955,580893,2499,3892,2619,3842,5235,35.81898937714463,7.780166052320878,1393,1,302591,8940,1283,0,1226,1276
7300,0,0,0,0,50,1,230,0,0,1661211,2984049,34.336569426778794,1149,2618,2588,1179,50715,620095,523917,2501,3710,2561,3940,5149,37.53664875824692,5.490867587491313,1209,0,244053,5280,1409,0,1352,1122
7301,0,0,0,0,51,1,632,0,1,1297268,2247270,29.427877939124322,536,2694,2364,866,54250,648750,563115,2265,3461,2925,4093,5289,38.704004960727254,18.494664839616355,1196,1,187922,54780,1498,0,1729,1097
7302,0,1,1,0,63,0,128,0,0,1320705,3466443,32.96968304366907,845,2544,2302,1087,55695,755793,749415,2947,4276,3431,4404,5733,34.85685011586675,16.181695947463304,1329,1,255445,31944,1215,0,2102,1974
7303,0,0,0,0,55,1,285,1,0,792396,2910672,32.31098884280702,693,2154,1803,1044,41520,482324,669120,2437,3832,3139,3547,4942,27.54995462791182,19.588272102490702,1395,1,250560,15444,759,0,1744,2029
7304,0,0,1,0,64,1,917,0,0,3184584,4431568,37.20215047547655,808,4261,3685,1384,47775,784490,624390,2626,4586,3778,5503,7463,47.968739820845826,24.112077770498775,1960,1,269880,108864,2301,0,1818,901
7305,0,0,1,0,63,1,1275,0,0,2380824,3282792,32.12475680841802,495,3876,3339,1032,48645,747535,658467,2644,4213,3718,5488,7057,48.03123983409131,23.2710800223774,1569,1,213624,89142,2307,0,2149,874
7306,0,0,0,1,68,1,1176,0,0,1184425,6219600,42.720018726587654,1421,2878,2474,1825,46530,800880,674784,3004,5233,3812,4057,6286,25.475478405713993,20.15384085447605,2229,1,361350,71508,649,0,1583,2759
7307,0,0,0,1,69,1,1594,0,0,1155035,7370020,46.20606020859169,1476,3335,2676,2135,40275,776700,617908,2793,5587,4111,3993,6787,23.259406699226016,25.772200008057926,2794,1,382165,122574,541,0,1317,2911
7308,0,0,0,1,68,1,1301,0,0,3793712,9242272,52.0,2283,4528,4107,2704,51980,772468,786140,2997,6122,3839,4821,7946,37.456641600656084,20.65470707087723,3125,1,621920,54309,1403,0,714,2015
7309,0,0,0,1,65,1,1065,0,0,5805000,9831000,54.772255750516614,2866,5069,4935,3000,50388,724217,747156,3143,6277,3411,5212,8346,43.98863489584554,11.583726138680884,3134,1,684000,16750,1935,0,277,1342
7310,0,0,0,1,65,1,1064,0,0,5852505,9851466,54.85435260760991,2859,5104,4954,3009,50328,707184,762842,3124,6283,3424,5219,8378,44.10215414239989,12.250849366392371,3159,1,701097,16950,1945,0,265,1329
7311,0,0,1,0,54,1,1750,0,0,1348491,6295287,48.25971404805462,2329,2908,2908,2329,56394,632502,651423,2703,5032,2703,3282,5611,24.06241883103193,0.0,2329,1,561289,0,579,0,374,2124
7312,0,0,1,0,53,1,1684,0,0,1466661,6209560,48.13522618623496,2317,2950,2950,2317,52899,613720,619080,2680,4997,2680,3313,5630,25.15949125081825,0.0,2317,1,535227,0,633,0,363,2047
7313,0,0,1,0,53,1,1666,0,0,1502435,6201885,48.11444689487763,2315,2964,2964,2315,49504,600096,592059,2679,4994,2679,3328,5643,25.475478405713993,0.0,2315,1,511615,0,649,0,364,2030
7314,0,0,0,0,53,1,1480,1,0,1917300,6172320,48.062459362791664,2243,3207,3140,2310,50244,566464,633264,2605,4982,2739,3502,5879,28.809720581775867,8.299636160530056,2377,1,547470,6834,830,0,362,1842
7315,0,0,0,0,51,1,606,0,0,3195160,5491020,46.0,2116,3626,3626,2116,56165,620205,609825,2595,4711,2595,4105,6221,38.8587184554509,0.0,2116,0,497260,0,1510,0,479,1085
7316,0,0,0,0,50,1,147,1,0,1861920,3664800,37.94733192202055,1440,2733,2733,1440,48231,592985,526815,2545,3985,2545,3838,5278,35.958309192730404,0.0,1440,1,298080,0,1293,0,1105,1252
7317,0,0,0,0,51,1,25,0,0,1770074,3428679,36.64696440361739,1313,2691,2661,1343,56165,599955,610167,2523,3896,2583,3871,5244,36.30426972134269,5.501408174353464,1373,0,320977,3720,1318,0,1210,1235
7318,0,0,0,0,50,1,59,0,0,1737572,3268904,35.90264614203248,1289,2637,2637,1289,53482,613712,560456,2536,3825,2536,3884,5173,36.71511950137164,0.0,1289,0,284869,0,1348,0,1247,1188
7319,0,0,0,0,50,1,101,0,0,1727990,3204245,35.566838487557476,1235,2661,2631,1265,52210,574991,582590,2503,3798,2563,3899,5194,36.959437225152655,5.490867587491313,1295,0,290950,3900,1366,0,1268,1167
7320,0,0,0,0,50,1,144,0,0,1724041,3142304,35.25620512760839,1243,2630,2630,1243,48160,566272,543520,2528,3771,2528,3915,5158,37.242448899072144,0.0,1243,0,267245,0,1387,0,1285,1141
7321,0,0,0,0,50,1,415,0,1,532266,1401193,23.473389188611005,274,1794,1517,551,50635,521315,628121,2266,3094,2820,3509,4337,31.080540535840107,17.1125053421481,828,1,136097,21606,966,0,1992,1577
7322,0,0,0,1,67,1,702,0,0,1281024,5182464,39.191835884530846,1278,2628,2370,1536,49164,813134,688296,3116,4910,3632,4208,6002,28.879058156387302,16.10617718647385,1794,1,313344,45408,834,0,1838,2540
7323,0,0,0,1,67,1,859,0,0,1242360,5500488,40.29888335921977,1305,2708,2389,1624,48923,816267,687561,3068,5011,3706,4152,6095,27.65863337187866,17.908164456931132,1943,1,329672,56144,765,0,1763,2622
7324,0,0,0,1,69,1,1663,0,0,1108230,7527272,46.61544808322666,1473,3383,2683,2173,40584,789792,616592,2764,5637,4164,3974,6847,22.58317958127243,26.578506648231848,2873,1,386794,133000,510,0,1291,2954
7325,0,0,0,1,68,1,1383,0,0,3571984,9272016,52.0,2194,4535,4025,2704,47700,726948,771525,2919,6133,3939,4750,7964,36.345563690772494,22.720835811334325,3214,1,608400,60690,1321,0,725,2108
7326,0,0,0,1,65,1,1065,0,0,5948956,9935120,55.036351623268054,2867,5155,4993,3029,50838,728160,751120,3118,6309,3442,5244,8435,44.31703961232068,12.740029376818088,3191,1,693641,20250,1964,0,251,1316
7327,0,0,0,1,65,1,1063,0,0,5995038,9952249,55.10898293381942,2862,5186,5011,3037,50976,707832,773372,3102,6314,3452,5251,8463,44.429719783046124,13.234044886003495,3212,1,716732,19250,1974,0,240,1303
7328,0,0,0,1,65,1,1062,0,0,6043264,9951282,55.190578906186516,2854,5222,5030,3046,49852,673002,790614,3075,6313,3459,5251,8489,44.54211490264017,13.869918330782513,3238,1,737132,16704,1984,0,221,1283
7329,0,0,1,0,62,1,53,0,0,8233328,8907119,53.319789947073126,2588,5994,5739,2843,50851,661063,755053,2878,5976,3388,6029,9127,53.81449618829484,16.006953473611997,3098,1,685163,24480,2896,0,290,237
7330,0,0,1,0,53,1,1757,0,0,1390608,6314112,48.46648326421054,2319,2971,2941,2349,49486,585984,610176,2658,5037,2718,3280,5659,24.331050121192877,5.501408174353464,2379,1,533223,3690,592,0,339,2096
7331,0,0,0,0,51,1,62,0,0,1870463,3567450,37.403208418530085,1399,2736,2736,1399,55388,622200,578850,2550,3949,2550,3887,5286,36.565010597564445,0.0,1399,0,317573,0,1337,0,1151,1213
7332,0,0,0,0,50,1,123,0,0,1801210,3248588,35.805027579936315,1282,2687,2687,1282,48150,570150,542276,2534,3816,2534,3939,5221,37.48332962798263,0.0,1282,0,274348,0,1405,0,1252,1129
7333,0,0,0,0,50,1,365,0,0,1750254,2910172,33.95585369269929,1123,2701,2671,1153,55932,598188,595664,2494,3677,2554,4042,5225,38.961519477556315,5.514871952411144,1183,0,272108,3930,1518,0,1371,1006
7334,0,0,0,0,50,1,533,0,1,1701870,2691255,32.63433774416144,998,2730,2663,1065,49530,641858,492765,2460,3592,2594,4125,5257,39.97499218261337,8.286047041568583,1132,1,207675,12596,1598,0,1462,929
7335,0,0,0,0,51,1,542,0,1,1354584,2385768,30.397368307141328,654,2660,2390,924,54718,648082,562876,2312,3506,2852,4048,5242,38.28837943815329,16.764275179295073,1194,1,201432,43740,1466,0,1658,1116
7336,0,0,0,0,51,1,461,0,1,1233960,2331416,30.066592756745816,619,2554,2269,904,54168,629276,572538,2294,3483,2864,3944,5133,36.945906403822335,17.17437973345589,1189,1,200688,44745,1365,0,1675,1214
7337,0,1,0,1,69,0,1365,0,0,2819350,8715035,49.949974974968704,1603,4517,3625,2495,50096,705586,866264,2601,5988,4385,4623,8010,33.61547262794322,30.264337566507102,3387,1,618760,64224,1130,0,998,2363
7338,0,0,0,0,55,1,320,1,0,896000,3092320,33.46640106136302,825,2215,1920,1120,40391,466609,659879,2466,3881,3056,3561,4976,28.284271247461902,17.763602092750975,1415,1,267680,11505,800,0,1641,1961
7339,0,0,1,0,64,1,1025,0,0,2551350,3746640,34.132096331752024,396,4124,3355,1165,52800,771840,707520,2447,4381,3985,5406,7340,46.79743582719036,27.742846136701417,1934,1,256300,119964,2190,0,2051,1026
7340,0,0,0,1,67,1,833,0,0,1229568,5414582,40.01249804748511,1282,2688,2369,1601,48800,825208,676400,3063,4983,3701,4150,6070,27.712812921102035,17.905334348371028,1920,1,320200,58058,768,0,1781,2614
7341,0,0,0,1,67,1,1089,0,0,1149526,5938053,41.79712908801273,1345,2807,2405,1747,49059,805563,703593,2997,5146,3801,4057,6206,25.65151067676132,20.099381787554137,2149,1,361629,67938,658,0,1652,2741
7342,0,0,0,1,65,1,1110,0,0,5837416,10003098,55.08175741568164,2907,5085,4958,3034,50380,725340,755013,3170,6331,3424,5221,8382,43.86342439892262,11.283549896340864,3161,1,694786,15621,1924,0,263,1373
7343,0,0,1,0,63,1,756,0,0,7860357,10146948,56.630380539071076,2965,5900,5658,3207,43000,680260,632800,2922,6371,3406,5615,9064,49.50757517794625,15.695002637885558,3449,1,641400,36784,2451,0,43,713
7344,0,0,1,0,57,1,468,0,0,3113644,5800320,44.87761134463375,1619,3955,3560,2014,42200,607680,576000,2485,4894,3275,4426,6835,39.319206502675,19.918060315580586,2409,1,402800,58065,1546,0,866,1334
7345,0,0,0,0,57,1,1265,1,0,1771146,6033690,45.89117562233506,1494,3559,2947,2106,39725,650355,501375,2253,4971,3477,3706,6424,29.0,24.89890848159017,2718,1,368550,116892,841,0,759,2024
7346,0,0,1,0,54,1,1880,0,0,1227609,6475458,48.91829923454004,2363,2936,2906,2393,51744,606144,625086,2676,5099,2736,3219,5642,22.64950330581225,5.490867587491313,2423,1,552783,3780,513,0,313,2193
7347,0,0,1,0,54,1,1865,0,0,1251836,6452689,48.877397639399746,2359,2943,2913,2389,51528,610426,615828,2671,5090,2731,3225,5644,22.891046284519195,5.514871952411144,2419,1,544692,3930,524,0,312,2177
7348,0,0,0,0,50,1,467,0,0,1785570,2820976,33.51119216023208,1123,2713,2713,1123,53946,610416,557664,2512,3635,2512,4102,5225,39.87480407475377,0.0,1123,0,249306,0,1590,0,1389,922
7349,0,0,0,0,51,1,436,0,1,1288812,2416288,30.62678566222711,691,2559,2312,938,54064,638848,561568,2329,3514,2823,3950,5135,37.067505985701274,16.048727149124424,1185,1,204484,40755,1374,0,1638,1202
7350,0,0,0,0,51,1,391,0,1,1233036,2400832,30.528675044947494,664,2523,2255,932,55388,628544,584752,2308,3508,2844,3899,5099,36.373066958946424,16.715296746065686,1200,1,211564,39932,1323,0,1644,1253
7351,0,0,0,0,50,1,346,0,1,976080,2111520,28.809720581775867,448,2388,2006,830,54692,615648,574944,2162,3374,2926,3720,4932,34.292856398964496,19.63820704538012,1212,1,187580,57300,1176,0,1714,1368
7352,0,0,0,0,51,1,344,0,1,886265,2016665,28.0178514522438,361,2338,1914,785,33638,621698,357091,2145,3354,2993,3698,4907,33.60059523282288,20.776614167531445,1209,1,109115,98792,1129,0,1784,1440
7353,0,1,1,0,60,0,107,0,0,465678,1903096,25.11971337416094,631,1369,1369,631,46305,570024,738920,3016,3647,3016,3754,4385,27.16615541441225,0.0,631,1,154595,0,738,0,2385,2278
7354,0,1,1,0,58,0,150,0,0,184471,1055203,19.0,294,939,872,361,46864,590446,678136,2856,3284,2990,3434,3862,22.60530911091463,8.261328108906353,428,1,83752,6499,511,0,2562,2412
7355,0,0,0,1,67,1,911,0,0,1188462,5542882,40.45985664828782,1276,2724,2363,1637,48000,812640,677200,3025,5023,3747,4112,6110,26.94438717061496,19.04706206206517,1998,1,327400,64619,726,0,1749,2660
7356,0,0,0,1,67,1,963,0,0,1171198,5646074,40.8166632639171,1284,2751,2369,1666,47561,809971,674411,3007,5055,3771,4092,6140,26.514147167125703,19.588072525940333,2048,1,331534,68760,703,0,1723,2686
7357,0,0,0,1,67,1,1015,0,0,1152600,5751135,41.1703777004778,1293,2777,2375,1695,46410,807534,661635,2991,5088,3795,4073,6170,26.076809620810597,20.096949035490134,2097,1,330525,73566,680,0,1698,2713
7358,0,0,0,1,68,1,1449,0,0,999090,6719370,44.26059195266146,1407,3021,2469,1959,41400,788900,617400,2878,5389,3982,3940,6451,22.58317958127243,23.568431669051233,2511,1,352620,104328,510,0,1471,2920
7359,0,0,0,1,67,1,1363,0,0,4351388,9749640,53.62835071116769,2686,4579,4389,2876,49275,742410,762750,3200,6266,3580,4903,7969,38.897300677553446,13.941784393794311,3066,1,647100,24130,1513,0,514,1877
7360,0,0,0,1,65,1,1117,0,0,6035958,10123542,55.47972602672079,2886,5231,5039,3078,50976,710424,776204,3097,6367,3481,5250,8520,44.28317965096906,13.877501437522838,3270,1,726408,20928,1961,0,211,1328
7361,0,0,0,0,57,1,1277,1,0,1804974,6086738,46.10856753359401,1478,3623,2975,2126,41132,647038,521066,2215,4989,3511,3712,6486,29.13760456866693,25.597261776317385,2774,1,386932,118584,849,0,737,2014
7362,0,0,0,0,57,1,1345,1,0,1713056,6166144,46.3033476111609,1555,3532,2943,2144,43039,641348,555068,2287,5020,3465,3675,6408,28.26658805020514,24.478227289937713,2733,1,413792,99541,799,0,732,2077
7363,0,0,1,0,54,1,1887,0,0,1266300,6514812,49.1121166312347,2327,3022,2937,2412,46004,586117,572612,2616,5113,2786,3226,5723,22.9128784747792,9.219544457292887,2497,1,511344,11900,525,0,289,2176
7364,0,0,0,0,50,1,339,1,0,1896426,3086412,34.899856733230294,1133,2860,2775,1218,40530,489062,532140,2449,3752,2619,4091,5394,39.45883931389772,9.28144526553527,1303,1,255780,9520,1557,0,1316,977
7365,0,1,0,1,68,0,471,0,0,3302596,7043608,45.47526800360829,1559,4174,3665,2068,49020,732290,776568,2897,5474,3915,5003,7580,39.96248240537617,22.87322626767224,2577,1,471504,60571,1597,0,1338,1809
7366,0,0,0,1,67,1,611,0,0,1265060,4952857,38.353617821530214,1176,2626,2331,1471,46648,801346,659932,3072,4838,3662,4227,5993,29.32575659723036,17.21691018983201,1766,1,288316,53690,860,0,1896,2507
7367,0,0,0,1,68,1,1567,0,0,924968,6980776,44.98888751680797,1408,3097,2481,2024,39550,779474,603575,2833,5473,4065,3906,6546,21.37755832643195,24.93123681734597,2640,1,354200,117656,457,0,1425,2992
7368,0,0,0,1,68,1,1468,0,0,3930240,9731616,53.36665625650534,2506,4570,4228,2848,49486,744906,775659,3075,6265,3759,4797,7987,37.14835124201342,18.673368975059056,3190,1,646496,42066,1380,0,569,2037
7369,0,0,0,1,68,1,1432,0,0,4170240,9794880,53.665631459994955,2624,4584,4328,2880,48792,727814,775428,3145,6281,3657,4849,7985,38.05259518088089,16.162545278392606,3136,1,656640,29952,1448,0,521,1953
7370,0,0,0,1,67,1,1385,0,0,4513434,9902041,54.101755978895916,2777,4619,4469,2927,47936,723962,757792,3233,6310,3533,4925,8002,39.26830783214372,12.401817263524045,3077,1,655648,18300,1542,0,456,1841
7371,0,0,0,1,67,1,1339,0,0,4880942,10029904,54.57105459856901,2888,4707,4617,2978,44702,693808,730856,3278,6346,3458,5007,8075,40.48456495999432,9.590813010750445,3068,1,646226,10890,1639,0,390,1729
7372,0,0,0,1,66,1,1198,0,0,5856248,10206692,55.60575509783138,2917,5161,4986,3092,50167,729521,749327,3126,6393,3476,5195,8462,43.520110293977886,13.246969194075609,3267,1,701884,22225,1894,0,209,1407
7373,0,0,1,0,64,1,1059,0,0,6633900,10250955,56.20498198558558,2840,5578,5259,3159,53788,733370,772310,2926,6404,3564,5345,8823,45.8257569495584,17.91108024210848,3478,1,751842,37642,2100,0,86,1145
7374,0,0,1,0,63,1,561,0,0,8532610,10281570,56.70097000933934,2731,6353,5869,3215,43600,697164,639600,2714,6413,3682,5852,9551,51.51698748956503,22.240305207571094,3699,1,643000,75020,2654,0,17,544
7375,0,0,0,0,57,1,1321,1,0,1797270,6182695,46.42197755374064,1500,3644,2989,2155,40544,642656,519289,2214,5024,3524,3703,6513,28.879058156387302,25.749738208296776,2810,1,390055,119865,834,0,714,2035
7376,0,0,0,0,57,1,1391,1,0,1699286,6262586,46.61544808322666,1575,3553,2955,2173,43008,645568,553344,2284,5055,3480,3664,6435,27.964262908219126,24.680902424854374,2771,1,417216,102258,782,0,709,2100
7377,0,0,1,0,54,1,2023,0,0,1075020,6698580,49.59838707054898,2370,2987,2897,2460,46592,566384,609952,2633,5183,2813,3160,5710,20.904544960366874,9.515978740065268,2550,1,551040,10350,437,0,263,2286
7378,0,0,0,0,51,1,142,1,0,2034143,3472563,36.837480912787726,1262,2951,2856,1357,35979,514359,458061,2464,3916,2654,4058,5510,38.71692136521188,9.886585106410566,1452,1,242903,14820,1499,0,1202,1060
7379,0,0,0,0,50,1,566,0,1,1832600,2774200,33.166247903554,1058,2808,2766,1100,53676,635544,537186,2480,3622,2564,4188,5330,40.8166632639171,6.538739683827756,1142,1,234300,7056,1666,0,1422,856
7380,0,0,0,0,51,1,258,0,1,822415,2018655,28.053520278211074,426,2193,1832,787,55822,579690,633555,2204,3352,2926,3610,4758,32.32645975048923,19.44157573061713,1148,1,194389,35378,1045,0,1778,1520
7381,0,0,1,0,52,1,349,0,0,1553372,3793151,37.8549864614954,1433,2517,2517,1433,51935,622045,584987,2647,4080,2647,3731,5164,32.92415526630866,0.0,1433,0,316693,0,1084,1,1214,1563
7382,0,0,1,0,64,1,1067,0,0,2222850,3365250,32.4037034920393,344,3873,3167,1050,51736,743560,714715,2499,4255,3911,5322,7078,46.010868281309364,26.620112116450187,1756,1,234150,101664,2117,0,2155,1088
7383,0,0,0,1,68,1,1467,0,0,4238388,9924600,54.0277706369604,2677,4613,4371,2919,48391,737800,758200,3158,6319,3642,4852,8013,38.1051177665153,15.726270627932008,3161,1,650937,30734,1452,0,481,1948
7384,0,0,0,1,67,1,1371,0,0,4975312,10167992,54.945427471264615,2899,4787,4667,3019,46728,666864,794848,3248,6387,3488,5016,8155,40.59556626036888,11.02247049704286,3139,1,712484,10320,1648,0,349,1720
7385,0,0,0,1,66,1,1242,0,0,5864359,10311784,55.86591089385369,2920,5201,5000,3121,50167,730184,750008,3103,6425,3505,5183,8505,43.347433603386484,14.197144937870076,3322,1,708467,25527,1879,0,183,1425
7386,0,0,1,0,64,1,1095,0,0,6672484,10341872,56.462376853972415,2846,5623,5281,3188,52156,716924,765584,2902,6432,3586,5337,8867,45.749316934791494,18.55616436325553,3530,1,752368,39330,2093,0,56,1151
7387,0,0,1,0,64,1,1059,0,0,6888636,10374645,56.630380539071076,2847,5715,5355,3207,52416,724640,756990,2875,6442,3595,5383,8950,46.34652090502587,19.150520003849635,3567,1,750438,43560,2148,0,28,1087
7388,0,0,0,0,57,1,1399,1,0,1738256,6317344,46.8187996428785,1556,3621,2985,2192,40050,648450,512996,2246,5074,3518,3675,6503,28.160255680657446,25.42620838132471,2828,1,390176,118296,793,0,690,2089
7389,0,0,1,0,54,1,2082,0,0,1015920,6792720,49.8998997994986,2370,3018,2898,2490,45938,561968,608344,2608,5218,2848,3136,5746,20.199009876724155,10.996993508431213,2610,1,555270,13680,408,0,238,2320
7390,0,0,1,0,53,1,1693,0,0,1886820,6568200,49.59838707054898,2430,3257,3227,2460,44492,606090,523320,2640,5130,2700,3437,5927,27.694764848252458,5.514871952411144,2490,1,482160,5100,767,0,210,1903
7391,0,0,0,0,51,1,219,1,0,2091960,3450393,36.61966684720111,1191,3051,2901,1341,34040,473432,476005,2423,3914,2723,4133,5624,39.496835316262995,12.449381359612769,1491,1,248085,19350,1560,0,1232,1013
7392,0,0,0,0,50,1,186,0,1,662112,1840410,26.94438717061496,492,1872,1638,726,56619,616005,590655,2301,3261,2769,3447,4407,30.199337741083,15.736031801555209,960,1,169158,31122,912,0,1809,1623
7393,0,0,0,0,48,1,80,0,1,448641,1544057,25.11971337416094,631,1342,1342,631,49416,567704,521211,2447,3078,2447,3158,3789,26.664583251946766,0.0,631,1,134403,0,711,0,1816,1736
7394,0,0,0,1,68,1,1200,0,0,1022976,6065040,42.14261501141095,1267,2861,2352,1776,38628,758130,594210,2906,5191,3924,3991,6276,24.0,22.644251546180516,2285,1,309024,95183,576,0,1639,2839
7395,0,0,0,1,68,1,1513,0,0,4225998,10031588,54.286278192559855,2689,4639,4381,2947,47952,735264,755688,3146,6351,3662,4838,8043,37.86819245752297,16.241837046512664,3205,1,654234,32766,1434,0,457,1970
7396,0,0,0,1,67,1,1451,0,0,4678892,10172681,54.83611948342078,2845,4725,4563,3007,50167,747643,767941,3221,6390,3545,4939,8108,39.44616584663204,12.865825024943737,3169,1,682589,20736,1556,0,376,1827
7397,0,0,1,0,64,1,470,0,0,8789451,10297681,56.64803615307419,2752,6405,5948,3209,46004,696353,680308,2752,6418,3666,5948,9614,52.3354564325181,21.412504881453653,3666,1,680308,63980,2739,0,0,470
7398,0,0,1,0,54,1,2110,0,0,1009824,6847712,50.11985634456667,2362,3064,2914,2512,43056,567008,564282,2576,5238,2876,3128,5790,20.049937655763422,12.270382205646603,2662,1,519984,20250,402,0,214,2324
7399,0,0,1,0,54,1,2091,0,0,1045836,6831792,50.07993610219566,2358,3075,2925,2508,40385,558420,536628,2574,5232,2874,3141,5799,20.42057785666214,12.263881625621906,2658,1,494076,21300,417,0,216,2307
7400,0,0,0,0,50,1,185,0,1,921704,2215752,29.5296461204668,549,2252,1929,872,44275,642873,444675,2218,3413,2864,3598,4793,32.51153641401772,18.10108291385635,1195,1,152600,67184,1057,0,1669,1484
7401,0,0,0,0,49,1,84,0,1,525312,1690164,26.153393661244042,599,1537,1452,684,55328,553504,610337,2386,3155,2556,3239,4008,27.712812921102035,9.412769291411893,769,1,168948,7650,768,0,1787,1703
7402,0,0,0,1,67,1,1495,0,0,4669326,10273124,55.08175741568164,2844,4763,4573,3034,50609,748306,775394,3196,6420,3576,4925,8149,39.230090491866065,13.912911596993856,3224,1,694786,23560,1539,0,352,1847
7403,0,0,1,0,64,1,1122,0,0,7040223,10588155,57.21013896155121,2943,5754,5424,3273,49560,679350,763460,2905,6508,3565,5386,8989,46.37887450122092,18.36688748451027,3603,1,772428,33660,2151,0,38,1084
7404,0,0,0,0,57,1,1521,1,0,1667142,6548841,47.52893855326458,1628,3628,2997,2259,42593,646477,553709,2268,5158,3530,3637,6527,27.16615541441225,25.394178994724637,2890,1,431469,107901,738,0,640,2161
7405,0,0,1,0,54,1,2208,0,0,872100,7002300,50.49752469181039,2368,3074,2892,2550,45510,562930,609612,2564,5296,2928,3088,5820,18.49324200890693,13.60027811201657,2732,1,566100,20748,342,0,196,2404
7406,0,0,1,0,54,1,2166,0,0,955792,6949828,50.41825066382212,2362,3098,2918,2542,41184,568672,541332,2554,5276,2914,3110,5832,19.390719429665317,13.461829731744027,2722,1,503316,26280,376,0,192,2358
7407,0,0,1,0,54,1,2147,0,0,992358,6938892,50.37856687124,2358,3109,2929,2538,38964,557736,522194,2554,5272,2914,3125,5843,19.77371993328519,13.461829731744027,2718,1,484758,26640,391,0,196,2343
7408,0,0,0,0,50,1,482,1,0,2038623,3045261,34.741905532080416,1165,2938,2896,1207,41958,476847,560106,2481,3730,2565,4212,5461,41.09744517606904,6.678188844436455,1249,1,267954,3906,1689,0,1316,834
7409,0,0,0,0,49,1,46,0,0,444360,1696710,26.267851073127396,660,1364,1334,690,41358,555734,449997,2429,3149,2489,3103,3823,25.37715508089904,5.5965095842615735,720,0,126270,5490,644,0,1769,1815
7410,0,1,1,0,62,0,42,0,0,1029784,3114202,31.52776554086889,867,2157,2030,994,50268,667329,739388,3006,4127,3260,4169,5290,32.18695387886216,11.501304536780918,1121,0,234584,13208,1036,0,2139,2097
7411,0,0,1,0,63,1,809,0,0,2796500,4169088,36.27671429443411,925,3832,3441,1316,38048,734976,519552,2777,4484,3559,5293,7000,46.09772228646444,19.87435214762763,1707,1,215824,81328,2125,0,1852,1043
7412,0,0,1,0,63,1,852,0,0,2584093,3952215,35.17101079013795,726,3837,3326,1237,49028,760410,658170,2684,4432,3706,5284,7032,45.70557952810576,22.752951950775806,1748,1,254822,87892,2089,0,1958,1106
7413,0,0,0,1,67,1,869,0,0,1155650,5402066,39.92492955535426,1151,2762,2319,1594,42222,769303,630354,2946,4983,3832,4114,6151,26.92582403567252,21.122480072769292,2037,1,296484,80183,725,0,1795,2664
7414,0,0,0,1,68,1,1090,0,0,1055544,5831112,41.32795663954365,1209,2825,2326,1708,37800,768150,573552,2915,5122,3913,4032,6239,24.859605789312106,22.456878940068762,2207,1,286944,97804,618,0,1706,2796
7415,0,0,0,1,68,1,1199,0,0,998990,6041595,42.01190307520001,1231,2865,2331,1765,41070,759906,633255,2889,5188,3957,3989,6288,23.790754506740637,23.23072456301035,2299,1,326525,94518,566,0,1658,2857
7416,0,0,0,1,68,1,1306,0,0,940152,6265858,42.68489194082609,1249,2911,2338,1822,35903,766897,553679,2866,5261,4012,3955,6350,22.715633383201094,24.080504048652305,2395,1,293342,114600,516,0,1617,2923
7417,0,0,0,1,68,1,1591,0,0,4288922,10277740,54.89990892524322,2737,4714,4437,3014,47897,719510,774070,3133,6424,3687,4833,8124,37.72267222772003,16.84152879264993,3291,1,684178,31855,1423,0,396,1987
7418,0,0,0,1,67,1,1499,0,0,4958400,10449828,55.66866263886712,2889,4909,4699,3099,49572,687888,819396,3162,6471,3582,4972,8281,40.0,14.534640317255622,3309,1,753057,17640,1600,0,273,1772
7419,0,0,0,1,65,1,1312,0,0,6200289,10636452,56.84188596448925,2907,5474,5150,3231,49140,691320,770328,2968,6523,3616,5211,8766,43.80639222761902,18.031168947891093,3555,1,756054,34020,1919,0,61,1373
7420,0,0,0,1,65,1,1217,0,0,6729288,10643796,57.21013896155121,2856,5746,5329,3273,49163,686172,757716,2835,6525,3669,5308,8998,45.34313619501854,20.48241925083364,3690,1,762609,44619,2056,0,21,1196
7421,0,0,0,0,55,1,2272,1,0,774473,7109199,50.724747411889595,2345,3102,2874,2573,45938,569178,616149,2535,5336,2991,3064,5865,17.349351572897472,15.278026045538596,2801,1,573779,25536,301,0,190,2462
7422,0,0,1,0,54,1,2240,0,0,862625,7060650,50.7444578254611,2365,3120,2910,2575,42021,567594,556626,2532,5317,2952,3077,5862,18.303005217723125,14.55997679978325,2785,1,522725,29190,335,0,167,2407
7423,0,0,0,0,50,1,460,1,0,2131584,3169920,35.32704346531139,1163,3041,2956,1248,38160,457200,538480,2455,3788,2625,4248,5581,41.32795663954365,9.53016293865306,1333,1,264576,7735,1708,0,1292,832
7424,0,0,0,0,50,1,241,0,1,1549230,2846470,33.61547262794322,1070,2561,2501,1130,55278,627231,559218,2459,3649,2579,3890,5080,37.027017163147235,7.9730082341141015,1190,1,250860,9060,1371,0,1389,1148
7425,0,0,0,0,50,1,150,0,1,1337656,2744688,32.92415526630866,957,2445,2318,1084,53424,638064,536784,2405,3616,2659,3766,4977,35.12833614050059,11.552234068076439,1211,1,229808,21463,1234,0,1448,1298
7426,0,0,0,0,50,1,99,0,1,899100,2276100,30.0,617,2182,1899,900,54780,629721,556380,2246,3429,2812,3528,4711,31.606961258558215,16.92335870424053,1183,1,198000,45563,999,0,1629,1530
7427,0,0,0,0,49,1,73,0,0,468578,1770344,26.870057685088806,692,1401,1371,722,39516,544344,436456,2422,3174,2482,3101,3853,25.475478405713993,5.501408174353464,752,0,128516,5520,649,0,1730,1803
7428,0,0,0,1,67,1,611,0,0,1251110,4942910,38.27531841800928,1081,2703,2319,1465,45901,786142,664678,2990,4839,3758,4228,6077,29.223278392404914,19.665843340272662,1849,1,288605,67200,854,0,1909,2520
7429,0,0,0,1,68,1,1113,0,0,1037068,5873857,41.43669871020132,1192,2846,2321,1717,38025,769725,578149,2896,5138,3946,4025,6267,24.576411454889016,23.044744742222353,2242,1,290173,102375,604,0,1704,2817
7430,0,0,0,1,66,1,1393,0,0,6009740,10718235,56.96490147450446,2922,5420,5097,3245,48175,677115,776205,2980,6548,3626,5155,8723,43.034869582700026,18.005869898985274,3568,1,762575,31331,1852,0,58,1451
7431,0,0,0,1,65,1,1314,0,0,6427512,10748556,57.23635208501674,2892,5622,5238,3276,47861,685729,751349,2897,6557,3665,5243,8903,44.294469180700204,19.631998379129584,3660,1,750204,42240,1962,0,5,1319
7432,0,0,1,0,64,1,296,0,0,9183252,10201492,56.40921910468182,2873,6377,6068,3182,49163,676466,746998,2897,6388,3515,6092,9583,53.72150407425317,17.631361899585805,3491,1,741406,33063,2886,0,24,320
7433,0,0,1,0,59,1,75,0,0,5727436,7290569,49.3051721424842,1880,5338,4787,2431,45998,632789,653782,2448,5430,3550,5355,8337,48.53864439804639,23.478335885455092,2982,1,529958,69977,2356,0,568,643
7434,0,0,0,0,55,1,2326,1,0,706656,7191264,50.97057974949863,2342,3126,2870,2598,46592,575744,620032,2512,5366,3024,3040,5894,16.492422502470642,16.181518938083777,2854,1,581952,29440,272,0,170,2496
7435,0,0,0,0,52,1,296,1,0,2368212,3651576,37.389838191679836,1143,3347,3092,1398,38220,511952,509340,2357,4010,2867,4306,5959,41.15823125451335,16.50672641415702,1653,1,272610,34170,1694,0,1214,918
7436,0,0,0,0,51,1,439,1,0,2224376,3295992,35.888716889852724,1164,3139,3015,1288,38640,470856,537390,2435,3847,2683,4286,5698,41.557189510360296,11.579219978559076,1412,1,270480,12400,1727,0,1271,832
7437,0,0,0,0,50,1,392,1,0,2049609,3164966,35.34119409414458,1182,2957,2890,1249,33252,413042,516936,2467,3783,2601,4175,5491,40.50925820105819,8.47749576439433,1316,1,254796,5226,1641,0,1285,893
7438,0,0,0,0,50,1,123,0,1,1406374,2835268,33.555923471125034,1041,2460,2375,1126,51612,637054,513672,2433,3644,2603,3767,4978,35.34119409414458,9.443791641391353,1211,1,229704,14875,1249,0,1392,1269
7439,0,0,0,0,50,1,66,0,1,949536,2375724,30.692018506445613,700,2192,1950,942,50953,633022,511966,2280,3464,2764,3530,4714,31.74901573277509,15.646474775487295,1184,1,191226,44286,1008,0,1580,1514
7440,0,0,0,0,50,1,59,0,1,908292,2332176,30.397368307141328,668,2163,1907,924,54340,623428,555280,2268,3448,2780,3507,4687,31.352830813181765,16.096774703375406,1180,1,203280,41216,983,0,1600,1541
7441,0,1,0,1,70,0,1585,0,0,2766750,9256755,51.332251070842396,1740,4580,3685,2635,48076,709626,836094,2618,6148,4408,4563,8093,32.4037034920393,30.760188537120793,3530,1,627130,77865,1050,0,878,2463
7442,0,1,1,0,60,0,23,0,0,434808,1964736,25.45584412271571,438,1529,1319,648,52398,645816,745872,2822,3680,3242,3703,4561,25.903667693977237,14.498026371449333,858,1,159408,18690,671,0,2384,2361
7443,0,0,0,0,55,1,421,1,0,1001196,3420342,35.11409973215888,986,2292,2045,1233,45549,524286,668534,2527,4007,3021,3586,5066,28.495613697550013,16.638162961826644,1480,1,297153,16302,812,0,1541,1962
7444,0,0,1,0,61,1,563,0,0,3878868,7024203,47.65501022977542,1910,4340,3979,2271,54093,763971,677367,2732,5364,3454,4801,7433,41.32795663954365,19.03271900284379,2632,1,497349,58843,1708,0,822,1385
7445,0,0,0,1,66,1,1455,0,0,5919804,10846440,57.15767664977295,2925,5421,5079,3267,47460,697200,750320,2978,6587,3662,5132,8741,42.567593307585526,18.512343769245525,3609,1,738342,39330,1812,0,53,1508
7446,0,0,0,1,65,1,1279,0,0,6883740,10875040,57.79273310719956,2950,5791,5401,3340,43848,660968,703296,2866,6596,3646,5317,9047,45.39823785126467,20.011895632835074,3730,1,721440,46020,2061,0,84,1195
7447,0,0,1,0,64,1,916,0,0,8480940,10963914,58.360945845659494,3316,5986,5896,3406,43039,717837,621267,3129,6625,3309,5709,9205,49.8998997994986,9.82680210338744,3496,1,657358,15210,2490,0,187,729
7448,0,0,0,0,57,1,2122,1,0,896363,7101380,49.82971001320397,2081,3246,2844,2483,48500,554840,715000,2458,5343,3262,3221,6106,19.0,20.42817750085841,2885,1,620750,22914,361,0,377,2499
7449,0,0,1,0,55,1,2371,0,0,707252,7288918,51.37119815616529,2369,3177,2907,2639,42436,568972,568972,2492,5401,3032,3030,5939,16.3707055437449,16.56533358479352,2909,1,543634,36180,268,0,123,2494
7450,0,0,0,0,52,1,213,1,0,2492964,3873024,38.41874542459709,1191,3450,3165,1476,43382,572032,522176,2339,4100,2909,4313,6074,41.09744517606904,17.22904594733818,1761,1,293724,44460,1689,0,1148,935
7451,0,0,0,0,51,1,389,1,0,2198690,3337065,36.069377593742864,1174,3118,2991,1301,39710,487350,536085,2438,3866,2692,4255,5683,41.10960958218893,11.798511981252409,1428,1,271909,13843,1690,0,1264,875
7452,0,0,0,0,50,1,339,1,0,2029060,3210570,35.566838487557476,1198,2936,2869,1265,38368,446688,553284,2471,3803,2605,4142,5474,40.049968789001575,8.592096094735382,1332,1,275770,5293,1604,0,1273,934
7453,0,0,0,0,50,1,321,1,0,1975050,3168858,35.41186241925155,1212,2871,2829,1254,40626,462441,560994,2485,3781,2569,4102,5398,39.68626966596886,6.73127350780198,1296,1,278388,3486,1575,0,1273,952
7454,0,0,0,0,50,1,91,0,1,1417602,2873022,33.85262175962151,1079,2450,2383,1146,50038,636778,493879,2440,3653,2574,3744,4957,35.17101079013795,8.299636160530056,1213,1,225762,12529,1237,0,1361,1270
7455,0,0,0,0,50,1,18,0,1,917683,2391480,30.805843601498726,721,2144,1916,949,54560,624960,554400,2292,3469,2748,3487,4664,31.096623610932426,15.198114466394223,1177,1,208780,36708,967,0,1571,1553
7456,0,1,1,0,61,0,15,0,0,701350,2567190,28.809720581775867,629,1876,1675,830,54635,689739,757785,2892,3923,3294,3938,4969,29.068883707497267,14.177797783946604,1031,1,203350,20502,845,0,2263,2248
7457,0,0,0,0,56,1,432,1,0,896185,3335470,34.45286635390443,874,2255,1942,1187,41652,500180,657540,2497,3997,3123,3565,5065,27.477263328068172,18.76113304346484,1500,1,277758,19093,755,0,1623,2055
7458,0,0,0,0,54,1,424,1,0,1200512,3648016,36.4417343165772,1153,2407,2232,1328,37975,480725,596099,2572,4075,2922,3651,5154,30.066592756745816,14.162333245144376,1503,1,288176,13825,904,0,1419,1843
7459,0,0,0,1,67,1,597,0,0,1266958,4937625,38.24918299781056,1046,2746,2329,1463,43338,786375,627750,2958,4838,3792,4241,6121,29.427877939124322,20.49358203335252,1880,1,272118,77562,866,0,1912,2509
7460,0,0,0,1,68,1,1159,0,0,1006302,5968292,41.689327171351664,1161,2894,2317,1738,38233,758914,594082,2857,5172,4011,4013,6328,24.06241883103193,24.185359619720053,2315,1,300674,108476,579,0,1696,2855
7461,0,0,1,0,55,1,2447,0,0,580970,7395375,51.62363799656123,2359,3189,2883,2665,44943,585525,591075,2469,5440,3081,2993,5964,14.7648230602334,17.669687961213416,2971,1,567645,40392,218,0,110,2557
7462,0,0,0,0,53,1,404,0,1,3641757,5716095,46.05431575867782,1865,4094,3838,2121,50264,657580,555170,2439,4816,2951,4412,6789,41.43669871020132,16.01761006559187,2377,1,436926,45056,1717,0,574,978
7463,0,0,0,0,53,1,392,0,1,3586800,5665800,45.8257569495584,1872,4036,3808,2100,52117,666406,569278,2470,4798,2926,4406,6734,41.32795663954365,15.128632192459419,2328,1,443100,39216,1708,0,598,990
7464,0,0,0,0,52,1,386,0,1,2497215,3656986,37.403208418530085,1165,3418,3184,1399,46452,512344,619518,2380,4013,2848,4399,6032,42.24926034855522,15.891790495269438,1633,1,331563,18720,1785,0,1215,829
7465,0,0,0,0,50,1,284,1,0,2007612,3248588,35.805027579936315,1215,2915,2848,1282,42180,468790,577752,2467,3816,2601,4100,5449,39.57271787481876,8.436161057888377,1349,1,292296,5293,1566,0,1252,968
7466,0,0,0,0,49,1,120,0,0,1629684,3038910,34.899856733230294,1188,2586,2556,1218,53590,581335,573850,2465,3713,2525,3833,5081,36.578682316343766,5.483301264452448,1248,0,280140,4080,1338,0,1277,1157
7467,0,0,0,0,49,1,87,0,1,707914,2210570,29.765752132274432,762,1809,1685,886,55350,561375,613770,2371,3381,2619,3294,4304,28.26658805020514,11.41455123074134,1010,1,217956,12772,799,0,1609,1696
7468,0,0,0,0,49,1,188,0,0,524064,2031160,28.705400188814647,794,1490,1460,824,35742,547230,396865,2435,3289,2495,3101,3955,25.219040425836983,5.652706486041966,854,0,132664,5970,636,0,1641,1829
7469,0,1,1,0,60,0,6,0,0,331767,1738737,24.06241883103193,309,1422,1152,579,49647,603603,741741,2733,3582,3273,3576,4425,23.93741840717165,16.512448686839516,849,1,143013,19440,573,0,2424,2430
7470,0,0,0,0,56,1,440,1,0,854100,3307590,34.20526275297414,819,2251,1900,1170,49234,582362,675653,2476,3997,3178,3557,5078,27.018512172212592,19.838203458341173,1521,1,279630,32292,730,0,1657,2097
7471,0,0,0,0,55,1,432,1,0,1150180,3623460,36.193922141707716,1094,2404,2188,1310,39560,508944,594690,2550,4076,2982,3644,5170,29.631064780058107,15.673295542138266,1526,1,281650,20520,878,0,1456,1888
7472,0,0,1,0,61,1,685,0,0,3936876,7261192,48.53864439804639,1990,4393,4027,2356,52216,752008,659548,2716,5438,3448,4753,7475,40.87786687193939,19.19987815458377,2722,0,504184,61122,1671,1,726,1411
7473,0,0,1,0,62,1,648,0,0,3273268,4708540,38.91015291668744,1406,3784,3676,1514,52430,761950,665540,3002,4624,3218,5272,6894,46.49731175025068,10.424232425346673,1622,0,323996,18144,2162,1,1596,948
7474,0,0,1,0,63,1,875,0,0,2075124,3414396,32.68026927673638,622,3457,3011,1068,52779,770477,700143,2751,4265,3643,5140,6654,44.07947368106838,21.12319629361427,1514,0,233892,70468,1943,1,2129,1254
7475,0,0,0,1,68,1,842,0,0,1175328,5387184,39.7994974842648,1074,2836,2326,1584,37910,758423,578170,2891,4985,3911,4143,6237,27.23967694375247,22.6979739224128,2094,1,269280,97920,742,0,1817,2659
7476,0,0,0,1,68,1,955,0,0,1121076,5598824,40.48456495999432,1098,2864,2323,1639,37349,754936,577304,2875,5055,3957,4100,6280,26.153393661244042,23.391860330443183,2180,1,276991,102790,684,0,1777,2732
7477,0,0,0,1,67,1,1651,0,0,5056970,10874096,56.753854494650845,2891,5121,4791,3221,46945,692080,773104,3046,6597,3706,4946,8497,39.6232255123179,18.196227716200095,3551,1,737609,34650,1570,0,155,1806
7478,0,0,0,0,53,1,337,0,1,3474120,5491680,45.16635916254486,1932,3851,3743,2040,55680,646080,624544,2584,4732,2800,4395,6543,41.2674205639267,10.435690064413366,2148,1,473280,15012,1703,0,652,989
7479,0,0,0,0,52,1,332,0,1,2603328,3826368,38.157568056677825,1159,3541,3244,1456,50176,588672,588672,2331,4084,2925,4416,6169,42.28474902373195,17.7867938793894,1753,1,326144,39798,1788,0,1172,840
7480,0,0,0,0,51,1,318,1,0,2269944,3497124,36.823905279043935,1186,3200,3030,1356,46398,539011,572538,2409,3935,2749,4253,5779,40.91454509095757,13.587439994874147,1526,1,301032,20230,1674,0,1223,905
7481,0,0,0,0,50,1,248,1,0,2040980,3328710,36.193922141707716,1225,2953,2868,1310,43052,477708,581889,2456,3851,2626,4099,5494,39.4715087119811,9.511914438752074,1395,1,299990,6885,1558,0,1231,983
7482,0,0,0,0,50,1,5,0,1,1273506,2821756,33.555923471125034,1018,2365,2257,1126,55278,623994,556332,2398,3632,2614,3637,4871,33.63034344160047,10.480278705357403,1234,1,249972,16740,1131,0,1380,1375
7483,0,0,0,0,50,1,39,0,1,1024776,2584128,32.12475680841802,882,2175,2025,1032,53250,626000,533352,2354,3536,2654,3497,4679,31.51190251317746,12.30702509692623,1182,1,219816,25800,993,0,1472,1511
7484,0,0,0,0,50,1,227,1,0,362274,1820808,26.94438717061496,564,1387,1225,726,38979,534204,458964,2346,3234,2670,3007,3895,22.338307903688676,13.156899899811384,888,1,132858,27054,499,0,1782,2009
7485,0,1,0,1,67,0,13,0,0,3004980,5804447,41.557189510360296,1127,4067,3467,1727,49164,685644,810001,2761,5088,3961,5101,7428,41.71330722922842,24.608482488989917,2327,1,416207,51600,1740,0,1634,1621
7486,0,1,0,1,67,0,13,0,0,2901870,5686647,41.19465984809196,1097,4007,3407,1697,48400,670200,810942,2751,5048,3951,5061,7358,41.352146256270665,24.582606838508408,2297,1,410674,47400,1710,0,1654,1641
7487,0,0,0,0,56,1,449,1,0,815430,3273270,33.98529093593286,779,2237,1861,1155,52377,626314,671658,2458,3989,3210,3540,5071,26.570660511172846,20.233986648185226,1531,1,273735,42488,706,0,1679,2128
7488,0,0,0,0,55,1,437,1,0,1165560,3663000,36.3318042491699,1104,2419,2203,1320,42460,535575,610500,2559,4095,2991,3658,5194,29.715315916207253,15.469358926783322,1536,1,290400,21384,883,0,1455,1892
7489,0,0,0,0,55,1,436,1,0,1229376,3733960,36.71511950137164,1156,2452,2260,1348,44265,540150,628790,2578,4118,2962,3682,5222,30.199337741083,14.682110731617461,1540,1,305996,18048,912,0,1422,1858
7490,0,0,1,0,62,1,39,0,0,4082040,6239118,44.73253849269008,1851,4191,4041,2001,51840,748320,673488,2968,5119,3268,5158,7309,45.16635916254486,12.24744871391589,2151,1,432216,24300,2040,0,1117,1078
7491,0,0,1,0,63,1,738,0,0,2579743,4036524,35.76310948449533,929,3646,3296,1279,38512,732192,523896,2806,4435,3506,5173,6802,44.91102314577124,18.78176968225438,1629,1,212314,71750,2017,0,1877,1139
7492,0,0,0,1,68,1,1144,0,0,1020737,5968452,41.6293165929973,1115,2940,2322,1733,35952,737016,578592,2826,5177,4062,4033,6384,24.269322199023193,25.04727374248012,2351,1,291144,113712,589,0,1711,2855
7493,0,0,0,1,68,1,1779,0,0,4432300,10871200,56.34713834792323,2796,4950,4571,3175,46662,691648,790944,3045,6599,3803,4820,8374,37.36308338453881,19.655777334720263,3554,1,733425,37521,1396,0,249,2028
7494,0,0,0,0,53,1,1627,1,0,2630628,7019388,51.264022471905186,2568,3689,3629,2628,48923,542213,643711,2611,5299,2731,3672,6360,31.63858403911275,7.952707287670506,2688,1,633348,5100,1001,0,43,1670
7495,0,0,0,0,53,1,1003,1,0,3549048,6602994,49.50757517794625,2142,4208,3899,2451,39360,552270,517248,2385,5145,3003,4142,6902,38.05259518088089,17.83841503000358,2760,1,470592,45732,1448,0,243,1246
7496,0,0,0,0,50,1,193,1,0,2019888,3370464,36.4417343165772,1233,2944,2849,1328,42624,487296,563436,2443,3866,2633,4059,5482,39.0,9.951904129305408,1423,1,294816,9215,1521,0,1210,1017
7497,0,0,0,0,49,1,200,0,1,615681,2186514,29.8496231131986,861,1612,1582,891,53360,564420,569328,2424,3345,2484,3145,4066,26.28687885618983,5.478746393072713,921,1,206712,3930,691,0,1563,1763
7498,0,0,0,0,50,1,224,1,0,352272,1799308,26.758176320519304,546,1378,1208,716,39376,537782,462392,2343,3229,2683,3005,3891,22.181073012818835,13.402306702748659,886,1,131744,28730,492,0,1797,2021
7499,0,0,0,0,50,1,226,1,0,331800,1761200,26.457513110645905,510,1364,1174,700,38979,535908,460428,2326,3216,2706,2990,3880,21.77154105707724,14.229707211083644,890,1,128100,31730,474,0,1816,2042
7500,0,0,0,0,50,1,228,1,0,297253,1693604,25.903667693977237,455,1330,1114,671,36890,547708,429080,2308,3195,2740,2967,3854,21.047565179849187,15.132096632713768,887,1,114070,40176,443,0,1853,2081
7501,0,1,0,1,70,0,1593,0,0,2815894,9376582,51.51698748956503,1780,4589,3715,2654,47286,752529,784326,2659,6187,4407,4594,8122,32.57299494980466,30.588318553202324,3528,1,589188,107502,1061,0,879,2472
7502,0,1,0,1,67,0,9,0,0,3011940,5823084,41.60528812542944,1101,4101,3471,1731,48314,682892,800632,2734,5095,3994,5104,7465,41.71330722922842,25.213255768031058,2361,1,411978,56700,1740,0,1633,1624
7503,0,1,0,1,65,0,6,0,0,2331720,5006340,39.03844259188627,1036,3542,3054,1524,50996,686565,801540,2797,4809,3773,4815,6827,39.11521443121589,22.39637131678652,2012,1,371856,42456,1530,0,1761,1755
7504,0,1,1,0,65,0,4,0,0,2067840,4684232,37.89459064299283,1010,3302,2876,1436,49560,685020,769832,2836,4698,3688,4702,6564,37.94733192202055,20.88140933013045,1862,1,338896,43452,1440,0,1826,1822
7505,0,0,0,0,56,1,446,1,0,1059080,3576628,35.7211421989835,1020,2362,2106,1276,45888,538176,669917,2547,4079,3059,3633,5165,28.809720581775867,16.917940215049025,1532,1,304964,18432,830,0,1527,1973
7506,0,0,0,0,55,1,445,1,0,1120136,3639464,36.11094017053558,1076,2391,2163,1304,45978,541454,661467,2563,4095,3019,3650,5182,29.30870177950569,15.994137403596097,1532,1,309048,18012,859,0,1487,1932
7507,0,0,1,0,62,1,437,0,0,4152708,7094304,47.62352359916263,1968,4399,4099,2268,54970,747592,719440,2828,5396,3428,4959,7527,42.790185790669334,17.325317324541928,2568,1,521640,42600,1831,0,860,1297
7508,0,0,0,1,68,1,1760,0,0,4842500,11059750,57.0087712549569,2860,5130,4740,3250,49440,701018,816720,3013,6653,3793,4893,8533,38.600518131237564,19.8423968611796,3640,1,780000,35490,1490,0,153,1913
7509,0,0,0,1,65,1,1453,0,0,6862440,11337495,58.69412236331676,3025,5857,5437,3445,45344,684528,717438,2871,6736,3711,5283,9148,44.63182720884279,20.940221426103477,3865,1,751010,51660,1992,0,154,1299
7510,0,0,0,1,65,1,1376,0,0,7333092,11400068,59.00847396772772,3182,5888,5588,3482,44254,664622,713732,2974,6756,3574,5380,9162,45.89117562233506,17.86583421945655,3782,1,759076,35100,2106,0,208,1168
7511,0,0,1,0,65,1,1356,0,0,7453285,11408588,59.08468498688979,3221,5896,5626,3491,43316,640528,722228,2998,6759,3538,5403,9164,46.20606020859169,16.999389342224802,3761,1,771511,27810,2135,0,223,1133
7512,0,0,1,0,64,1,993,0,0,8967748,11461340,59.430631832414505,3382,6221,6071,3532,44220,713900,652245,3095,6777,3395,5784,9466,50.38849074937649,12.459604606992961,3682,1,709932,23400,2539,0,287,706
7513,0,0,1,0,54,1,2059,0,0,1831830,7431060,52.24940191045253,2596,3535,3401,2730,42680,598840,528068,2588,5452,2856,3393,6257,25.903667693977237,11.718240104647752,2864,1,529620,22110,671,0,8,2051
7514,0,0,1,0,53,1,233,0,0,3370188,5212740,44.22668877499196,1914,3721,3679,1956,51700,626275,586300,2623,4621,2707,4388,6386,41.50903516103452,6.484411467763075,1998,1,430320,6384,1723,0,709,942
7515,0,0,0,0,52,1,229,0,1,2834546,4152720,39.66106403010388,1173,3775,3375,1573,52102,630960,575520,2240,4213,3040,4442,6415,42.44997055358225,20.243064223933317,1973,1,342914,63200,1802,0,1067,838
7516,0,0,0,0,49,1,209,1,0,452160,1958575,28.0178514522438,700,1446,1361,785,26624,518960,319360,2410,3280,2580,3071,3941,24.0,9.692340849365527,870,1,100480,18105,576,0,1710,1919
7517,0,0,0,0,50,1,222,1,0,324079,1742702,26.28687885618983,499,1352,1160,691,38160,534664,453960,2330,3213,2714,2991,3874,21.656407827707714,14.2955385753886,883,1,124380,32640,469,0,1831,2053
7518,0,1,0,1,65,0,0,0,0,2250000,4917000,38.72983346207417,1054,3446,3000,1500,50932,701492,780164,2832,4778,3724,4778,6724,38.72983346207417,21.42723370542782,1946,1,357000,46384,1500,0,1778,1778
7519,0,1,1,0,64,0,4,0,0,1827900,4392376,36.796738985948195,1004,3054,2704,1354,48068,639068,791536,2894,4598,3594,4594,6298,36.742346141747674,18.919448368858667,1704,1,330376,25200,1350,0,1890,1894
7520,0,1,1,0,63,0,7,0,0,1521510,3941082,35.17101079013795,931,2773,2467,1237,47520,630828,764640,2880,4423,3492,4416,5959,35.07135583350036,17.50633766424146,1543,1,296880,24480,1230,0,1949,1956
7521,0,0,0,0,56,1,454,1,0,960507,3485691,35.11409973215888,938,2307,2012,1233,48231,585189,658691,2532,4060,3122,3606,5134,27.910571473905726,18.254907670515145,1528,1,287289,30090,779,0,1594,2048
7522,0,0,0,0,55,1,448,1,0,1201985,3736226,36.64696440361739,1153,2428,2238,1343,50298,561964,692718,2592,4125,2972,3677,5210,29.916550603303182,14.766764436079752,1533,1,334407,13300,895,0,1439,1887
7523,0,0,0,0,55,1,447,1,0,1266804,3797670,37.027017163147235,1209,2457,2295,1371,50600,554000,700810,2608,4141,2932,3694,5227,30.397368307141328,13.704029552821586,1533,1,346863,9396,924,0,1399,1846
7524,0,0,1,0,61,1,310,0,0,3845064,5608140,42.567593307585526,1659,4087,3934,1812,55687,739705,721135,2942,4907,3248,5217,7182,46.06517122512408,12.464513167977666,1965,0,422196,21114,2122,1,1283,973
7525,0,0,1,0,61,1,165,0,0,6621244,8109164,51.54609587543949,2024,5782,5149,2657,40572,631764,598192,2419,5709,3685,5544,8834,49.91993589739474,25.160495839790443,3290,1,520772,92418,2492,0,395,560
7526,0,0,1,0,61,1,182,0,0,6509528,8069488,51.419840528729765,1995,5755,5106,2644,39168,622608,585984,2403,5696,3701,5514,8807,49.61854492022111,25.476446077754414,3293,1,507648,95403,2462,0,408,590
7527,0,0,1,0,54,1,528,0,0,3954340,6133540,47.644516998286385,1940,4342,4012,2270,53118,632268,613354,2372,4972,3032,4444,7044,41.737273509418415,18.189875653645732,2600,1,515290,46860,1742,0,432,960
7528,0,0,1,0,53,1,377,0,0,4042848,5948352,46.98936049788292,1968,4279,4039,2208,51744,622314,603456,2454,4902,2934,4525,6973,42.790185790669334,15.509118029532386,2448,1,494592,34320,1831,0,486,863
7529,0,0,0,0,53,1,20,1,0,3108069,4728591,42.1070065428546,1557,3742,3526,1773,51968,597408,618744,2451,4440,2883,4420,6409,41.86884283091664,14.706458146888055,1989,1,411336,27000,1753,0,894,914
7530,0,0,0,0,51,1,233,0,1,2440350,3764200,38.07886552931954,1195,3388,3133,1450,48180,568524,571120,2341,4046,2851,4279,5984,41.02438299353203,16.404618284338717,1705,1,319000,34170,1683,0,1146,913
7531,0,0,0,0,51,1,180,1,0,2256925,3649285,37.61648574760805,1223,3202,3010,1415,43584,495168,585433,2387,3994,2771,4174,5781,39.93745109543172,14.283629007749804,1607,1,321205,17280,1595,0,1164,984
7532,0,0,0,0,50,1,217,1,0,319428,1728468,26.153393661244042,492,1343,1151,684,37914,538251,449806,2335,3211,2719,2994,3870,21.61018278497431,14.332108965596055,876,1,121752,33216,467,0,1843,2060
7533,0,1,0,1,68,0,522,0,0,3410104,7296432,46.10856753359401,1333,4523,3730,2126,51012,748176,803088,2639,5558,4225,5036,7955,40.049968789001575,28.418742282852154,2919,1,497484,91195,1604,0,1306,1828
7534,0,1,0,1,68,0,344,0,0,3448641,6956355,45.13313638558703,1285,4482,3730,2037,52432,771790,792280,2663,5452,4167,5108,7897,41.14608122288197,27.644148150769848,2789,1,472584,95504,1693,0,1378,1722
7535,0,1,0,1,68,0,107,0,0,3477228,6528438,43.80639222761902,1206,4444,3731,1919,54056,792666,789264,2689,5321,4115,5214,7846,42.567593307585526,26.898543017198897,2632,1,445208,95542,1812,0,1483,1590
7536,0,1,0,1,67,0,1,0,0,3350730,6205530,42.77849927241488,1137,4354,3661,1830,53536,759584,810449,2698,5221,4084,5222,7745,42.790185790669334,26.992795470797898,2523,1,437370,78309,1831,0,1561,1560
7537,0,0,1,0,57,1,457,0,0,664350,3069125,32.78719262151,618,2150,1693,1075,49248,650940,616680,2398,3930,3312,3473,5005,24.859605789312106,22.187347217074038,1532,1,232200,68093,618,0,1780,2237
7538,0,0,0,0,56,1,456,1,0,867697,3372267,34.45286635390443,845,2260,1918,1187,39520,539790,590928,2499,4028,3183,3572,5101,27.03701166919155,19.53144621384319,1529,1,246896,37962,731,0,1654,2110
7539,0,0,0,0,56,1,456,1,0,978241,3517690,35.25620512760839,958,2315,2030,1243,45800,566000,648070,2545,4073,3115,3617,5145,28.053520278211074,18.05177379366439,1528,1,284647,27645,787,0,1587,2043
7540,0,0,0,0,56,1,455,1,0,1037136,3584220,35.651086939951774,1015,2343,2087,1271,44503,538620,657060,2564,4091,3076,3636,5163,28.5657137141714,17.196003990823552,1527,1,296143,20480,816,0,1549,2004
7541,0,0,0,1,68,1,635,0,0,1314104,5126814,38.82009788756334,982,2904,2379,1507,42770,799470,619164,2877,4909,3927,4274,6306,29.5296461204668,23.105967964348196,2032,1,274274,101325,872,0,1895,2530
7542,0,0,1,0,65,1,1450,0,0,7392971,11629154,59.48949487094339,3238,5929,5628,3539,45980,686774,722920,2985,6825,3587,5375,9215,45.70557952810576,17.920991962353117,3840,1,778580,36421,2089,0,253,1197
7543,0,0,1,0,54,1,807,0,0,3815218,6496182,48.96937818678118,1917,4470,3989,2398,49494,612234,593271,2228,5107,3190,4300,7179,39.88734135035826,22.164950927990496,2879,1,525162,68783,1591,0,311,1118
7544,0,0,0,0,53,1,153,0,0,3407404,5123612,43.86342439892262,1924,3695,3695,1924,55189,641783,609827,2663,4587,2663,4434,6358,42.08325082500163,0.0,1924,0,440596,0,1771,0,739,892
7545,0,0,0,0,53,1,49,0,1,3241200,4885525,42.720018726587654,1675,3751,3601,1825,52664,607679,621064,2527,4502,2827,4453,6428,42.14261501141095,12.30702509692623,1975,1,423400,19350,1776,0,852,901
7546,0,0,0,0,52,1,83,0,1,3132948,4554186,41.58124577258358,1394,3876,3541,1729,53788,595284,626892,2299,4363,2969,4446,6510,42.567593307585526,18.303657551044466,2064,1,411502,39530,1812,0,905,822
7547,0,0,0,0,51,1,126,1,0,2234047,3692841,37.8549864614954,1232,3193,2992,1433,41548,484476,569517,2376,4010,2778,4136,5770,39.48417404479927,14.555844298125802,1634,1,316693,18492,1559,0,1144,1018
7548,0,0,0,0,51,1,66,1,0,2066755,3593990,37.48332962798263,1225,3056,2876,1405,43000,511600,549970,2378,3963,2738,4029,5614,38.353617821530214,13.64881300169067,1585,1,302075,20700,1471,0,1153,1087
7549,0,0,0,0,50,1,0,0,1,1912689,3518352,37.1887079635741,1203,2946,2766,1383,47488,539328,569856,2364,3927,2724,3927,5490,37.1887079635741,13.534510284478205,1563,1,309792,21600,1383,0,1161,1161
7550,0,0,0,0,49,1,79,0,1,1627892,3287368,36.27671429443411,1256,2613,2553,1316,44312,477118,579536,2438,3814,2558,3735,5111,35.17101079013795,7.864259938752337,1376,1,305312,4920,1237,0,1182,1261
7551,0,0,0,0,49,1,172,0,1,694848,2295216,30.397368307141328,864,1736,1676,924,55304,553932,616032,2424,3408,2544,3236,4220,27.422618401604176,7.880145860644973,984,1,229152,5760,752,0,1560,1732
7552,0,0,0,0,50,1,218,1,0,272208,1630680,25.337718918639855,408,1300,1066,642,37170,533400,449580,2306,3182,2774,2964,3840,20.591260281974,15.78933274275226,876,1,113634,39546,424,0,1898,2116
7553,0,1,0,1,66,0,7,0,0,2840898,5641260,41.09744517606904,1138,3922,3371,1689,50750,678020,835000,2789,5029,3891,5022,7262,41.012193308819754,24.037905618209898,2240,1,422250,38019,1682,0,1651,1658
7554,0,0,0,0,56,1,457,1,0,999438,3557598,35.41186241925155,977,2328,2051,1254,45507,558889,655347,2560,4091,3114,3634,5165,28.231188426986208,17.95602912872068,1531,1,289674,25207,797,0,1583,2040
7555,0,0,0,1,66,1,1671,0,0,6364246,11652648,59.10160742314882,2924,5884,5315,3493,45900,680544,750600,2767,6829,3905,5158,9220,42.68489194082609,23.85637281144357,4062,1,785925,61452,1822,0,157,1514
7556,0,0,0,1,66,1,1586,0,0,6824051,11664653,59.3548650070068,3069,5914,5460,3523,45990,695310,725109,2857,6834,3765,5248,9225,44.01136216933077,21.83800155719635,3977,1,771537,55842,1937,0,212,1374
7557,0,0,1,0,63,1,126,0,0,9899640,9726936,55.53377350765928,2934,6444,6294,3084,46652,674956,687572,3004,6238,3304,6364,9598,56.65686189686118,12.24962545775264,3234,1,672312,19500,3210,0,70,56
7558,0,0,0,0,58,1,1848,1,0,1754449,7482433,50.38849074937649,1711,4058,3230,2539,51756,671916,668969,2119,5486,3775,3638,7005,26.28687885618983,29.112752502377166,3367,1,576353,111780,691,0,408,2256
7559,0,0,1,0,54,1,624,0,0,3991140,6311136,48.31148931672465,1969,4409,4044,2334,51282,624624,600288,2339,5038,3069,4414,7113,41.352146256270665,19.129162440471575,2699,1,518148,52925,1710,0,370,994
7560,0,0,0,0,53,1,270,0,0,3843000,5632200,45.8257569495584,2040,3990,3930,2100,50808,622224,587358,2622,4782,2742,4512,6672,42.77849927241488,7.750803389552748,2160,0,459900,8940,1830,0,582,852
7561,0,0,0,0,53,1,231,1,0,3717352,5471631,45.24378410345447,2017,3893,3863,2047,50609,590733,612117,2643,4720,2703,4489,6566,42.61455150532503,5.483301264452448,2077,1,468763,3720,1816,0,626,857
7562,0,0,0,0,53,1,218,1,0,3678360,5416040,45.05552130427524,2000,3872,3842,2030,51520,597632,613640,2638,4698,2698,4480,6540,42.567593307585526,5.483301264452448,2060,1,466900,3810,1812,0,638,856
7563,0,0,0,0,49,1,117,0,1,1582918,3287092,36.30426972134269,1276,2561,2519,1318,44850,486330,573620,2452,3812,2536,3695,5055,34.655446902326915,6.553889165207866,1360,1,303140,3738,1201,0,1176,1293
7564,0,0,0,0,49,1,147,0,1,1021780,2694673,32.96968304366907,1057,2057,2027,1087,55660,570170,599918,2449,3566,2509,3419,4536,30.659419433511783,5.531194905403055,1117,1,263054,3420,940,0,1392,1539
7565,0,0,0,0,49,1,150,0,1,966571,2624914,32.57299494980466,1019,2014,1972,1061,54366,608604,546754,2432,3535,2516,3385,4488,30.18277654557314,6.48074069840786,1103,1,234481,6720,911,0,1413,1563
7566,0,0,0,0,50,1,201,1,0,349300,1772400,26.457513110645905,550,1349,1199,700,35640,557040,410184,2382,3232,2682,3031,3881,22.338307903688676,13.002616415293671,850,1,113400,29400,499,0,1832,2033
7567,0,0,0,0,51,1,224,1,0,193572,1448960,23.790754506740637,247,1227,908,566,37698,527360,468480,2241,3126,2879,2902,3787,18.49324200890693,18.351737857243336,885,1,103578,50721,342,0,1994,2218
7568,0,1,0,1,65,0,14,0,0,2471135,5198068,39.736632972611055,1146,3577,3144,1579,53482,727532,796664,2859,4871,3725,4857,6869,39.56008088970496,21.235820844169442,2012,1,382118,45465,1565,0,1713,1727
7569,0,0,0,0,55,1,456,1,0,1265920,3823904,37.094473981982816,1223,2449,2296,1376,42000,466872,694750,2626,4155,2932,3699,5228,30.331501776206203,13.663929619980625,1529,1,344000,2601,920,0,1403,1859
7570,0,0,1,0,65,1,1480,0,0,7535049,11795236,59.85816569190874,3298,5971,5686,3583,46209,694612,720948,3007,6875,3577,5395,9263,45.858477951192405,17.26219050422444,3868,1,784677,35910,2103,0,291,1189
7571,0,0,1,0,61,1,231,0,0,6932520,8478582,52.44997616777342,2072,5950,5271,2751,34953,588662,564006,2403,5833,3761,5602,9032,50.19960159204453,26.06792294782594,3430,1,503433,95060,2520,0,331,562
7572,0,0,1,0,54,1,850,0,0,3879600,6624600,49.39635614091387,1952,4518,4030,2440,48620,600015,597300,2227,5155,3203,4305,7233,39.87480407475377,22.1224016296024,2928,1,536800,66856,1590,0,275,1125
7573,0,0,1,0,54,1,696,0,0,3991680,6431832,48.744230427815765,1976,4456,4056,2376,48178,598247,590126,2307,5083,3107,4387,7163,40.98780306383839,20.026229605455622,2776,1,517968,55600,1680,0,331,1027
7574,0,0,0,0,53,1,301,0,0,4092162,5854973,46.67976006793523,2052,4184,4057,2179,49268,607262,585766,2560,4866,2814,4565,6871,43.3358973600409,11.280590367767239,2306,0,475022,18161,1878,0,508,809
7575,0,0,0,0,53,1,252,0,0,3904524,5650398,45.89117562233506,2021,4045,3960,2106,49946,606358,592943,2598,4789,2768,4537,6728,43.05810028322197,9.265143265380413,2191,0,465426,11985,1854,0,577,829
7576,0,0,0,0,53,1,239,1,0,3864650,5598520,45.70557952810576,2022,4006,3939,2089,49504,592280,600320,2613,4769,2747,4530,6686,43.01162633521314,8.222029866439447,2156,1,467936,8777,1850,0,591,830
7577,0,0,0,0,53,1,145,1,0,3618056,5248256,44.45222154178574,1946,3837,3807,1976,52664,602912,616192,2626,4632,2686,4487,6493,42.790185790669334,5.483301264452448,2006,1,458432,3840,1831,0,680,825
7578,0,0,0,0,53,1,58,0,1,3469928,5068668,43.497126341863094,1797,3821,3726,1892,53136,659034,578664,2584,4571,2774,4513,6500,42.82522621072771,9.886585106410566,1987,1,408672,15770,1834,0,787,845
7579,0,0,0,0,52,1,269,0,1,3191382,4341340,40.70626487409524,1253,3987,3583,1657,53750,655000,563300,2216,4277,3024,4546,6607,43.88621651498338,20.270734196701532,2061,1,356255,68276,1926,0,963,694
7580,0,0,0,0,49,1,146,0,1,891480,2524500,31.937438845342623,990,1924,1894,1020,51750,618750,512325,2445,3495,2505,3349,4399,29.563490998188964,5.514871952411144,1050,1,211140,5340,874,0,1455,1601
7581,0,0,0,0,49,1,163,0,0,607230,2133090,29.410882339705484,865,1567,1567,865,53312,586908,552384,2466,3331,2466,3168,4033,26.49528259898354,0.0,865,0,193760,0,702,0,1601,1764
7582,0,0,0,0,49,1,170,1,0,527136,2016336,28.5657137141714,786,1492,1462,816,37740,548562,420070,2441,3287,2501,3117,3963,25.41653005427767,5.514871952411144,846,1,138720,5730,646,0,1655,1825
7583,0,0,0,0,51,1,208,1,0,251328,1575112,24.819347291981714,374,1266,1024,616,36366,534413,444918,2315,3173,2799,2965,3823,20.199009876724155,16.20548032945909,858,1,107184,41624,408,0,1941,2149
7584,0,1,1,0,63,0,34,0,0,1502787,3942796,35.25620512760839,1061,2634,2452,1243,51504,704184,735904,2990,4415,3354,4381,5806,34.77067730142742,13.491653849526754,1425,1,288376,22022,1209,0,1929,1963
7585,0,0,1,0,57,1,453,0,0,779530,3274026,33.734255586866,738,2223,1823,1138,41856,627186,552384,2477,4015,3277,3562,5100,26.1725046566048,21.200752636625474,1538,1,218496,65600,685,0,1739,2192
7586,0,0,0,0,57,1,456,1,0,881172,3445884,34.55430508634199,852,2274,1932,1194,42016,582972,600288,2544,4080,3228,3624,5160,27.16615541441225,20.08569761874925,1536,1,248352,43092,738,0,1692,2148
7587,0,0,0,0,61,1,26,1,0,3693915,5994630,43.98863489584554,1679,4100,3844,1935,54036,706344,734226,2842,5033,3354,5007,7198,43.69210454990696,16.122189342008447,2191,1,458595,30976,1909,0,1163,1189
7588,0,0,1,0,61,1,510,0,0,3272904,4840188,39.64845520319802,1512,3714,3654,1572,44650,723565,585010,3019,4651,3139,5161,6793,45.628938186199335,7.750803389552748,1632,0,298680,11100,2082,1,1507,997
7589,0,0,0,1,67,1,631,0,0,1377900,5199276,39.1279950930277,958,3004,2431,1531,42542,811644,604488,2823,4927,3969,4296,6400,30.0,23.99641846920291,2104,1,272518,115173,900,0,1865,2496
7590,0,0,1,0,55,1,2491,0,0,1126862,7954320,53.68426212587819,2852,3303,3273,2882,46010,593400,590640,2730,5642,2790,3151,6063,19.77371993328519,5.478746393072713,2912,1,616748,4050,391,0,122,2369
7591,0,0,1,0,54,1,718,0,0,4028640,6505774,48.96937818678118,1990,4486,4078,2398,45156,577869,575156,2305,5111,3121,4393,7199,40.98780306383839,20.23606863364595,2806,1,508376,55488,1680,0,315,1033
7592,0,0,1,0,53,1,369,0,0,4269510,6097041,47.52893855326458,2043,4365,4149,2259,46656,582984,582984,2483,4958,2915,4589,7064,43.474130238568314,14.731545485687572,2475,1,487944,29376,1890,0,440,809
7593,0,0,1,0,53,1,284,0,0,4149600,5874960,46.73328578219169,2050,4218,4084,2184,47300,591800,578350,2556,4874,2824,4590,6908,43.58898943540674,11.595289322469533,2318,1,469560,18894,1900,0,506,790
7594,0,0,0,0,53,1,155,1,0,3755654,5377322,44.91102314577124,1950,3946,3879,2017,47064,565192,591852,2599,4683,2733,4528,6612,43.15089802078283,8.20759886765899,2084,1,447774,8241,1862,0,649,804
7595,0,0,0,0,52,1,204,0,1,3017196,4291560,40.47221268969612,1314,3804,3480,1638,54492,626180,597360,2296,4258,2944,4462,6424,42.91852746774987,18.236427457834708,1962,1,373464,46980,1842,0,982,778
7596,0,0,0,0,49,1,138,0,0,924535,2551510,32.14031735997639,1033,1928,1928,1033,53325,585390,555750,2470,3503,2470,3365,4398,29.916550603303182,0.0,1033,0,232425,0,895,0,1437,1575
7597,0,0,0,0,49,1,163,1,0,508164,1980721,28.26658805020514,757,1477,1435,799,32116,537943,366892,2437,3278,2521,3115,3956,25.219040425836983,6.609134537568676,841,1,118252,8652,636,0,1680,1843
7598,0,0,0,0,51,1,211,1,0,189126,1422869,23.515952032609693,244,1204,895,553,37948,545476,460567,2264,3126,2882,2915,3777,18.49324200890693,18.186925702552198,862,1,98987,52530,342,0,2020,2231
7599,0,0,0,0,51,1,215,1,0,170346,1375584,23.108440016582687,199,1188,853,534,39405,548688,476560,2241,3110,2911,2895,3764,17.86057109949175,18.85492209236464,869,1,98790,55275,319,0,2042,2257
7600,0,1,0,1,69,0,934,0,0,3338907,8157851,48.507731342539614,1453,4672,3772,2353,50095,745405,807811,2567,5820,4367,4886,8139,37.66961640367472,30.494631944367573,3253,1,548249,100800,1419,0,1114,2048
7601,0,1,0,1,68,0,396,0,0,3427840,7028720,45.387222871640866,1376,4408,3724,2060,54285,788172,801820,2728,5472,4096,5076,7820,40.792156108742276,26.59010991772789,2744,1,484100,86868,1664,0,1352,1748
7602,0,1,0,1,67,0,45,0,0,3252106,6170054,42.731721238442994,1257,4176,3607,1826,53165,733243,827855,2810,5205,3948,5160,7555,42.20189569201838,24.237007845843806,2395,1,447370,54624,1781,0,1553,1598
7603,0,1,1,0,64,0,36,0,0,1742076,4289628,36.578682316343766,1146,2832,2640,1338,52364,679672,791882,3014,4544,3398,4508,6038,36.08323710533743,13.98329739283976,1530,1,330486,16704,1302,0,1868,1904
7604,0,1,1,0,59,0,101,0,0,347322,1918938,25.337718918639855,450,1375,1183,642,47765,612745,696437,2797,3631,3181,3530,4364,23.259406699226016,13.901665601458292,834,1,149586,18816,541,0,2347,2448
7605,0,0,1,0,57,1,446,0,0,754880,3226720,33.46640106136302,696,2218,1794,1120,44814,665511,558914,2457,4001,3305,3555,5099,25.96150997149434,21.741949915525982,1544,1,217280,75048,674,0,1761,2207
7606,0,0,1,0,57,1,448,0,0,803600,3309684,33.88214869219483,753,2243,1848,1148,42750,648675,547770,2488,4031,3278,3583,5126,26.457513110645905,21.161843634139508,1543,1,218120,68730,700,0,1735,2183
7607,0,0,0,0,57,1,455,1,0,959274,3547341,35.11409973215888,927,2317,2011,1233,43432,512106,701988,2571,4110,3183,3655,5194,27.892651361962706,19.19171357925596,1539,1,300852,13770,778,0,1644,2099
7608,0,0,0,1,67,1,1878,0,0,5687248,11854270,59.177698502053964,2913,5715,5126,3502,42560,643150,758240,2796,6887,3974,5009,9100,40.29888335921977,24.291956368564158,4091,1,784448,53010,1624,0,117,1761
7609,0,0,0,1,66,1,1730,0,0,6493256,11905488,59.632206063502295,2996,5942,5382,3556,45526,689688,739908,2788,6904,3908,5174,9290,42.731721238442994,24.272259831741202,4116,1,785876,64960,1826,0,208,1522
7610,0,0,1,0,66,1,1498,0,0,7161840,11695320,59.39696961966999,3166,5920,5558,3528,45114,682890,725985,2953,6843,3677,5345,9235,45.05552130427524,19.4510606146305,3890,1,772632,42716,2030,0,213,1285
7611,0,0,0,0,55,1,2307,1,0,1754730,8054880,53.94441583704471,2720,3703,3513,2910,40600,561904,553600,2578,5678,2958,3371,6471,24.55605831561735,13.949435170761742,3100,1,582000,25840,603,0,142,2165
7612,0,0,1,0,54,1,993,0,0,3864244,6885472,50.23942674832188,2036,4543,4055,2524,48399,602888,597432,2240,5252,3216,4259,7271,39.1279950930277,22.314586250447963,3012,1,552756,67344,1531,0,204,1197
7613,0,0,1,0,54,1,942,0,0,3907183,6823178,50.02999100539596,1985,4582,4064,2503,47957,602446,591542,2208,5229,3244,4287,7308,39.50949253027682,22.985582734771,3021,1,543151,72520,1561,0,223,1165
7614,0,0,1,0,53,1,266,0,0,4213560,5895480,46.79743582719036,2037,4267,4114,2190,48174,597624,584164,2539,4882,2845,4616,6959,43.86342439892262,12.427165892302435,2343,1,475230,21573,1924,0,502,768
7615,0,0,0,0,53,1,151,1,0,3865356,5456853,45.19955751995809,1958,4020,3935,2043,46830,560910,595633,2586,4714,2756,4563,6691,43.497126341863094,9.321211371972165,2128,1,455589,10115,1892,0,628,779
7616,0,0,0,0,53,1,124,1,0,3806460,5351198,44.87761134463375,1972,3946,3904,2014,50576,579226,616424,2615,4671,2699,4547,6603,43.474130238568314,6.488991180673202,2056,1,467248,4914,1890,0,643,767
7617,0,0,0,0,52,1,206,0,1,3215007,4428888,41.14608122288197,1354,3931,3592,1693,51336,648768,541512,2277,4309,2955,4515,6547,43.57751713900185,18.610623549342986,2032,1,350451,60342,1899,0,923,717
7618,0,0,0,0,49,1,126,0,0,1077631,2746470,33.21144381083123,1036,2147,2080,1103,48278,502980,595110,2423,3593,2557,3467,4637,31.25699921617557,8.222029866439447,1170,0,263617,5896,977,0,1387,1513
7619,0,0,0,0,49,1,128,0,0,1018025,2667075,32.78719262151,1033,2064,2022,1075,50032,525972,585516,2439,3556,2523,3428,4545,30.773365106858236,6.5135556243263055,1117,0,253700,4368,947,0,1406,1534
7620,0,0,0,0,49,1,130,0,0,962064,2593800,32.37282811247729,1018,1996,1966,1048,50794,539550,576675,2445,3523,2505,3393,4471,30.298514815086232,5.477225575051661,1078,0,244184,3480,918,0,1427,1557
7621,0,0,0,0,49,1,156,1,0,489532,1945616,27.964262908219126,715,1475,1408,782,27797,519992,330904,2421,3270,2555,3114,3963,25.019992006393608,8.397588990243326,849,1,104006,14137,626,0,1706,1862
7622,0,0,0,0,50,1,171,1,0,350892,1736676,26.153393661244042,534,1347,1197,684,31588,538268,378311,2389,3223,2689,3052,3886,22.64950330581225,13.056526021193557,834,1,101916,30000,513,0,1855,2026
7623,0,0,0,0,51,1,211,0,1,153300,1320935,22.60530911091463,161,1161,811,511,45200,584210,517000,2235,3096,2935,2885,3746,17.320508075688775,19.322605777997165,861,1,102200,57400,300,0,2074,2285
7624,0,1,0,1,68,0,301,0,0,3320762,6734537,44.48595283907045,1372,4264,3657,1979,54289,792899,792899,2796,5382,4010,5081,7667,40.963398296528084,25.106896432688796,2586,1,461107,80124,1678,0,1424,1725
7625,0,1,0,1,67,0,23,0,0,3113328,5962032,42.14261501141095,1252,4053,3529,1776,52961,708327,842607,2833,5133,3881,5110,7410,41.86884283091664,23.204997564920976,2300,1,445776,40348,1753,0,1581,1604
7626,0,0,0,0,56,1,455,1,0,1098500,3692000,36.05551275463989,1058,2387,2145,1300,47564,533920,718520,2598,4140,3082,3685,5227,29.068883707497267,17.16385828484395,1542,1,328900,9922,845,0,1540,1995
7627,0,0,0,0,56,1,457,1,0,1219044,3814428,36.823905279043935,1174,2437,2255,1356,47564,528844,711689,2631,4169,2995,3712,5250,29.9833287011299,15.173270831115888,1538,1,343068,7826,899,0,1457,1914
7628,0,0,1,0,61,1,589,0,0,3674930,6918698,47.265209192385896,1742,4371,3879,2234,53628,761862,675146,2605,5331,3589,4742,7468,40.55859958134649,22.305468352889342,2726,1,487012,80196,1645,0,863,1452
7629,0,0,0,1,68,1,715,0,0,1391250,5425080,39.87480407475377,1079,2976,2465,1590,40775,794996,597100,2901,5002,3923,4287,6388,29.58039891549808,22.71977003110242,2101,1,278250,100667,875,0,1822,2537
7630,0,0,0,1,68,1,2013,0,0,4982110,11857560,58.77924803874238,2855,5497,4897,3455,45024,689832,768768,2832,6887,4032,4874,8929,37.97367509209505,24.611250043543972,4055,1,773920,63600,1442,0,23,1990
7631,0,0,0,1,66,1,1639,0,0,6604926,11750297,59.30430001273095,3004,5908,5395,3517,44220,671541,735020,2828,6858,3854,5219,9249,43.3358973600409,23.288438378862306,4030,1,773740,56943,1878,0,176,1463
7632,0,0,0,1,66,1,1606,0,0,6699291,11719368,59.270566050949775,3028,5905,5420,3513,43860,680544,717240,2851,6849,3821,5243,9241,43.669211121796096,22.612836961147934,3998,1,755295,59170,1907,0,177,1429
7633,0,0,1,0,61,1,867,0,0,4544878,8009630,51.07837115648854,1709,5251,4351,2609,40572,635490,601720,2170,5679,3970,4812,8321,41.737273509418415,30.367283264564584,3509,1,511364,131400,1742,0,461,1328
7634,0,0,1,0,54,1,911,0,0,3988872,6833416,50.039984012787215,1991,4610,4097,2504,46410,603109,573090,2216,5233,3242,4322,7339,39.91240408695021,22.705260506599753,3017,1,525840,75411,1593,0,225,1136
7635,0,0,1,0,54,1,660,0,0,4184284,6533440,49.01020301937138,2026,4520,4144,2402,45582,582080,579360,2344,5122,3096,4462,7240,41.737273509418415,19.45092472863846,2778,1,511626,51136,1742,0,318,978
7636,0,0,1,0,53,1,224,0,0,4194057,5820633,46.50806381693394,2010,4255,4102,2163,48174,597402,583947,2538,4854,2844,4630,6946,44.034077712607996,12.421821630336948,2316,1,469371,21573,1939,0,528,752
7637,0,0,0,0,53,1,87,0,1,3644298,4950498,43.197222132910355,1674,4011,3819,1866,45630,517335,620802,2461,4519,2845,4606,6664,44.19275958796871,14.01927502583177,2058,1,436644,16128,1953,0,787,700
7638,0,0,0,0,51,1,95,0,1,2882646,4290949,40.63249930782009,1423,3625,3397,1651,52041,543191,647151,2371,4250,2827,4345,6224,41.78516483155236,15.307105875285492,1879,1,411099,17784,1746,0,948,853
7639,0,0,0,0,51,1,41,0,1,2677712,4188672,40.19950248448356,1406,3483,3273,1616,52668,653184,541728,2382,4208,2802,4249,6075,40.70626487409524,14.669535104114596,1826,1,337744,36750,1657,0,976,935
7640,0,0,0,0,51,1,103,0,1,2156778,3889197,39.0,1397,3063,2939,1521,54000,552312,639250,2433,4078,2681,3975,5620,37.656340767525464,11.428142902795917,1645,1,380250,10292,1418,0,1036,1139
7641,0,0,0,0,50,1,106,0,1,1904352,3625152,37.86819245752297,1367,2829,2762,1434,56364,583968,616832,2461,3962,2595,3856,5357,36.4417343165772,8.2732738280919,1501,1,349896,7303,1328,0,1094,1200
7642,0,0,0,0,49,1,139,1,0,596570,2091375,29.068883707497267,785,1611,1551,845,38665,517275,457875,2415,3320,2535,3181,4086,26.570660511172846,7.746504550744806,905,1,156325,9660,706,0,1630,1769
7643,0,1,0,1,69,0,1048,0,0,3335424,8411280,49.23413450036468,1508,4716,3800,2424,55328,857090,777280,2554,5894,4386,4846,8186,37.094473981982816,30.759767637995285,3340,1,542976,141064,1376,0,1046,2094
7644,0,1,0,1,68,0,589,0,0,3397092,7399264,46.486557196677836,1461,4433,3733,2161,52851,763552,811488,2724,5585,4124,4996,7857,39.64845520319802,26.936779775493406,2861,1,512157,81200,1572,0,1263,1852
7645,0,1,1,0,64,0,42,0,0,2021643,4668105,37.986839826445156,1227,3060,2844,1443,50676,666410,795810,3019,4678,3451,4636,6295,37.429934544425805,15.058325596438765,1659,1,354978,17280,1401,0,1792,1834
7646,0,1,1,0,63,0,49,0,0,1708956,4254408,36.49657518178932,1205,2742,2615,1332,52272,689904,772948,3067,4526,3321,4477,5936,35.81898937714463,11.377048979465448,1459,1,322344,12573,1283,0,1862,1911
7647,0,0,0,0,56,1,450,1,0,1126600,3716470,36.193922141707716,1070,2410,2170,1310,46620,524845,714924,2597,4147,3077,3697,5247,29.32575659723036,17.06596957644698,1550,1,330120,9600,860,0,1527,1977
7648,0,0,0,0,56,1,454,1,0,1245792,3834362,36.959437225152655,1186,2458,2278,1366,48514,536137,712978,2627,4173,2987,3719,5265,30.199337741083,15.0,1546,1,346964,7740,912,0,1441,1895
7649,0,0,1,0,63,1,657,0,0,1935558,3474756,33.18132004607411,939,3021,2859,1101,53820,738504,725880,2994,4257,3318,4914,6177,41.92851058647326,12.797192222025664,1263,0,253230,22356,1758,1,2055,1398
7650,0,0,0,1,68,1,676,0,0,1438272,5399856,39.7994974842648,1100,2976,2492,1584,39444,777252,589757,2925,4993,3893,4317,6385,30.133038346638727,22.11415352238509,2068,1,274032,94380,908,0,1825,2501
7651,0,0,0,1,67,1,1753,0,0,6151278,11818590,59.21992907797171,2871,5897,5261,3507,43884,697590,714440,2734,6877,4006,5124,9267,41.88078318274385,25.8499955205169,4143,1,743484,81408,1754,0,137,1616
7652,0,0,0,1,66,1,1419,0,0,7094902,11514052,58.872744118140105,3100,5879,5513,3466,42336,651112,717552,2956,6788,3688,5369,9201,45.24378410345447,19.48538243220456,3832,1,748656,39528,2047,0,144,1275
7653,0,0,1,0,66,1,1322,0,0,7386288,11442522,58.80476171195663,3161,5891,5594,3458,43054,681654,691581,3012,6767,3606,5445,9200,46.216880033165374,17.46819034261299,3755,1,722722,38610,2136,0,149,1173
7654,0,0,1,0,65,1,611,0,0,9656676,11295260,58.54912467321779,3007,6666,6245,3428,43780,724900,655705,2874,6723,3716,6112,9961,53.075418038862395,20.666697786173877,3849,1,682172,66518,2817,0,133,478
7655,0,0,1,0,55,1,2714,0,0,799176,8304870,54.607691765904185,2982,3250,3250,2982,46176,618270,579280,2785,5767,2785,3053,6035,16.3707055437449,0.0,2982,1,620256,0,268,0,197,2517
7656,0,0,1,0,54,1,1186,0,0,3801795,7216833,51.29327441292864,2213,4494,4076,2631,48792,625404,587002,2325,5374,3161,4188,7237,38.01315561749642,20.760204205678725,3049,1,563034,63536,1445,0,112,1298
7657,0,0,1,0,54,1,930,0,0,4027375,6903350,50.24937810560445,2001,4644,4120,2525,45333,598746,565938,2210,5259,3258,4329,7378,39.93745109543172,22.95612926259383,3049,1,522675,78076,1595,0,209,1139
7658,0,0,1,0,54,1,631,0,0,4266470,6551220,49.040799340956916,2039,4545,4179,2405,45365,585660,574764,2358,5129,3090,4498,7269,42.118879377305376,19.206232948733852,2771,1,507455,50874,1774,0,319,950
7659,0,0,1,0,54,1,386,0,0,4444440,6264720,48.062459362791664,2052,4492,4234,2310,46225,583080,583080,2454,5022,2970,4636,7204,43.86342439892262,16.12767506825533,2568,1,496650,34830,1924,0,402,788
7660,0,0,0,0,53,1,156,1,0,4122940,5667460,45.93473631142341,1960,4214,4064,2110,47085,577490,588234,2536,4796,2836,4640,6900,44.204072210600685,12.393026621210916,2260,1,462090,19500,1954,0,576,732
7661,0,0,0,0,52,1,75,1,0,3952726,5362822,45.0111097397076,2026,3977,3977,2026,52920,648515,571752,2647,4673,2647,4598,6624,44.170125650715555,0.0,2026,1,437616,0,1951,0,621,696
7662,0,0,0,0,52,1,208,1,0,3637284,4697406,42.49705872175156,1538,4088,3820,1806,54390,577422,637245,2333,4407,2869,4615,6689,44.87761134463375,16.38527348300288,2074,1,442470,27336,2014,0,795,587
7663,0,0,0,0,51,1,98,0,1,2140895,3861176,38.897300677553446,1418,3023,2928,1513,54500,556336,638000,2457,4065,2647,3967,5575,37.61648574760805,9.951904129305408,1608,1,378250,8075,1415,0,1039,1137
7664,0,0,0,0,51,1,204,0,1,107932,1152464,21.118712081942874,38,1096,688,446,53824,599488,599488,2176,3030,2992,2826,3680,15.556349186104045,20.68593000877657,854,1,103472,54264,242,0,2138,2342
7665,0,1,0,1,69,0,930,0,0,3420424,8209492,48.703182647543684,1523,4663,3814,2372,56386,837562,806413,2612,5833,4310,4903,8124,37.97367509209505,29.6493154633733,3221,1,552676,116313,1442,0,1089,2019
7666,0,1,0,1,68,0,746,0,0,3406560,7776432,47.49736834815167,1506,4516,3766,2256,51170,741105,820386,2697,5703,4197,4957,7963,38.8587184554509,27.927286486232187,3006,1,536928,79500,1510,0,1191,1937
7667,0,1,0,1,68,0,540,0,0,3312700,7197210,45.93473631142341,1474,4316,3680,2110,54273,781119,808407,2775,5521,4047,4981,7727,39.6232255123179,25.69901258363408,2746,1,500070,77592,1570,0,1301,1841
7668,0,1,0,1,67,0,235,0,0,3192084,6452856,43.68065933568311,1398,4091,3581,1908,55890,777860,821826,2872,5290,3892,5055,7473,40.90232267243512,23.05038078220444,2418,1,463644,56610,1673,0,1474,1709
7669,0,1,1,0,59,0,125,0,0,311376,1858896,24.979991993593593,557,1190,1123,624,47610,616653,685170,2912,3603,3046,3478,4169,22.338307903688676,8.250220863768833,691,1,143520,7102,499,0,2355,2480
7670,0,0,0,0,57,1,438,1,0,988363,3569982,35.17101079013795,907,2366,2036,1237,47250,545454,721500,2556,4123,3216,3685,5252,28.26658805020514,19.832148744518605,1567,1,309250,16170,799,0,1649,2087
7671,0,0,0,0,56,1,448,1,0,1213200,3801360,36.71511950137164,1138,2458,2248,1348,47564,530160,713460,2610,4168,3030,3720,5278,30.0,16.028488276964655,1558,1,341044,8610,900,0,1472,1920
7672,0,0,1,0,61,1,859,0,0,3565562,7301476,48.641546028061235,1841,4398,3873,2366,51957,774586,638802,2561,5452,3611,4593,7484,38.82009788756334,23.019864117526467,2891,1,489762,93975,1507,0,720,1579
7673,0,0,0,0,61,1,29,1,0,3446382,5660466,42.91852746774987,1692,3863,3713,1842,56404,725228,734447,2923,4915,3223,4944,6936,43.255057507764334,12.291303419254204,1992,1,440238,18750,1871,0,1231,1202
7674,0,0,0,1,67,1,17,0,0,1709484,4423076,36.27671429443411,709,3222,2615,1316,45828,766308,675561,2754,4677,3968,4660,6583,36.0416425818802,24.771675064914348,1923,1,264516,100762,1299,0,2045,2062
7675,0,0,0,1,66,1,1297,0,0,7305068,11370676,58.54912467321779,3109,5878,5559,3428,43255,679985,699887,2998,6745,3636,5448,9195,46.16275555033516,18.121744530788348,3747,1,723308,40513,2131,0,111,1186
7676,0,0,1,0,59,1,1830,0,0,2288599,7992657,51.79768334587948,1633,4586,3536,2683,48840,661338,655380,1929,5662,4029,3832,7565,29.206163733020468,32.73204064655441,3733,1,590260,144900,853,0,296,2126
7677,0,0,1,0,54,1,1359,0,0,3689686,7455448,52.124850119688595,2367,4425,4075,2717,51408,653072,592704,2394,5461,3094,4102,7169,36.851051545376556,19.01016096701585,3067,1,586872,56000,1358,0,27,1386
7678,0,0,1,0,54,1,849,0,0,4152442,6863934,50.05996404313531,2022,4647,4163,2506,44928,591624,569712,2255,5245,3223,4396,7386,40.70626487409524,22.08684820056291,2990,1,521248,69212,1657,0,233,1082
7679,0,0,1,0,54,1,652,0,0,4312128,6628440,49.27473997901968,2044,4588,4204,2428,44726,584220,570570,2346,5158,3114,4506,7318,42.14261501141095,19.685142587227237,2812,1,507452,53760,1776,0,302,954
7680,0,0,1,0,53,1,178,0,0,4306008,5835204,46.54030511288038,1956,4364,4154,2166,47080,592680,576516,2484,4860,2904,4682,7058,44.58699361921591,14.627540818632527,2376,1,463524,30030,1988,0,528,706
7681,0,0,0,0,52,1,59,1,0,4045262,5406609,45.17742799230607,2041,4023,4023,2041,52858,654303,566886,2649,4690,2649,4631,6672,44.51965857910413,0.0,2041,1,436774,0,1982,0,608,667
7682,0,0,0,0,50,1,99,0,0,1566306,3264114,36.08323710533743,1272,2535,2505,1302,46200,579117,501400,2477,3809,2537,3710,5042,34.68429039204925,5.490867587491313,1332,0,260400,5100,1203,0,1205,1304
7683,0,0,0,0,50,1,103,1,0,1286708,3004297,34.45286635390443,1102,2356,2271,1187,40533,579599,447987,2446,3718,2616,3615,4887,32.92415526630866,9.511914438752074,1272,1,210099,16320,1084,0,1344,1447
7684,0,0,0,0,50,1,107,0,1,1094394,2762409,33.18132004607411,951,2245,2095,1101,49776,511836,612196,2359,3610,2659,3503,4754,31.52776554086889,12.401817263524045,1251,1,268644,12150,994,0,1408,1515
7685,0,0,0,0,49,1,123,1,0,570024,2044224,28.61817604250837,699,1635,1515,819,34272,509184,419328,2376,3315,2616,3192,4131,26.38181191654584,11.07142749248319,939,1,137592,20640,696,0,1677,1800
7686,0,0,0,0,57,1,435,1,0,1073116,3658292,35.7211421989835,976,2417,2117,1276,43500,498858,716750,2567,4143,3167,3708,5284,29.0,18.915755688216553,1576,1,319000,7800,841,0,1591,2026
7687,0,0,0,1,68,1,1993,0,0,5274500,12012000,59.16079783099616,2807,5700,5007,3500,45771,717288,751608,2739,6932,4125,4939,9132,38.82009788756334,26.418794833636532,4193,1,766500,84546,1507,0,68,1925
7688,0,0,1,0,66,1,1178,0,0,7515495,11247795,58.249463516842795,3098,5903,5608,3393,43263,692835,686205,3020,6708,3610,5530,9218,47.06378650300037,17.453726409009207,3688,1,702351,40415,2215,0,78,1100
7689,0,0,1,0,54,1,1222,0,0,3878523,7345404,51.70106381884226,2230,4567,4124,2673,47403,629292,568836,2305,5421,3191,4199,7315,38.09199390948182,21.31590233871072,3116,1,553311,70880,1451,0,75,1297
7690,0,0,1,0,54,1,525,0,0,4474386,6535620,48.92851929090027,2052,4605,4263,2394,46224,584220,589680,2388,5124,3072,4599,7335,43.23193264243457,18.595206991496834,2736,1,517104,45486,1869,0,336,861
7691,0,0,0,0,53,1,123,1,0,4291474,5725522,46.195237849804386,2026,4253,4145,2134,45030,509770,635871,2575,4817,2791,4694,6936,44.844174649557324,10.613247510664669,2242,1,505758,7884,2011,0,549,672
7692,0,0,0,0,52,1,56,1,0,4160816,5471928,45.47526800360829,2068,4080,4080,2068,55189,637686,605934,2646,4714,2646,4658,6726,44.85532298401161,0.0,2068,1,473572,0,2012,0,578,634
7693,0,0,0,0,52,1,171,1,0,3891340,4939735,43.46262762420146,1699,4139,3949,1889,48556,520385,638060,2425,4504,2805,4675,6754,45.387222871640866,13.784430565831073,2079,1,460916,14060,2060,0,726,555
7694,0,0,0,0,50,1,95,1,0,1412654,3119714,35.17101079013795,1170,2446,2379,1237,35145,537186,416130,2455,3759,2589,3664,4968,33.793490497431605,8.329212945039274,1304,1,204105,12462,1142,0,1285,1380
7695,0,0,0,0,50,1,98,0,1,1209800,2917550,33.91164991562634,1023,2329,2202,1150,53482,560677,613954,2410,3687,2664,3589,4866,32.43454948045371,11.501304536780918,1277,1,278300,13462,1052,0,1387,1485
7696,0,0,0,0,50,1,119,1,0,476016,1897296,27.422618401604176,590,1547,1385,752,28560,514692,353220,2361,3275,2685,3156,4070,25.15949125081825,12.998520457496102,914,1,105280,32238,633,0,1771,1890
7697,0,0,0,0,50,1,125,1,0,399954,1775712,26.419689627245813,508,1461,1271,698,30528,539328,366336,2354,3242,2734,3117,4005,23.93741840717165,14.266784873633224,888,1,100512,38950,573,0,1846,1971
7698,0,1,0,1,68,0,652,0,0,3238965,7355015,46.42197755374064,1537,4276,3658,2155,51646,740621,812294,2795,5568,4031,4916,7689,38.768543949960254,25.37085029601349,2773,1,512890,66126,1503,0,1258,1910
7699,0,1,1,0,61,0,98,0,0,851375,3003651,31.192947920964443,613,2208,1848,973,41992,558747,716184,2727,4060,3447,3962,5295,29.58039891549808,19.209372712298546,1333,1,225736,24120,875,0,2114,2212
7700,0,0,1,0,58,1,415,0,0,902700,3433800,34.351128074635334,760,2365,1945,1180,44850,669300,567450,2490,4090,3330,3675,5275,27.65863337187866,21.971488574693037,1600,1,230100,73080,765,0,1730,2145
7701,0,0,1,0,58,1,423,0,0,1000774,3579834,35.12833614050059,874,2405,2045,1234,50344,588903,719448,2541,4135,3261,3712,5306,28.478061731796284,20.655813471980228,1594,1,306032,26640,811,0,1667,2090
7702,0,0,0,0,56,1,439,1,0,1277772,3856623,37.027017163147235,1161,2513,2303,1371,45069,509153,700437,2603,4184,3023,3745,5326,30.528675044947494,15.904233963909613,1581,1,341379,8400,932,0,1442,1881
7703,0,0,1,0,64,1,990,0,0,765000,1638630,22.58317958127243,238,2282,2010,510,50880,771120,681156,2941,3723,3485,4713,5495,38.72983346207417,16.539092699776447,782,1,108120,45152,1500,0,2703,1713
7704,0,0,0,1,67,1,53,0,0,1777520,4583200,36.87817782917155,765,3262,2667,1360,44748,761620,667260,2775,4730,3965,4677,6632,36.15245496505044,24.409158439729136,1955,1,269280,99365,1307,0,2010,2063
7705,0,0,0,1,67,1,203,0,0,1730778,4798717,37.69615364994153,890,3170,2639,1421,45113,773333,665269,2846,4798,3908,4595,6547,34.899856733230294,23.07288370094348,1952,1,279937,90801,1218,0,1956,2159
7706,0,0,0,1,68,1,2007,0,0,5116138,11967798,58.974570791146924,2757,5670,4949,3478,47740,746697,757020,2720,6919,4162,4912,9111,38.353617821530214,26.960080228029163,4199,1,765160,94451,1471,0,37,1970
7707,0,0,0,1,67,1,1683,0,0,5935384,11600667,58.47221562417487,2748,5826,5155,3419,42355,668421,729495,2722,6812,4064,5129,9219,41.66533331199932,26.621013266742416,4090,1,735085,75152,1736,0,26,1657
7708,0,0,0,1,67,1,1647,0,0,6027358,11553005,58.42088667591412,2769,5823,5179,3413,42705,660075,741315,2741,6798,4029,5151,9208,42.02380277890139,26.032384256614595,4057,1,747447,66976,1766,0,28,1619
7709,0,0,1,0,64,1,2,0,0,11142243,10744902,57.784080852774665,3177,6838,6676,3339,42840,656472,675780,3056,6557,3380,6555,10056,57.766772456144714,12.751620014469642,3501,1,701190,20574,3337,0,121,119
7710,0,0,1,0,63,1,378,0,0,7681563,9440994,54.47017532558529,2161,6362,5556,2967,36075,620490,588670,2376,6149,3988,5771,9544,50.882216932834204,28.468748074872693,3773,1,548895,114452,2589,0,215,593
7711,0,0,1,0,63,1,628,0,0,6221600,8911028,53.178943201233324,1781,6075,5028,2828,40582,620747,649106,2104,5979,4198,5351,9226,46.9041575982343,32.44153702247639,3875,1,582568,127734,2200,0,323,951
7712,0,0,1,0,55,1,1239,0,0,3919770,7413888,51.90375708944392,2237,4606,4149,2694,46308,624704,561408,2295,5446,3209,4207,7358,38.144462245521304,21.63394963832223,3151,1,549576,74034,1455,0,58,1297
7713,0,0,1,0,54,1,262,0,0,4743963,6295986,48.093658625644196,2018,4659,4364,2313,44520,571620,577064,2427,5035,3017,4773,7381,45.28796749689701,17.302485883351352,2608,1,490356,39235,2051,0,409,671
7714,0,0,1,0,53,1,144,0,0,4472272,5903224,46.776062254106,2013,4407,4232,2188,48400,593560,593560,2523,4886,2873,4742,7105,45.21061822182926,13.43304388518588,2363,1,481360,23625,2044,0,510,654
7715,0,0,0,0,53,1,132,1,0,4439308,5858930,46.62617290749907,2024,4366,4216,2174,47897,568645,611765,2545,4869,2845,4737,7061,45.18849411078001,12.502807054311965,2324,1,493498,17250,2042,0,521,653
7716,0,0,0,0,51,1,127,1,0,3784830,4886385,43.393547907494266,1693,4083,3893,1883,51832,542355,643560,2405,4478,2785,4605,6678,44.83302354291979,13.784048752090222,2073,1,466984,15390,2010,0,712,585
7717,0,0,0,0,51,1,62,0,1,2626680,4229120,40.64480286580315,1562,3332,3242,1652,55304,634880,570880,2470,4212,2650,4150,5892,39.87480407475377,9.552038418812673,1742,1,368396,13320,1590,0,908,970
7718,0,0,0,0,49,1,99,1,0,790540,2341540,30.659419433511783,790,1931,1781,940,40392,538056,465817,2341,3431,2641,3332,4422,29.0,12.30702509692623,1090,1,175780,24900,841,0,1551,1650
7719,0,0,0,0,49,1,100,1,0,738821,2272945,30.18277654557314,761,1872,1722,911,35616,528940,419160,2345,3406,2645,3306,4367,28.478061731796284,12.331628572798303,1061,1,153048,27150,811,0,1584,1684
7720,0,0,0,0,51,1,114,1,0,391135,1748120,26.1725046566048,469,1472,1256,685,31390,548680,372592,2336,3237,2768,3123,4024,23.895606290697042,15.154270372012492,901,1,100010,44280,571,0,1867,1981
7721,0,0,0,0,51,1,123,1,0,290524,1560736,24.576411454889016,346,1343,1085,604,32376,550392,392768,2326,3188,2842,3065,3927,21.93171219946131,16.81897932706518,862,1,91808,51084,481,0,1980,2103
7722,0,0,1,0,58,1,406,0,0,978891,3528617,34.828149534535996,823,2410,2020,1213,50268,619617,686524,2519,4122,3299,3716,5319,28.407745422683583,21.362700800940438,1603,1,286268,40950,807,0,1696,2102
7723,0,0,0,0,56,1,428,1,0,1195200,3780816,36.4417343165772,1058,2498,2228,1328,42484,489684,703209,2577,4175,3117,3747,5345,30.0,17.937475041485726,1598,1,328016,8100,900,0,1519,1947
7724,0,0,0,0,55,1,437,1,0,1371930,3943770,37.54996671103717,1230,2563,2383,1410,41002,464302,690859,2617,4207,2977,3770,5360,31.192947920964443,14.80358301250448,1590,1,348270,3960,973,0,1387,1824
7725,0,0,1,0,63,1,789,0,0,1113372,2329224,27.055498516937366,702,2283,2253,732,47530,779590,617308,3152,3914,3212,4703,5465,39.0,5.623413251903491,762,0,142008,5670,1521,1,2450,1661
7726,0,0,0,1,67,1,309,0,0,1920760,4173840,35.21363372331802,550,3479,2789,1240,44038,764082,653004,2676,4606,4056,4915,6845,39.35733730830886,26.391459846837847,1930,1,240560,118680,1549,0,2126,1817
7727,0,0,0,1,67,1,26,0,0,1843995,4535340,36.6742416417845,721,3340,2716,1345,45426,762072,677772,2748,4717,3996,4743,6712,37.027017163147235,24.997439606690023,1969,1,270345,102336,1371,0,2027,2001
7728,0,0,0,1,67,1,472,0,0,1668273,5257306,39.35733730830886,1132,3043,2626,1549,47436,800984,682194,2977,4943,3811,4471,6437,32.817678162843876,20.50881419446748,1966,1,311349,72558,1077,0,1845,2317
7729,0,0,0,1,68,1,2021,0,0,4964252,11916279,58.7962583843564,2707,5643,4893,3457,50400,775575,772128,2697,6904,4197,4883,9090,37.89459064299283,27.50228296137806,4207,1,774368,101250,1436,0,10,2011
7730,0,0,0,1,67,1,1451,0,0,6414240,11329920,57.96550698475775,2826,5803,5269,3360,41800,674400,704748,2838,6732,3906,5281,9175,43.69210454990696,23.557137673268723,3894,1,702240,65682,1909,0,12,1463
7731,0,0,1,0,63,1,532,0,0,6941148,9263606,53.98147830506312,1957,6253,5296,2914,42228,658053,648516,2222,6093,4136,5561,9432,48.80573736764972,31.029865176018212,3871,1,594456,131109,2382,0,265,797
7732,0,0,1,0,58,1,2355,0,0,1461150,8443155,53.52569476429054,2202,4038,3375,2865,47424,612976,671916,2284,5812,3610,3457,6985,22.58317958127243,26.06792294782594,3528,1,653220,72930,510,0,82,2437
7733,0,0,1,0,54,1,238,0,0,4839048,6327450,48.187135212627034,2009,4719,4406,2322,46434,580425,594050,2412,5047,3038,4809,7444,45.65084884205331,17.822008628018427,2635,1,506196,40377,2084,0,403,641
7734,0,0,1,0,54,1,178,0,0,4700979,6126408,47.52893855326458,1991,4608,4340,2259,50167,599352,615624,2444,4971,2980,4793,7320,45.617978911828175,16.559115417025907,2527,1,512793,34036,2081,0,453,631
7735,0,0,0,0,52,1,51,1,0,4398856,5602597,46.07602413403309,2063,4255,4195,2123,52514,572663,638638,2579,4762,2699,4711,6894,45.51922670696417,7.765259411425052,2183,1,513766,6000,2072,0,516,567
7736,0,0,0,0,52,1,5,0,0,4320156,5420436,45.56314299957807,2076,4157,4157,2076,51865,660583,535255,2611,4687,2611,4692,6768,45.617978911828175,0.0,2076,0,425580,0,2081,0,535,530
7737,0,0,0,0,51,1,86,1,0,3750120,4890308,43.520110293977886,1719,4049,3874,1894,52819,570622,617098,2407,4476,2757,4562,6631,44.49719092257398,13.241804011448092,2069,1,452666,19250,1980,0,688,602
7738,0,0,0,0,50,1,82,1,0,1613760,3312800,36.22154055254967,1227,2627,2542,1312,35659,532775,426725,2440,3837,2610,3755,5152,35.07135583350036,9.265143265380413,1397,1,221728,15215,1230,0,1213,1295
7739,0,0,0,0,49,1,90,0,1,891000,2472030,31.464265445104548,800,2080,1890,990,47064,554334,529364,2307,3487,2687,3397,4577,30.0,13.853116346949227,1180,1,209880,27930,900,0,1507,1597
7740,0,1,1,0,66,0,235,0,0,3025986,6165493,43.139309220245984,1499,3849,3487,1861,54750,725547,828250,2951,5174,3675,4939,7162,40.32369030731191,19.254464580462663,2223,1,465250,30770,1626,0,1452,1687
7741,0,0,1,0,58,1,383,0,0,958334,3468313,34.48187929913333,768,2416,1995,1189,50778,682578,632989,2496,4106,3338,3723,5333,28.39013913315678,22.070332556209436,1610,1,258013,64834,806,0,1728,2111
7742,0,0,1,0,58,1,398,0,0,1060800,3620448,35.32704346531139,887,2459,2098,1248,49053,571497,722349,2540,4149,3262,3751,5360,29.154759474226502,20.676235757344756,1609,1,310752,23104,850,0,1653,2051
7743,0,0,0,0,56,1,424,1,0,1286772,3869878,36.959437225152655,1124,2550,2308,1366,43610,504274,694085,2591,4199,3075,3775,5383,30.692018506445613,17.04884263360742,1608,1,334670,10164,942,0,1467,1891
7744,0,0,0,1,67,1,508,0,0,2032188,4015422,34.55430508634199,459,3631,2896,1194,43979,743223,669237,2628,4557,4098,5065,6994,41.255302689472536,27.21645541490373,1929,1,237606,116865,1702,0,2169,1661
7745,0,0,0,1,68,1,536,0,0,1678505,5409400,39.88734135035826,1215,3022,2646,1591,47637,805800,683400,3024,4991,3776,4455,6422,32.48076353782343,19.51706948389328,1967,1,319791,66176,1055,0,1809,2345
7746,0,0,1,0,63,1,500,0,0,7363125,9496200,54.543560573178574,2051,6374,5450,2975,46224,683088,689472,2268,6167,4116,5667,9566,49.749371855331,30.487761987022076,3899,1,642600,122892,2475,0,217,717
7747,0,0,1,0,57,1,2596,0,0,1638525,8922939,55.86591089385369,2905,3862,3646,3121,39179,551787,580377,2643,5980,3075,3384,6721,22.9128784747792,15.165535868158557,3337,1,633563,26136,525,0,262,2334
7748,0,0,1,0,55,1,1575,0,0,3691696,7893184,53.51635264103861,2525,4492,4153,2864,40779,570492,542932,2417,5620,3095,4045,7248,35.90264614203248,18.578894417414798,3203,1,564208,49155,1289,0,108,1467
7749,0,0,0,0,53,1,125,1,0,4681154,6003992,47.19110085598767,2035,4521,4329,2227,55418,617384,652432,2504,4923,2888,4798,7217,45.8475735453906,14.059477767970847,2419,1,538934,21888,2102,0,469,594
7750,0,0,0,0,52,1,23,1,0,4479440,5573232,46.130250378683186,2086,4275,4233,2128,47034,526419,612846,2577,4747,2661,4724,6894,45.880278987817846,6.570697549716149,2170,1,497952,3864,2105,0,491,514
7751,0,0,0,0,50,1,75,1,0,1760850,3452085,36.945906403822335,1298,2722,2655,1365,37948,536148,452691,2462,3894,2596,3819,5251,35.91656999213594,8.230562448445415,1432,1,244335,11390,1290,0,1164,1239
7752,0,1,0,1,68,0,717,0,0,3095298,7355910,46.411205543489174,1613,4132,3591,2154,50718,730810,809355,2874,5569,3956,4852,7547,37.907782842049734,23.891280995358315,2695,1,510498,56805,1437,0,1261,1978
7753,0,1,0,1,67,0,498,0,0,3046168,6764344,44.85532298401161,1588,3950,3526,2012,51359,682486,850586,2938,5374,3786,4876,7312,38.91015291668744,21.052068204565593,2436,1,509036,25864,1514,0,1350,1848
7754,0,1,1,0,64,0,78,0,0,2026255,4712323,38.24918299781056,1339,2972,2848,1463,50250,647421,805250,3097,4684,3345,4606,6193,37.21558813185679,11.64690025978279,1587,1,365750,8432,1385,0,1758,1836
7755,0,0,1,0,57,1,391,0,0,1144436,3697606,35.81898937714463,948,2510,2175,1283,44571,515878,717618,2547,4165,3217,3774,5392,29.866369046136157,19.88415360203658,1618,1,319467,12395,892,0,1599,1990
7756,0,0,0,1,67,1,695,0,0,2148786,3897717,34.044089061098404,359,3813,3013,1159,41610,736497,638970,2563,4522,4163,5217,7176,43.05810028322197,28.37732588957875,1959,1,220210,133600,1854,0,2204,1509
7757,0,0,0,1,68,1,549,0,0,1713556,5484024,40.149719799769464,1262,3025,2675,1612,47908,802872,690606,3052,5014,3752,4465,6427,32.60368077380221,18.858016923437496,1962,1,327236,60200,1063,0,1790,2339
7758,0,0,0,1,67,1,2273,0,0,1020288,9025829,51.54609587543949,2657,3041,3041,2657,54366,835662,750737,3397,6054,3397,3781,6438,19.595917942265423,0.0,2657,1,587197,0,384,0,740,3013
7759,0,0,0,1,68,1,2301,0,0,1374156,9496200,52.848841046895245,2708,3370,3285,2793,52080,843200,714000,3315,6193,3485,3892,6770,22.181073012818835,9.235136611923052,2878,1,586530,14790,492,0,607,2908
7760,0,0,0,1,69,1,3020,0,0,1239276,11702016,58.18934610390462,2544,4594,3752,3386,54467,867456,749952,2614,6842,4298,3822,8050,19.131126469708992,29.05776314368637,4228,1,734762,137246,366,0,70,3090
7761,0,0,0,1,68,1,1788,0,0,5291788,11561918,57.982756057296896,2538,5760,4936,3362,44075,704995,739385,2615,6801,4263,5013,9199,39.67366884975475,28.79063174949501,4186,1,722830,99704,1574,0,77,1865
7762,0,0,1,0,63,1,746,0,0,6231447,9180593,53.823786563191554,1773,6172,5048,2897,43054,652814,662321,2045,6066,4293,5320,9341,46.37887450122092,34.10787146413522,4021,1,605473,146120,2151,0,272,1018
7763,0,0,1,0,62,1,1102,0,0,4794963,8800597,53.0,1697,5628,4516,2809,40200,629733,626600,2021,5942,4245,4840,8761,41.31585652022719,33.8069308022997,3921,1,561800,149008,1707,0,324,1426
7764,0,0,1,0,55,1,1590,0,0,3736075,7977025,53.71219600798314,2524,4541,4180,2885,42600,588945,553000,2404,5650,3126,4060,7306,35.98610843089316,19.176133117591966,3246,1,577000,53789,1295,0,120,1470
7765,0,0,1,0,55,1,1188,0,0,4158540,7528860,52.1344415909483,2167,4799,4248,2718,45305,612170,567850,2219,5488,3321,4300,7569,39.11521443121589,23.72926773689994,3269,1,557190,84303,1530,0,52,1240
7766,0,0,0,0,52,1,34,1,0,4622211,5707878,46.551047249229526,2082,4385,4300,2167,47637,529434,624258,2549,4801,2719,4767,7019,46.184412955021955,9.412769291411893,2252,1,513579,7480,2133,0,467,501
7767,0,0,0,0,52,1,58,0,0,4485083,5464824,45.70557952810576,2089,4236,4236,2089,54531,651384,572904,2616,4705,2616,4763,6852,46.33573135281238,0.0,2089,0,457491,0,2147,0,527,469
7768,0,0,0,0,51,1,7,0,1,2939498,4380900,41.44876355212541,1676,3471,3429,1718,54612,566100,627300,2508,4268,2592,4261,6021,41.36423575989287,6.538739683827756,1760,1,422628,4200,1711,0,832,839
7769,0,0,0,0,51,1,71,1,0,1456796,3173379,35.25620512760839,1081,2577,2415,1243,47025,574425,533577,2391,3796,2715,3725,5130,34.23448553724738,12.917631945094628,1405,1,259787,24786,1172,0,1310,1381
7770,0,0,0,0,51,1,79,1,0,491946,1898036,27.23967694375247,474,1673,1405,742,40443,565318,468114,2290,3300,2826,3221,4231,25.748786379167466,16.795177980486653,1010,1,135786,47436,663,0,1816,1895
7771,0,1,0,1,68,0,710,0,0,3042375,7278215,46.20606020859169,1636,4059,3560,2135,53966,760207,824978,2910,5544,3908,4834,7468,37.749172176353746,23.002793934854957,2634,1,516670,54391,1425,0,1274,1984
7772,0,0,0,1,67,1,508,0,0,2149628,4165984,35.12833614050059,434,3776,2976,1234,41447,732592,644816,2576,4610,4176,5118,7152,41.737273509418415,28.405302364843592,2034,1,235694,130400,1742,0,2142,1634
7773,0,0,0,1,68,1,661,0,0,1701140,5710132,40.93897898091744,1381,2986,2691,1676,49504,810866,708656,3112,5083,3702,4422,6393,31.85906464414798,17.399306263874642,1971,1,348608,49855,1015,0,1731,2392
7774,0,0,0,1,68,1,1563,0,0,1119798,7165449,45.79301256742124,1651,3077,2631,2097,55552,847416,765408,2971,5514,3863,3951,6494,23.108440016582687,21.42723370542782,2543,1,469728,68684,534,0,1320,2883
7775,0,0,0,1,67,1,2099,0,0,804330,8244990,49.29503017546495,2158,3033,2761,2430,55144,827892,766818,3121,5823,3665,3724,6426,18.193405398660254,16.49292404683106,2702,1,549180,41072,331,0,963,3062
7776,0,0,0,1,69,1,2222,0,0,4166655,11864490,58.60887304837041,2582,5501,4648,3435,55842,849684,784058,2601,6889,4307,4667,8955,34.828149534535996,29.31617622723006,4288,1,779745,127097,1213,0,19,2241
7777,0,0,0,1,67,1,1109,0,0,6942086,10942390,56.9824534396335,2790,5842,5385,3247,40602,677370,680740,2913,6617,3827,5508,9212,46.238512086787566,21.80378614880668,3704,1,655894,59867,2138,0,123,1232
7778,0,0,0,1,67,1,984,0,0,7314937,10870314,56.929781309961136,2817,5922,5498,3241,43239,680862,714402,2930,6595,3778,5611,9276,47.50789408087881,20.959932987892294,3665,1,690333,51304,2257,0,113,1097
7779,0,0,1,0,66,1,863,0,0,7701480,10828080,56.92099788303083,2816,6041,5617,3240,43260,701820,688452,2918,6582,3766,5719,9383,48.75448697299562,20.888544615412293,3664,1,667440,58936,2377,0,102,965
7780,0,0,1,0,63,1,626,0,0,7063007,9549855,54.67174773134658,1944,6397,5352,2989,47294,706095,683730,2150,6184,4240,5558,9592,48.61069841094653,32.42221137916648,4034,1,639646,149435,2363,0,206,832
7781,0,0,0,0,57,1,2612,1,0,1232160,8748940,54.954526656136345,2546,3902,3428,3020,52192,648928,675001,2423,5917,3371,3305,6799,20.199009876724155,22.005186933172943,3494,1,703660,57828,408,0,123,2489
7782,0,0,1,0,55,1,1755,0,0,3612736,8238583,54.506880299646575,2652,4506,4187,2971,45492,618379,565692,2454,5744,3092,3989,7279,34.87119154832539,18.006383777357115,3290,1,606084,49764,1216,0,198,1557
7783,0,0,1,0,55,1,1704,0,0,3671505,8174628,54.30469592954186,2610,4533,4194,2949,45980,609840,579348,2433,5721,3111,4017,7305,35.2845575287547,18.554481677935737,3288,1,616341,50172,1245,0,177,1527
7784,0,0,1,0,55,1,1655,0,0,3727344,8113488,54.11099703387473,2567,4562,4201,2928,45540,609620,573597,2410,5699,3132,4044,7333,35.679125549822544,19.152157198945847,3289,1,606096,54150,1273,0,157,1498
7785,0,0,1,0,55,1,672,0,0,4709520,6975660,50.3189825016365,2048,4876,4392,2532,43659,636405,520695,2271,5287,3239,4615,7631,43.12771730569565,22.163825885740945,3016,1,478548,88088,1860,0,223,895
7786,0,0,1,0,54,1,256,0,0,5064132,6505242,48.80573736764972,1991,4899,4508,2382,49450,587165,628130,2340,5113,3122,4857,7630,46.10856753359401,19.962708329438467,2773,1,547860,45356,2126,0,349,605
7787,0,0,0,0,52,1,84,0,0,4573557,5468976,45.79301256742124,2097,4278,4278,2097,55822,644176,589408,2608,4705,2608,4789,6886,46.70117771534247,0.0,2097,0,473922,0,2181,0,511,427
7788,0,0,0,0,50,1,4,0,0,2544021,4070753,39.96248240537617,1567,3220,3190,1597,48952,591368,537839,2519,4146,2579,4142,5769,39.91240408695021,5.501408174353464,1627,0,336967,4770,1593,0,952,956
7789,0,0,0,0,50,1,27,1,0,1950030,3574350,37.54996671103717,1343,2860,2793,1410,37558,534885,451230,2468,3945,2602,3918,5395,37.1887079635741,8.19672545160342,1477,1,250980,11390,1383,0,1125,1152
7790,0,0,1,0,58,1,354,0,0,1154592,3676464,35.58089374931439,887,2557,2178,1266,45140,537240,708576,2525,4170,3283,3816,5461,30.199337741083,21.080093478077703,1645,1,308904,20845,912,0,1638,1992
7791,0,0,1,0,57,1,362,0,0,1208235,3741255,35.98610843089316,944,2579,2228,1295,41796,496908,702027,2538,4184,3240,3822,5468,30.54504869860253,20.314085984018725,1646,1,314685,12987,933,0,1594,1956
7792,0,0,0,1,67,1,185,0,0,2095394,4606336,36.851051545376556,656,3603,2901,1358,42532,736064,664832,2690,4750,4094,4935,6995,39.28103868280471,26.532958171205816,2060,1,266168,110916,1543,0,2034,1849
7793,0,0,0,1,68,1,425,0,0,1857864,5417576,39.89987468652001,1231,3120,2759,1592,47234,769078,711227,3042,4995,3764,4570,6523,34.161381705077446,19.147564871653366,1953,1,332728,55955,1167,0,1811,2236
7794,0,0,0,1,68,1,1020,0,0,1540864,6317172,43.034869582700026,1605,2931,2684,1852,54168,832284,757242,3164,5263,3658,4243,6342,28.844410203711913,16.039950221539115,2099,1,411144,38779,832,0,1559,2579
7795,0,0,0,1,68,1,1700,0,0,1067744,7454516,46.776062254106,1700,3164,2676,2188,56350,834715,783610,2919,5595,3895,3895,6571,22.090722034374522,22.43350969034116,2676,1,503240,69784,488,0,1219,2919
7796,0,0,0,1,68,1,1745,0,0,1038366,7538670,47.05316142407437,1715,3182,2683,2214,56386,824010,793365,2906,5619,3904,3874,6587,21.656407827707714,22.403422487052303,2713,1,515862,68862,469,0,1191,2936
7797,0,0,0,1,67,1,1831,0,0,980312,7695336,47.58150901348127,1794,3167,2697,2264,56400,815760,798765,2929,5663,3869,3832,6566,20.808652046684813,21.70947695756209,2734,1,532040,62980,433,0,1135,2966
7798,0,0,0,1,67,1,2282,0,0,1420619,9472654,52.82991576748916,2761,3330,3300,2791,52948,828136,736498,3364,6185,3424,3903,6724,22.561028345356956,5.478746393072713,2821,1,605647,4890,509,0,603,2885
7799,0,0,0,1,68,1,2318,0,0,3850560,11857662,58.63446085707619,2536,5460,4558,3438,56350,845005,793270,2547,6887,4351,4569,8909,33.46640106136302,30.125177313314058,4340,1,790740,127182,1120,0,11,2329
7800,0,0,0,1,68,1,2197,0,0,4117854,11737076,58.360945845659494,2523,5498,4615,3406,55822,851162,778796,2563,6852,4329,4655,8944,34.77067730142742,29.80456143222911,4289,1,769756,131567,1209,0,40,2237
7801,0,0,0,1,67,1,1146,0,0,6683575,10896643,56.753854494650845,2711,5806,5296,3221,42849,700281,700281,2873,6604,3893,5458,9189,45.552167895721496,23.020417441958713,3731,1,666747,68340,2075,0,162,1308
7802,0,0,1,0,63,1,773,0,0,6488970,9434192,54.433445601027316,1775,6341,5153,2963,49032,722768,687744,1996,6147,4372,5374,9525,46.79743582719036,34.56852995834687,4151,1,640008,177012,2190,0,221,994
7803,0,0,1,0,63,1,907,0,0,5873028,9221121,54.0277706369604,1749,6101,4931,2919,46652,676026,688662,1989,6078,4329,5171,9260,44.85532298401161,34.7189357040842,4089,1,636342,153270,2012,0,240,1147
7804,0,0,0,0,52,1,48,1,0,4747465,5626705,46.42197755374064,2088,4425,4358,2155,50525,561365,613585,2544,4766,2678,4814,7036,46.93612681080534,8.19263674150144,2222,1,506425,7370,2203,0,456,408
7805,0,0,0,0,50,1,15,0,0,2710906,4164699,40.48456495999432,1609,3323,3293,1639,47959,612381,505659,2511,4180,2571,4195,5864,40.66939881532551,5.477225575051661,1669,0,326161,5430,1654,0,902,887
7806,0,0,0,0,51,1,8,0,0,2436705,3970350,39.45883931389772,1497,3182,3122,1557,50167,563550,578850,2490,4107,2610,4115,5732,39.56008088970496,7.759379671981613,1617,0,353439,7620,1565,0,993,985
7807,0,1,1,0,65,0,2332,0,0,2096325,9858475,55.0,2863,3880,3718,3025,54984,756088,772383,3097,6284,3421,3952,7139,26.324893162176366,12.727922061357855,3187,0,716925,20412,693,1,234,2566
7808,0,1,1,0,65,0,2318,0,0,2027615,9736745,54.72659317004851,2887,3780,3672,2995,54755,757483,763985,3143,6246,3359,3928,7031,26.019223662515376,10.392527581411793,3103,0,703825,13824,677,1,256,2574
7809,0,1,1,0,59,0,50,0,0,380064,1905456,25.337718918639855,575,1301,1234,642,44226,560952,694512,2901,3610,3035,3560,4269,24.331050121192877,8.314029025396882,709,1,150228,5159,592,0,2326,2376
7810,0,0,1,0,57,1,356,0,0,1300032,3828168,36.49657518178932,997,2643,2308,1332,43011,508698,698382,2539,4206,3209,3850,5517,31.240998703626616,19.77850379907951,1667,1,323676,15075,976,0,1542,1898
7811,0,0,1,0,60,1,807,0,0,3089800,6724729,46.97871858618538,1949,3865,3607,2207,53599,752609,661199,2789,5254,3305,4447,6912,37.416573867739416,16.194013327585786,2465,1,478919,42828,1400,0,840,1647
7812,0,0,1,0,62,1,409,0,0,2100012,3912972,35.482389998420345,1192,2994,2927,1259,53680,758352,683760,3041,4367,3175,4776,6102,40.84115571332428,8.18535277187245,1326,1,276980,10653,1668,0,1849,1440
7813,0,0,0,1,67,1,862,0,0,2247839,3805859,33.60059523282288,255,3994,3120,1129,42924,738249,660716,2497,4500,4245,5362,7365,44.62062303464621,29.704142872012305,2003,1,221284,141588,1991,0,2242,1380
7814,0,0,0,1,67,1,698,0,0,2327424,4108864,34.87119154832539,305,4041,3130,1216,42432,746759,648768,2468,4595,4290,5293,7420,43.749285708454714,30.288271985530063,2127,1,233472,152137,1914,0,2163,1465
7815,0,0,0,1,68,1,60,0,0,2058325,4986860,38.27531841800928,913,3422,2870,1465,43979,752284,677396,2852,4869,3956,4809,6826,37.48332962798263,23.57570397142689,2017,1,291535,87768,1405,0,1939,1999
7816,0,0,0,1,68,1,633,0,0,1805608,5785073,41.19465984809196,1439,3019,2761,1697,50955,807933,732935,3151,5106,3667,4473,6428,32.61901286060018,16.35015334740438,1955,1,364855,41280,1064,0,1712,2345
7817,0,0,0,1,68,1,927,0,0,1641574,6224834,42.731721238442994,1616,2935,2725,1826,55860,835205,777252,3199,5235,3619,4308,6344,29.9833287011299,14.878152983881654,2036,1,416328,31080,899,0,1583,2510
7818,0,0,0,1,68,1,1649,0,0,1157580,7412000,46.69047011971501,1734,3157,2711,2180,56069,839800,771800,2954,5580,3846,3931,6557,23.043437243605826,21.4671462113237,2626,1,494860,66454,531,0,1220,2869
7819,0,0,0,1,67,1,1781,0,0,1068870,7660235,47.486840282335066,1797,3187,2729,2255,56394,818677,794898,2939,5652,3855,3871,6584,21.77154105707724,21.454702216774596,2713,1,527670,62288,474,0,1142,2923
7820,0,0,0,1,67,1,2392,0,0,1331828,9700052,53.46026561849464,2768,3414,3324,2858,53352,838318,733104,3304,6252,3484,3860,6808,21.587033144922902,9.48712577043745,2948,1,617328,14940,466,0,536,2928
7821,0,0,0,1,69,1,3007,0,0,1733490,12123924,59.177698502053964,2523,4976,3997,3502,50298,862038,699324,2483,6964,4441,3957,8438,22.24859546128699,31.591716833312166,4481,1,707404,180136,495,0,40,2967
7822,0,0,0,1,68,1,2375,0,0,3627624,11812944,58.58327406350724,2483,5438,4489,3432,56350,843290,791660,2493,6874,4391,4499,8880,32.51153641401772,30.87954037178171,4381,1,789360,133809,1057,0,10,2385
7823,0,0,0,1,68,1,2334,0,0,3718627,11775082,58.489315263559035,2481,5448,4508,3421,55822,850174,777892,2502,6863,4382,4529,8890,32.96968304366907,30.734172003751024,4361,1,773146,139120,1087,0,21,2355
7824,0,0,0,1,68,1,2172,0,0,4073868,11613564,58.12056434688156,2466,5496,4584,3378,55822,849186,776988,2526,6816,4350,4644,8934,34.72751070837067,30.270982198850188,4290,1,763428,136800,1206,0,60,2232
7825,0,0,0,1,68,1,1528,0,0,5556788,11110334,56.938563381947034,2474,5724,4956,3242,53590,788210,798491,2659,6669,4195,5141,9151,41.400483088968905,28.21689996848226,4010,1,755386,99072,1714,0,185,1713
7826,0,0,0,1,68,1,1492,0,0,5643584,11073592,56.88585061331157,2491,5725,4980,3236,52875,769950,804170,2677,6658,4167,5166,9147,41.7612260356422,27.778382177606893,3981,1,760460,90145,1744,0,186,1678
7827,0,0,0,1,68,1,1422,0,0,5819704,11007112,56.79788728465171,2526,5730,5030,3226,51302,771112,774524,2712,6638,4112,5216,9142,42.473521163190604,26.884427462449448,3926,1,732302,93100,1804,0,186,1608
7828,0,0,0,1,67,1,1086,0,0,6706467,10804332,56.471231613982,2665,5816,5292,3189,43888,704704,714868,2864,6577,3912,5491,9204,45.858477951192405,23.34036052746423,3713,1,672879,68120,2103,0,199,1285
7829,0,0,1,0,65,1,148,0,0,10414508,10338812,56.16048432839589,2907,6703,6456,3154,39984,668712,642488,3031,6432,3525,6580,9981,57.463031594234565,15.907526592507436,3401,1,618184,35074,3302,0,124,24
7830,0,0,0,0,51,1,49,1,0,3730092,4918153,43.669211121796096,1840,3930,3863,1907,55692,613802,603486,2512,4486,2646,4535,6509,44.22668877499196,8.250220863768833,1974,1,446238,9045,1956,0,672,623
7831,0,0,0,0,51,1,6,1,0,1918216,3525482,37.17526059088221,1258,2894,2770,1382,40950,573975,464282,2427,3933,2675,3939,5445,37.255872020394314,11.187488446066107,1506,1,251524,22692,1388,0,1169,1163
7832,0,0,0,0,51,1,3,1,0,1840090,3462025,36.810324638611924,1221,2847,2713,1355,42408,582540,475230,2421,3910,2689,3913,5402,36.851051545376556,11.627706147355314,1489,1,252030,24388,1358,0,1200,1197
7833,0,0,0,0,52,1,41,0,1,191862,1197531,21.42428528562855,5,1331,877,459,55695,618333,613115,2155,3068,3063,3027,3940,20.445048300260872,21.763420977649012,913,1,107865,60382,418,0,2150,2191
7834,0,1,0,1,66,0,686,0,0,2913432,6970980,45.65084884205331,1708,3858,3482,2084,46482,612135,849630,2969,5429,3721,4743,7203,37.389838191679836,19.80723086975197,2460,1,529336,9400,1398,0,1261,1947
7835,0,0,1,0,57,1,342,0,0,1334983,3852303,36.59234892706397,989,2686,2336,1339,48443,555261,722127,2527,4216,3227,3874,5563,31.575306807693888,20.139930840177716,1689,1,336089,18900,997,0,1538,1880
7836,0,0,0,1,67,1,332,0,0,2246508,4560116,36.6333181680284,512,3846,3016,1342,46125,764550,696590,2568,4740,4228,5072,7244,40.91454509095757,28.846045580154016,2172,1,275110,131140,1674,0,2056,1724
7837,0,0,0,1,68,1,2268,0,0,3767548,11610406,58.154965394194846,2422,5456,4496,3382,56334,844518,786157,2473,6815,4393,4547,8889,33.37663853655727,31.04300231324066,4342,1,774478,139200,1114,0,51,2319
7838,0,0,0,1,68,1,1122,0,0,6460888,10757600,56.24944444170093,2587,5783,5206,3164,43884,720800,703800,2823,6564,3977,5442,9183,45.18849411078001,24.475312053294875,3741,1,654948,81357,2042,0,236,1358
7839,0,0,1,0,66,1,243,0,0,9000244,10312324,55.89275444992848,2698,6431,6005,3124,56644,785638,785638,2875,6425,3727,6182,9732,53.67494760127857,20.810621768290492,3550,1,743512,54102,2881,0,177,420
7840,0,0,1,0,60,1,2105,0,0,2549900,8954300,54.45181356024793,1975,4815,3825,2965,44099,637220,631180,2030,5985,4010,3880,7835,29.32575659723036,31.85256080291006,3955,1,619685,135630,860,0,55,2160
7841,0,0,0,0,53,1,38,1,0,5157080,6086820,47.853944456021594,2089,4743,4542,2290,46161,550206,592734,2457,4948,2859,4910,7401,47.45524207081869,14.322673538179135,2491,1,510670,23115,2252,0,368,406
7842,0,0,0,0,52,1,18,1,0,5053423,5908721,47.31807265728392,2089,4646,4496,2239,45627,530439,599053,2489,4878,2789,4896,7285,47.50789408087881,12.318810369945247,2389,1,508253,15300,2257,0,400,382
7843,0,0,0,0,52,1,73,1,0,4929288,5711160,46.73328578219169,2099,4526,4441,2184,44823,525615,583145,2530,4799,2700,4872,7141,47.50789408087881,9.332611979058527,2269,1,487032,9095,2257,0,431,358
7844,0,0,0,0,52,1,65,0,0,4061184,5157783,44.53088815642464,1983,4031,4031,1983,56144,629442,603432,2601,4584,2601,4649,6632,45.254833995939045,0.0,1983,0,460056,0,2048,0,618,553
7845,0,0,0,0,50,1,47,0,0,2776670,4183078,40.53393639902249,1613,3363,3333,1643,47264,570304,537206,2516,4189,2576,4236,5909,41.10960958218893,5.477225575051661,1673,0,346673,4500,1690,0,903,856
7846,0,0,0,0,51,1,38,0,1,2405240,3914260,39.14077158156185,1412,3222,3102,1532,50175,569765,574875,2435,4087,2675,4125,5777,39.6232255123179,10.981735174982626,1652,1,344700,15960,1570,0,1023,985
7847,0,0,0,0,51,1,17,0,1,1751580,3372975,36.26292872893749,1140,2822,2647,1315,46366,613035,497610,2390,3880,2740,3897,5387,36.49657518178932,13.312619750312495,1490,1,255110,32200,1332,0,1250,1233
7848,0,0,1,0,63,1,609,0,0,1019250,2373750,27.386127875258307,570,2289,2109,750,43659,731115,598185,2985,3915,3345,4524,5454,36.864617182333525,13.527749258468683,930,0,141750,32760,1359,1,2415,1806
7849,0,0,0,1,67,1,595,0,0,2343534,4276918,35.52463933666322,302,4079,3119,1262,46460,779470,684578,2429,4651,4349,5246,7468,43.09292285283048,31.100239489244213,2222,1,254924,160320,1857,0,2127,1532
7850,0,0,0,1,68,1,509,0,0,1964430,5730427,40.97560249709576,1396,3132,2849,1679,49464,781577,737208,3130,5092,3696,4583,6545,34.20526275297414,17.103068639356795,1962,1,362664,42450,1170,0,1734,2243
7851,0,0,0,1,67,1,1639,0,0,1275840,7502205,47.06378650300037,1807,3199,2791,2215,56105,829815,775623,2979,5602,3795,3963,6586,24.0,20.71546563021957,2623,1,507235,59568,576,0,1172,2811
7852,0,0,0,1,68,1,3229,0,0,1081710,12125050,59.455865984778995,2711,4665,3841,3535,51500,857500,706580,2606,6965,4254,3736,8095,17.4928556845359,28.9788505476314,4359,1,728210,148320,306,0,105,3124
7853,0,0,0,1,68,1,1472,0,0,5446113,10898592,56.418082207746124,2376,5701,4894,3183,54522,801216,797792,2617,6607,4231,5135,9125,41.36423575989287,28.830086172159632,3990,1,741639,108138,1711,0,241,1713
7854,0,0,0,1,68,1,1261,0,0,5960432,10748320,56.142675390472796,2468,5727,5043,3152,49680,784300,736560,2726,6562,4094,5301,9137,43.485629810317796,26.552797630016688,3836,1,680832,103968,1891,0,258,1519
7855,0,0,0,1,68,1,1061,0,0,6486372,10664460,55.96427431853289,2541,5794,5203,3132,45368,721860,728670,2814,6537,3996,5476,9199,45.50824101193101,24.776410303303997,3723,1,670248,78012,2071,0,273,1334
7856,0,0,0,1,67,1,933,0,0,6844684,10580988,55.89275444992848,2571,5868,5315,3124,45333,701109,741753,2834,6511,3940,5578,9255,46.8081189538738,23.92618285117886,3677,1,684156,65807,2191,0,263,1196
7857,0,0,1,0,67,1,809,0,0,7210320,10523760,55.85696017507576,2580,5971,5431,3120,45792,728568,715076,2833,6493,3913,5684,9344,48.07286136688766,23.58765714608673,3660,1,661440,75060,2311,0,253,1062
7858,0,0,1,0,63,1,1194,0,0,5236816,9368806,54.42425929675111,1702,5990,4730,2962,53357,736979,724327,1903,6125,4423,4931,9153,42.04759208325728,35.97006298664136,4222,1,678298,173880,1768,0,201,1395
7859,0,0,0,0,51,1,80,1,0,4408400,5353940,45.387222871640866,2000,4260,4200,2060,49476,563983,592572,2539,4659,2659,4739,6859,46.26013402488151,7.754559014766193,2120,1,469680,7260,2140,0,539,459
7860,0,0,0,0,51,1,78,1,0,4168243,5193779,44.75488800120049,1973,4114,4084,2003,54934,627506,588611,2563,4596,2623,4674,6707,45.617978911828175,5.483301264452448,2033,1,454681,4440,2081,0,590,512
7861,0,0,0,0,51,1,74,0,0,3816747,4936275,43.78355855797927,1917,3908,3908,1917,55860,587100,630875,2575,4492,2575,4566,6483,44.62062303464621,0.0,1917,0,469665,0,1991,0,658,584
7862,0,0,0,0,51,1,58,0,1,2669115,4097565,40.06245124802026,1538,3335,3268,1605,44916,582084,502941,2486,4158,2620,4216,5888,40.779897008207364,8.20171446926608,1672,1,316185,11390,1663,0,948,890
7863,0,0,0,0,51,1,47,0,1,2135430,3669776,37.92097045171708,1288,3073,2923,1438,39668,538472,479776,2402,3990,2702,4037,5625,38.535697735995385,12.254111330655777,1588,1,270344,24000,1485,0,1114,1067
7864,0,0,0,0,50,1,17,0,1,1323578,2908674,33.793490497431605,842,2601,2301,1142,48231,527229,593451,2247,3689,2847,3706,5148,34.044089061098404,17.345903692228287,1442,1,266086,30300,1159,0,1405,1388
7865,0,0,1,0,60,1,1457,0,0,2809044,7780464,50.556898639058154,2082,4129,3655,2556,56394,733604,712296,2570,5600,3518,4143,7173,33.15116890850155,21.94854250936937,3030,1,598104,64464,1099,0,488,1945
7866,0,0,0,1,68,1,520,0,0,2011764,5812330,41.255302689472536,1434,3152,2884,1702,49932,778620,747885,3147,5117,3683,4597,6567,34.38022687534217,16.690349473383787,1970,1,372738,38860,1182,0,1713,2233
7867,0,0,0,1,67,1,2051,0,0,1214880,8537063,50.309044912421065,2275,3267,3011,2531,54834,833131,748806,3117,5904,3629,3853,6640,21.908902300206645,16.004941557904118,2787,1,561882,40704,480,0,842,2893
7868,0,0,0,1,67,1,2561,0,0,1154232,9995472,54.3323108288245,2777,3518,3343,2952,53136,832956,731376,3211,6338,3561,3777,6904,19.77371993328519,13.232642477343864,3127,1,637632,29050,391,0,434,2995
7869,0,0,0,1,68,1,2216,0,0,3691860,11371594,57.67148342118486,2307,5455,4436,3326,55860,837655,779532,2400,6745,4438,4529,8874,33.31666249791537,31.959372461805795,4345,1,758328,150812,1110,0,93,2309
7870,0,0,0,1,68,1,1098,0,0,6247080,10604496,55.749439459065414,2464,5762,5118,3108,46782,771112,706284,2768,6520,4056,5422,9174,44.83302354291979,25.82309165875416,3752,1,643356,101108,2010,0,304,1402
7871,0,0,1,0,65,1,39,0,0,9532276,10107071,55.74047003748713,2549,6733,6175,3107,54450,731925,787226,2695,6360,3811,6321,9986,55.389529696504916,23.6791896344468,3665,1,751894,61380,3068,0,146,185
7872,0,0,1,0,55,1,948,0,0,4837824,7599960,52.191953402799555,2117,5107,4500,2724,47304,602640,611010,2183,5514,3397,4566,7897,42.14261501141095,24.697331744316525,3331,1,596556,80124,1776,0,66,1014
7873,0,0,0,0,53,1,1,1,0,5352282,6162182,48.104053883222775,2098,4843,4627,2314,50976,575208,628468,2447,4977,2879,4976,7506,48.093658625644196,14.875115696189704,2530,1,546104,23760,2313,0,349,350
7874,0,0,0,0,52,1,96,1,0,5037721,5791292,46.87216658103186,2047,4640,4490,2197,50955,566740,624732,2486,4833,2786,4929,7276,47.885279575251516,12.459604606992961,2347,1,520689,15900,2293,0,439,343
7875,0,0,0,0,52,1,92,1,0,4522013,5431410,45.617978911828175,1986,4349,4254,2081,50976,563760,615960,2515,4691,2705,4783,6959,46.61544808322666,9.80698324197389,2176,1,491116,10355,2173,0,529,437
7876,0,0,0,0,51,1,55,0,1,1804236,3374224,36.27671429443411,1100,2903,2687,1316,50808,594848,561516,2348,3880,2780,3935,5467,37.027017163147235,14.734906844635344,1532,1,288204,32400,1371,0,1248,1193
7877,0,0,0,0,51,1,3,0,1,289980,1401840,23.2379000772445,43,1574,1077,540,55104,638616,581504,2099,3136,3093,3133,4170,23.173260452512935,22.643390253282295,1037,1,120960,76538,537,0,2056,2059
7878,0,1,0,1,66,0,702,0,0,2818024,6823998,45.45327270945405,1781,3715,3430,2066,48068,650691,805932,3018,5369,3588,4667,7018,36.932370625238775,17.130983971056178,2351,1,504104,20805,1364,0,1237,1939
7879,0,1,1,0,65,0,468,0,0,2828448,6296388,43.95452195167182,1782,3546,3396,1932,55671,752829,785419,3109,5191,3409,4723,6805,38.262252939417984,12.338422017092807,2082,0,465612,17550,1464,1,1327,1795
7880,0,0,1,0,54,1,844,0,0,1712541,4925577,42.391036788453285,1622,2925,2750,1797,47216,622207,570128,2566,4538,2916,3694,5666,30.870698080866262,13.490839382040427,1972,1,373776,27475,953,0,944,1788
7881,0,0,1,0,64,1,844,0,0,436572,1165278,19.026297590440446,62,1868,1568,362,46230,740370,647019,2919,3581,3519,4425,5087,34.72751070837067,17.386001707279018,662,0,72762,50400,1206,1,2857,2013
7882,0,0,0,1,68,1,437,0,0,2374950,4549200,36.578682316343766,344,4107,3113,1338,44550,765000,673200,2406,4738,4394,5175,7507,42.13074886588179,31.557407552459278,2332,1,264924,165004,1775,0,2062,1625
7883,0,0,0,1,68,1,338,0,0,2111808,5591232,40.39801975344831,1232,3326,2926,1632,46830,763998,719460,3026,5058,3826,4720,6752,35.9722114972099,20.23244737619974,2032,1,342720,60400,1294,0,1794,2132
7884,0,0,0,1,68,1,534,0,0,2054475,5896050,41.53311931459037,1469,3172,2916,1725,49056,765632,748542,3162,5143,3674,4609,6590,34.51086785347479,16.368026731500475,1981,1,377775,36352,1191,0,1693,2227
7885,0,0,0,1,67,1,1411,0,0,1537172,7206160,46.17358552246078,1877,3108,2853,2132,55552,838240,757120,3125,5512,3635,4101,6488,26.851443164195103,16.50672641415702,2387,1,477568,39270,721,0,1248,2659
7886,0,0,0,1,67,1,1746,0,0,1340371,7823864,48.19751030914356,1962,3261,2900,2323,56364,821792,778008,3007,5691,3729,3945,6629,24.020824298928627,19.039568597447047,2684,1,536613,50901,577,0,1045,2791
7887,0,0,0,1,67,1,1953,0,0,1279978,8317386,49.70915408654627,2203,3257,2989,2471,54340,831402,740520,3098,5837,3634,3884,6623,22.759613353482084,16.370933467052748,2739,1,543620,43416,518,0,895,2848
7888,0,0,0,1,67,1,2160,0,0,1461241,9110473,51.97114584074513,2606,3337,3242,2701,53382,829758,731941,3278,6074,3468,3914,6710,23.259406699226016,9.74706432789427,2796,1,586117,15675,541,0,672,2832
7889,0,0,0,1,67,1,2292,0,0,1529280,9563664,53.21653878260028,2802,3402,3372,2832,53628,830742,736186,3347,6209,3407,3917,6779,23.2379000772445,5.483301264452448,2862,1,617376,4920,540,0,545,2837
7890,0,0,0,1,68,1,1906,0,0,4258320,11023242,56.79788728465171,2206,5566,4546,3226,53500,854250,731238,2397,6643,4437,4737,8983,36.3318042491699,31.972865897966635,4246,1,690364,173400,1320,0,191,2097
7891,0,0,0,1,67,1,842,0,0,6797640,10401614,55.33534132902769,2455,5889,5282,3062,43430,686194,730355,2790,6459,4004,5617,9286,47.11687595755899,25.044489102234024,3669,1,658330,71626,2220,0,335,1177
7892,0,0,1,0,62,1,1642,0,0,4078359,9327108,54.78138369920935,1658,5703,4360,3001,48930,652680,724164,1765,6109,4451,4467,8811,36.864617182333525,36.836660696120475,4344,1,699233,142358,1359,0,107,1749
7893,0,0,1,0,55,1,643,0,0,5225810,7285100,51.28352561983234,2135,5112,4617,2630,49060,609400,617710,2275,5400,3265,4757,7882,44.57577817604534,22.28482739070142,3125,1,586490,64845,1987,0,140,783
7894,0,0,0,0,53,1,67,1,0,5341910,6043534,47.7283982551269,2103,4798,4623,2278,54900,596925,647332,2478,4931,2828,4998,7451,48.425200051213004,13.382010133418634,2453,1,555832,18725,2345,0,375,308
7895,0,0,0,0,52,1,102,1,0,4390615,5319045,45.221676218380054,1955,4282,4192,2045,53984,582624,626841,2511,4646,2691,4748,6883,46.33573135281238,9.48712577043745,2135,1,492845,9900,2147,0,556,454
7896,0,0,0,0,51,1,96,0,0,3461017,4648532,42.579337712087536,1813,3722,3722,1813,51296,587156,574336,2564,4377,2564,4473,6286,43.69210454990696,0.0,1813,0,406112,0,1909,0,751,655
7897,0,0,0,0,51,1,89,0,1,2745326,4129280,40.162171256046406,1528,3400,3315,1613,48256,593920,532480,2475,4173,2645,4262,5960,41.255302689472536,9.235136611923052,1698,1,335504,13770,1702,0,947,858
7898,0,0,0,0,51,1,86,0,1,2554952,3984916,39.44616584663204,1429,3325,3198,1556,49203,591591,545493,2434,4117,2688,4203,5886,40.52159917870962,11.294497304567454,1683,1,331428,19812,1642,0,1005,919
7899,0,0,0,0,51,1,77,0,1,1951524,3489912,36.864617182333525,1141,3013,2795,1359,48530,590640,541848,2350,3927,2786,4004,5581,37.89459064299283,14.805740272943908,1577,1,286749,34008,1436,0,1209,1132
7900,0,1,1,0,64,0,162,0,0,2812480,5686560,41.95235392680606,1700,3418,3358,1760,55902,746361,781902,3171,4991,3291,4829,6649,39.97499218261337,7.745966692414834,1820,1,425920,6900,1598,0,1471,1633
7901,0,0,1,0,64,1,1088,0,0,144960,388200,10.954451150103322,42,1490,1328,120,52864,763460,724640,3073,3355,3397,4443,4725,34.75629439396553,12.728043305644134,282,1,26880,23814,1208,0,3115,2027
7902,0,0,0,1,68,1,267,0,0,2380030,4826565,37.61648574760805,513,3999,3097,1415,42705,747009,665145,2509,4826,4313,5093,7410,41.012193308819754,30.081041393204615,2317,1,275925,146124,1682,0,1996,1729
7903,0,0,0,1,68,1,42,0,0,2279659,5096847,38.58756276314948,767,3742,3020,1489,42532,742791,670908,2701,4912,4145,4954,7165,39.1279950930277,26.960526740633814,2211,1,291844,114076,1531,0,1934,1892
7904,0,0,0,1,68,1,343,0,0,2124144,5621770,40.48456495999432,1215,3359,2935,1639,46592,768320,713440,3006,5069,3854,4726,6789,36.0,20.824394184241775,2063,1,340912,65296,1296,0,1791,2134
7905,0,0,0,1,67,1,864,0,0,1933312,6338016,43.45112196480086,1821,2979,2912,1888,54718,731826,842607,3290,5245,3424,4381,6336,32.0,8.329212945039274,1955,1,473888,5628,1024,0,1469,2333
7906,0,0,0,1,67,1,2362,0,0,1468103,9696375,53.600373133029585,2813,3444,3384,2873,53352,833625,729000,3315,6248,3435,3886,6819,22.60530911091463,7.754559014766193,2933,1,620568,9960,511,0,502,2864
7907,0,0,0,1,67,1,2418,0,0,1394419,9789923,53.842362503887216,2809,3470,3380,2899,53599,834119,732809,3287,6276,3467,3858,6847,21.93171219946131,9.497356383238309,2989,1,629083,14940,481,0,478,2896
7908,0,0,0,1,68,1,2078,0,0,3800160,11059440,56.991227395100026,2183,5483,4418,3248,55596,837630,769530,2340,6653,4470,4575,8888,34.20526275297414,32.65687192903087,4313,1,734048,161880,1170,0,157,2235
7909,0,0,1,0,55,1,887,0,0,5068038,7636282,52.32590180780452,2213,5114,4589,2738,50850,630314,627525,2264,5527,3314,4640,7903,43.02324952859791,22.984882776406234,3263,1,616050,70875,1851,0,51,938
7910,0,0,0,0,52,1,114,1,0,4381587,5296200,45.13313638558703,1977,4248,4188,2037,54240,587600,624000,2540,4637,2660,4751,6848,46.37887450122092,7.745966692414834,2097,1,488880,6840,2151,0,563,449
7911,0,0,0,0,51,1,110,0,0,3675699,4786047,43.162483709814474,1863,3836,3836,1863,51067,588301,572887,2569,4432,2569,4542,6405,44.41846462902562,0.0,1863,0,415449,0,1973,0,706,596
7912,0,0,0,0,51,1,105,0,1,3033550,4317950,41.10960958218893,1648,3527,3485,1690,49665,590205,549325,2513,4245,2597,4350,6082,42.36744032862972,6.48074069840786,1732,1,363350,6384,1795,0,865,760
7913,0,0,0,0,51,1,91,0,1,1786836,3315272,35.94440151122286,1024,2943,2675,1292,52210,590180,582482,2298,3858,2834,3949,5509,37.1887079635741,16.39345090320684,1560,1,293284,36984,1383,0,1274,1183
7914,0,0,0,0,51,1,89,0,1,1712810,3242195,35.566838487557476,982,2902,2619,1265,52437,592053,581801,2280,3828,2846,3917,5465,36.796738985948195,16.83959204912944,1548,1,287155,39054,1354,0,1298,1209
7915,0,0,0,0,51,1,51,0,1,750172,2158006,29.0,361,2213,1733,841,47236,618406,502936,2086,3407,3046,3458,4779,29.866369046136157,22.12477962161222,1321,1,164836,88320,892,0,1725,1674
7916,0,0,0,0,51,1,13,0,1,406364,1633659,25.11971337416094,107,1799,1275,631,55660,626538,595470,2065,3220,3113,3233,4388,25.37715508089904,23.180650014057626,1155,1,145130,74932,644,0,1958,1945
7917,0,0,0,0,51,1,21,0,1,338032,1476035,23.895606290697042,30,1704,1163,571,56105,633325,591965,2044,3156,3126,3177,4289,24.331050121192877,23.51781657557122,1112,1,130759,78445,592,0,2014,1993
7918,0,1,0,1,65,0,728,0,0,2764308,6803338,45.45327270945405,1824,3646,3404,2066,51088,678358,816664,3051,5359,3535,4631,6939,36.578682316343766,15.790094819097714,2308,1,512368,18634,1338,0,1227,1955
7919,0,0,1,0,61,1,79,0,0,2859612,5046860,40.64480286580315,1610,3425,3383,1652,44736,711815,586560,3013,4707,3097,4786,6480,41.60528812542944,6.484411467763075,1694,0,317184,7644,1731,1,1403,1324
7920,0,0,0,1,68,1,765,0,0,2254644,3970134,34.161381705077446,255,4011,3099,1167,40992,762048,622566,2490,4569,4314,5334,7413,43.95452195167182,30.406905541428074,2079,1,213561,164160,1932,0,2235,1470
7921,0,0,0,1,68,1,151,0,0,2367440,5014695,38.27531841800928,624,3922,3081,1465,39744,739368,629832,2582,4888,4264,5039,7345,40.19950248448356,29.0720586684476,2306,1,269560,142970,1616,0,1958,1807
7922,0,0,0,1,68,1,350,0,0,2139104,5660880,40.59556626036888,1197,3397,2946,1648,46176,762570,714480,2984,5083,3886,4733,6832,36.02776706930364,21.473334853237617,2099,1,342784,68101,1298,0,1787,2137
7923,0,0,0,1,67,1,857,0,0,1949448,6356485,43.46262762420146,1822,2988,2921,1889,47058,625890,851345,3298,5254,3432,4397,6353,32.12475680841802,8.47749576439433,1956,1,477917,2546,1032,0,1476,2333
7924,0,0,0,1,66,1,932,0,0,1929069,6455333,43.94314508543966,1901,2960,2930,1931,56376,775576,812349,3313,5274,3373,4342,6303,31.606961258558215,5.501408174353464,1961,1,469233,3390,999,0,1412,2344
7925,0,0,0,1,67,1,2319,0,0,1554066,9647802,53.49766350038102,2820,3447,3405,2862,53655,825895,738249,3329,6233,3413,3914,6818,23.302360395462088,6.481658975540136,2904,1,626778,6762,543,0,509,2828
7926,0,0,0,1,68,1,2214,0,0,3435832,11107666,57.148928248918196,2145,5439,4318,3266,55370,833245,768626,2280,6667,4522,4453,8840,32.43454948045371,33.499334589152504,4387,1,738116,168150,1052,0,135,2349
7927,0,0,1,0,66,1,254,0,0,8152035,9889305,54.63515351859094,2347,6354,5716,2985,54808,732173,821624,2675,6298,3951,6044,9667,52.25897052181568,25.38339402677081,3623,1,740280,59334,2731,0,328,582
7928,0,0,0,0,51,1,122,0,1,3557048,4692820,42.731721238442994,1784,3816,3774,1826,49910,591100,557690,2528,4396,2612,4518,6386,44.13615298142782,6.481658975540136,1868,1,396242,6258,1948,0,744,622
7929,0,0,0,0,51,1,121,0,1,3339752,4538456,42.04759208325728,1708,3717,3657,1768,49504,575008,567307,2507,4335,2627,4456,6284,43.46262762420146,7.745966692414834,1828,1,390728,8280,1889,0,799,678
7930,0,0,0,0,51,1,120,0,1,3129300,4377600,41.352146256270665,1650,3600,3540,1710,49729,570880,570880,2500,4270,2620,4390,6160,42.77849927241488,7.746504550744806,1770,1,381330,8100,1830,0,850,730
7931,0,0,0,0,51,1,113,0,1,2272380,3725832,38.1051177665153,1218,3251,3017,1452,47736,600444,523464,2332,4018,2800,4131,5817,39.56008088970496,15.32220938086023,1686,1,296208,39546,1565,0,1114,1001
7932,0,0,0,0,51,1,112,0,1,2102265,3587940,37.3496987939662,1125,3172,2902,1395,48930,599276,540120,2302,3967,2842,4079,5744,38.82009788756334,16.49270114387531,1665,1,292950,43740,1507,0,1177,1065
7933,0,0,0,0,51,1,108,0,1,1781980,3289612,35.805027579936315,987,2967,2672,1282,52210,590180,582482,2271,3848,2861,3956,5533,37.282703764614496,17.197282142295823,1577,1,291014,40710,1390,0,1284,1176
7934,0,0,0,0,51,1,98,0,1,1227480,2708300,32.55764119219941,643,2635,2218,1060,52140,605535,562100,2138,3615,2972,3713,5190,34.02939905434711,20.450574941819507,1477,1,233200,63801,1158,0,1495,1397
7935,0,0,0,0,51,1,69,0,1,614250,1929750,27.386127875258307,239,2080,1569,750,51728,627812,545476,2062,3323,3084,3392,4653,28.61817604250837,22.8314974862301,1261,1,159000,86359,819,0,1823,1754
7936,0,0,0,0,51,1,43,0,1,405944,1589896,24.819347291981714,64,1827,1275,616,56619,627183,601373,2029,3197,3133,3240,4408,25.67099530598687,23.728668976023577,1168,1,143528,75072,659,0,1965,1922
7937,0,1,1,0,60,0,49,0,0,790610,2785872,30.23243291566195,734,1959,1779,914,53775,685800,728472,2868,3962,3228,3913,5007,29.410882339705484,13.416407864998739,1094,1,218446,20700,865,0,2134,2183
7938,0,0,0,1,68,1,7,0,0,2330190,5260140,39.11521443121589,780,3803,3053,1530,41567,725418,677286,2688,4968,4188,4961,7241,39.02563260217571,27.504650210283643,2280,1,301410,112500,1523,0,1908,1915
7939,0,0,0,0,52,1,137,1,0,4749888,5508096,45.95650117230423,2082,4391,4361,2112,53130,599840,602448,2578,4720,2638,4857,6999,47.4236228055175,5.490867587491313,2142,1,487872,3960,2249,0,496,359
7940,0,0,0,0,51,1,130,0,1,2445000,3852000,38.72983346207417,1288,3342,3130,1500,49184,595776,544416,2356,4068,2780,4198,5910,40.3732584763727,14.578408619690006,1712,1,318000,33496,1630,0,1068,938
7941,0,0,0,0,51,1,130,0,1,2266824,3704498,37.97367509209505,1187,3269,3014,1442,47970,601146,526645,2314,4011,2824,4141,5838,39.64845520319802,15.9932207903403,1697,1,295610,42840,1572,0,1127,997
7942,0,0,0,0,51,1,126,0,1,1775587,3262657,35.651086939951774,948,2991,2668,1271,52437,592977,582709,2244,3838,2890,3964,5558,37.376463182061514,17.993008616382102,1594,1,288517,44574,1397,0,1296,1170
7943,0,0,0,0,51,1,125,0,1,1700424,3188295,35.25620512760839,908,2946,2611,1243,52437,592515,582255,2230,3808,2900,3933,5511,36.98648401781386,18.319292668959594,1578,1,282161,46565,1368,0,1322,1197
7944,0,0,0,0,51,1,124,0,1,1626885,3112830,34.85685011586675,865,2904,2554,1215,52200,594384,576450,2212,3777,2912,3901,5466,36.59234892706397,18.718053408889613,1565,1,273375,50050,1339,0,1347,1223
7945,0,0,1,0,60,1,173,0,0,2826690,5391420,42.07136793592526,1620,3517,3367,1770,42136,697534,560464,2896,4816,3196,4643,6563,39.96248240537617,12.376180362832391,1920,0,325680,27600,1597,1,1276,1449
7946,0,0,1,0,61,1,212,0,0,2196960,4255920,37.14835124201342,1295,3057,2972,1380,47124,733992,610632,2999,4464,3169,4676,6141,39.89987468652001,9.227509513928014,1465,0,273240,15215,1592,1,1704,1492
7947,0,0,1,0,61,1,229,0,0,2044680,4089360,36.3318042491699,1230,2959,2869,1320,41536,731128,545248,3008,4418,3188,4647,6057,39.35733730830886,9.580310602724222,1410,0,232320,17910,1549,1,1778,1549
7948,0,0,0,1,68,1,334,0,0,2374611,4739541,37.1887079635741,393,4090,3100,1383,44642,757367,692254,2437,4810,4417,5144,7517,41.43669871020132,31.526233771745293,2373,1,279366,154440,1717,0,2044,1710
7949,0,0,0,1,68,1,118,0,0,2405223,5129948,38.63935817272331,622,3975,3104,1493,42525,773100,649404,2565,4929,4307,5047,7411,40.13726448077895,29.603793992671065,2364,1,282177,153296,1611,0,1943,1825
7950,0,0,0,1,68,1,64,0,0,2410785,5232240,39.0,680,3947,3106,1521,42525,774000,650160,2599,4961,4281,5025,7387,39.81205847478876,29.104004744608293,2362,1,287469,147175,1585,0,1919,1855
7951,0,0,0,1,68,1,556,0,0,2080677,6016668,41.79712908801273,1386,3299,2938,1747,47475,774900,726684,3083,5191,3805,4635,6743,34.51086785347479,19.38969066969344,2108,1,368617,54511,1191,0,1697,2253
7952,0,0,0,1,68,1,636,0,0,2042172,6131862,42.21374183841087,1481,3229,2928,1782,47952,763902,743256,3140,5223,3742,4587,6670,33.85262175962151,17.8273059659544,2083,1,384912,43043,1146,0,1659,2295
7953,0,0,0,1,66,1,1402,0,0,1785680,7392450,47.01063709417264,2020,3208,3018,2210,50652,842940,672345,3155,5555,3535,4153,6553,28.42534080710379,14.51440612729095,2400,1,444210,33060,808,0,1135,2537
7954,0,0,0,1,67,1,2228,0,0,1738080,9562280,53.291650377896914,2810,3482,3452,2840,53743,811447,750841,3337,6207,3397,3979,6849,24.73863375370596,5.477225575051661,2870,1,633320,4590,612,0,527,2755
7955,0,0,0,1,68,1,3210,0,0,1249911,12157254,59.67411499134277,2861,4612,3912,3561,50592,846672,696456,2714,6975,4114,3765,8026,18.734993995195193,26.784144745522728,4261,1,726444,126700,351,0,147,3063
7956,0,0,0,1,67,1,2112,0,0,3477313,10851008,56.55970296951709,2075,5410,4286,3199,55104,834432,759808,2268,6591,4516,4479,8802,32.96968304366907,33.76308061681769,4323,1,716576,174220,1087,0,193,2305
7957,0,0,1,0,62,1,1197,0,0,6208204,9935023,56.22277118748239,2069,6217,5125,3161,56628,760606,735462,2051,6304,4235,5107,9360,44.31703961232068,33.25796476615352,4253,1,739674,141960,1964,0,18,1179
7958,0,0,0,0,60,1,2163,1,0,3175498,9643636,56.2672195865408,2079,5256,4169,3166,52731,660982,740178,1959,6212,4133,4049,8302,31.670175244226233,33.390595030359904,4253,1,769338,108700,1003,0,120,2043
7959,0,0,1,0,56,1,1715,0,0,4401716,8819052,55.89275444992848,2573,5084,4533,3124,42158,604122,556131,2272,5947,3374,4232,7907,37.53664875824692,23.59919273145401,3675,1,615428,84854,1409,0,301,1414
7960,0,0,0,0,52,1,148,1,0,5007645,5663640,46.52956049652737,2135,4508,4478,2165,53799,593832,619992,2586,4781,2646,4929,7124,48.093658625644196,5.478746393072713,2195,1,513105,3600,2313,0,451,303
7961,0,0,0,0,52,1,147,1,0,4619248,5416816,45.574115460423364,2077,4301,4301,2077,48391,565936,581584,2608,4685,2608,4832,6909,47.15930449020638,0.0,2077,1,463171,0,2224,0,531,384
7962,0,0,0,0,51,1,147,0,1,3775678,4829051,43.255057507764334,1829,3931,3889,1871,46438,552334,560077,2539,4452,2623,4599,6512,44.9221548904324,6.481658975540136,1913,1,406007,5460,2018,0,710,563
7963,0,0,0,0,51,1,147,0,1,3663738,4748676,42.91852746774987,1775,3898,3831,1842,46004,559426,546536,2511,4420,2645,4567,6476,44.598206241955516,8.18535277187245,1909,1,390504,9380,1989,0,736,589
7964,0,0,0,0,51,1,146,0,1,3227475,4434975,41.53311931459037,1605,3716,3596,1725,47520,555336,565620,2451,4296,2691,4442,6287,43.255057507764334,10.95616238207774,1845,1,379500,15600,1871,0,846,700
7965,0,0,0,0,51,1,146,0,1,2820432,4127736,40.099875311526844,1458,3512,3362,1608,47096,595544,521101,2417,4175,2717,4321,6079,41.88078318274385,12.256148736246766,1758,1,326424,25200,1754,0,959,813
7966,0,0,0,0,51,1,146,0,1,2723775,4054872,39.736632972611055,1409,3474,3304,1579,48256,595776,534144,2398,4147,2738,4293,6042,41.53311931459037,13.054616162192646,1749,1,328432,27710,1725,0,989,843
7967,0,0,0,0,51,1,145,0,1,2264286,3686814,37.86819245752297,1157,3290,3013,1434,48880,604185,534768,2294,4005,2848,4150,5861,39.736632972611055,16.660858965059326,1711,1,298272,45982,1579,0,1137,992
7968,0,0,0,0,51,1,144,0,1,2011216,3468404,36.71511950137164,1017,3171,2840,1348,52650,602082,578925,2242,3921,2904,4065,5744,38.62641583165593,18.2258656565877,1679,1,303300,47664,1492,0,1225,1081
7969,0,0,1,0,57,1,611,0,0,1551476,4584556,39.84971769034255,1311,2842,2565,1588,44268,588948,626479,2610,4475,3164,3864,5729,31.25699921617557,16.717062958109565,1865,1,344596,32686,977,0,1299,1910
7970,0,0,1,0,59,1,747,0,0,2738610,6187230,45.4972526643093,2070,3393,3393,2070,51906,735294,630679,2989,5059,2989,4312,6382,36.373066958946424,0.0,2070,0,436770,0,1323,0,919,1666
7971,0,0,1,0,61,1,163,0,0,2494500,4603500,38.72983346207417,1410,3253,3163,1500,48360,761112,598455,2979,4569,3159,4732,6322,40.779897008207364,9.52871847115494,1590,0,292500,17190,1663,1,1569,1406
7972,0,0,1,0,61,1,185,0,0,2248950,4348440,37.54996671103717,1315,3100,3005,1410,48076,733992,622968,2989,4494,3179,4679,6184,39.93745109543172,9.833118885374187,1505,0,284820,16625,1595,1,1674,1489
7973,0,0,1,0,64,1,675,0,0,415350,1258140,19.748417658131498,18,1863,1455,390,48616,761336,664556,2818,3616,3634,4291,5089,32.63433774416144,20.27745410950857,798,1,80340,68544,1065,0,2836,2161
7974,0,0,0,1,68,1,92,0,0,2363328,5463216,39.7994974842648,832,3828,3076,1584,48548,789821,731188,2697,5033,4201,4941,7277,38.62641583165593,27.56814523275716,2336,1,335808,116560,1492,0,1865,1957
7975,0,0,0,1,67,1,1944,0,0,1721905,8737170,51.03920062069938,2497,3374,3266,2605,52576,831792,711048,3246,5959,3462,4015,6728,25.709920264364882,10.394308954048586,2713,1,552260,18576,661,0,749,2693
7976,0,0,0,1,67,1,1970,0,0,1735800,8831540,51.28352561983234,2535,3385,3290,2630,51832,832784,701822,3263,5988,3453,4018,6743,25.69046515733026,9.759997214798725,2725,1,549670,16720,660,0,728,2698
7977,0,0,0,1,67,1,2182,0,0,1833840,9520120,53.19774431308154,2830,3478,3478,2830,54240,807360,760264,3364,6194,3364,4012,6842,25.45584412271571,0.0,2830,1,639580,0,648,0,534,2716
7978,0,0,0,1,67,1,2039,0,0,3538080,10699533,56.20498198558558,2059,5379,4279,3159,55370,829815,765462,2287,6546,4487,4507,8766,33.46640106136302,33.39832840659358,4259,1,713934,167200,1120,0,228,2267
7979,0,0,0,1,68,1,1334,0,0,4956087,10172391,54.69003565550127,1992,5647,4648,2991,54635,833245,758423,2402,6392,4400,5058,9048,40.70626487409524,31.812731727337262,3990,1,666993,155844,1657,0,410,1744
7980,0,0,0,1,68,1,1260,0,0,5111509,10124777,54.56189146281496,2017,5654,4694,2977,55104,836646,761824,2441,6378,4361,5118,9055,41.43669871020132,31.202128158062493,3937,1,666848,148800,1717,0,424,1684
7981,0,0,0,1,68,1,687,0,0,6479200,9909536,53.96295025292817,2157,5892,5137,2912,56168,803108,809914,2648,6315,4158,5628,9295,47.16990566028302,27.795802325988603,3667,1,693056,95130,2225,0,491,1178
7982,0,0,0,0,52,1,158,0,1,4492400,5325536,45.18849411078001,2012,4272,4242,2042,47508,558112,578976,2578,4650,2638,4808,6880,46.9041575982343,5.477225575051661,2072,1,453324,3780,2200,0,566,408
7983,0,0,0,0,51,1,161,0,1,2091672,3522600,36.98648401781386,1029,3236,2897,1368,52392,607700,571650,2236,3943,2914,4104,5811,39.102429592034305,18.43896928265435,1707,1,303696,50850,1529,0,1207,1046
7984,0,0,0,0,51,1,161,0,1,1771742,3216451,35.397740040855716,874,3046,2667,1253,53360,595544,590410,2188,3820,2946,3981,5613,37.603191353926334,19.489064710427993,1632,1,288190,51544,1414,0,1314,1153
7985,0,0,0,0,51,1,153,0,1,363204,1358298,23.043437243605826,21,1725,1215,531,56404,611362,603688,2048,3089,3068,3242,4283,26.153393661244042,22.836768087442138,1041,1,125316,66810,684,0,2027,1874
7986,0,0,0,0,50,1,151,0,1,263142,1126992,21.047565179849187,26,1454,1037,443,56400,610560,597840,2127,2987,2961,3138,3998,24.372115213907882,20.654338230995794,860,1,104105,55461,594,0,2101,1950
7987,0,1,1,0,64,0,1777,0,0,2690658,8920206,52.478567053607705,2553,3932,3731,2754,49950,728775,719058,3038,5993,3440,4216,7171,31.25699921617557,14.18060408792329,2955,0,611388,27738,977,1,485,2262
7988,0,0,1,0,54,1,1531,0,0,1532490,6056667,47.12748667179272,2161,2971,2911,2221,39078,638118,455409,2667,4948,2787,3417,5698,26.267851073127396,7.914659756013729,2281,1,370907,12360,690,0,506,2037
7989,0,0,0,1,69,1,290,0,0,2286336,5745792,40.792156108742276,1028,3674,3038,1664,47234,780378,721677,2817,5117,4089,4827,7127,37.067505985701274,25.419209439919413,2300,1,347776,98580,1374,0,1789,2079
7990,0,0,0,1,68,1,963,0,0,1895380,6613460,44.04543109109048,1790,3067,2917,1940,41175,623847,767025,3259,5349,3559,4386,6476,31.25699921617557,12.865825024943737,2090,1,436500,12000,977,0,1469,2432
7991,0,0,1,0,65,1,1302,0,0,1737099,6965364,46.05431575867782,2121,2940,2940,2121,55842,745468,807864,3284,5405,3284,4103,6224,28.61817604250837,0.0,2121,0,521766,0,819,1,1163,2465
7992,0,0,0,1,67,1,1932,0,0,1812493,8787050,51.21523210920751,2538,3399,3314,2623,52750,837500,706850,3265,5973,3435,4041,6749,26.28687885618983,9.219544457292887,2708,1,553453,14790,691,0,727,2659
7993,0,0,0,1,67,1,2091,0,0,3361140,10676748,56.178287620752556,2095,5282,4221,3156,55388,825452,767941,2322,6539,4444,4448,8665,32.63433774416144,32.80743843881714,4217,1,716412,158089,1065,0,227,2318
7994,0,0,0,1,67,1,1723,0,0,4069260,10359505,55.27205442174191,1924,5518,4387,3055,51750,847750,701937,2260,6446,4522,4723,8909,36.49657518178932,33.862708729791905,4186,1,632385,201318,1332,0,336,2059
7995,0,0,0,1,67,1,1229,0,0,5067612,10014356,54.29548784199291,1964,5651,4667,2948,55350,835662,764325,2413,6345,4381,5116,9048,41.46082488325576,31.569039174291543,3932,1,663300,149568,1719,0,449,1678
7996,0,0,0,1,67,1,1121,0,0,5300370,9953210,54.12947441089743,1998,5671,4739,2930,54531,845853,743943,2465,6327,4329,5206,9068,42.532340636273474,30.745696229930026,3862,1,641670,151916,1809,0,467,1588
7997,0,0,0,1,67,1,624,0,0,6502417,9778114,53.67494760127857,2099,5920,5138,2881,56169,804378,804378,2612,6275,4176,5651,9314,47.50789408087881,28.23496540354899,3663,1,682797,100878,2257,0,513,1137
7998,0,0,0,0,51,1,172,1,0,3441053,4581577,42.08325082500163,1621,3864,3714,1771,46225,556205,556205,2437,4358,2737,4530,6451,44.07947368106838,12.25845656828046,1921,1,380765,20400,1943,0,816,644
7999,0,0,0,0,51,1,173,1,0,3227120,4418672,41.376321731154405,1532,3777,3597,1712,47085,554915,565239,2401,4293,2761,4466,6358,43.41658669218482,13.424785270182428,1892,1,374928,23400,1885,0,869,696
8000,0,0,0,0,51,1,173,1,0,3018378,4253169,40.65710270051225,1471,3661,3479,1653,47523,563487,558341,2391,4226,2755,4399,6234,42.731721238442994,13.493282342130057,1835,1,358701,24934,1826,0,920,747
8001,0,0,0,0,51,1,174,0,1,2626560,3955200,39.191835884530846,1302,3480,3246,1536,48279,594825,538175,2341,4111,2809,4285,6055,41.352146256270665,15.314906812703457,1770,1,321024,37440,1710,0,1039,865
8002,0,0,0,0,50,1,217,0,1,175284,817452,18.0,24,1165,865,324,55209,582813,602997,2223,2847,2823,3064,3688,23.259406699226016,17.53881817214849,624,1,77436,36300,541,0,2199,1982
8003,0,0,1,0,68,1,802,0,0,2257224,3930524,33.97057550292606,236,4028,3110,1154,43134,807222,619892,2488,4560,4324,5362,7434,44.22668877499196,30.514923663272548,2072,1,210028,179010,1956,0,2252,1450
8004,0,0,0,1,69,1,489,0,0,2191720,6028975,41.773197148410844,1221,3525,3001,1745,48548,791195,732460,2931,5200,3979,4711,6980,35.4400902933387,23.166487174613295,2269,1,369940,81220,1256,0,1710,2199
8005,0,0,0,1,65,1,1454,0,0,1658912,7209208,46.968074263269514,2139,3025,2958,2206,47120,810464,620920,3201,5474,3335,4020,6293,27.422618401604176,8.2732738280919,2273,1,419140,11524,752,0,1062,2516
8006,0,0,0,1,66,1,1609,0,0,1634390,7655705,48.11444689487763,2123,3213,3021,2315,49053,823443,651479,3115,5622,3499,4013,6520,26.570660511172846,14.319779673152123,2507,1,456055,32256,706,0,992,2601
8007,0,0,0,1,67,1,2198,0,0,1900368,9613458,53.49766350038102,2820,3568,3526,2862,55216,799442,779288,3317,6221,3401,4023,6927,25.768197453450252,6.503581472166948,2904,1,663984,5796,664,0,497,2695
8008,0,0,0,1,67,1,2184,0,0,3113161,10713961,56.27610505356603,2145,5172,4150,3167,56160,811920,791622,2361,6550,4405,4366,8555,31.352830813181765,32.216519646841896,4189,1,741078,137970,983,0,216,2400
8009,0,0,0,1,67,1,1651,0,0,4121222,10230647,54.92722457943783,1902,5498,4383,3017,52750,847750,715501,2276,6408,4506,4757,8889,36.959437225152655,33.62893021456697,4132,1,636587,194010,1366,0,374,2025
8010,0,0,0,1,67,1,1196,0,0,5029437,9898329,54.0277706369604,1911,5650,4642,2919,55596,834186,766366,2383,6310,4399,5114,9041,41.50903516103452,31.92797988505548,3927,1,659694,152208,1723,0,472,1668
8011,0,0,0,1,67,1,1159,0,0,5104736,9871680,53.96295025292817,1922,5655,4665,2912,55842,833940,769530,2400,6302,4380,5143,9045,41.86884283091664,31.64568611277063,3902,1,661024,148500,1753,0,478,1637
8012,0,0,1,0,56,1,1533,0,0,4811130,8763240,55.58776843874919,2392,5345,4647,3090,47722,606904,632428,2138,5926,3534,4393,8181,39.45883931389772,26.551568983021344,3788,1,689070,85854,1557,0,254,1279
8013,0,0,0,0,55,1,524,1,0,5543517,7293132,51.29327441292864,2354,5015,4738,2631,54520,643104,651420,2495,5403,3049,4879,7787,45.902069670114,16.738160657857883,2908,1,618285,35733,2107,0,141,665
8014,0,0,0,0,53,1,118,1,0,5843243,6362223,48.569537778323564,2131,5064,4836,2359,52488,582552,655371,2469,5056,2925,5174,7761,49.76946855251722,15.338238378984531,2587,1,573237,22344,2477,0,338,220
8015,0,0,0,0,52,1,185,1,0,5539824,5992424,47.57099956906519,2173,4801,4711,2263,53984,593152,638168,2558,4911,2738,5096,7449,49.47726750741192,9.82680210338744,2353,1,545383,9990,2448,0,385,200
8016,0,0,0,0,52,1,179,0,1,5011830,5620563,46.37887450122092,2151,4481,4481,2151,47838,621894,525213,2613,4764,2613,4943,7094,48.27007354458868,0.0,2151,1,432351,0,2330,0,462,283
8017,0,0,0,0,51,1,186,1,0,3022432,4248544,40.59556626036888,1436,3694,3482,1648,46440,554270,556848,2366,4226,2790,4412,6272,42.82522621072771,14.566775612304511,1860,1,355968,28408,1834,0,930,744
8018,0,0,0,0,51,1,187,1,0,2920490,4167968,40.22437072223753,1400,3641,3423,1618,46410,569296,540960,2358,4194,2794,4381,6217,42.485291572496,14.769791454327697,1836,1,339780,32264,1805,0,958,771
8019,0,0,0,0,51,1,190,0,1,2535000,3867000,38.72983346207417,1223,3467,3190,1500,48990,592940,549114,2301,4078,2855,4268,6045,41.10960958218893,16.66285869514053,1777,1,319500,42935,1690,0,1078,888
8020,0,0,0,0,51,1,198,0,1,1550200,2942850,33.91164991562634,680,2968,2498,1150,52598,609042,565539,2089,3709,3029,3907,5527,36.71511950137164,21.685761724405737,1620,1,254150,72380,1348,0,1409,1211
8021,0,1,1,0,65,0,350,0,0,2768304,6009696,42.988370520409354,1714,3480,3346,1848,46410,634140,773976,3118,5100,3386,4750,6732,38.704004960727254,11.633585509503979,1982,1,439824,10586,1498,0,1404,1754
8022,0,0,1,0,56,1,1131,0,0,1387152,5297760,43.266615305567875,1644,2841,2613,1872,42588,515060,662220,2602,4702,3058,3571,5671,27.2213151776324,15.883499378271265,2100,1,438048,14820,741,0,958,2089
8023,0,0,0,0,57,1,1828,1,0,1763148,7322874,50.25932749251625,2286,3464,3224,2526,30160,672568,376870,2659,5425,3139,3597,6363,26.419689627245813,16.55007833976383,2766,1,328380,56160,698,0,373,2201
8024,0,0,0,1,68,1,176,0,0,2397857,5040035,38.24918299781056,491,4074,3102,1463,49629,802685,733785,2473,4908,4417,5084,7519,40.48456495999432,31.269198141458734,2435,1,311619,153576,1639,0,1982,1806
8025,0,0,0,1,69,1,256,0,0,2386116,5804202,40.963398296528084,943,3835,3100,1678,49560,816324,726390,2724,5137,4194,4881,7294,37.70941526992961,27.289769057989197,2413,1,352380,120540,1422,0,1781,2037
8026,0,0,0,1,65,1,1629,0,0,1582092,7593579,48.093658625644196,2163,3147,2997,2313,47439,824033,620487,3133,5596,3433,3967,6430,26.153393661244042,12.54961581009077,2463,1,437157,27000,684,0,970,2599
8027,0,0,0,1,67,1,2058,0,0,1753488,9067806,52.01922721455981,2706,3354,3354,2706,49698,841101,663498,3351,6057,3351,3999,6705,25.45584412271571,0.0,2706,1,535788,0,648,0,645,2703
8028,0,0,0,1,66,1,321,0,0,7063146,9437289,53.131911315140925,1989,6159,5325,2823,55388,758861,815692,2509,6166,4177,5845,9502,50.0199960015992,29.39967328512988,3657,1,688812,90072,2502,0,520,841
8029,0,0,1,0,66,1,235,0,0,7322166,9379494,53.16013544000805,2061,6182,5417,2826,55278,736818,826431,2554,6145,4084,5910,9501,50.90186637049765,28.13318035077946,3591,1,703674,70380,2591,0,493,728
8030,0,0,1,0,65,1,543,0,0,9335844,9114960,52.87721626560914,2264,6667,6135,2796,56350,798700,749800,2728,6056,3792,6599,9927,57.784080852774665,23.476461919032445,3328,1,643080,74480,3339,0,464,79
8031,0,0,0,0,52,1,214,0,1,5496960,5927040,47.32863826479693,2155,4779,4694,2240,54208,592704,640332,2561,4886,2731,5100,7425,49.53786430600334,9.344583777936014,2325,1,542080,9265,2454,0,406,192
8032,0,0,0,0,52,1,196,1,0,3669120,4737460,42.661458015403085,1658,3998,3836,1820,46652,567454,557042,2441,4423,2765,4619,6601,44.8998886412873,12.745345677861021,1982,1,389480,22680,2016,0,783,587
8033,0,0,0,0,51,1,200,1,0,3024564,4242928,40.52159917870962,1400,3726,3484,1642,44943,545224,550392,2342,4226,2826,4426,6310,42.91852746774987,15.565903057519908,1884,1,349746,31944,1842,0,942,742
8034,0,0,0,0,51,1,203,0,1,2538510,3857100,38.66522985836241,1195,3493,3193,1495,49450,593400,554700,2280,4075,2880,4278,6073,41.20679555607303,17.336075532623774,1795,1,321425,45600,1698,0,1085,882
8035,0,0,0,0,51,1,213,0,1,1774890,3154950,35.07135583350036,764,3139,2673,1230,52441,587385,587385,2099,3795,3031,4008,5704,37.986839826445156,21.595080687758404,1696,1,281670,61978,1443,0,1335,1122
8036,0,0,0,0,51,1,214,0,1,1699415,3076962,34.655446902326915,727,3090,2616,1201,52437,591822,581574,2088,3763,3036,3977,5652,37.61648574760805,21.77853884793559,1675,1,272627,65412,1415,0,1361,1147
8037,0,0,0,0,50,1,229,0,1,1038540,2322139,30.18277654557314,293,2669,2051,911,53788,606662,576074,1931,3460,3167,3689,5218,33.76388603226827,24.863266318648787,1529,1,205886,90228,1140,0,1638,1409
8038,0,1,1,0,62,0,104,0,0,2190657,4824351,39.153543900903784,1399,3096,2962,1533,46215,613665,745839,3013,4680,3281,4576,6243,37.8021163428716,11.683282254829438,1667,1,363321,10586,1429,0,1614,1718
8039,0,0,0,0,56,1,1167,1,0,1348228,5334539,43.393547907494266,1665,2817,2599,1883,45549,535437,682753,2615,4716,3051,3549,5650,26.758176320519304,15.640728156069711,2101,1,453803,14388,716,0,950,2117
8040,0,0,0,1,65,1,1371,0,0,1660230,7069920,46.314144707637645,2078,2986,2919,2145,44678,586688,827296,3229,5441,3363,4070,6282,27.820855486487112,8.416522024785497,2212,1,538395,2010,774,0,1151,2522
8041,0,0,0,1,65,1,1789,0,0,1533126,7990178,49.21381919745713,2302,3175,3055,2422,52371,834647,682893,3179,5721,3419,3932,6474,25.15949125081825,11.232917923179112,2542,1,501354,20760,633,0,877,2666
8042,0,0,0,1,66,1,2088,0,0,1652400,9018000,51.96152422706632,2700,3312,3312,2700,49896,841680,661320,3340,6040,3340,3952,6652,24.73863375370596,0.0,2700,1,534600,0,612,0,640,2728
8043,0,0,0,1,67,1,1351,0,0,4514370,9824710,53.898051912847464,1757,5607,4459,2905,55104,831972,757568,2234,6287,4530,4936,8989,39.42080668885405,34.08849978026511,4053,1,650720,176792,1554,0,477,1828
8044,0,0,0,1,67,1,1314,0,0,4585951,9797654,53.823786563191554,1748,5629,4480,2897,55104,831972,757568,2233,6279,4531,4965,9011,39.786932528155525,34.02740679920435,4046,1,648928,178095,1583,0,485,1799
8045,0,0,0,1,67,1,1202,0,0,4805328,9716994,53.60970061472084,1782,5638,4546,2874,55370,828345,764106,2289,6255,4473,5053,9019,40.890096600521744,33.184241705203725,3966,1,649524,164892,1672,0,507,1709
8046,0,0,0,1,67,1,495,0,0,6408136,9419625,52.82991576748916,1920,5958,5087,2791,56406,799875,803250,2504,6166,4246,5671,9333,47.916594202843754,29.690970714690366,3662,1,664258,110617,2296,0,584,1079
8047,0,0,0,0,55,1,214,1,0,5629176,6825500,49.8196748283246,2272,4960,4750,2482,53824,638000,638000,2540,5232,2960,5018,7710,47.62352359916263,14.524125829022891,2692,1,575824,27720,2268,0,268,482
8048,0,0,0,0,52,1,234,0,1,5340907,5791292,46.87216658103186,2155,4670,4628,2197,53874,577284,648456,2594,4833,2678,5067,7306,49.3051721424842,6.570697549716149,2239,1,540462,4074,2431,0,439,205
8049,0,0,0,0,51,1,213,1,0,3031938,4244058,40.47221268969612,1366,3761,3489,1638,44520,544110,549292,2319,4229,2863,4442,6352,43.02324952859791,16.508504844836306,1910,1,347256,36176,1851,0,953,740
8050,0,0,0,0,51,1,224,0,1,2101572,3455650,36.6333181680284,918,3332,2908,1342,51744,594825,576800,2151,3917,2999,4141,5907,39.57271787481876,20.606391302763342,1766,1,300608,60632,1566,0,1233,1009
8051,0,0,0,0,51,1,229,0,1,1856946,3218957,35.397740040855716,765,3223,2735,1253,52437,593439,583163,2081,3822,3057,4051,5792,38.49675310984031,22.0966564128908,1741,1,284431,67832,1482,0,1316,1087
8052,0,1,1,0,63,0,1443,0,0,1674280,6950465,46.93612681080534,1902,3264,2963,2203,55552,782440,706720,2854,5358,3456,3915,6419,27.568097504180443,17.370425120633413,2504,0,493472,46354,760,1,952,2395
8053,0,1,1,0,60,0,14,0,0,1026120,3025042,31.71750305430741,1006,2026,2026,1006,46398,628463,667554,3007,4013,3007,4027,5033,31.937438845342623,0.0,1006,1,223332,0,1020,0,2001,1987
8054,0,0,0,0,56,1,1248,1,0,1295428,5425806,43.840620433565945,1740,2778,2596,1922,50141,573069,697281,2641,4745,3005,3497,5601,25.96150997149434,14.427286056808692,2104,1,474734,13468,674,0,901,2149
8055,0,0,0,0,56,1,1811,1,0,1413600,6775200,48.98979485566356,2250,3139,2989,2400,22680,609768,296415,2673,5223,2973,3412,5962,24.269322199023193,12.899034672654562,2550,1,252000,35850,589,0,423,2234
8056,0,0,0,0,59,1,1385,1,0,2351250,7030000,48.73397172404482,2255,3485,3365,2375,54282,737040,645280,2840,5335,3080,3950,6445,31.464265445104548,10.996993508431213,2495,1,517750,19680,990,0,585,1970
8057,0,0,1,0,65,1,781,0,0,139650,488550,12.24744871391589,51,1282,1081,150,47443,739339,680713,3056,3407,3458,4188,4539,30.512292604784715,14.223629663068442,351,1,31350,31557,931,0,3107,2326
8058,0,0,1,0,64,1,1564,0,0,1540565,7289009,47.4236228055175,2249,2934,2934,2249,55221,755153,768117,3241,5490,3241,3926,6175,26.1725046566048,0.0,2249,0,533013,0,685,1,992,2556
8059,0,0,0,1,65,1,1758,0,0,1468368,7764768,48.744230427815765,2252,3118,2994,2376,47244,830072,607848,3144,5644,3392,3886,6386,24.859605789312106,11.147098121756736,2500,1,441936,24180,618,0,892,2650
8060,0,0,0,1,65,1,1863,0,0,1480864,8116416,49.63869458396343,2374,3155,3065,2464,50800,836676,658800,3204,5758,3384,3895,6449,24.515301344262525,9.808573176892017,2554,1,492800,16290,601,0,830,2693
8061,0,0,0,1,66,1,2030,0,0,1485171,8632719,51.0,2534,3239,3172,2601,51660,836388,680395,3252,5920,3386,3890,6558,23.895606290697042,8.18535277187245,2668,1,533205,12194,571,0,718,2748
8062,0,0,0,1,66,1,2136,0,0,1581876,9064530,52.1344415909483,2688,3330,3300,2718,49896,840420,660330,3305,6053,3365,3917,6665,24.124676163629637,5.477225575051661,2748,1,538164,5700,582,0,617,2753
8063,0,0,0,1,67,1,1510,0,0,4125864,9870516,54.055527006958314,1875,5381,4334,2922,54612,830988,749916,2331,6300,4425,4790,8759,37.57658845611187,32.58358008278795,3969,1,648684,165426,1412,0,456,1966
8064,0,0,1,0,64,1,388,0,0,8789205,8905839,52.69724850502159,2159,6560,5942,2777,55932,756852,760059,2589,5984,3825,6372,9767,56.25833271614081,25.014435492180247,3395,1,658149,79104,3165,0,430,42
8065,0,0,1,0,61,1,890,0,0,6920199,9550684,55.794264938253285,2239,6210,5336,3113,51000,767000,625872,2194,6181,3942,5291,9278,47.148700936505136,29.655979454113854,3987,1,635052,144210,2223,0,45,845
8066,0,0,0,0,55,1,430,1,0,5495091,7093009,50.68530358989675,2379,4898,4708,2569,55448,659879,640552,2571,5330,2951,4900,7659,46.24932431938871,13.874881522629007,2759,1,596008,26220,2139,0,192,622
8067,0,0,0,0,52,1,211,1,0,4769652,5481354,45.617978911828175,2014,4440,4373,2081,46662,608454,532068,2567,4715,2701,4926,7074,47.8748368143433,8.314029025396882,2148,1,420362,11256,2292,0,553,342
8068,0,0,0,0,52,1,212,1,0,4641413,5404385,45.28796749689701,1956,4409,4314,2051,46104,595510,537540,2540,4686,2730,4898,7044,47.57099956906519,9.874922862703322,2146,1,418404,15295,2263,0,584,372
8069,0,0,0,0,51,1,235,1,0,2368586,3681932,37.76241517699841,1042,3471,3087,1426,50616,588696,573204,2198,4008,2966,4243,6053,40.755367744629666,19.609193777381268,1810,1,316572,54144,1661,0,1156,921
8070,0,0,0,0,51,1,268,0,1,1163613,2431103,30.870698080866262,364,2763,2174,953,53823,594383,589281,1962,3504,3140,3772,5314,34.942810419312295,24.35456851528279,1542,1,220143,79515,1221,0,1598,1330
8071,0,1,1,0,62,0,1474,0,0,1582595,6907665,46.850827100489916,1925,3186,2916,2195,54780,783603,692340,2877,5342,3417,3868,6333,26.851443164195103,16.43443718226862,2465,0,482900,43200,721,1,952,2426
8072,0,0,1,0,57,1,1055,0,0,1335914,5187230,42.40283009422838,1468,2871,2541,1798,55695,683745,677975,2555,4683,3215,3628,5756,27.258026340878022,19.18491950011871,2128,1,422530,43560,743,0,1087,2142
8073,0,0,1,0,60,1,96,0,0,2693860,5146050,41.10960958218893,1395,3579,3284,1690,48843,739935,612045,2750,4735,3340,4639,6624,39.92492955535426,17.18153117471089,1985,0,339690,53395,1594,1,1355,1451
8074,0,0,1,0,65,1,715,0,0,161100,586080,13.416407864998739,62,1317,1075,180,48175,765160,667480,3014,3436,3498,4151,4573,29.916550603303182,15.588391269727603,422,1,36900,40898,895,0,3076,2361
8075,0,0,1,0,64,1,1647,0,0,1475404,7411385,47.86439177509728,2291,2935,2935,2291,53280,776400,718170,3235,5526,3235,3879,6170,25.37715508089904,0.0,2291,0,508602,0,644,1,944,2591
8076,0,0,0,1,65,1,1889,0,0,1410726,8070436,49.61854492022111,2402,3095,3035,2462,51612,829334,668712,3218,5740,3338,3851,6373,23.93741840717165,7.914659756013729,2522,1,502248,10440,573,0,816,2705
8077,0,0,0,1,66,1,2125,0,0,1442306,8848454,51.633322573702344,2666,3207,3207,2666,54500,829750,723542,3319,5985,3319,3860,6526,23.259406699226016,0.0,2666,1,581188,0,541,0,653,2778
8078,0,0,0,1,67,1,1713,0,0,3682710,9959586,54.38749856354859,2009,5152,4203,2958,51832,835016,703703,2418,6325,4316,4612,8519,35.2845575287547,31.036063701930257,3907,1,618222,167024,1245,0,409,2122
8079,0,0,0,1,67,1,1634,0,0,3822672,9897256,54.18486873657626,1967,5207,4238,2936,52398,829266,718023,2402,6307,4340,4673,8578,36.08323710533743,31.36282770749822,3905,1,625368,163761,1302,0,435,2069
8080,0,0,0,1,67,1,1207,0,0,4597544,9546132,53.207142377692115,1697,5589,4455,2831,55370,826140,762072,2238,6203,4506,4996,8961,40.29888335921977,33.86254133131897,3965,1,639806,172368,1624,0,541,1748
8081,0,0,0,1,67,1,1097,0,0,4809008,9466330,53.0,1686,5644,4521,2809,55615,825650,764990,2247,6179,4493,5082,9014,41.376321731154405,33.62461712731539,3932,1,637643,167327,1712,0,561,1658
8082,0,0,0,1,67,1,647,0,0,5749328,9243910,52.373657500693994,1783,5799,4839,2743,55822,832390,761620,2410,6113,4330,5466,9169,45.78209256903839,31.127107082567377,3703,1,619918,143040,2096,0,627,1274
8083,0,0,1,0,60,1,2024,0,0,3546900,9601200,56.124860801609124,1985,5441,4276,3150,49648,707136,652272,1883,6198,4213,4174,8489,33.555923471125034,34.51843182645255,4315,1,674100,181740,1126,0,102,1922
8084,0,0,0,0,55,1,548,1,0,5409888,7233240,51.146847410177685,2404,4896,4684,2616,54707,666365,627655,2553,5381,2977,4833,7661,45.47526800360829,14.658435386318777,2828,1,593832,31376,2068,0,149,697
8085,0,0,0,0,51,1,251,1,0,2287056,3594144,37.30951621235526,966,3461,3035,1392,49950,580950,573204,2156,3974,3008,4225,6043,40.53393639902249,20.651131328572568,1818,1,309024,58788,1643,0,1190,939
8086,0,0,0,0,50,1,291,0,1,1109862,2337228,30.298514815086232,365,2680,2127,918,54990,598310,595764,1993,3464,3099,3755,5226,34.77067730142742,23.596757581227134,1471,1,214812,72996,1209,0,1628,1337
8087,0,0,0,0,57,1,1231,1,0,1250612,5392200,43.497126341863094,1652,2793,2553,1892,48306,552900,709650,2610,4742,3090,3511,5643,25.709920264364882,16.492422502470642,2132,1,471108,14160,661,0,958,2189
8088,0,0,0,0,57,1,1983,1,0,1572130,7441070,50.89204259999789,2466,3321,3197,2590,46552,726869,528632,2749,5463,2997,3480,6194,24.63736998950984,11.974455588104178,2714,1,476560,23684,607,0,283,2266
8089,0,0,1,0,60,1,225,0,0,2678584,5336132,41.86884283091664,1440,3594,3281,1753,51660,748824,639240,2731,4797,3357,4572,6638,39.08964057138413,17.879540345223443,2066,0,368130,54149,1528,1,1291,1516
8090,0,0,1,0,67,1,994,0,0,2262047,3681669,32.96968304366907,187,4068,3168,1087,43737,809493,619821,2487,4474,4287,5468,7455,45.617978911828175,30.20892768076575,1987,1,198921,176400,2081,0,2300,1306
8091,0,0,0,1,68,1,407,0,0,2396870,4663372,36.851051545376556,229,4252,3123,1358,52514,831028,745178,2305,4792,4563,5199,7686,42.01190307520001,33.82152476143856,2487,1,294686,182898,1765,0,2076,1669
8092,0,0,0,1,65,1,1964,0,0,1355205,8193855,50.049975024968795,2475,3076,3046,2505,48514,830834,624761,3241,5776,3301,3812,6347,23.259406699226016,5.652706486041966,2535,1,478455,5820,541,0,766,2730
8093,0,0,0,1,66,1,2102,0,0,1344624,8645880,51.146847410177685,2556,3190,3130,2616,52750,826250,697355,3245,5921,3365,3819,6495,22.67156809750927,7.864259938752337,2676,1,551976,10380,514,0,689,2791
8094,0,0,0,1,66,1,2128,0,0,1348529,8729812,51.37119815616529,2597,3192,3150,2639,52459,830308,691372,3266,5947,3350,3819,6500,22.60530911091463,6.484411467763075,2681,1,551551,7392,511,0,669,2797
8095,0,0,0,1,66,1,2231,0,0,1443620,9160375,52.48809388804284,2688,3346,3279,2755,51865,841225,681625,3258,6080,3392,3849,6671,22.891046284519195,8.185808589931957,2822,1,564775,12127,524,0,570,2801
8096,0,0,0,1,67,1,1362,0,0,4223464,9599558,53.34791467339656,1822,5354,4330,2846,53946,819639,748806,2349,6219,4397,4857,8727,38.52272056851645,32.22079541072066,3870,1,631812,159744,1484,0,527,1889
8097,0,0,0,1,67,1,712,0,0,5480688,9158088,52.191953402799555,1709,5751,4736,2724,55250,840500,743002,2347,6086,4377,5374,9113,44.85532298401161,31.975389714773517,3739,1,602004,160370,2012,0,638,1350
8098,0,0,1,0,60,1,1854,0,0,3980671,9493572,55.91958512006326,1954,5573,4400,3127,55596,746856,686136,1863,6163,4209,4309,8609,35.679125549822544,34.44240201475704,4300,1,706702,167739,1273,0,91,1763
8099,0,0,1,0,57,1,1886,0,0,3741855,8963120,55.632724182804495,2636,4763,4304,3095,43680,608160,602368,2437,5991,3355,4105,7659,34.77067730142742,21.67904173790269,3554,1,643760,62883,1209,0,199,1687
8100,0,0,0,0,55,1,567,1,0,5378860,7239060,51.18593556827891,2404,4889,4673,2620,54000,663120,621675,2547,5383,2979,4816,7652,45.31004303683677,14.781958355223496,2836,1,589500,32400,2053,0,143,710
8101,0,0,0,0,54,1,68,1,0,5582613,6558192,48.95916665957459,2277,4846,4726,2397,56882,653904,651168,2616,5133,2856,5065,7582,48.25971404805462,10.96129127279285,2517,1,570486,15120,2329,0,339,407
8102,0,0,0,0,54,1,20,1,0,5597856,6486480,48.744230427815765,2256,4852,4732,2376,56350,627900,668850,2610,5106,2850,5086,7582,48.53864439804639,10.95616238207774,2496,1,582120,12960,2356,0,354,374
8103,0,0,0,0,53,1,325,0,1,5688084,5964356,47.20169488482379,2120,4889,4781,2228,49938,543431,658542,2569,4905,2785,5230,7566,50.52722038663912,10.498474454302341,2336,1,548088,8424,2553,0,449,124
8104,0,0,0,0,52,1,236,0,1,4287552,5171664,44.22668877499196,1755,4349,4148,1956,45771,552596,579036,2443,4600,2845,4836,6993,46.8187996428785,14.255752335575957,2157,1,428364,24522,2192,0,688,452
8105,0,0,0,0,52,1,252,1,0,3057133,4248097,40.33608806019741,1266,3867,3506,1627,45368,553532,558754,2250,4238,2972,4490,6478,43.347433603386484,19.03057925423903,1988,1,348178,47652,1879,0,984,732
8106,0,0,0,0,51,1,286,0,1,1651400,2947450,33.91164991562634,552,3184,2586,1150,52200,594616,576675,1965,3713,3161,3999,5747,37.89459064299283,24.455747917323148,1748,1,258750,85514,1436,0,1413,1127
8107,0,0,1,0,57,1,1125,0,0,1277500,5235925,42.720018726587654,1495,2855,2525,1825,55404,697167,654132,2539,4694,3199,3569,5724,26.457513110645905,19.006848607041135,2155,1,416100,48840,700,0,1044,2169
8108,0,0,0,1,65,1,1633,0,0,1460550,7407400,47.69696007084728,2190,3002,2917,2275,47500,618640,814000,3171,5531,3341,3898,6258,25.337718918639855,9.300149152818726,2360,1,568750,4505,642,0,981,2614
8109,0,0,0,1,65,1,2096,0,0,1282545,8534754,50.90186637049765,2561,3116,3086,2591,50953,826794,668682,3264,5885,3324,3789,6410,22.24859546128699,5.514871952411144,2621,1,525973,5490,495,0,703,2799
8110,0,0,0,1,66,1,2178,0,0,1278979,8782677,51.56549233741495,2629,3170,3140,2659,53250,825750,703539,3273,5962,3333,3784,6473,21.93171219946131,5.483301264452448,2689,1,566367,5130,481,0,644,2822
8111,0,0,0,1,66,1,2201,0,0,1286880,8863386,51.778373863998475,2681,3161,3161,2681,54000,826500,714096,3306,5987,3306,3786,6467,21.908902300206645,0.0,2681,1,579096,0,480,0,625,2826
8112,0,0,0,1,67,1,1928,0,0,3183488,10023200,54.699177324709375,2147,4901,4056,2992,55104,824100,750400,2505,6342,4195,4414,8251,32.61901286060018,29.289299115585234,3837,1,670208,130130,1064,0,358,2286
8113,0,0,0,1,67,1,1886,0,0,3251976,9976300,54.57105459856901,2129,4919,4070,2978,55104,824100,750400,2501,6328,4199,4442,8269,33.04542328371661,29.356487218946608,3827,1,667072,131595,1092,0,372,2258
8114,0,0,0,1,67,1,1482,0,0,3932608,9631460,53.46026561849464,1919,5173,4234,2858,52948,822280,731290,2431,6228,4309,4746,8543,37.094473981982816,30.88543950065042,3797,1,620186,153057,1376,0,512,1994
8115,0,0,0,1,67,1,744,0,0,5295177,9063159,51.99038372622383,1639,5726,4662,2703,55822,828191,757778,2289,6056,4417,5312,9079,44.26059195266146,32.71222578585846,3767,1,610878,159600,1959,0,650,1394
8116,0,0,1,0,61,1,325,0,0,7401944,8811288,53.74011537017761,2138,6201,5451,2888,55029,674271,759699,2301,5939,3801,5614,9252,50.62608023538856,27.41412829817871,3638,1,719112,69000,2563,0,163,488
8117,0,0,1,0,58,1,1918,0,0,3385944,8853212,55.08175741568164,2546,4638,4150,3034,41006,592354,589436,2430,5952,3406,4034,7556,33.406586176980134,22.43350969034116,3522,1,612868,65392,1116,0,116,1802
8118,0,0,0,0,56,1,1239,1,0,4987026,8332269,54.194095619356915,2330,5242,4635,2937,49896,612792,655347,2230,5774,3444,4535,8079,41.20679555607303,24.826571688808766,3544,1,678447,70412,1698,0,100,1139
8119,0,0,0,0,53,1,258,1,0,5638243,6065553,47.4236228055175,2154,4851,4756,2249,52272,582552,652674,2602,4946,2792,5204,7548,50.06995106848019,9.759997214798725,2344,1,544258,9405,2507,0,448,190
8120,0,0,0,0,52,1,335,1,0,4964934,5473416,45.46427168667722,2025,4511,4469,2067,35700,540192,463400,2606,4715,2690,5050,7159,49.01020301937138,6.609134537568676,2109,1,361725,6888,2402,0,581,246
8121,0,0,0,0,52,1,260,1,0,3383436,4499250,41.400483088968905,1379,4023,3688,1714,43888,553875,546000,2290,4339,2960,4599,6648,44.429719783046124,18.32843530268791,2049,1,356512,46230,1974,0,911,651
8122,0,0,0,0,52,1,265,1,0,3067736,4250008,40.29888335921977,1240,3897,3513,1624,45792,554804,565272,2233,4241,3001,4506,6514,43.46262762420146,19.62985039477768,2008,1,350784,49536,1889,0,993,728
8123,0,0,0,0,51,1,309,0,1,1517452,2780546,32.96968304366907,527,3043,2483,1087,54522,598572,596014,1998,3645,3118,3954,5601,37.36308338453881,23.72118063774177,1647,1,253271,75040,1396,0,1471,1162
8124,0,0,0,1,64,1,1755,0,0,1360134,7564869,48.342527861087284,2295,2961,2919,2337,53724,718614,783354,3195,5574,3279,3819,6198,24.124676163629637,6.5135556243263055,2379,1,565554,4494,582,0,900,2655
8125,0,0,0,1,66,1,2969,0,0,1488422,11277266,58.360945845659494,3205,4044,3843,3406,54467,831061,718487,3110,6717,3512,3748,7355,20.904544960366874,14.336946952226079,3607,1,739102,33165,437,0,95,2874
8126,0,0,1,0,66,1,1807,0,0,3322878,9827610,54.20332093147061,2114,4893,4069,2938,55304,829560,745935,2521,6283,4169,4476,8238,33.63034344160047,28.919134283608557,3762,1,655174,129368,1131,0,407,2214
8127,0,0,1,0,64,1,168,0,0,7326208,8454528,51.22499389946279,2113,5927,5416,2624,54858,718506,792612,2711,5846,3733,6014,9149,52.839379254491625,22.844656668741514,3135,1,645504,51100,2792,0,598,430
8128,0,0,1,0,60,1,952,0,0,6306560,9180896,55.06359959174482,2232,5912,5112,3032,54718,760028,660104,2228,6060,3828,5108,8940,45.60701700396552,28.36944565749922,3832,1,660976,128000,2080,0,4,948
8129,0,0,1,0,58,1,1837,0,0,3543288,8797960,54.89080068645383,2502,4700,4189,3013,44308,619040,610280,2409,5933,3431,4096,7620,34.292856398964496,22.936140384026647,3524,1,629717,70518,1176,0,93,1744
8130,0,0,0,0,55,1,552,1,0,5348065,7197615,51.03920062069938,2387,4876,4658,2605,52440,635490,629964,2545,5368,2981,4816,7639,45.31004303683677,14.848688813420488,2823,1,593940,29648,2053,0,158,710
8131,0,0,0,0,54,1,53,1,0,5524148,6472571,48.75448697299562,2317,4761,4701,2377,56376,661689,631736,2663,5100,2783,5047,7484,48.2078831727758,7.750803389552748,2437,1,551464,8400,2324,0,346,399
8132,0,0,0,0,54,1,144,1,0,5578585,6208610,47.86439177509728,2224,4793,4726,2291,55460,636850,639560,2643,5001,2777,5145,7503,49.345719165901315,8.189452396126915,2358,1,540676,8643,2435,0,419,275
8133,0,0,0,0,53,1,340,1,0,5616476,5929728,46.968074263269514,2146,4812,4752,2206,51240,564480,655872,2628,4894,2748,5234,7500,50.457903246171455,7.746504550744806,2266,1,538264,5340,2546,0,482,142
8134,0,0,0,0,53,1,328,1,0,4518528,5238816,44.36214602563767,1806,4426,4264,1968,43680,559020,553696,2500,4630,2824,4958,7088,47.916594202843754,12.917631945094628,2130,1,409344,22194,2296,0,694,366
8135,0,0,0,0,53,1,318,0,1,4422600,5185050,44.15880433163923,1760,4408,4218,1950,45368,569026,563708,2469,4609,2849,4927,7067,47.62352359916263,13.934305809385554,2140,1,413400,25840,2268,0,709,391
8136,0,0,0,0,52,1,288,1,0,2593953,3840111,38.379682124790975,1016,3691,3234,1473,44304,542256,555291,2150,4080,3064,4368,6298,41.96427051671457,21.405371217426726,1930,1,313749,58496,1761,0,1134,846
8137,0,0,0,0,50,1,334,0,1,1390592,2610176,32.0,514,2892,2382,1024,56144,616858,591368,2039,3573,3059,3907,5441,36.851051545376556,22.628970539392345,1534,1,237568,71910,1358,0,1525,1191
8138,0,0,0,0,56,1,1386,1,0,1122507,5543970,44.26059195266146,1747,2744,2532,1959,53250,602790,707500,2618,4789,3042,3403,5574,23.93741840717165,15.42479684557981,2171,1,489750,17172,573,0,871,2257
8139,0,0,1,0,62,1,10,0,0,1471344,3762920,34.75629439396553,762,2872,2426,1208,49245,763175,626115,2669,4323,3561,4333,5987,34.899856733230294,21.207439475975118,1654,0,242808,81618,1218,1,1907,1897
8140,0,0,1,0,65,1,667,0,0,217680,784560,15.491933384829668,16,1403,1147,240,52488,794367,706104,3013,3509,3525,4176,4672,30.116440692751194,16.074249621235904,496,1,51840,41984,907,0,3029,2362
8141,0,0,0,1,66,1,1523,0,0,1564878,7452648,47.18050444834179,1992,3163,2929,2226,42408,572508,830304,3114,5574,3582,4051,6511,26.514147167125703,15.92773453843406,2460,1,552048,0,703,0,1122,2645
8142,0,0,0,1,65,1,1646,0,0,1451352,7494088,47.77028364998475,2120,3080,2918,2282,45612,594404,827568,3122,5566,3446,3920,6364,25.219040425836983,12.95642684315187,2444,1,575064,0,636,0,1002,2648
8143,0,0,0,1,65,1,1685,0,0,1417416,7524270,47.968739820845826,2167,3051,2917,2301,48500,634380,817500,3136,5571,3404,3886,6321,24.819347291981714,11.718240104647752,2435,1,575250,0,616,0,969,2654
8144,0,0,0,1,67,1,1138,0,0,4359135,9180147,52.278102490430925,1730,5331,4328,2733,55680,806160,779288,2356,6092,4362,4954,8690,39.93745109543172,31.862411680300582,3736,1,634056,139417,1595,0,626,1764
8145,0,0,1,0,64,1,235,0,0,7322166,8322292,50.90186637049765,2122,5886,5417,2591,55216,745184,764456,2743,5803,3681,6038,9098,53.16013544000805,21.879770258647063,3060,1,616658,58156,2826,0,621,386
8146,0,0,1,0,63,1,508,0,0,8322300,8346078,51.40038910358559,2132,6302,5792,2642,56105,773955,723411,2649,5801,3669,6309,9461,56.124860801609124,22.742034972249467,3152,1,605018,71400,3150,0,517,9
8147,0,0,0,0,55,1,470,1,0,5364359,7073880,50.62608023538856,2381,4838,4656,2563,51948,612720,645840,2578,5323,2942,4853,7598,45.749316934791494,13.581456357942667,2745,1,599742,21658,2093,0,197,667
8148,0,0,0,0,53,1,425,1,0,5214986,5535460,45.617978911828175,2051,4617,4587,2081,41447,577220,508060,2630,4741,2690,5166,7277,50.05996404313531,5.514871952411144,2111,1,397471,4890,2506,0,579,154
8149,0,0,0,0,53,1,380,1,0,4681484,5301850,44.51965857910413,1855,4471,4344,1982,44298,572450,553725,2548,4657,2802,5037,7146,48.60041152089147,11.526200699097002,2109,1,410274,18288,2362,0,693,313
8150,0,0,0,0,53,1,371,1,0,4581642,5245136,44.30575583375144,1813,4447,4297,1963,46010,574480,571808,2522,4635,2822,5006,7119,48.31148931672465,12.525768210359056,2113,1,420082,20400,2334,0,709,338
8151,0,0,0,0,52,1,283,1,0,3411734,4517040,41.36423575989287,1321,4095,3705,1711,49056,591360,578160,2250,4351,3030,4634,6735,44.654227123532216,19.78157269549737,2101,1,374709,55380,1994,0,929,646
8152,0,0,0,0,51,1,310,1,0,2335271,3587838,37.16180835212409,856,3597,3072,1381,49476,563766,592344,2073,3979,3123,4289,6195,41.12177038990418,22.93033672529423,1906,1,314868,63000,1691,0,1217,907
8153,0,1,1,0,64,0,1261,0,0,3263952,8222208,50.438080851673966,2484,3887,3827,2544,49680,698112,743360,3172,5776,3292,4515,7119,35.81898937714463,7.745966692414834,2604,0,585120,7080,1283,1,688,1949
8154,0,1,1,0,62,0,1485,0,0,1221586,6504064,45.5411901469428,1966,2771,2663,2074,55189,755776,718144,3028,5210,3244,3725,5907,24.269322199023193,10.393195703494003,2182,0,474946,15660,589,1,1062,2547
8155,0,0,0,0,56,1,1468,1,0,1061469,5629184,44.710177812216315,1809,2720,2530,1999,54064,613888,698368,2626,4815,3006,3347,5536,23.043437243605826,14.605765483509789,2189,1,495752,17290,531,0,817,2285
8156,0,0,0,1,65,1,1770,0,0,1342539,7631151,48.40454524112379,2223,3036,2916,2343,46812,612316,810993,3137,5600,3377,3830,6293,23.93741840717165,11.080810612286749,2463,1,583407,6120,573,0,914,2684
8157,0,0,0,1,64,1,1848,0,0,1271988,7701006,48.80573736764972,2322,2976,2916,2382,52974,704794,785619,3173,5615,3293,3767,6209,23.108440016582687,7.748117453886108,2442,1,578826,6000,534,0,851,2699
8158,0,0,1,0,66,1,2479,0,0,1461732,9804300,54.506880299646575,2715,3719,3463,2971,51612,834900,673200,3044,6271,3556,3792,7019,22.181073012818835,16.070094675408992,3227,1,606084,44288,492,0,329,2808
8159,0,0,1,0,66,1,1730,0,0,3332175,9612820,53.71219600798314,2120,4805,4040,2885,55056,826336,739704,2567,6217,4097,4487,8137,33.98529093593286,27.856186718204253,3650,1,640470,120870,1155,0,447,2177
8160,0,0,0,1,66,1,808,0,0,4845428,8829564,51.40038910358559,1543,5575,4476,2642,55660,808764,768660,2243,5984,4441,5176,8917,42.82522621072771,33.302470663754214,3741,1,607660,157157,1834,0,700,1508
8161,0,0,0,0,54,1,12,1,0,5489613,6354303,48.342527861087284,2337,4686,4686,2337,50848,617213,609056,2719,5056,2719,5068,7405,48.46648326421054,0.0,2337,1,523488,0,2349,0,382,370
8162,0,0,0,0,54,1,259,1,0,5536322,6021808,47.19110085598767,2197,4743,4713,2227,52200,627328,608400,2674,4931,2734,5190,7447,49.85980344927164,5.490867587491313,2257,1,501075,4260,2486,0,477,218
8163,0,0,0,0,53,1,439,1,0,4958226,5396132,44.9221548904324,1933,4560,4475,2018,41280,574910,513408,2589,4692,2759,5131,7234,49.56813492557492,9.344583777936014,2103,1,387456,13685,2457,0,656,217
8164,0,0,0,0,53,1,364,0,1,4161180,4971024,43.197222132910355,1598,4364,4096,1866,49494,602064,583416,2396,4530,2932,4894,7028,47.22287581247038,16.48489384028688,2134,1,408654,38324,2230,0,798,434
8165,0,0,0,0,52,1,312,1,0,2718000,3930000,38.72983346207417,997,3815,3312,1500,48620,579020,576400,2117,4120,3123,4432,6435,42.567593307585526,22.459593617163634,2003,1,330000,68911,1812,0,1120,808
8166,0,0,0,0,52,1,315,1,0,2623950,3846990,38.34057902536163,957,3768,3255,1470,49932,573123,596676,2104,4087,3130,4402,6385,42.24926034855522,22.678901587818302,1983,1,335160,63612,1785,0,1147,832
8167,0,0,0,0,50,1,401,0,0,1044522,2124366,29.0,446,2478,2083,841,52884,591084,570876,2131,3367,2921,3768,5004,35.24202037341219,19.891431663643996,1236,0,190066,56485,1242,0,1685,1284
8168,0,0,1,0,57,1,1309,0,0,1145400,5440650,43.69210454990696,1624,2794,2509,1909,55912,661200,686850,2565,4759,3135,3450,5644,24.49489742783178,17.641069309764326,2194,1,460069,33630,600,0,941,2250
8169,0,0,1,0,65,1,2951,0,0,1765110,11417839,58.83026432033091,3269,4163,3971,3461,52371,834647,682893,3107,6760,3491,3809,7462,22.58317958127243,14.068015852622846,3653,1,716427,33792,510,0,162,2789
8170,0,0,1,0,60,1,1000,0,0,5703600,8861160,54.22176684690383,2205,5615,4880,2940,52877,762542,629926,2279,5954,3749,4954,8629,44.04543109109048,27.266909695230567,3675,1,614460,128625,1940,0,74,1074
8171,0,0,0,0,55,1,505,1,0,5325606,7137702,50.73460357586329,2332,4885,4643,2574,49946,612833,626698,2531,5347,3015,4842,7658,45.48626166217664,15.677709056199316,2816,1,581724,30976,2069,0,199,704
8172,0,0,0,0,53,1,389,1,0,5524692,5838472,46.51881339845203,2164,4717,4717,2164,51714,596258,631332,2698,4862,2698,5251,7415,50.52722038663912,0.0,2164,1,506376,0,2553,0,534,145
8173,0,0,0,0,53,1,427,0,1,4412850,5075252,43.56604182158393,1686,4435,4223,1898,50176,598976,598976,2462,4572,2886,4999,7109,48.218253804964775,14.675787412724949,2110,1,425152,28620,2325,0,776,349
8174,0,0,0,0,53,1,418,0,1,4316063,5016930,43.347433603386484,1645,4410,4176,1879,49506,595410,592740,2436,4549,2904,4967,7080,47.92702786528704,15.430515836556204,2113,1,417138,31824,2297,0,791,373
8175,0,0,0,0,53,1,388,0,1,4034688,4859136,42.708313008125245,1515,4345,4036,1824,51067,594072,610056,2355,4488,2973,4876,7009,47.031904065219386,17.670866064269237,2133,1,417696,39243,2212,0,840,452
8176,0,0,0,0,51,1,376,1,0,1572480,2757240,32.863353450309965,634,2982,2536,1080,51684,559107,602508,2107,3633,2999,4009,5535,38.157568056677825,21.184757240832795,1526,1,254880,49952,1456,0,1473,1097
8177,0,1,1,0,63,0,1376,0,0,1773657,6948099,46.76537180435969,2187,2998,2998,2187,51736,737064,708471,3177,5364,3177,3988,6175,28.478061731796284,0.0,2187,0,487701,0,811,1,990,2366
8178,0,0,0,0,56,1,1442,1,0,1055184,5592080,44.45222154178574,1758,2728,2510,1976,55328,633920,699010,2612,4806,3048,3364,5558,23.108440016582687,15.555352978307177,2194,1,488072,21800,534,0,854,2296
8179,0,0,0,0,56,1,1491,1,0,1023022,5645640,44.74371464239419,1812,2703,2513,2002,52961,595020,707820,2630,4822,3010,3331,5523,22.60530911091463,14.574857044323968,2192,1,502502,14820,511,0,818,2309
8180,0,0,1,0,57,1,2091,0,0,1637686,7756750,51.94227565288221,2668,3335,3305,2698,38500,632500,503125,2845,5573,2905,3482,6210,24.63736998950984,5.753771868478424,2728,0,472150,5520,607,0,177,2268
8181,0,0,1,0,66,1,461,0,0,5289902,8441982,50.41825066382212,1383,5782,4623,2542,55596,816966,750546,2162,5863,4480,5402,9103,45.617978911828175,34.307291198172685,3701,1,574492,176168,2081,0,779,1240
8182,0,0,1,0,59,1,776,0,0,6220032,8703968,53.96295025292817,2228,5732,5048,2912,54500,747250,651602,2305,5901,3673,5125,8721,46.216880033165374,26.217776531011893,3596,1,634816,108756,2136,0,77,853
8183,0,0,1,0,60,1,1739,0,0,3448520,8862200,54.037024344425184,1793,5228,4101,2920,52900,698050,698050,1908,5955,4162,4216,8263,34.36568055487916,33.92993075187329,4047,1,671600,149891,1181,0,115,1854
8184,0,0,0,0,55,1,221,1,0,5395740,6701436,49.35585071701227,2328,4759,4651,2436,48816,594216,621726,2643,5187,2859,4966,7510,47.06378650300037,10.489171794062365,2544,1,550536,13284,2215,0,315,536
8185,0,0,0,0,54,1,275,1,0,5482464,5981472,46.98936049788292,2178,4721,4691,2208,51756,617652,614943,2679,4917,2739,5192,7430,49.82971001320397,5.478746393072713,2238,1,501216,4080,2483,0,501,226
8186,0,0,0,0,53,1,539,1,0,5442822,5584194,45.59605246071199,2019,4757,4697,2079,44732,569432,566746,2626,4765,2746,5304,7443,51.16639522186413,7.750803389552748,2139,1,438669,8100,2618,0,607,68
8187,0,0,0,0,53,1,532,1,0,5330220,5525730,45.36518488885502,1998,4708,4648,2058,40964,561165,526260,2625,4743,2745,5275,7393,50.89204259999789,7.750803389552748,2118,1,403368,8940,2590,0,627,95
8188,0,0,0,0,53,1,518,0,1,5103995,5416320,44.88875137492688,1930,4633,4548,2015,38850,564480,497280,2603,4703,2773,5221,7321,50.32891812864648,9.357120099656203,2100,1,372775,13685,2533,0,673,155
8189,0,0,0,0,56,1,1374,1,0,1098040,5515420,44.04543109109048,1672,2774,2506,1940,48755,565757,696535,2575,4783,3111,3409,5617,23.790754506740637,17.112206004140152,2208,1,475300,19564,566,0,903,2277
8190,0,0,0,0,56,1,1424,1,0,1063065,5562915,44.328320518603,1723,2748,2506,1965,53105,608665,699257,2589,4796,3073,3372,5579,23.259406699226016,16.254134743887725,2207,1,485355,21780,541,0,866,2290
8191,0,0,1,0,59,1,1600,0,0,2036496,7249536,49.35585071701227,2341,3367,3272,2436,47478,574368,732096,2881,5412,3071,3812,6343,28.91366458960192,10.917944406230927,2531,0,599256,6080,836,1,540,2140
8192,0,0,1,0,65,1,266,0,0,274992,1327632,20.199009876724155,6,1484,1082,408,54168,793976,722388,2852,3662,3656,3928,4738,25.96150997149434,20.062332988943222,810,1,90576,63114,674,0,2846,2580
8193,0,0,0,1,67,1,1646,0,0,1518995,7820865,48.010415536631214,1999,3270,2964,2305,21582,335907,739674,3087,5698,3699,4052,6663,25.67099530598687,18.49644291634118,2611,1,502490,0,659,0,1088,2734
8194,0,0,1,0,65,1,2885,0,0,1981434,11318034,58.80476171195663,3350,4139,4031,3458,52371,828069,677511,3165,6731,3381,3846,7412,23.93741840717165,10.498474454302341,3566,1,715806,18576,573,0,185,2700
8195,0,0,1,0,66,1,423,0,0,5247568,8327280,50.11985634456667,1358,5755,4601,2512,55350,815490,745875,2161,5827,4469,5404,9070,45.70557952810576,34.22035140741603,3666,1,565200,177716,2089,0,803,1226
8196,0,0,1,0,66,1,390,0,0,5311944,8314020,50.07993610219566,1384,5750,4626,2508,55104,815490,742560,2191,5823,4439,5433,9065,46.021733996015406,33.78579848717775,3632,1,561792,173096,2118,0,807,1197
8197,0,0,1,0,66,1,358,0,0,5378235,8304075,50.049975024968795,1410,5747,4652,2505,55370,812175,749190,2220,5820,4410,5462,9062,46.33573135281238,33.36069179971083,3600,1,566130,166440,2147,0,810,1168
8198,0,0,1,0,66,1,171,0,0,5783932,8231076,49.91993589739474,1574,5731,4813,2492,56120,759690,805932,2385,5795,4221,5624,9034,48.176757881783615,30.608049756149608,3410,1,608048,100980,2321,0,811,982
8199,0,0,1,0,61,1,27,0,0,7292518,8214159,51.836280730777744,2117,5971,5401,2687,54120,672540,752022,2487,5744,3627,5771,9028,52.09606511052442,23.944978905534033,3257,1,661002,55860,2714,0,370,343
8200,0,0,1,0,56,1,641,0,0,5268086,7402228,51.36146415358503,2267,5006,4635,2638,48616,578036,662216,2435,5444,3177,4803,7812,44.68780594300866,19.460328111023042,3009,1,622568,35616,1997,0,168,809
8201,0,0,1,0,54,1,39,0,0,5416876,6435474,48.4458460551573,2257,4745,4655,2347,48351,584046,622434,2652,5089,2832,5050,7487,48.041648597857254,9.52871847115494,2437,1,532769,10530,2308,0,395,434
8202,0,0,0,0,50,1,458,1,0,1090320,2125200,28.982753492378876,534,2444,2138,840,51302,571780,574310,2224,3370,2836,3828,4974,36.02776706930364,17.526804243380145,1146,1,190680,40698,1298,0,1690,1232
8203,0,0,1,0,63,1,83,0,0,829110,3024822,30.870698080866262,413,2363,1823,953,48068,774456,625278,2634,4127,3714,4044,5537,29.49576240750525,23.370717639335314,1493,0,187741,100980,870,1,2221,2304
8204,0,0,0,1,65,1,1902,0,0,1247688,7909278,49.17316341257699,2243,3109,2934,2418,44345,592051,801395,3096,5689,3446,3787,6380,22.715633383201094,13.43304388518588,2593,1,592410,0,516,0,853,2755
8205,0,0,0,0,53,1,573,0,1,4928800,5262592,44.181444068749045,1802,4627,4477,1952,54720,647040,614688,2546,4648,2846,5221,7323,50.24937810560445,12.318810369945247,2102,1,445056,21900,2525,0,744,171
8206,0,0,0,0,52,1,362,0,1,2987883,4101138,39.45883931389772,1139,3894,3476,1557,54145,645330,582114,2216,4191,3052,4553,6528,43.80639222761902,20.70409472934719,1975,1,344097,66462,1919,0,1077,715
8207,0,1,1,0,63,0,1450,0,0,1059456,6257536,44.54211490264017,1899,2603,2518,1984,50388,719112,697034,3069,5138,3239,3688,5757,23.108440016582687,9.257905235465769,2069,0,438464,12155,534,1,1170,2620
8208,0,0,0,0,56,1,1590,1,0,937984,5748736,45.254833995939045,1886,2668,2506,2048,45567,513681,698943,2645,4855,2969,3265,5475,21.400934559032695,13.47482551954778,2210,1,509952,6966,458,0,759,2349
8209,0,0,0,1,64,1,2071,0,0,1063722,8087783,49.969990994595946,2402,3018,2923,2497,47235,651039,761165,3144,5736,3334,3665,6257,20.639767440550294,9.842833472037558,2592,1,586795,8645,426,0,742,2813
8210,0,0,0,1,65,1,2782,0,0,2288144,11247744,58.70264048575669,3446,4110,4110,3446,55418,747456,789888,3264,6710,3264,3928,7374,25.768197453450252,0.0,3446,1,833932,0,664,0,182,2600
8211,0,0,1,0,66,1,379,0,0,5105646,8117928,49.56813492557492,1333,5659,4535,2457,54808,819392,730184,2180,5761,4428,5382,8963,45.58508528016593,33.65908857141129,3581,1,542997,179840,2078,0,847,1226
8212,0,0,1,0,64,1,350,0,0,6718979,7765715,49.22397789695587,1957,5662,5196,2423,56394,749970,772405,2739,5628,3671,5978,8867,52.65928218272634,21.781248981840513,2889,1,583943,55920,2773,0,782,432
8213,0,0,1,0,59,1,569,0,0,6388452,8373708,53.178943201233324,2251,5664,5087,2828,55552,734328,663264,2384,5789,3538,5220,8625,47.52893855326458,24.049632429507927,3405,1,633472,88858,2259,0,133,702
8214,0,0,0,0,57,1,1170,1,0,5082016,8328212,53.98147830506312,2179,5393,4658,2914,56105,654482,700210,2123,5772,3593,4602,8251,41.7612260356422,27.31414157237575,3649,1,713930,77175,1744,0,56,1114
8215,0,0,1,0,55,1,123,0,0,5380938,6586230,48.80573736764972,2207,4816,4641,2382,49042,600005,624890,2590,5147,2940,5024,7581,47.52893855326458,13.359104871799886,2557,1,538332,21700,2259,0,383,506
8216,0,1,1,0,62,0,1484,0,0,771936,5925744,43.497126341863094,1832,2360,2300,1892,49725,692172,704700,3072,5024,3192,3540,5492,20.199009876724155,7.746504550744806,1952,0,425700,7800,408,1,1240,2724
8217,0,1,1,0,60,0,288,0,0,924048,3356928,33.406586176980134,756,2304,1944,1116,54467,652736,755008,2648,4124,3368,3836,5312,28.77498913987632,18.97381236105937,1476,1,280116,29520,828,0,1892,2180
8218,0,0,1,0,57,1,1308,0,0,1162405,5549670,43.76071297408213,1584,2853,2522,1915,36808,498456,620172,2567,4813,3229,3505,5751,24.63736998950984,19.325723808202582,2246,1,409810,25487,607,0,983,2291
8219,0,0,1,0,57,1,1360,0,0,1122681,5599832,44.034077712607996,1638,2819,2518,1939,37518,488072,641136,2587,4827,3189,3467,5707,24.06241883103193,18.50137932967124,2240,1,430458,18963,579,0,949,2309
8220,0,0,1,0,60,1,358,0,0,2637915,5482512,42.579337712087536,1746,3335,3268,1813,47092,737856,583632,2957,4837,3091,4479,6359,38.144462245521304,8.2732738280919,1880,0,349909,12730,1455,1,1211,1569
8221,0,0,0,1,67,1,1849,0,0,1360932,8088376,49.122296363260546,2136,3254,2977,2413,29388,415648,794424,3075,5765,3629,3916,6606,23.748684174075834,17.386049277927572,2690,1,571881,0,564,0,939,2788
8222,0,0,0,1,64,1,2113,0,0,1028568,8178124,50.20956084253277,2413,3037,2929,2521,45396,629336,759096,3136,5765,3352,3652,6281,20.199009876724155,10.528806301837951,2629,1,589914,8856,408,0,723,2836
8223,0,0,0,1,65,1,2572,0,0,638400,9105600,52.91502622129181,2692,3136,3028,2800,52070,826008,666660,3144,6052,3360,3480,6388,15.0996688705415,10.948360265819424,2908,1,574000,19008,228,0,452,3024
8224,0,0,0,1,65,1,2631,0,0,602716,9259651,53.319789947073126,2693,3205,3055,2843,54216,817507,703512,3107,6100,3407,3469,6462,14.560219778561036,12.667476048676626,2993,1,614088,24750,212,0,414,3045
8225,0,0,1,0,61,1,380,0,0,7389525,7810335,50.34878350069642,2089,5896,5450,2535,56640,739440,727116,2635,5616,3527,5996,8977,53.99073994677235,21.27837533522874,2981,1,598260,57088,2915,0,546,166
8226,0,0,0,0,56,1,840,0,1,5215284,7787280,52.364109846344185,2173,5213,4644,2742,55692,675920,664560,2271,5582,3409,4742,8053,43.61192497471305,24.073536477921536,3311,1,641628,76815,1902,0,98,938
8227,0,0,0,0,52,1,455,0,1,2995014,3978678,38.961519477556315,1153,3856,3491,1518,51106,663113,529442,2256,4139,2986,4594,6477,44.41846462902562,19.341602334163284,1883,1,306636,67525,1973,0,1103,648
8228,0,1,1,0,62,0,835,0,0,2074194,6023214,43.78355855797927,1458,3458,2999,1917,54033,782358,681814,2683,5059,3601,4224,6600,32.89376840679705,21.82305512271456,2376,1,415989,69768,1082,0,1225,2060
8229,0,1,1,0,60,0,347,0,0,1700438,4508692,38.58756276314948,1069,3051,2631,1489,55575,747916,681300,2608,4517,3448,4170,6079,33.793490497431605,20.53571386485692,1909,1,335025,63420,1142,0,1539,1886
8230,0,0,0,0,58,1,1229,1,0,1234020,5514468,43.40506882842141,1494,2929,2539,1884,32617,494663,564911,2537,4811,3317,3582,5856,25.592967784139454,20.95729893833533,2274,1,363612,38610,655,0,1043,2272
8231,0,0,0,0,57,1,1440,1,0,1071721,5709242,44.50842616853577,1711,2792,2522,1981,40460,489940,685916,2612,4863,3152,3423,5674,23.259406699226016,17.672813948537303,2251,1,471478,11340,541,0,901,2341
8232,0,0,0,0,56,1,1650,1,0,894400,5844800,45.60701700396552,1930,2660,2510,2080,41583,469270,699690,2660,4890,2960,3240,5470,20.73644135332772,13.130475867068439,2230,1,517920,2550,430,0,730,2380
8233,0,0,1,0,55,1,2236,0,0,434880,6716480,49.15282290977803,2226,2786,2596,2416,47336,678320,539320,2590,5196,2970,2960,5566,13.416407864998739,14.104954533688527,2606,1,468704,35910,180,0,364,2600
8234,0,0,1,0,57,1,2336,0,0,1189380,7966080,52.592775169218825,2699,3263,3196,2766,45220,685440,547200,2813,5646,2947,3310,6143,20.73644135332772,8.20759886765899,2833,1,525540,12596,430,0,114,2450
8235,0,0,0,0,56,1,906,1,0,5209720,7889640,52.72570530585627,2144,5290,4654,2780,55056,703824,630036,2202,5618,3474,4712,8128,43.289721643826724,25.39891026548874,3416,1,617160,99852,1874,0,58,964
8236,0,0,1,0,54,1,687,0,0,5355268,5405168,44.67661580737735,1814,4861,4679,1996,51983,614716,620132,2526,4704,2890,5391,7569,51.79768334587948,13.491144824634242,2178,1,457084,23842,2683,0,712,25
8237,0,0,0,0,53,1,582,0,1,3663415,4364185,40.55859958134649,1227,4290,3872,1645,55890,610190,644679,2235,4298,3071,4880,6943,47.19110085598767,20.84073595754843,2063,1,399735,46398,2227,0,1008,426
8238,0,0,0,0,52,1,484,0,1,2896397,3872694,38.43175770115127,1146,3769,3438,1477,53383,663366,553242,2291,4099,2953,4583,6391,44.28317965096906,18.47289123594439,1808,1,311647,56932,1961,0,1145,661
8239,0,0,0,0,51,1,476,0,1,1691040,2782628,32.92415526630866,812,2916,2644,1084,53100,605812,577575,2295,3651,2839,4127,5483,39.496835316262995,16.751578885542976,1356,1,243900,39440,1560,0,1483,1007
8240,0,0,0,0,51,1,489,0,1,1549312,2625536,32.0,768,2793,2537,1024,53360,594848,589720,2308,3588,2820,4077,5357,38.897300677553446,16.20835795771336,1280,1,235520,34816,1513,0,1540,1051
8241,0,0,0,0,56,1,1573,1,0,970278,5827809,45.24378410345447,1837,2731,2521,2047,42579,486837,708903,2637,4894,3057,3321,5578,21.77154105707724,15.584165627900072,2257,1,509703,5040,474,0,800,2373
8242,0,0,1,0,64,1,147,0,0,305404,2035606,25.11971337416094,67,1679,1115,631,51448,761336,703268,2662,3857,3790,3710,4905,22.0,23.85298408018143,1195,1,137558,87420,484,0,2595,2742
8243,0,0,0,1,64,1,2236,0,0,905100,8378640,50.85272854036448,2459,3063,2936,2586,47040,622080,793800,3113,5826,3367,3590,6303,18.708286933869708,11.444189009687426,2713,1,633570,8001,350,0,654,2890
8244,0,0,1,0,58,1,1079,0,0,4715346,8167157,52.69724850502159,2036,5216,4475,2777,53037,732309,626433,2200,5718,3682,4639,8157,41.20679555607303,27.32788373919967,3518,1,591501,126711,1698,0,164,1243
8245,0,0,1,0,59,1,1210,0,0,4321200,8204740,52.630789467763066,1951,5149,4330,2770,49053,737538,583514,2143,5732,3781,4522,8111,39.496835316262995,28.77054962639596,3589,1,545690,155610,1560,0,192,1402
8246,0,0,0,0,55,1,75,0,1,5369400,6509220,48.52834223420371,2087,4903,4635,2355,56608,674416,641248,2496,5119,3032,5044,7667,47.74934554525329,16.43618287578425,2623,1,546360,36716,2280,0,409,484
8247,0,0,0,0,53,1,663,0,1,4181220,4631880,41.71330722922842,1379,4504,4143,1740,56350,652190,612260,2301,4402,3023,5065,7166,49.02040391510457,19.000583148542432,2101,1,400200,51262,2403,0,922,259
8248,0,0,0,0,52,1,635,0,1,3809700,4394020,40.74309757492672,1269,4346,3955,1660,56376,643221,614104,2256,4307,3038,4942,6993,47.90615826801394,20.019502704788522,2051,1,385120,52003,2295,0,987,352
8249,0,0,0,0,59,1,1174,1,0,1311800,5556410,43.289721643826724,1424,3024,2574,1874,38352,557420,604860,2515,4839,3415,3665,5989,26.457513110645905,22.42027825641447,2324,1,382296,50400,700,0,1091,2265
8250,0,0,0,1,64,1,2364,0,0,749101,8523340,51.44900387762624,2580,2997,2930,2647,54168,714840,785680,3153,5867,3287,3503,6217,16.822603841260722,8.361900766312248,2714,1,645868,6901,283,0,573,2937
8251,0,0,0,1,65,1,1628,0,0,3101004,9038628,52.478567053607705,2270,4364,3880,2754,56635,771270,790962,2798,6036,3766,4408,7646,33.555923471125034,22.14874756881173,3238,1,663714,57596,1126,0,528,2156
8252,0,0,0,0,56,1,641,0,1,5305230,7432614,51.43928459844674,2095,5202,4651,2646,56376,651688,682587,2258,5455,3360,4814,8011,44.77722635447622,23.59310344169437,3197,1,642978,58957,2005,0,163,804
8253,0,0,0,0,55,1,9,0,1,5370786,6367689,48.093658625644196,2028,4920,4635,2313,56608,671732,638696,2468,5066,3038,5075,7673,48.187135212627034,16.909363204997415,2598,1,536616,39330,2322,0,440,431
8254,0,0,1,0,54,1,607,0,0,5325144,5501232,44.98888751680797,1784,4895,4655,2024,53128,622422,630576,2478,4742,2958,5349,7613,51.29327441292864,15.495227059715251,2264,1,469568,30960,2631,0,694,87
8255,0,0,0,0,52,1,632,0,1,3352308,4033872,39.26830783214372,1207,4051,3716,1542,56619,609528,635688,2281,4158,2951,4790,6667,46.62617290749907,18.564844441418142,1877,1,374706,37520,2174,0,1074,442
8256,0,0,0,0,51,1,596,0,1,3047637,3812124,38.379682124790975,1178,3837,3542,1473,55552,641824,579712,2293,4061,2883,4657,6425,45.48626166217664,17.31251586689444,1768,1,329952,45430,2069,0,1115,519
8257,0,0,0,0,51,1,576,0,1,2906497,3736513,37.960505792204614,1164,3735,3458,1441,51106,656029,523786,2316,4034,2870,4610,6328,44.91102314577124,16.799239788186497,1718,1,291082,48475,2017,0,1152,576
8258,0,1,1,0,63,0,1278,0,0,1419583,6333371,44.62062303464621,1781,2914,2704,1991,51290,709363,731630,2971,5172,3391,3894,6095,26.70205984563738,14.5098253853819,2201,0,457930,26250,713,1,1190,2468
8259,0,1,1,0,63,0,1451,0,0,654132,5709612,42.567593307585526,1812,2173,2173,1812,50624,705824,712126,3151,4963,3151,3512,5324,19.0,0.0,1812,0,409512,0,361,1,1339,2790
8260,0,1,1,0,61,0,1092,0,0,1087213,5315455,41.50903516103452,1522,2555,2354,1723,52371,780505,638595,2884,4808,3286,3716,5640,25.11971337416094,14.197144937870076,1924,0,356661,35577,631,1,1362,2454
8261,0,0,0,0,59,1,1145,1,0,1358346,5577451,43.255057507764334,1404,3064,2597,1871,44232,578314,679668,2514,4852,3448,3707,6045,26.94438717061496,22.884415591812555,2338,1,426588,42497,726,0,1110,2255
8262,0,0,0,0,59,1,1251,1,0,1276722,5685822,43.78355855797927,1500,3000,2583,1917,52750,625826,741500,2549,4883,3383,3632,5966,25.80697580112788,21.767615466768266,2334,1,479250,32943,666,0,1049,2300
8263,0,0,0,0,59,1,1304,1,0,1233840,5723000,44.04543109109048,1550,2966,2576,1940,51054,592950,749300,2560,4890,3340,3586,5916,25.219040425836983,21.02379604162864,2330,1,492760,21840,636,0,1010,2314
8264,0,0,1,0,57,1,2408,0,0,940500,7900750,52.44044240850758,2580,3262,3092,2750,41216,643552,528632,2703,5623,3043,3215,6135,18.49324200890693,13.04561731755299,2920,1,506000,30430,342,0,123,2531
8265,0,0,1,0,66,1,463,0,0,913680,2504160,27.422618401604176,45,2764,1967,752,47840,765900,692640,2533,4082,4127,4545,6094,34.85685011586675,28.24478955031347,1549,1,156416,127520,1215,0,2578,2115
8266,0,0,1,0,67,1,1129,0,0,2236542,3490784,32.155870381627054,159,4072,3197,1034,45590,793360,654944,2501,4410,4251,5539,7448,46.50806381693394,29.71624008314467,1909,1,200596,157500,2163,0,2342,1213
8267,0,0,0,1,68,1,480,0,0,2483236,4603600,36.796738985948195,488,4054,3188,1354,54432,826200,761600,2534,4754,4266,5234,7454,42.82522621072771,29.790330680922462,2220,1,303296,132498,1834,0,2046,1566
8268,0,0,0,1,68,1,421,0,0,2494932,4703583,37.1887079635741,524,4046,3187,1383,54145,833245,751621,2542,4784,4260,5205,7447,42.473521163190604,29.679205956433304,2242,1,305643,135722,1804,0,2018,1597
8269,0,0,0,0,51,1,563,0,1,2556510,3479806,36.6333181680284,1130,3459,3247,1342,54780,645657,570460,2381,3935,2805,4498,6052,43.64630568559039,14.790851390782576,1554,1,295240,33920,1905,0,1251,688
8270,0,0,0,0,51,1,518,0,1,2179920,3202920,35.21363372331802,1022,3216,2998,1240,56400,619920,607005,2365,3823,2801,4341,5799,41.92851058647326,14.912948840865376,1458,1,291400,28994,1758,0,1343,825
8271,0,1,1,0,58,0,432,0,0,502425,2796354,30.93541659651604,729,1710,1482,957,55822,660372,721734,2694,3879,3150,3447,4632,22.9128784747792,16.008355269390623,1185,0,236379,22116,525,1,1965,2397
8272,0,1,1,0,58,0,422,0,0,475320,2712120,30.528675044947494,731,1643,1442,932,54718,634380,730410,2709,3842,3111,3420,4553,22.58317958127243,15.05898450319845,1133,0,233932,16482,510,1,1978,2400
8273,0,0,0,0,56,1,1700,1,0,900576,5998176,46.08687448721165,1942,2730,2548,2124,40089,454664,703176,2642,4948,3006,3248,5554,20.591260281974,14.393869999100541,2306,1,528876,1092,424,0,700,2400
8274,0,0,1,0,58,1,2295,0,0,1345036,8078553,52.716221412388805,2737,3305,3263,2779,44650,683145,552330,2865,5686,2949,3391,6212,22.0,6.488991180673202,2821,1,528010,7770,484,0,128,2423
8275,0,0,1,0,60,1,420,0,0,2681701,5635108,43.139309220245984,1831,3332,3302,1861,43878,644964,623768,2998,4889,3058,4469,6360,37.960505792204614,5.5503012171862105,1891,0,383366,4290,1441,0,1167,1587
8276,0,0,1,0,61,1,381,0,0,1831032,4811130,39.45883931389772,1449,2841,2733,1557,49000,772500,605640,2982,4647,3198,4266,5931,34.292856398964496,10.684669642126707,1665,0,305172,20628,1176,1,1533,1914
8277,0,0,1,0,64,1,339,0,0,346426,2514912,27.964262908219126,352,1655,1225,782,55161,781488,730032,2786,3998,3646,3659,4871,21.047565179849187,20.86117122600405,1212,1,177514,64500,443,0,2434,2773
8278,0,0,0,1,68,1,953,0,0,2302638,7083609,45.46427168667722,1203,4045,3181,2067,51940,839615,726524,2563,5494,4291,4541,7472,33.37663853655727,29.863299971693923,2931,1,438204,146880,1114,0,1360,2313
8279,0,0,0,1,68,1,1188,0,0,2168908,7510444,46.71188285650665,1427,3931,3176,2182,51832,853616,719378,2687,5624,4197,4436,7373,31.52776554086889,28.157344488169322,2937,1,456038,132880,994,0,1260,2448
8280,0,0,0,1,65,1,2205,0,0,1042000,8593895,51.03920062069938,2430,3180,3005,2605,34881,498149,762069,3124,5904,3474,3699,6479,20.0,14.179639608858487,2780,1,601755,4025,400,0,694,2899
8281,0,0,1,0,64,1,2795,0,0,2292654,11224668,58.80476171195663,3242,4337,4121,3458,54467,814746,704382,3030,6704,3462,3909,7583,25.748786379167466,14.719644992803179,3674,1,750386,34992,663,0,212,2583
8282,0,0,1,0,64,1,310,0,0,5764811,7293240,47.44470465710583,1529,5534,4812,2251,53280,719280,777600,2518,5491,3962,5801,8774,50.60632371551998,27.066045438695216,2973,1,540240,79420,2561,0,989,679
8283,0,0,1,0,58,1,848,0,0,4878225,7823871,51.70106381884226,2055,5116,4498,2673,55370,717115,661502,2309,5600,3545,4752,8043,42.720018726587654,24.960546704467966,3291,1,604098,93936,1825,0,254,1102
8284,0,0,0,0,52,1,743,0,1,3717320,4161488,39.89987468652001,1291,4228,3927,1592,56882,622132,624746,2313,4206,2915,4949,6842,48.321837713398274,17.492388621753044,1893,1,380488,36722,2335,0,1022,279
8285,0,0,0,0,51,1,648,0,1,2778228,3533928,37.067505985701274,1162,3608,3396,1374,53676,648144,547836,2360,3946,2784,4594,6180,44.96665431183423,14.669851868889596,1586,1,292662,35192,2022,0,1198,550
8286,0,1,1,0,61,0,1335,0,0,527626,5107552,40.66939881532551,1624,2003,1973,1654,51520,691712,710240,3058,4742,3118,3407,5091,17.86057109949175,5.478746393072713,1684,0,380420,3810,319,1,1434,2769
8287,0,1,1,0,61,0,631,0,0,2163980,5571020,42.661458015403085,1520,3309,3009,1820,55902,707091,740762,2761,4881,3361,4250,6370,34.48187929913333,17.42142869747889,2120,1,440440,31200,1189,0,1241,1872
8288,0,0,0,0,59,1,1138,1,0,1418639,5661333,43.46262762420146,1439,3090,2640,1889,50344,608391,743256,2547,4886,3447,3748,6087,27.40437921208944,22.71025662884941,2339,1,468472,32850,751,0,1108,2246
8289,0,0,0,0,58,1,1347,1,0,1248118,5795540,44.474711915874174,1617,2970,2609,1978,50546,583070,744220,2569,4908,3291,3561,5900,25.11971337416094,20.18619614891074,2339,1,502412,17689,631,0,952,2299
8290,0,0,1,0,65,1,6,0,0,393120,2053170,25.099800796022265,6,1890,1254,630,50610,785419,684390,2623,3889,3895,3883,5149,24.979991993593593,25.228776477400977,1266,1,132300,107484,624,0,2629,2635
8291,0,0,0,1,67,1,581,0,0,2477210,4450070,36.193922141707716,485,4026,3201,1310,54450,822074,764325,2572,4707,4222,5288,7423,43.485629810317796,29.100190970538893,2135,1,294750,124575,1891,0,2087,1506
8292,0,0,0,1,68,1,960,0,0,2304064,7096600,45.51922670696417,1236,4020,3184,2072,52824,849400,729525,2589,5497,4261,4537,7445,33.34666400106613,29.397429935048052,2908,1,441336,142956,1112,0,1353,2313
8293,0,0,0,1,67,1,2095,0,0,1248236,8678335,50.78385570237849,2332,3310,3063,2579,31610,487925,733570,3118,5944,3612,3849,6675,22.0,17.234908893302006,2826,1,562222,7904,484,0,786,2881
8294,0,0,1,0,64,1,2446,0,0,2780895,10590438,57.367238037053866,3224,4203,4136,3291,53535,691870,801282,3151,6509,3285,4063,7421,29.068883707497267,8.185808589931957,3358,1,819459,5762,845,0,73,2373
8295,0,0,1,0,58,1,797,0,0,4883468,7723124,51.419840528729765,2052,5083,4491,2644,55615,715645,663067,2329,5565,3513,4768,8004,42.9767378938886,24.42301914157278,3236,1,600188,88208,1847,0,277,1074
8296,0,0,0,0,55,1,833,1,0,5337284,7733672,52.57375771237966,2172,5287,4695,2764,56880,671520,663126,2206,5562,3390,4729,8085,43.94314508543966,24.78500242935143,3356,1,655068,76368,1931,0,34,867
8297,0,0,0,0,54,1,408,0,1,5331508,5790246,45.9782557302906,1772,4978,4636,2114,55200,657360,629970,2397,4853,3081,5261,7717,50.21951811795888,18.52415408383962,2456,1,486220,48564,2522,0,625,217
8298,0,0,0,0,54,1,458,0,1,5320683,5715504,45.70557952810576,1754,4971,4636,2089,55225,642960,642960,2401,4825,3071,5283,7707,50.46781152378217,18.32843530268791,2424,1,490915,43885,2547,0,647,189
8299,0,0,0,0,53,1,852,0,1,5108524,5039186,43.289721643826724,1573,4901,4600,1874,56643,637293,642671,2388,4563,2990,5415,7590,52.21110992882645,17.845457646150862,2175,1,447886,37324,2726,0,815,37
8300,0,1,1,0,63,0,1414,0,0,563112,5502508,41.689327171351664,1653,2147,2062,1738,46440,680690,683856,3081,4904,3251,3490,5313,18.0,9.222414255489701,1823,0,375408,11305,324,1,1428,2842
8301,0,1,1,0,58,0,555,0,0,960336,3820608,36.0,1086,2247,2037,1296,56386,686884,713416,2738,4244,3158,3689,5195,27.2213151776324,14.627540818632527,1506,1,313632,23100,741,0,1652,2207
8302,0,1,1,0,57,0,516,0,0,469260,2870010,31.464265445104548,810,1644,1464,990,54492,660972,692861,2719,3889,3079,3373,4543,21.77154105707724,13.774493079968597,1170,0,236610,17460,474,1,1909,2425
8303,0,0,0,0,56,1,1687,1,0,961650,6049847,46.22769732530488,1947,2777,2587,2137,46228,515242,719074,2641,4968,3021,3281,5608,21.213203435596427,14.621386345521588,2327,1,542798,5320,450,0,694,2381
8304,0,0,1,0,66,1,369,0,0,1029952,2824745,29.103264421710495,145,2765,2063,847,49980,793730,700350,2633,4182,4037,4551,6100,34.87119154832539,26.51676220138395,1549,1,177870,116532,1216,0,2488,2119
8305,0,0,1,0,66,1,743,0,0,1218048,2638311,28.160255680657446,162,2960,2329,793,47073,735267,708651,2696,4120,3958,4863,6287,39.191835884530846,25.25503094546654,1424,1,168909,90864,1536,0,2534,1791
8306,0,0,1,0,66,1,831,0,0,1218580,2540300,27.640549922170507,187,2936,2359,764,46209,728175,701575,2748,4089,3902,4920,6261,39.93745109543172,24.1688194671287,1341,1,161204,83088,1595,0,2561,1730
8307,0,0,0,1,68,1,729,0,0,2409570,6684108,44.26059195266146,1188,3960,3189,1959,53463,856412,726756,2641,5371,4183,4642,7372,35.07135583350036,28.249703326541574,2730,1,417267,131841,1230,0,1453,2182
8308,0,0,1,0,58,1,429,0,0,5549580,7564560,50.79370039680118,2190,5121,4731,2580,54808,727136,647972,2542,5512,3322,5083,8053,46.37887450122092,19.838971914323803,2970,1,570180,62400,2151,0,352,781
8309,0,0,0,0,55,1,799,1,0,5369952,7678041,52.44997616777342,2185,5269,4703,2751,56394,653094,672631,2225,5542,3357,4743,8060,44.181444068749045,24.235743489539765,3317,1,662991,66788,1952,0,40,839
8310,0,0,0,0,55,1,703,1,0,5377818,7503054,51.93264869039514,2160,5228,4691,2697,56640,656552,667680,2245,5479,3319,4776,8010,44.654227123532216,23.601303853156246,3234,1,647280,62292,1994,0,85,788
8311,0,0,0,0,55,1,506,0,1,5392887,7153407,50.882216932834204,2104,5157,4672,2589,56406,654831,657594,2278,5352,3248,4846,7920,45.639894828976104,22.40228852100505,3074,1,616182,57230,2083,0,174,680
8312,0,0,0,0,54,1,10,0,1,5387016,6317416,48.228622207149975,1896,5072,4642,2326,56619,659988,632828,2286,5042,3146,5032,7788,48.12483766206386,20.741178046223347,2756,1,541958,56760,2316,0,390,400
8313,0,0,0,0,53,1,875,0,1,4855356,4844502,42.532340636273474,1537,4765,4493,1809,54900,653432,602550,2406,4487,2950,5362,7443,51.807335387954474,16.954632475331408,2081,1,407025,41344,2684,0,869,6
8314,0,0,0,0,51,1,674,0,1,2354472,3166444,35.12833614050059,1114,3262,3142,1234,56376,623538,595312,2446,3800,2686,4474,5828,43.68065933568311,11.090536506409418,1354,1,286288,15960,1908,0,1332,658
8315,0,0,0,0,50,1,628,0,1,1946304,2836872,33.406586176980134,996,2980,2860,1116,56088,579576,625332,2422,3658,2662,4286,5522,41.7612260356422,11.029743904822288,1236,1,274536,12240,1744,0,1426,798
8316,0,0,0,0,50,1,605,0,1,1737750,2652300,32.4037034920393,960,2795,2705,1050,56876,608766,596136,2436,3576,2616,4181,5321,40.681691213615984,9.570344002193607,1140,1,247800,11610,1655,0,1476,871
8317,0,1,1,0,62,0,1480,0,0,244500,5116570,40.3732584763727,1535,1875,1780,1630,44238,634078,687441,3044,4769,3234,3289,5014,12.24744871391589,9.747874142570481,1725,0,356970,10735,150,1,1509,2989
8318,0,1,1,0,60,0,514,0,0,2171967,5313343,41.86884283091664,1513,3232,2992,1753,56640,715316,727440,2791,4784,3271,4270,6263,35.199431813596085,15.509118029532386,1993,1,420720,29040,1239,0,1278,1792
8319,0,1,1,0,59,0,540,0,0,1755004,4825450,40.27406113120453,1412,2914,2704,1622,56364,725900,687225,2765,4597,3185,4057,5889,32.89376840679705,14.503191983680601,1832,1,374682,29610,1082,0,1353,1893
8320,0,0,0,0,59,1,1231,1,0,1407392,5799392,44.181444068749045,1561,3064,2673,1952,51612,606084,751663,2580,4923,3362,3692,6035,26.851443164195103,21.251258487832157,2343,1,493856,24633,721,0,1019,2250
8321,0,0,0,0,56,1,1651,1,0,1025492,6067672,46.17358552246078,1931,2814,2613,2132,49276,552124,722884,2645,4978,3047,3327,5660,21.93171219946131,15.0436608546514,2333,1,541528,9447,481,0,714,2365
8322,0,0,0,0,56,1,1758,1,0,917359,6122990,46.67976006793523,2029,2750,2600,2179,42670,477700,705310,2660,4989,2960,3231,5560,20.518284528683193,12.9849534146292,2329,1,546929,2550,421,0,631,2389
8323,0,0,0,0,55,1,1811,1,0,860982,6136974,46.92547282660026,2078,2717,2593,2202,43172,479364,699537,2663,4989,2911,3178,5504,19.77371993328519,11.629613944648966,2326,1,552702,2604,391,0,585,2396
8324,0,0,1,0,66,1,305,0,0,971750,2817230,29.068883707497267,155,2685,1995,845,51120,800160,710142,2644,4179,4024,4484,6019,33.91164991562634,26.288805507966394,1535,1,179985,113850,1150,0,2489,2184
8325,0,0,1,0,66,1,412,0,0,1207488,3046080,30.199337741083,271,2877,2236,912,51884,794920,728120,2699,4252,3981,4664,6217,36.38681079732051,25.349114812362178,1553,1,198816,99996,1324,0,2428,2016
8326,0,0,1,0,66,1,666,0,0,1251000,2779722,28.879058156387302,204,2964,2334,834,49476,759924,723261,2703,4167,3963,4833,6297,38.72983346207417,25.122599213972144,1464,1,180978,93240,1500,0,2499,1833
8327,0,0,0,1,67,1,558,0,0,2478960,6373932,43.3358973600409,1152,3924,3198,1878,54216,851894,733104,2668,5272,4120,4714,7318,36.3318042491699,27.385154094330666,2604,1,405648,119790,1320,0,1516,2074
8328,0,0,0,1,66,1,2243,0,0,1118460,8894420,51.60426338976267,2483,3263,3083,2663,28644,414160,771540,3160,6003,3520,3760,6603,20.493901531919196,15.100830606950982,2843,1,615153,0,420,0,677,2920
8329,0,0,1,0,64,1,1171,0,0,3442160,8197909,50.309044912421065,2180,4242,3891,2531,54282,806511,706102,2888,5770,3590,4599,7481,36.87817782917155,18.78682397010789,2882,0,551758,57564,1360,1,708,1879
8330,0,0,1,0,59,1,895,0,0,7119474,6744646,47.51841748206689,2083,5586,5411,2258,56334,734802,684023,2812,5245,3162,6140,8573,56.15158056546583,13.234044886003495,2433,1,517082,25200,3153,0,729,166
8331,0,0,0,0,59,1,1079,1,0,3718946,7534488,50.41825066382212,1660,4887,4005,2542,56350,681720,726180,2082,5506,3846,4427,7851,38.24918299781056,29.964269550752306,3424,1,622790,91728,1463,0,422,1501
8332,0,0,0,0,56,1,803,1,0,5186454,7626340,52.09606511052442,2119,5220,4625,2714,54033,609770,699690,2215,5524,3405,4721,8030,43.71498598878879,24.938348318915956,3309,1,675786,51765,1911,0,96,899
8333,0,0,0,0,55,1,717,1,0,5405734,7536580,52.06726418777925,2186,5230,4705,2711,56628,650520,672760,2255,5491,3305,4774,8010,44.654227123532216,23.343584350534503,3236,1,656062,60900,1994,0,69,786
8334,0,0,0,0,55,1,620,1,0,5412309,7354576,51.54609587543949,2160,5191,4694,2657,56334,633872,680928,2271,5425,3265,4805,7959,45.13313638558703,22.6880477547456,3154,1,653622,51191,2037,0,111,731
8335,0,1,1,0,63,0,1307,0,0,762128,5544176,41.7612260356422,1714,2211,2181,1744,47460,718454,667590,3149,4923,3209,3616,5390,20.904544960366874,5.501408174353464,1774,0,366240,4620,437,1,1435,2742
8336,0,1,1,0,59,0,320,0,0,2376900,5111190,41.352146256270665,1530,3280,3100,1710,54168,729316,663558,2809,4699,3169,4379,6269,37.282703764614496,13.42674807141325,1890,0,379620,28080,1390,1,1279,1599
8337,0,0,0,0,60,1,1097,1,0,1550108,5728909,43.69210454990696,1452,3178,2721,1909,56376,696232,729243,2544,4910,3458,3813,6179,28.495613697550013,22.887064389872045,2366,1,463887,48442,812,0,1092,2189
8338,0,0,0,0,59,1,1251,1,0,1424506,5853891,44.41846462902562,1597,3071,2695,1973,55000,652740,741750,2591,4940,3343,3689,6038,26.870057685088806,20.89608360334709,2349,1,493250,32712,722,0,994,2245
8339,0,0,0,0,57,1,1510,1,0,1193559,6009455,45.639894828976104,1828,2911,2656,2083,45540,519300,729905,2630,4968,3140,3458,5796,23.93741840717165,17.070042222505307,2338,1,526999,6630,573,0,802,2312
8340,0,0,0,0,57,1,1614,1,0,1093792,6069056,46.130250378683186,1916,2854,2642,2128,51308,576104,724408,2640,4980,3064,3366,5706,22.67156809750927,15.469358926783322,2340,1,540512,11660,514,0,724,2338
8341,0,0,0,0,56,1,1720,1,0,986996,6139376,46.62617290749907,2012,2790,2628,2174,48260,536560,717296,2662,4998,2986,3278,5614,21.307275752662516,13.47482551954778,2336,1,552196,6318,454,0,650,2370
8342,0,0,0,0,56,1,1773,1,0,931528,6166979,46.87216658103186,2063,2755,2621,2197,45034,499646,710171,2673,5004,2941,3231,5562,20.591260281974,12.372354058352016,2331,1,555841,3350,424,0,610,2383
8343,0,0,1,0,66,1,635,0,0,1285700,2867240,29.32575659723036,260,2955,2355,860,50328,776822,720144,2734,4194,3934,4829,6289,38.66522985836241,24.52072927186072,1460,1,185760,92400,1495,0,2474,1839
8344,0,0,1,0,66,1,726,0,0,1286712,2760552,28.77498913987632,225,2985,2382,828,48792,760152,713476,2731,4162,3937,4888,6319,39.42080668885405,24.581698026522314,1431,1,177192,91656,1554,0,2506,1780
8345,0,0,1,0,66,1,828,0,0,1266205,2616405,28.0178514522438,203,2980,2398,785,46575,749925,689931,2751,4118,3915,4946,6313,40.162171256046406,24.29732618262003,1367,1,162495,91374,1613,0,2548,1720
8346,0,0,1,0,68,1,860,0,0,2375100,6908090,45.05552130427524,1299,3931,3200,2030,53463,854153,724839,2672,5433,4134,4573,7334,34.20526275297414,27.515085253754293,2761,1,432390,125001,1170,0,1373,2233
8347,0,0,0,1,68,1,1810,0,0,1728191,8580931,50.00999900019995,2051,3642,3192,2501,56105,840595,785699,2981,5932,3881,4122,7073,26.28687885618983,22.490599048052758,2951,1,572729,65700,691,0,930,2740
8348,0,0,0,1,68,1,1922,0,0,1610943,8751684,50.52722038663912,2163,3574,3184,2553,56153,826148,798724,3038,5981,3818,4059,7002,25.11971337416094,21.254565900482316,2943,1,594849,53430,631,0,875,2797
8349,0,0,1,0,61,1,1401,0,0,7430710,6468840,45.9782557302906,2084,5659,5629,2114,51212,664020,722160,3030,5174,3090,6575,8719,59.28743543112655,5.478746393072713,2144,1,498904,3300,3515,0,946,455
8350,0,0,1,0,58,1,617,0,0,4929150,7400100,50.49752469181039,2051,4982,4483,2550,56088,713892,661656,2403,5452,3401,4835,7884,43.965895873961216,22.413376208763417,3049,1,581400,73353,1933,0,352,969
8351,0,0,1,0,58,1,642,0,0,4887715,7412055,50.547007824400445,2039,4984,4468,2555,56350,710745,667230,2385,5456,3417,4814,7885,43.73785545725808,22.784615638357028,3071,1,587650,74304,1913,0,346,988
8352,0,0,1,0,57,1,666,0,0,4848640,7421440,50.59644256269407,2026,4988,4454,2560,56088,713154,660972,2365,5459,3433,4793,7887,43.520110293977886,23.167291435279417,3094,1,583680,77964,1894,0,339,1005
8353,0,0,1,0,57,1,691,0,0,4806810,7435935,50.6458290484024,2012,4992,4439,2565,55029,721851,640679,2346,5464,3452,4773,7891,43.289721643826724,23.5718109773811,3118,1,566865,87927,1874,0,334,1025
8354,0,0,1,0,57,1,1012,0,0,3562080,7097100,49.59838707054898,1396,4972,3908,2460,53424,727020,611620,1821,5345,3949,4333,7857,38.05259518088089,32.70117176763013,3524,1,521520,183008,1448,0,425,1437
8355,0,0,1,0,57,1,1009,0,0,3569460,7102020,49.59838707054898,1385,4986,3911,2460,54531,718863,632253,1812,5347,3962,4338,7873,38.09199390948182,32.87114107715199,3535,1,538740,175225,1451,0,427,1436
8356,0,0,0,0,54,1,489,1,0,5441590,7114730,50.89204259999789,2147,5134,4691,2590,56644,653786,653786,2304,5337,3190,4848,7881,45.83666654546336,21.381881679155615,3033,1,616420,56261,2101,0,157,646
8357,0,0,0,0,54,1,391,1,0,5439720,6946104,50.35871324805669,2118,5099,4681,2536,56350,629970,671055,2321,5275,3157,4884,7838,46.314144707637645,20.760204205678725,2954,1,621320,44726,2145,0,203,594
8358,0,0,0,0,54,1,342,1,0,5437003,6852079,50.08991914547278,2101,5084,4676,2509,55527,609013,680019,2323,5240,3139,4898,7815,46.551047249229526,20.478577825785838,2917,1,624741,37536,2167,0,222,564
8359,0,0,0,0,54,1,44,0,1,5414445,6358743,48.46648326421054,1959,5044,4654,2349,56882,646973,644266,2317,5056,3097,5012,7751,48.010415536631214,19.919167527394755,2739,1,559062,49530,2305,0,358,402
8360,0,0,0,0,54,1,407,0,1,5334030,5744340,45.98912915026767,1780,4972,4637,2115,49530,689864,529620,2381,4831,3051,5238,7688,50.21951811795888,18.76930512745683,2450,1,412425,63650,2522,0,601,194
8361,0,0,0,0,54,1,457,0,1,5318594,5686258,45.70557952810576,1758,4966,4635,2089,49530,691388,530790,2391,4811,3053,5268,7688,50.457903246171455,18.71919691744928,2420,1,407355,63221,2546,0,633,176
8362,0,0,0,0,51,1,887,0,1,3603858,3896022,38.80721582386451,1324,4081,3899,1506,56619,602771,628641,2405,4093,2769,4980,6668,48.91829923454004,13.569865516338865,1688,1,365958,20748,2393,0,1081,194
8363,0,0,0,0,50,1,703,0,1,1743770,2550695,31.85906464414798,973,2775,2733,1015,55454,585529,598094,2471,3528,2555,4231,5288,41.44876355212541,6.495386533491135,1057,1,241570,5208,1718,0,1498,795
8364,0,0,0,0,59,1,1116,1,0,1573765,5769828,43.94314508543966,1488,3189,2746,1931,55615,678276,732060,2545,4919,3431,3803,6177,28.548204847240395,22.47821667150848,2374,1,473095,42528,815,0,1057,2173
8365,0,0,0,0,59,1,1319,1,0,1402440,5954325,44.88875137492688,1680,3046,2711,2015,56386,688515,715110,2620,4970,3290,3651,6001,26.38181191654584,19.88415360203658,2350,1,487630,38860,696,0,940,2259
8366,0,0,0,0,58,1,1371,1,0,1356642,6007113,45.13313638558703,1728,3012,2703,2037,51000,601596,737250,2640,4986,3258,3615,5961,25.80697580112788,19.242300291632002,2346,1,509250,21939,666,0,912,2283
8367,0,0,0,0,58,1,1474,1,0,1263167,6036981,45.617978911828175,1823,2946,2688,2081,36505,432249,710745,2643,4982,3159,3508,5847,24.63736998950984,17.378575899499673,2339,1,509845,0,607,0,820,2294
8368,0,0,0,0,56,1,1786,1,0,952880,6207016,47.07440918375928,2092,2770,2646,2216,48006,529389,711454,2677,5017,2925,3231,5571,20.73644135332772,11.718395466430005,2340,1,562864,4588,430,0,585,2371
8369,0,0,1,0,66,1,220,0,0,979916,2951266,29.765752132274432,256,2622,1992,886,52272,806102,719496,2701,4217,3961,4437,5953,33.25657829663178,25.302790522717537,1516,1,191376,102690,1106,0,2445,2225
8370,0,0,1,0,66,1,282,0,0,1153008,3140628,30.692018506445613,335,2773,2166,942,53217,810162,730146,2727,4276,3941,4558,6107,34.9857113690718,24.662757199507197,1549,1,206298,97120,1224,0,2392,2110
8371,0,0,1,0,66,1,603,0,0,1319254,2955696,29.765752132274432,316,2945,2375,886,50290,783960,713904,2766,4222,3906,4825,6281,38.58756276314948,23.905494326901817,1456,1,189604,90630,1489,0,2450,1847
8372,0,0,1,0,66,1,1040,0,0,1257296,2392872,26.758176320519304,228,2960,2472,716,43183,725214,665058,2854,4058,3830,5098,6302,41.90465367951393,22.292842440867123,1204,1,142484,75640,1756,0,2626,1586
8373,0,0,0,1,68,1,1636,0,0,1890876,8284068,49.17316341257699,1878,3740,3200,2418,55822,846222,774276,2886,5844,3966,4208,7166,27.964262908219126,24.19473792318254,2958,1,546468,81000,782,0,1008,2644
8374,0,0,0,1,67,1,2243,0,0,1224438,9134739,51.93264869039514,2487,3361,3151,2697,33558,477567,806106,3177,6084,3597,3841,6748,21.307275752662516,16.768783651545267,2907,1,641886,0,454,0,690,2933
8375,0,0,1,0,64,1,1524,0,0,3132685,8715049,51.85556864985669,2328,4215,3854,2689,55860,794045,738948,2880,5930,3602,4406,7456,34.132096331752024,19.055197113694206,3050,1,613092,53067,1165,0,552,2076
8376,0,0,1,0,58,1,492,0,0,5056128,7273200,50.07993610219566,2078,4954,4524,2508,56153,698900,675700,2470,5408,3330,4916,7854,44.8998886412873,20.811842160186252,2938,1,584364,59340,2016,0,392,884
8377,0,0,1,0,57,1,516,0,0,5013952,7282288,50.11985634456667,2069,4951,4508,2512,56376,704457,672568,2456,5411,3342,4895,7850,44.67661580737735,21.12820780078216,2955,1,582784,62463,1996,0,387,903
8378,0,0,1,0,57,1,589,0,0,4888400,7307350,50.24937810560445,2033,4953,4461,2525,56350,709030,665620,2402,5419,3386,4830,7847,44.0,22.235872365732323,3017,1,580750,70356,1936,0,369,958
8379,0,0,0,0,57,1,961,1,0,3577472,6989568,49.31531202375181,1426,4909,3903,2432,56619,698382,669642,1868,5306,3880,4345,7783,38.353617821530214,31.78797934097031,3438,1,566656,134804,1471,0,442,1403
8380,0,0,0,0,57,1,958,1,0,3580863,6981832,49.3051721424842,1416,4919,3904,2431,55822,709384,649072,1857,5303,3887,4345,7791,38.379682124790975,31.927157971330345,3446,1,549406,150220,1473,0,441,1399
8381,0,0,1,0,57,1,941,0,0,3618270,7012980,49.29503017546495,1394,4955,3919,2430,52459,724386,603174,1850,5316,3922,4375,7841,38.58756276314948,32.53432655211295,3466,1,507870,182336,1489,0,456,1397
8382,0,0,0,0,54,1,210,0,1,5450544,6605610,49.416596402423345,2077,5039,4674,2442,56364,624855,660020,2340,5147,3070,4937,7744,47.24404724407086,19.283188637386633,2807,1,595848,38690,2232,0,263,473
8383,0,0,0,0,53,1,89,0,1,5410622,6143144,47.77028364998475,1921,5014,4653,2282,56165,632620,643388,2331,4974,3053,5063,7706,48.692915295759406,19.121443302957882,2643,1,545398,44764,2371,0,410,321
8384,0,0,0,0,50,1,769,0,1,1930082,2672096,32.51153641401772,1027,2913,2883,1057,56404,596608,604192,2498,3585,2558,4354,5441,42.731721238442994,5.531194905403055,1087,1,252623,3720,1826,0,1471,702
8385,0,1,1,0,61,0,942,0,0,868095,4640445,38.92300091205713,1473,2130,2088,1515,53924,747372,676923,3021,4578,3105,3636,5193,23.93741840717165,6.495386533491135,1557,0,334815,6636,573,1,1548,2490
8386,0,1,1,0,59,0,485,0,0,1942004,4917976,40.70626487409524,1537,2949,2829,1657,50616,676704,658896,2848,4625,3088,4140,5917,34.23448553724738,10.957492786145426,1777,1,367854,16920,1172,0,1311,1796
8387,0,0,0,0,58,1,1336,1,0,1425200,5996020,45.12205669071391,1713,3059,2736,2036,56404,703855,695020,2622,4981,3268,3645,6004,26.457513110645905,19.477707126614654,2359,1,480496,39729,700,0,909,2245
8388,0,0,1,0,66,1,137,0,0,885500,2911125,29.58039891549808,275,2487,1887,875,50851,801807,701997,2727,4202,3927,4339,5814,31.811947441173732,24.732307038954147,1475,1,184625,100200,1012,0,2452,2315
8389,0,0,1,0,66,1,284,0,0,1268061,3307683,31.51190251317746,433,2830,2270,993,53655,816095,729489,2771,4324,3891,4608,6161,35.73513677041127,23.688730438831403,1553,1,217467,90720,1277,0,2338,2054
8390,0,0,1,0,66,1,306,0,0,1308307,3336333,31.63858403911275,448,2861,2308,1001,53136,819918,719928,2780,4334,3886,4640,6194,36.15245496505044,23.543663015325162,1554,1,216216,91245,1307,0,2332,2026
8391,0,0,1,0,66,1,871,0,0,1317096,2650032,28.142494558940577,252,2995,2455,792,43262,746158,649124,2806,4138,3886,5009,6341,40.779897008207364,23.262267097391593,1332,1,153648,90720,1663,0,2554,1683
8392,0,0,1,0,66,1,1228,0,0,1281948,2255204,25.96150997149434,244,3006,2576,674,44100,702660,702660,2916,4020,3776,5248,6352,43.61192497471305,21.00062085574041,1104,1,141540,57620,1902,0,2672,1444
8393,0,0,1,0,67,1,989,0,0,2342742,7145994,45.858477951192405,1410,3910,3217,2103,54000,849500,733968,2705,5501,4091,4512,7308,33.37663853655727,26.816146154802425,2796,1,454248,115731,1114,0,1295,2284
8394,0,0,0,1,68,1,1699,0,0,1852770,8390226,49.53786430600334,1943,3720,3209,2454,55575,844493,769275,2908,5873,3930,4174,7139,27.477263328068172,23.57862245187503,2965,1,552150,78183,755,0,965,2664
8395,0,0,0,1,68,1,1876,0,0,1692972,8688556,50.41825066382212,2121,3629,3208,2542,55370,837410,772468,2997,5960,3839,4084,7047,25.80697580112788,21.773696805116042,2963,1,574492,63150,666,0,876,2752
8396,0,0,0,1,67,1,2308,0,0,1177340,9180514,52.32590180780452,2556,3350,3168,2738,25877,378889,767837,3171,6091,3535,3783,6703,20.73644135332772,15.419685222753444,2920,1,627002,0,430,0,615,2923
8397,0,0,1,0,63,1,2601,0,0,2431630,10655869,57.7148161220323,3036,4356,4061,3331,54718,802949,697382,2904,6530,3494,3929,7555,27.018512172212592,17.195266466078692,3626,1,726158,47790,730,0,132,2469
8398,0,0,1,0,64,1,921,0,0,3580696,7777840,49.07137658554119,2089,4214,3895,2408,54312,801040,707370,2911,5638,3549,4717,7444,38.561638969317684,17.89487307450726,2727,1,527352,51678,1487,0,822,1743
8399,0,0,1,0,65,1,81,0,0,4605822,6867666,45.89117562233506,1231,5168,4293,2106,52920,798945,704376,2386,5367,4136,5448,8429,46.76537180435969,29.727808691311296,2981,1,454896,144375,2187,0,1155,1074
8400,0,0,1,0,57,1,610,0,0,4777824,7257168,50.11985634456667,1981,4945,4414,2512,52668,728028,603801,2358,5401,3420,4791,7834,43.61192497471305,23.088438222953595,3043,1,525008,93987,1902,0,377,987
8401,0,0,0,0,57,1,908,1,0,3615909,6945147,49.08156476723211,1482,4837,3910,2409,55029,637143,717867,1956,5292,3810,4384,7720,38.742741255621034,30.545715377819914,3336,1,599841,77868,1501,0,474,1382
8402,0,0,0,0,57,1,907,1,0,3610500,6917718,49.06118628814432,1465,4849,3907,2407,56608,666768,701256,1932,5281,3816,4374,7723,38.72983346207417,30.77140042555112,3349,1,587308,99852,1500,0,467,1374
8403,0,0,0,0,57,1,881,1,0,3645600,6914400,48.98979485566356,1394,4925,3919,2400,52500,720250,605010,1875,5281,3887,4400,7806,38.97435053981015,32.063925622410935,3406,1,504000,177056,1519,0,481,1362
8404,0,0,0,0,56,1,668,1,0,5059520,7362384,51.068581339214816,2035,5121,4548,2608,52290,592830,702927,2250,5431,3396,4763,7944,44.04543109109048,24.576310404374382,3181,1,649392,45840,1940,0,215,883
8405,0,0,0,0,55,1,616,1,0,5507825,7401725,51.720402163943,2225,5184,4734,2675,55912,641944,666847,2317,5442,3217,4826,7951,45.37620521815371,21.66201762086372,3125,1,644675,53550,2059,0,92,708
8406,0,0,0,0,53,1,127,1,0,5464550,6463782,49.01020301937138,2071,5008,4677,2402,56595,659295,621621,2360,5093,3022,4966,7699,47.69696007084728,18.326810945397828,2733,1,554862,46340,2275,0,289,416
8407,0,0,0,0,53,1,422,0,1,5342520,5675900,45.93473631142341,1825,4927,4642,2110,49276,683260,521860,2405,4800,2975,5222,7617,50.3189825016365,17.22904594733818,2395,1,409340,53865,2532,0,580,158
8408,0,0,0,0,54,1,573,0,1,5293360,5510784,45.077710678338576,1762,4907,4637,2032,54750,678000,593928,2442,4744,2982,5317,7619,51.03920062069938,17.02052051899176,2302,1,445008,43200,2605,0,680,107
8409,0,1,1,0,63,0,1479,0,0,63882,4817007,39.0,1311,1773,1563,1521,45760,658736,696740,2957,4688,3377,3209,4940,6.48074069840786,14.564753151219703,1731,0,334620,25200,42,1,1646,3125
8410,0,1,1,0,59,0,241,0,0,2236980,4848411,40.26164427839479,1513,3109,3001,1621,50850,675966,672975,2883,4612,3099,4371,6100,37.14835124201342,10.414507905016443,1729,0,364725,14688,1380,1,1370,1611
8411,0,0,0,0,59,1,992,1,0,1655625,5589375,43.30127018922193,1417,3216,2758,1875,56876,703516,718421,2523,4856,3439,3864,6197,29.715315916207253,22.63862983751085,2333,1,451875,54044,883,0,1106,2098
8412,0,0,0,0,59,1,1052,1,0,1624965,5667375,43.64630568559039,1472,3191,2758,1905,56608,690200,725900,2542,4880,3408,3828,6166,29.206163733020468,22.07960539222501,2338,1,464820,46764,853,0,1070,2122
8413,0,0,0,0,58,1,1289,1,0,1487640,5946512,44.98888751680797,1689,3094,2759,2024,55615,666926,719810,2603,4962,3273,3673,6032,27.110883423451916,19.662621269369613,2359,1,495880,31490,735,0,914,2203
8414,0,0,1,0,61,1,782,0,0,2703219,6351212,45.617978911828175,2051,3410,3380,2081,48265,747740,601244,3022,5133,3082,4351,6462,36.0416425818802,5.478746393072713,2111,0,409957,5580,1299,1,971,1753
8415,0,0,1,0,66,1,44,0,0,802332,2903428,29.563490998188964,304,2362,1792,874,50820,803924,697620,2752,4196,3892,4240,5684,30.298514815086232,24.134925630057946,1444,1,183540,96900,918,0,2448,2404
8416,0,0,1,0,66,1,271,0,0,1342362,3433230,32.109188716004645,507,2857,2333,1031,53105,822510,715950,2806,4361,3854,4632,6187,36.08323710533743,22.916535346729997,1555,1,221665,87508,1302,0,2299,2028
8417,0,0,0,1,68,1,1642,0,0,1918059,8297003,49.3051721424842,1888,3763,3220,2431,55056,846424,757686,2870,5844,3956,4202,7176,28.089143810376278,24.151233777751482,2974,1,539682,85251,789,0,982,2624
8418,0,0,0,1,64,1,2551,0,0,839570,9226732,53.34791467339656,2786,3201,3141,2846,26390,421460,658126,3182,6088,3302,3537,6443,17.175564037317667,8.557998229399338,2906,1,577738,0,295,0,396,2947
8419,0,0,1,0,64,1,1498,0,0,3171623,8667673,51.778373863998475,2315,4230,3864,2681,55647,785619,740357,2867,5914,3599,4416,7463,34.39476704383968,19.165346210225643,3047,1,613949,53436,1183,0,552,2050
8420,0,0,1,0,57,1,484,0,0,4887612,7102080,49.658836071740545,2020,4894,4448,2466,56120,702720,662400,2434,5346,3326,4862,7774,44.51965857910413,21.156935193388193,2912,1,567180,64224,1982,0,414,898
8421,0,0,1,0,57,1,557,0,0,4782258,7158489,49.82971001320397,1974,4918,4409,2483,52459,723633,602547,2374,5366,3392,4809,7801,43.88621651498338,22.608965816416916,2992,1,518947,89584,1926,0,400,957
8422,0,0,0,0,58,1,850,1,0,3779475,7063875,49.14264950122246,1628,4767,3980,2415,56406,693225,696150,2138,5340,3712,4490,7692,39.56008088970496,28.269786532638246,3202,1,574770,99162,1565,0,510,1360
8423,0,0,0,0,57,1,843,0,0,3630690,6789153,48.7134478352744,1433,4843,3903,2373,56350,700945,658030,1921,5234,3801,4391,7704,39.11521443121589,30.719004656689236,3313,0,545790,136300,1530,0,488,1331
8424,0,0,0,0,57,1,835,0,0,3637950,6778200,48.68264577855234,1401,4874,3905,2370,51204,717860,583440,1891,5230,3829,4395,7734,39.179076048319466,31.18570504766093,3339,0,483480,177327,1535,0,490,1325
8425,0,0,0,0,53,1,354,0,1,5374296,5733012,46.34652090502587,1865,4933,4650,2148,53928,672588,571166,2386,4817,2952,5171,7602,50.0199960015992,17.020926117136145,2431,1,459672,47261,2502,0,521,167
8426,0,0,0,0,54,1,606,0,1,5290591,5451951,44.91102314577124,1777,4880,4640,2017,55000,675750,594660,2463,4720,2943,5326,7583,51.21523210920751,16.077559228392104,2257,1,443740,38160,2623,0,686,80
8427,0,0,0,0,52,1,1025,0,1,4289166,4253504,40.26164427839479,1501,4387,4267,1621,56400,629760,616640,2504,4245,2744,5270,7011,51.43928459844674,11.246826503806982,1741,1,380935,14880,2646,0,1003,22
8428,0,0,0,0,52,1,1022,0,1,4186760,4186760,39.97499218261337,1478,4338,4218,1598,56386,610460,634040,2500,4218,2740,5240,6958,51.18593556827891,11.193019168523147,1718,1,386716,13080,2620,0,1022,0
8429,0,0,0,0,50,1,866,0,0,1996995,2643850,32.32645975048923,1045,2956,2956,1045,55695,599610,594550,2530,3575,2530,4441,5486,43.71498598878879,0.0,1045,0,245575,0,1911,0,1485,619
8430,0,0,0,0,50,1,863,0,0,1938114,2589624,32.03123475609393,1026,2915,2915,1026,55176,575472,610808,2524,3550,2524,4413,5439,43.46262762420146,0.0,1026,0,248292,0,1889,0,1498,635
8431,0,1,1,0,63,0,1158,0,0,916920,5430204,41.20679555607303,1668,2268,2238,1698,45066,709956,649194,3168,4896,3228,3738,5466,23.2379000772445,5.514871952411144,1728,0,344694,4710,540,1,1500,2658
8432,0,0,0,0,59,1,1043,1,0,1633818,5641332,43.61192497471305,1485,3178,2761,1902,55418,679214,717772,2549,4868,3383,3825,6144,29.30870177950569,21.660172775206767,2319,1,460284,41283,859,0,1064,2107
8433,0,0,0,0,59,1,1101,1,0,1602730,5706105,43.94314508543966,1540,3152,2761,1931,55125,664875,723975,2564,4886,3346,3785,6107,28.809720581775867,21.00043190547463,2322,1,473095,35581,830,0,1024,2125
8434,0,0,0,0,58,1,1220,1,0,1535061,5849558,44.62062303464621,1649,3104,2762,1991,54033,637546,731562,2596,4929,3280,3709,6042,27.76688675382964,19.816650341599658,2333,1,495759,25992,771,0,947,2167
8435,0,0,0,0,58,1,1279,1,0,1499582,5911425,44.955533585978046,1702,3082,2763,2021,55081,652275,722475,2606,4946,3244,3667,6007,27.23967694375247,19.138441618404613,2340,1,499187,27753,742,0,904,2183
8436,0,0,1,0,65,1,251,0,0,494760,2759400,28.982753492378876,356,1913,1429,840,46964,775260,653715,2801,4125,3769,3874,5198,24.269322199023193,22.20889997264646,1324,1,167160,85184,589,0,2445,2696
8437,0,0,1,0,67,1,1355,0,0,2321550,3321450,31.464265445104548,300,4025,3335,990,47637,795135,674355,2665,4345,4045,5700,7380,48.425200051213004,26.39933092177806,1680,1,198990,121440,2345,0,2365,1010
8438,0,0,1,0,57,1,407,0,0,4920344,6991556,49.3051721424842,2027,4859,4455,2431,56160,690240,672984,2472,5307,3280,4900,7735,44.98888751680797,20.13524692498938,2835,1,568854,54540,2024,0,445,852
8439,0,0,1,0,57,1,455,0,0,4852254,7015866,49.416596402423345,1996,4875,4429,2442,55081,709631,640679,2427,5315,3319,4860,7748,44.57577817604534,21.144173102049116,2888,1,544566,70022,1987,0,431,886
8440,0,0,0,0,57,1,788,1,0,3666789,6722838,48.46648326421054,1474,4785,3910,2349,55842,649674,704052,1987,5211,3737,4423,7647,39.50949253027682,29.64671576832751,3224,1,577854,84000,1561,0,513,1301
8441,0,0,0,0,56,1,573,1,0,5000688,7183407,50.40833264451424,1989,5061,4509,2541,53500,604978,706750,2275,5368,3379,4795,7888,44.36214602563767,24.18880489694307,3093,1,635250,45816,1968,0,286,859
8442,0,0,0,0,54,1,404,0,1,5557152,7028616,50.67543783727971,2218,5082,4732,2568,55278,607614,681513,2387,5305,3087,4901,7819,46.51881339845203,19.10081310535224,2918,1,639432,31500,2164,0,169,573
8443,0,0,0,0,53,1,110,1,0,5510079,6444846,49.02040391510457,2126,4973,4696,2403,54780,590040,667818,2405,5085,2959,4975,7655,47.885279575251516,16.76687462490817,2680,1,598347,25207,2293,0,279,389
8444,0,0,0,0,53,1,287,0,1,5410638,5837103,46.76537180435969,1902,4946,4661,2187,56640,629884,640560,2384,4856,2954,5143,7615,49.73932046178355,16.945237688130096,2472,1,524880,34770,2474,0,482,195
8445,0,0,0,0,52,1,990,0,1,5123464,4775462,42.68489194082609,1698,4758,4634,1822,55304,584483,650008,2497,4443,2745,5433,7379,53.028294334251406,11.388237031910945,1946,1,451856,11036,2812,0,799,191
8446,0,0,0,0,52,1,1071,0,1,4923046,4556176,41.79712908801273,1652,4660,4565,1747,55304,646784,581584,2513,4355,2703,5426,7268,53.08483775994799,9.886585106410566,1842,1,389581,14060,2818,0,861,210
8447,0,0,0,0,59,1,974,1,0,1672755,5521026,43.23193264243457,1439,3194,2764,1869,54755,694190,688282,2524,4823,3384,3849,6148,29.916550603303182,21.806173455060936,2299,1,435477,48590,895,0,1085,2059
8448,0,0,0,0,58,1,1150,1,0,1582064,5746730,44.24929377967517,1608,3116,2766,1958,55144,663310,716140,2585,4893,3285,3743,6051,28.42534080710379,19.885139309582005,2308,1,477752,32550,808,0,977,2127
8449,0,0,0,0,57,1,1502,1,0,1359768,6125370,46.238512086787566,1937,2975,2774,2138,49949,570135,719115,2664,5003,3066,3501,5840,25.219040425836983,15.283491167422378,2339,1,536638,9246,636,0,727,2229
8450,0,0,1,0,67,1,1095,0,0,1433416,2583071,27.730849247724095,319,3083,2633,769,51040,779288,738980,2909,4128,3809,5223,6442,43.174066289845804,21.273287459985912,1219,1,169180,67050,1864,0,2590,1495
8451,0,0,1,0,63,1,2053,0,0,3101780,9657815,55.362442142665635,2980,4162,4077,3065,56628,737334,762542,3066,6216,3236,4163,7313,31.811947441173732,9.219863456115478,3150,1,741730,9945,1012,0,86,2139
8452,0,0,1,0,64,1,90,0,0,4167739,6757706,45.68369512200168,1487,4684,4084,2087,50058,786834,667028,2638,5325,3838,5235,7922,44.68780594300866,24.643836901460062,2687,1,429922,105600,1997,0,1151,1241
8453,0,0,1,0,57,1,146,0,0,5284671,6867462,48.7134478352744,2126,4847,4600,2373,56120,706136,665620,2647,5267,3141,5121,7741,47.19110085598767,15.813285326007605,2620,1,545790,35568,2227,0,521,667
8454,0,0,1,0,57,1,378,0,0,4883803,6905683,49.06118628814432,2003,4840,4436,2407,55890,697167,659870,2465,5276,3273,4898,7709,45.044422518220834,20.12215750167547,2811,1,553610,58580,2029,0,462,840
8455,0,0,1,0,59,1,716,0,0,3948197,7035920,48.75448697299562,1693,4722,4038,2377,53128,686720,677840,2276,5337,3644,4621,7682,40.755367744629666,26.51704377431659,3061,1,544333,93708,1661,0,583,1299
8456,0,0,0,0,58,1,735,1,0,3787324,6816244,48.45616575834287,1596,4713,3961,2348,56105,664787,711235,2151,5251,3655,4516,7616,40.162171256046406,27.61011001503645,3100,1,575260,78960,1613,0,555,1290
8457,0,0,0,0,57,1,713,0,0,3689070,6599670,48.062459362791664,1384,4833,3907,2310,51156,719964,579971,1931,5167,3783,4454,7690,39.96248240537617,30.49414705476841,3236,0,468930,169458,1597,0,547,1260
8458,0,0,0,0,59,1,608,0,1,4213209,7044219,48.774993593028796,1694,4835,4150,2379,55912,686952,713601,2276,5340,3646,4732,7796,42.08325082500163,27.30973625849973,3064,1,573339,71925,1771,0,582,1190
8459,0,0,0,0,59,1,603,0,1,4258408,7051198,48.85693400122443,1713,4845,4171,2387,56144,685328,714868,2280,5341,3628,4738,7799,42.23742416388575,27.073103472639126,3061,1,577654,71444,1784,0,567,1170
8460,0,0,0,0,55,1,484,1,0,5449845,7124928,50.882216932834204,2185,5098,4694,2589,56069,624704,679744,2348,5341,3156,4857,7850,45.880278987817846,20.550161276323745,2993,1,639483,39188,2105,0,163,647
8461,0,0,0,0,53,1,78,0,1,5530383,6405489,48.8978527135906,2144,4951,4704,2391,53599,581343,661713,2432,5070,2926,4992,7630,48.093658625644196,15.845053753325034,2638,1,590577,22724,2313,0,288,366
8462,0,0,0,0,52,1,1101,0,1,4902192,4500600,41.60528812542944,1664,4630,4563,1731,55800,644800,585000,2533,4331,2667,5432,7230,53.21653878260028,8.286047041568583,1798,1,389475,10117,2832,0,869,232
8463,0,1,1,0,62,0,985,0,0,545100,4298700,37.14835124201342,1230,1925,1775,1380,33649,501515,651035,2965,4495,3265,3510,5040,19.87460691435179,12.613010185831968,1530,0,288420,10200,395,1,1735,2720
8464,0,0,1,0,54,1,2067,0,0,876508,6669716,49.27473997901968,2386,2831,2789,2428,43316,653786,499954,2705,5175,2789,3108,5578,19.0,6.538739683827756,2470,1,441896,8190,361,0,319,2386
8465,0,0,1,0,62,1,708,0,0,1165180,4648800,38.600518131237564,1490,2272,2272,1490,48880,733200,648960,3120,4610,3120,3902,5392,27.964262908219126,0.0,1490,0,309920,0,782,0,1630,2338
8466,0,0,1,0,67,1,1181,0,0,1504992,2586705,27.76688675382964,347,3147,2723,771,51736,778360,748165,2931,4126,3779,5307,6502,44.181444068749045,20.646474403859205,1195,1,171933,61480,1952,0,2584,1403
8467,0,0,1,0,67,1,2106,0,0,1554615,9104835,51.81698563212646,2350,3599,3264,2685,55680,813840,786712,3056,6076,3726,3970,6990,24.06241883103193,19.63731573731539,3020,1,622920,46565,579,0,706,2812
8468,0,0,1,0,63,1,1730,0,0,3255776,9131076,53.53503525729669,2746,4122,4002,2866,35090,771012,461970,3066,6052,3306,4322,7308,33.704599092705436,11.453518157187645,2986,1,415570,27480,1136,0,320,2050
8469,0,0,1,0,64,1,995,0,0,3463896,7781040,49.23413450036468,2304,3973,3853,2424,54675,780030,722250,3090,5634,3330,4639,7183,37.8021163428716,10.966602528904897,2544,0,545400,18360,1429,1,786,1781
8470,0,0,1,0,58,1,1003,0,0,6620760,6243400,46.04345773288535,2090,5273,5243,2120,53536,703855,659680,2915,5065,2975,6068,8218,55.883808030591474,5.478746393072713,2150,1,474880,4530,3123,0,825,178
8471,0,0,0,0,57,1,672,1,0,3728704,6582632,47.916594202843754,1503,4713,3920,2296,52624,596336,725351,2074,5163,3660,4491,7580,40.29888335921977,28.24655348061222,3089,1,580888,49959,1624,0,571,1243
8472,0,0,0,0,56,1,667,1,0,3704940,6495080,47.82258880487337,1451,4743,3907,2287,55575,701480,639000,2004,5127,3676,4460,7583,40.24922359499622,28.953339884762705,3123,1,514575,127072,1620,0,553,1220
8473,0,0,0,0,56,1,656,0,0,3702720,6493440,47.74934554525329,1394,4790,3904,2280,52080,706304,598080,1962,5128,3734,4472,7638,40.29888335921977,29.820355792912856,3166,0,478800,155050,1624,0,568,1224
8474,0,0,0,0,57,1,653,0,0,3709560,6502560,47.74934554525329,1381,4806,3907,2280,50547,710148,578956,1953,5132,3751,4479,7658,40.33608806019741,30.056525229342107,3179,0,462840,164517,1627,0,572,1225
8475,0,0,0,0,57,1,630,1,0,3773799,6597870,47.78074926160116,1419,4800,3936,2283,41310,702270,491300,2026,5173,3754,4543,7690,40.65710270051225,29.83467544038101,3147,1,388110,182304,1653,0,607,1237
8476,0,0,0,0,54,1,429,1,0,5535396,7048095,50.76416058598822,2216,5086,4725,2577,56350,629050,670075,2374,5312,3096,4883,7821,46.34652090502587,19.39692281009749,2938,1,631365,37905,2148,0,158,587
8477,0,0,0,0,53,1,95,0,1,5564984,6465202,49.06118628814432,2179,4947,4719,2407,54531,588234,668814,2458,5093,2914,4998,7633,48.08326112068523,15.292307076301322,2635,1,599343,20748,2312,0,279,374
8478,0,0,0,0,52,1,1056,0,1,5094340,4662950,42.30839160261236,1723,4703,4636,1790,55000,573100,651250,2538,4395,2672,5451,7308,53.34791467339656,8.397588990243326,1857,1,447500,5695,2846,0,815,241
8479,0,0,0,0,51,1,1113,0,0,3616650,3659400,37.749172176353746,1395,3993,3963,1425,55224,600912,606048,2538,3993,2598,5106,6561,50.37856687124,5.478746393072713,1455,0,336300,3840,2538,0,1143,30
8480,0,0,0,0,50,1,1076,1,0,2620992,2965552,34.17601498127012,1138,3442,3412,1168,47053,566197,535729,2509,3707,2569,4783,5981,47.37087712930804,5.483301264452448,1198,1,246448,4440,2244,0,1371,295
8481,0,1,1,0,63,0,1296,0,0,180721,4550754,37.72267222772003,1093,1880,1550,1423,44712,690768,661986,2868,4621,3528,3325,5078,11.269427669584644,18.319130009366607,1753,0,294561,47850,127,1,1775,3071
8482,0,0,1,0,63,1,755,0,0,490314,3709026,34.249087579087416,1088,1676,1591,1173,54880,774690,708288,3077,4335,3247,3580,4838,20.445048300260872,9.265143265380413,1258,0,262752,13175,418,1,1989,2744
8483,0,0,1,0,66,1,498,0,0,1505503,3341996,31.670175244226233,612,2895,2504,1003,51660,819672,699720,2941,4335,3723,4833,6227,38.742741255621034,19.817838876454456,1394,1,210630,67252,1501,0,2329,1831
8484,0,0,1,0,64,1,2892,0,0,775333,10160943,56.02677931132576,3044,3481,3386,3139,39004,634452,644163,3142,6376,3332,3484,6718,15.716233645501712,10.097077230934874,3234,0,624661,12255,247,1,98,2990
8485,0,0,1,0,62,1,1897,0,0,3231404,9321587,54.59853477887479,2939,4107,4065,2981,56876,753607,737972,3085,6108,3169,4211,7234,32.92415526630866,6.488991180673202,3023,1,703516,5460,1084,0,146,2043
8486,0,0,1,0,64,1,137,0,0,4249214,6468536,44.654227123532216,1323,4796,4125,1994,49980,794780,661776,2573,5238,3915,5375,8040,46.16275555033516,26.066793830876623,2665,1,406776,120109,2131,0,1250,1113
8487,0,0,1,0,65,1,424,0,0,4581857,6342469,44.034077712607996,1039,5202,4302,1939,50880,785040,693452,2371,5210,4171,5634,8473,48.61069841094653,30.179857569890153,2839,1,411068,149400,2363,0,1332,908
8488,0,0,1,0,64,1,946,0,0,5550680,6179860,43.93176527297759,1288,5448,4806,1930,49500,704440,720450,2560,5132,3844,6078,8650,53.62835071116769,25.450628941465226,2572,1,434250,82176,2876,0,1272,326
8489,0,0,0,0,57,1,617,1,0,3807428,6577920,47.791212581394085,1573,4662,3951,2284,56635,676800,694080,2169,5164,3591,4547,7542,40.82891132518721,26.80608014896195,2995,1,550444,84609,1667,0,596,1213
8490,0,0,0,0,57,1,612,1,0,3747964,6473962,47.60252094164762,1499,4687,3920,2266,53424,605684,719964,2090,5123,3624,4511,7544,40.66939881532551,27.766092634101444,3033,1,571032,52923,1654,0,591,1203
8491,0,0,0,0,56,1,605,0,0,3720750,6397435,47.486840282335066,1439,4721,3905,2255,53352,700739,612792,2021,5092,3653,4487,7558,40.620192023179804,28.604246342441495,3071,0,487080,135456,1650,0,582,1187
8492,0,0,0,0,57,1,590,0,0,3735000,6426000,47.43416490252569,1376,4784,3910,2250,46170,694008,542640,1982,5106,3730,4516,7640,40.74309757492672,29.868742940938255,3124,0,427500,168682,1660,0,606,1196
8493,0,0,0,0,57,1,587,1,0,3741750,6439500,47.43416490252569,1384,4779,3913,2250,44880,686880,535194,1996,5112,3728,4525,7641,40.779897008207364,29.758023258948903,3116,1,420750,166272,1663,0,612,1199
8494,0,0,0,0,57,1,575,1,0,3776604,6492516,47.45524207081869,1405,4776,3929,2252,40592,680388,495876,2036,5135,3730,4560,7659,40.95119045888654,29.512485437272662,3099,1,387344,172788,1677,0,631,1206
8495,0,0,0,0,58,1,485,0,1,4328124,6835725,48.342527861087284,1730,4796,4189,2337,55932,693225,690300,2318,5262,3532,4777,7721,43.034869582700026,25.689432994255323,2944,1,551532,70412,1852,0,588,1073
8496,0,0,0,0,57,1,434,1,0,4819347,6905550,49.22397789695587,1857,4978,4412,2423,50953,578550,715350,2284,5273,3416,4839,7828,44.598206241955516,24.556244032676855,2989,1,608173,37356,1989,0,427,861
8497,0,0,0,0,53,1,86,0,1,5544176,6138360,48.08326112068523,2132,4890,4710,2312,55822,600030,655785,2475,4967,2835,5053,7545,48.96937818678118,13.461829731744027,2492,1,571064,17460,2398,0,343,257
8498,0,0,0,0,53,1,284,0,1,5474172,5846310,46.92547282660026,2020,4870,4688,2202,56088,653130,605340,2473,4857,2837,5141,7525,49.85980344927164,13.535417710445202,2384,1,502056,26754,2486,0,453,169
8499,0,1,1,0,64,0,1125,0,0,570016,4881984,38.781438859330635,1329,2058,1883,1504,43239,691398,658938,3071,4750,3421,3625,5304,19.467922333931785,13.522191576281958,1679,0,305312,25550,379,1,1742,2867
8500,0,1,1,0,61,0,518,0,0,1294808,4353578,37.76241517699841,1384,2376,2334,1426,42460,589229,671660,3011,4479,3095,3961,5429,30.133038346638727,6.48074069840786,1468,0,313720,4200,908,1,1627,2145
8501,0,0,0,0,58,1,825,1,0,1760554,5260038,42.44997055358225,1365,3216,2779,1802,56364,712236,674289,2482,4721,3356,3896,6135,31.25699921617557,21.654142992015576,2239,1,416262,59432,977,0,1117,1942
8502,0,0,1,0,57,1,2435,0,0,860124,7947216,52.421369688324624,2358,3451,3061,2748,14448,485856,248712,2502,5640,3282,3205,6343,17.69180601295413,20.559488312444806,3138,1,236328,79170,313,0,144,2579
8503,0,0,1,0,61,1,712,0,0,2462145,6042375,44.328320518603,1965,3218,3218,1965,49533,728775,642675,3075,5040,3075,4328,6293,35.397740040855716,0.0,1965,0,410685,0,1253,0,1110,1822
8504,0,0,1,0,66,1,708,0,0,1554300,3154758,30.692018506445613,582,2952,2592,942,49551,833901,666451,2989,4291,3709,4999,6301,40.620192023179804,19.026297590440446,1302,1,187458,67320,1650,0,2407,1699
8505,0,0,1,0,67,1,1225,0,0,1662600,2734325,28.548204847240395,425,3245,2855,815,50481,795135,714615,2965,4170,3745,5395,6600,45.16635916254486,19.7836716440551,1205,1,173595,63180,2040,0,2540,1315
8506,0,0,1,0,64,1,2896,0,0,906585,10319164,56.4003546088143,3047,3600,3466,3181,41173,639068,677996,3110,6425,3378,3529,6844,16.881943016134134,11.875984241237097,3315,0,664829,15946,285,1,63,2959
8507,0,0,1,0,64,1,1254,0,0,3378235,8267042,50.68530358989675,2263,4190,3884,2569,53100,759448,724050,2912,5787,3524,4533,7408,36.26292872893749,17.50479977423867,2875,1,578025,44370,1315,0,649,1903
8508,0,0,1,0,57,1,242,0,0,4838568,6635020,48.2078831727758,1964,4766,4406,2324,55161,693765,648085,2495,5179,3215,4937,7621,45.628938186199335,18.994712766476617,2684,1,527548,54000,2082,0,531,773
8509,0,0,0,0,56,1,547,0,0,3741360,6306864,47.19110085598767,1448,4686,3907,2227,54366,696672,625872,2053,5059,3611,4512,7518,40.98780306383839,27.94528901567249,3006,0,492167,124640,1680,0,605,1152
8510,0,0,0,0,56,1,545,0,0,3738000,6303425,47.16990566028302,1438,4692,3905,2225,53320,702584,609095,2046,5058,3620,4513,7525,40.98780306383839,28.091534949855664,3012,0,478375,132216,1680,0,608,1153
8511,0,0,0,0,57,1,530,1,0,3751800,6342540,47.11687595755899,1375,4755,3910,2220,43802,691394,517117,2012,5077,3702,4547,7612,41.10960958218893,29.348667741071694,3065,1,401820,169000,1690,0,637,1167
8512,0,0,0,0,57,1,527,1,0,3758460,6358080,47.11687595755899,1383,4750,3913,2220,43259,684496,518384,2027,5084,3701,4557,7614,41.14608122288197,29.285407979905727,3057,1,401820,164889,1693,0,644,1171
8513,0,0,0,0,53,1,127,0,1,5643720,6553840,49.39635614091387,2239,4954,4753,2440,56643,636582,641954,2485,5126,2887,4999,7640,48.093658625644196,14.40893599983394,2641,1,583160,24120,2313,0,246,373
8514,0,0,0,0,51,1,1194,0,0,4607575,4203087,40.38564101261734,1631,4456,4456,1631,51948,603018,572094,2577,4208,2577,5402,7033,53.150729063673246,0.0,1631,0,362082,0,2825,0,946,248
8515,0,0,1,0,60,1,1740,0,0,6756181,5699066,43.255057507764334,1670,5683,5482,1871,45248,615292,682304,2845,4917,3247,6657,8729,60.091596750294464,14.255752335575957,2072,1,419104,21306,3611,0,1175,565
8516,0,0,1,0,59,1,1283,0,0,6508008,5871528,44.598206241955516,1904,5346,5261,1989,42781,528408,705528,2867,4941,3037,6224,8298,57.201398584300364,9.235136611923052,2074,1,475371,0,3272,0,963,320
8517,0,0,1,0,58,1,977,0,0,6425510,6136676,45.749316934791494,2033,5223,5163,2093,51465,642108,689020,2872,5025,2992,6002,8155,55.40758070878027,7.7992067098508295,2153,1,491855,6840,3070,0,839,138
8518,0,0,0,0,56,1,473,0,0,3760230,6237120,46.79743582719036,1371,4726,3907,2190,44345,697760,515488,2029,5038,3667,4565,7574,41.43669871020132,28.706097741952057,3009,0,396390,166257,1717,0,658,1131
8519,0,0,0,0,58,1,384,0,1,4252177,6574015,47.57099956906519,1686,4719,4142,2263,54752,685580,673960,2328,5168,3482,4784,7624,43.347433603386484,24.99079491723493,2840,1,525016,66932,1879,0,642,1026
8520,0,0,0,0,53,1,239,1,0,5719350,6777744,50.1398045468867,2280,5023,4789,2514,55822,609296,665912,2462,5210,2930,4971,7719,47.69696007084728,15.601376800644807,2748,1,620958,23634,2275,0,182,421
8521,0,0,0,0,52,1,699,0,1,5332410,5221194,44.56455991031439,1901,4756,4671,1986,53212,659879,557348,2544,4615,2714,5314,7385,51.81698563212646,9.370214040084857,2071,1,421032,13855,2685,0,643,56
8522,0,0,0,0,52,1,1001,0,1,5157450,4766900,42.720018726587654,1765,4711,4651,1825,56376,605984,634716,2552,4437,2672,5438,7323,53.16013544000805,7.789174875971784,1885,1,443475,6360,2826,0,787,214
8523,0,0,0,0,51,1,1225,0,0,4820964,4307528,40.82891132518721,1637,4589,4559,1667,44377,576232,514216,2554,4251,2614,5476,7173,53.777318638995006,5.501408174353464,1697,0,331733,4890,2892,0,917,308
8524,0,0,1,0,63,1,908,0,0,382173,3860802,34.942810419312295,1221,1534,1534,1221,49296,749394,657696,3162,4383,3162,3475,4696,17.69180601295413,0.0,1221,0,253968,0,313,0,1941,2849
8525,0,0,1,0,66,1,744,0,0,1651860,3235134,31.080540535840107,666,2976,2676,966,54093,827203,733431,3049,4315,3649,5059,6325,41.352146256270665,17.38956842285305,1266,1,211554,48600,1710,0,2383,1639
8526,0,0,1,0,67,1,1320,0,0,1905300,2921460,29.49576240750525,446,3484,3060,870,49980,799204,705180,2934,4228,3782,5548,6842,46.79743582719036,20.6015896000888,1294,1,182700,70808,2190,0,2488,1168
8527,0,0,1,0,67,1,1470,0,0,2035800,2927550,29.49576240750525,329,3751,3210,870,49450,773950,723475,2824,4235,3906,5705,7116,48.373546489791295,23.272825539844355,1411,1,187050,82232,2340,0,2495,1025
8528,0,0,1,0,67,1,1612,0,0,2186220,2943934,29.631064780058107,344,3902,3368,878,52212,767837,764484,2819,4231,3887,5843,7255,49.8998997994986,23.12788481243941,1412,1,200184,72624,2490,0,2475,863
8529,0,0,1,0,66,1,1664,0,0,2259300,2967214,29.765752132274432,402,3920,3436,886,51984,763572,763572,2865,4235,3833,5899,7269,50.49752469181039,22.03382499153368,1370,1,202008,64372,2550,0,2463,799
8530,0,0,1,0,64,1,2982,0,0,1273819,10761922,57.97413216254298,3227,3874,3740,3361,50976,691632,755672,3068,6563,3336,3581,7076,19.467922333931785,11.583726138680884,3495,0,793196,14606,379,1,159,2823
8531,0,0,1,0,56,1,157,0,0,4800894,6460995,47.65501022977542,1970,4686,4385,2271,55902,688490,657195,2544,5116,3146,4959,7531,45.9782557302906,17.363170339092083,2572,1,524601,42742,2114,0,574,731
8532,0,0,0,0,56,1,423,0,0,3763620,6119127,46.50806381693394,1422,4644,3903,2163,51832,701592,591261,2088,4992,3570,4569,7473,41.71330722922842,27.275143716703734,2904,0,452067,130416,1740,0,666,1089
8533,0,0,0,0,57,1,411,1,0,3777840,6175440,46.475800154489,1373,4696,3909,2160,38070,671865,463158,2072,5019,3646,4608,7555,41.82104733265297,28.33202352000475,2947,1,349920,166844,1749,0,699,1110
8534,0,0,0,0,55,1,249,1,0,5230890,6699210,49.14264950122246,2049,4947,4581,2415,50000,554800,693500,2408,5189,3140,4940,7721,46.54030511288038,19.804560111063996,2781,1,603750,23790,2166,0,359,608
8535,0,0,0,0,52,1,831,0,1,5277250,5025861,43.80639222761902,1889,4699,4669,1919,54612,644274,581418,2589,4538,2649,5369,7318,52.44044240850758,5.684275577662207,1949,1,426018,4290,2750,0,700,131
8536,0,0,0,0,51,1,1251,1,0,3062772,3168810,35.11409973215888,1125,3825,3717,1233,47008,580820,534560,2462,3803,2678,5054,6395,49.839743177508446,10.406531168715494,1341,1,256464,16740,2484,0,1337,86
8537,0,0,0,0,57,1,1247,1,0,1617720,5834400,45.16635916254486,1839,3034,2833,2040,56640,674960,686400,2659,4900,3061,3653,5894,28.160255680657446,15.12126234418381,2241,1,489600,23919,793,0,820,2067
8538,0,0,0,0,57,1,1303,1,0,1587690,5907780,45.4972526643093,1895,3012,2837,2070,56334,653566,702084,2679,4924,3029,3621,5866,27.694764848252458,14.249967263768658,2245,1,509220,17675,767,0,784,2087
8539,0,0,1,0,67,1,1137,0,0,1845064,3033824,30.066592756745816,595,3254,2945,904,51840,805440,724896,3047,4260,3665,5397,6610,45.17742799230607,17.61185307153986,1213,1,195264,50058,2041,0,2452,1315
8540,0,0,1,0,66,1,661,0,0,2820002,4586301,37.16180835212409,882,3922,3423,1381,56619,807003,773793,2822,4702,3820,5363,7243,45.18849411078001,22.60013476239868,1880,1,321773,68363,2042,0,1940,1279
8541,0,0,1,0,63,1,1426,0,0,3523695,8688153,52.16320542297991,2541,4196,4016,2721,32562,775899,427862,3013,5914,3373,4488,7389,35.98610843089316,13.774493079968597,2901,1,364614,41220,1295,0,472,1898
8542,0,0,1,0,61,1,1827,0,0,6593868,5548344,42.567593307585526,1556,5707,5451,1812,44496,630772,661392,2806,4874,3318,6701,8769,60.32412452742269,16.12761547088173,2068,1,391392,31232,3639,0,1250,577
8543,0,0,1,0,56,1,127,0,0,4772378,6382662,47.4236228055175,1979,4641,4371,2249,55596,698148,641388,2568,5087,3108,4960,7479,46.06517122512408,16.512448686839516,2519,1,508274,40770,2122,0,589,716
8544,0,0,1,0,58,1,362,0,0,4096263,6506220,47.042533945356304,1718,4559,4064,2213,43326,732060,511560,2445,5153,3435,4791,7499,43.02324952859791,22.768450834207407,2708,1,385062,104445,1851,0,727,1089
8545,0,0,0,0,56,1,376,1,0,3833745,6118045,46.42197755374064,1522,4567,3934,2155,55000,624580,709750,2206,4994,3472,4618,7406,42.17819341792628,25.217699862260964,2788,1,538750,55071,1779,0,684,1060
8546,0,0,0,0,57,1,351,1,0,3789270,6100320,46.151923036857305,1371,4668,3909,2130,35037,655856,438192,2105,4994,3623,4643,7532,42.17819341792628,27.862256769576284,2889,1,325890,162426,1779,0,734,1085
8547,0,0,0,0,57,1,341,1,0,3814490,6167114,46.16275555033516,1396,4656,3921,2131,38420,654044,491980,2159,5025,3629,4684,7550,42.30839160261236,27.618563117841457,2866,1,362270,144060,1790,0,763,1104
8548,0,0,0,0,57,1,337,1,0,3826940,6180668,46.17358552246078,1402,4657,3927,2132,46968,660972,597194,2169,5031,3629,4694,7556,42.36744032862972,27.622632560214193,2862,1,439192,116800,1795,0,767,1104
8549,0,0,0,0,57,1,304,0,1,3988905,6238725,46.42197755374064,1489,4672,4006,2155,54189,703485,645585,2229,5050,3561,4746,7567,43.02324952859791,26.519818799088412,2821,1,480565,90576,1851,0,740,1044
8550,0,0,0,0,53,1,79,1,0,5751242,6489956,49.37610758251404,2288,4947,4797,2438,56088,606936,654852,2512,5100,2812,5021,7609,48.569537778323564,12.393026621210916,2588,1,599748,15600,2359,0,224,303
8551,0,0,0,0,52,1,362,0,1,5560464,5733000,46.73328578219169,2124,4790,4730,2184,54808,651000,580125,2565,4809,2685,5171,7415,50.457903246171455,7.754559014766193,2244,1,482664,9600,2546,0,441,79
8552,0,0,0,0,52,1,762,0,1,5344488,5118858,44.294469180700204,1920,4728,4686,1962,55822,644423,589634,2567,4571,2651,5333,7337,52.191953402799555,6.589126398255297,2004,1,443412,6216,2724,0,647,115
8553,0,0,0,0,51,1,1065,0,0,5147674,4665810,42.40283009422838,1798,4661,4661,1798,56386,627990,604635,2595,4393,2595,5458,7256,53.50700888668698,0.0,1798,0,418934,0,2863,0,797,268
8554,0,0,0,0,51,1,1227,1,0,4934338,4374617,41.12177038990418,1649,4651,4609,1691,48930,602771,543270,2545,4278,2629,5505,7238,54.01851534427802,6.48074069840786,1733,1,355110,6804,2918,0,896,331
8555,0,0,0,0,56,1,1343,1,0,1589700,5953500,45.8257569495584,1966,2991,2857,2100,53928,606690,714420,2701,4935,2969,3592,5826,27.51363298439521,12.575842945415378,2234,1,529200,10184,757,0,735,2078
8556,0,0,1,0,60,1,1610,0,0,2488416,7782096,50.75431016179808,2306,3812,3542,2576,44583,697851,583053,2751,5597,3291,3987,6833,31.080540535840107,16.46403862829034,2846,0,497168,47790,966,1,445,2055
8557,0,0,1,0,63,1,1070,0,0,110675,3712855,34.132096331752024,1135,1290,1260,1165,52675,780815,685205,3157,4352,3217,3282,4477,9.746794344808963,5.5503012171862105,1195,0,250475,5010,95,0,2022,3092
8558,0,0,1,0,67,1,1528,0,0,2299508,3137306,30.56141357987225,409,3921,3396,934,51980,759134,772570,2834,4293,3884,5821,7280,49.61854492022111,22.941277090895824,1459,1,214820,67200,2462,0,2425,897
8559,0,0,1,0,58,1,1147,0,0,6288854,5879059,44.710177812216315,1849,5295,5145,1999,48375,632315,661725,2791,4940,3091,6087,8236,56.089214649520635,12.248673275118406,2149,1,449775,18450,3146,0,942,205
8560,0,0,0,0,56,1,313,0,0,3819068,5965706,46.010868281309364,1481,4557,3921,2117,55926,659412,673502,2182,4935,3454,4622,7375,42.473521163190604,25.247810973907512,2753,0,505963,78864,1804,0,701,1014
8561,0,0,0,0,57,1,284,1,0,3813600,6071100,45.8257569495584,1387,4629,3916,2100,33673,644693,436541,2178,4991,3604,4707,7520,42.61455150532503,27.163972956636602,2813,1,317100,149017,1816,0,791,1075
8562,0,0,0,0,57,1,206,1,0,4353312,6253776,46.8187996428785,1722,4648,4178,2192,54208,690426,639072,2383,5045,3323,4839,7501,44.56455991031439,22.490774849252222,2662,1,491008,62040,1986,0,661,867
8563,0,0,0,0,55,1,143,1,0,5301000,6543125,48.73397172404482,2066,4916,4607,2375,49644,542735,694260,2446,5130,3064,4987,7671,47.24404724407086,18.22669145870833,2684,1,598500,18231,2232,0,380,523
8564,0,0,0,0,52,1,196,0,1,5678621,6014810,47.82258880487337,2245,4812,4770,2287,54273,623310,602270,2588,4917,2672,5113,7442,49.82971001320397,6.488991180673202,2329,1,523723,5964,2483,0,343,147
8565,0,0,0,0,52,1,246,0,0,5654032,5936282,47.51841748206689,2228,4792,4762,2258,51980,604670,594154,2599,4887,2659,5133,7421,50.039984012787215,5.501408174353464,2288,0,510308,4170,2504,0,371,125
8566,0,0,0,0,51,1,844,0,0,5316252,4993356,43.840620433565945,1922,4688,4688,1922,54014,620922,587148,2598,4520,2598,5364,7286,52.592775169218825,0.0,1922,0,434372,0,2766,0,676,168
8567,0,0,1,0,67,1,1413,0,0,2278080,3234240,30.983866769659336,436,3857,3333,960,51744,778239,754656,2845,4329,3893,5742,7226,48.7134478352744,22.90978123105612,1484,1,215040,74932,2373,0,2409,996
8568,0,0,1,0,67,1,1443,0,0,2306880,3232320,30.983866769659336,408,3915,3363,960,51980,774410,760942,2815,4327,3919,5770,7282,49.02040391510457,23.509778576488415,1512,1,216960,76728,2403,0,2407,964
8569,0,0,1,0,66,1,584,0,0,2914560,4757760,37.94733192202055,1007,3897,3464,1440,56640,779744,792960,2871,4744,3737,5328,7201,44.98888751680797,21.03962423979427,1873,1,345600,52393,2024,0,1864,1280
8570,0,0,1,0,65,1,39,0,0,2932276,5541189,41.14608122288197,1387,3731,3425,1693,55800,811704,736425,2967,4966,3579,5005,7004,41.617304093369626,17.698844655896092,1999,1,380925,45900,1732,0,1580,1541
8571,0,0,1,0,66,1,1243,0,0,2491850,7716622,48.14561246884289,1900,3811,3393,2318,51562,845566,675787,2911,5647,3747,4404,7140,32.78719262151,21.17296734115764,2736,1,470554,75658,1075,0,1011,2254
8572,0,0,1,0,63,1,2821,0,0,2032520,10767232,58.44655678480983,3386,4041,4011,3416,54240,756480,712352,3122,6568,3182,3747,7193,24.392621835300936,5.477225575051661,3446,0,772016,4470,595,1,264,2557
8573,0,0,1,0,63,1,6,0,0,3825927,6239415,44.26059195266146,1691,4180,3912,1959,50298,793065,643370,2917,5144,3453,5138,7365,44.19275958796871,16.46566292217285,2227,1,395718,49580,1953,0,1226,1232
8574,0,0,1,0,58,1,954,0,0,6229152,6047520,45.43126676640219,1889,5257,5082,2064,44726,627020,612370,2755,4994,3105,5948,8187,54.93632677928149,13.359104871799886,2239,1,431376,24500,3018,0,866,88
8575,0,0,1,0,56,1,141,0,0,4930092,6123897,46.37887450122092,2001,4593,4443,2151,54635,697515,634881,2697,4998,2997,5139,7440,47.8748368143433,12.282138241571156,2301,1,479673,23400,2292,0,696,555
8576,0,0,0,0,52,1,326,0,0,5652120,5838600,47.11687595755899,2220,4766,4766,2220,47880,552300,599640,2630,4850,2630,5176,7396,50.457903246171455,0.0,2220,0,506160,0,2546,0,410,84
8577,0,0,0,0,52,1,1093,1,0,4952310,4537000,41.773197148410844,1685,4643,4583,1745,36064,509600,478400,2540,4345,2660,5438,7243,53.27288240746881,7.746504550744806,1805,1,321080,8700,2838,0,855,238
8578,0,0,0,0,56,1,1145,1,0,1738650,5708400,44.83302354291979,1800,3085,2875,2010,56394,664560,684440,2630,4850,3050,3705,5925,29.410882339705484,15.102354979206075,2220,1,484410,24780,865,0,830,1975
8579,0,0,0,0,56,1,1254,1,0,1689120,5860170,45.4972526643093,1920,3036,2886,2070,56628,662454,685102,2681,4901,2981,3647,5867,28.5657137141714,13.038404810405298,2220,1,500940,17250,816,0,761,2015
8580,0,0,1,0,61,1,2466,0,0,1773936,9305544,55.20869496736904,2490,4188,3630,3048,47436,720508,613653,2495,6101,3611,3635,7241,24.124676163629637,23.761067855027207,3606,1,612648,97650,582,0,5,2471
8581,0,0,1,0,61,1,977,0,0,2825618,6840145,47.31807265728392,1984,3756,3501,2239,44793,724035,577395,2800,5294,3310,4317,6811,35.52463933666322,15.982515305448514,2494,0,423171,48195,1262,1,816,1793
8582,0,0,1,0,66,1,600,0,0,1833769,3619710,32.96968304366907,907,2954,2774,1087,53037,829170,709290,3150,4417,3510,5017,6284,41.0731055558257,13.45362404707371,1267,0,231531,30780,1687,0,2243,1643
8583,0,0,1,0,67,1,1083,0,0,2058400,3328160,31.496031496047245,737,3322,3067,992,51360,805200,717970,3100,4347,3610,5430,6677,45.552167895721496,15.984413273753786,1247,1,212288,41820,2075,0,2363,1280
8584,0,0,1,0,67,1,1115,0,0,2083950,3322440,31.464265445104548,713,3372,3095,990,50668,802084,711472,3079,4346,3633,5461,6728,45.880278987817846,16.65896666554177,1267,1,209880,45705,2105,0,2366,1251
8585,0,0,1,0,67,1,1839,0,0,2107762,8837300,51.36146415358503,2104,3971,3437,2638,55527,834150,747050,2816,5988,3884,4149,7321,28.26658805020514,23.879374304742452,3172,1,588274,82770,799,0,712,2551
8586,0,0,1,0,56,1,36,0,0,4747717,6098342,46.486557196677836,1981,4538,4358,2161,55671,680102,651882,2642,4983,3002,5019,7360,46.87216658103186,13.466234094236986,2341,1,499191,25380,2197,0,661,625
8587,0,0,0,0,56,1,194,0,0,3836112,5785038,45.36518488885502,1479,4501,3922,2058,55189,677451,643719,2232,4869,3390,4675,7312,43.174066289845804,24.08966552396098,2637,0,471282,83955,1864,0,753,947
8588,0,0,0,0,56,1,192,0,0,3824548,5771740,45.32107677449864,1465,4505,3916,2054,54225,677210,632250,2221,4864,3399,4672,7315,43.15089802078283,24.307863678508618,2643,0,462150,88939,1862,0,756,948
8589,0,0,0,0,56,1,190,0,0,3816911,5761259,45.28796749689701,1453,4510,3912,2051,53482,679778,620789,2211,4860,3407,4670,7319,43.139309220245984,24.48706891677046,2649,0,453271,93886,1861,0,758,948
8590,0,0,0,0,57,1,171,1,0,3812760,5873160,45.16635916254486,1369,4580,3909,2040,33288,656412,420334,2208,4919,3550,4748,7459,43.23193264243457,26.347830689297258,2711,1,297840,146278,1869,0,839,1010
8591,0,0,0,0,56,1,74,1,0,4655595,6218435,46.850827100489916,1834,4677,4316,2195,56635,682753,665755,2472,5028,3194,4954,7510,46.05431575867782,19.943826281327176,2556,1,515825,45486,2121,0,638,712
8592,0,0,0,0,54,1,36,1,0,5447232,6409200,48.49742261192856,2124,4896,4668,2352,51750,564075,681250,2497,5077,2953,5041,7621,48.12483766206386,15.67997926561349,2580,1,588000,16872,2316,0,373,409
8593,0,0,0,0,53,1,25,1,0,5767046,6467106,49.13247398615299,2287,4930,4803,2414,49750,533121,669750,2552,5093,2806,5068,7609,48.877397639399746,11.622136368289254,2541,1,603500,8001,2389,0,265,290
8594,0,0,0,0,52,1,1215,1,0,4610536,4258128,40.29888335921977,1497,4590,4463,1624,31395,511290,422142,2495,4246,2749,5461,7212,53.28226721902888,11.423450032283785,1751,1,261464,21209,2839,0,998,217
8595,0,1,0,1,65,0,783,0,0,1005580,4800360,38.31448812133603,1383,2238,2153,1468,43095,722670,637650,3185,4738,3355,3955,5508,26.1725046566048,9.290499583346438,1553,1,286260,13940,685,0,1802,2585
8596,0,0,0,0,56,1,1128,1,0,1772820,5694330,44.83302354291979,1820,3082,2892,2010,56144,657256,685586,2643,4843,3023,3715,5915,29.698484809834994,14.413196119988699,2200,1,486420,22040,882,0,823,1951
8597,0,0,1,0,66,1,533,0,0,1870820,3745021,33.57082066318904,977,2937,2787,1127,52117,820781,701153,3173,4450,3473,4983,6260,40.74309757492672,12.26699777646566,1277,0,237797,25950,1660,0,2196,1663
8598,0,0,1,0,66,1,667,0,0,2995184,4718558,37.8021163428716,1005,3949,3525,1429,55615,749554,808990,2878,4731,3726,5398,7251,45.78209256903839,20.78115631127834,1853,1,350105,44944,2096,0,1873,1206
8599,0,0,1,0,65,1,2881,0,0,1702152,11153664,58.172158288995945,3061,4210,3887,3384,49266,682272,784448,2973,6680,3619,3799,7506,22.427661492005804,18.396271700261583,3707,1,805392,30039,503,0,88,2793
8600,0,0,1,0,63,1,565,0,0,3647024,7070535,47.042533945356304,2128,3946,3861,2213,51736,712485,741240,3110,5408,3280,4843,7141,40.59556626036888,9.227509513928014,2298,0,513416,10370,1648,1,982,1547
8601,0,0,1,0,56,1,114,0,0,4757875,5998875,46.09772228646444,1972,4517,4364,2125,55209,652113,674697,2670,4948,2976,5062,7340,47.31807265728392,12.37776262367691,2278,1,507875,18360,2239,0,698,584
8602,0,0,0,0,57,1,138,1,0,3967288,5930312,45.40925015897091,1619,4429,3986,2062,54750,629844,719000,2433,4938,3319,4800,7305,43.86342439892262,21.295429420382774,2505,1,515500,36326,1924,0,814,952
8603,0,0,0,0,56,1,142,1,0,3915359,5837146,45.28796749689701,1567,4444,3960,2051,51562,577738,722884,2362,4897,3330,4755,7290,43.69210454990696,22.107770502956416,2535,1,520954,27588,1909,0,795,937
8604,0,0,0,0,56,1,132,0,0,3829408,5683392,44.98888751680797,1464,4476,3916,2024,53261,676728,620568,2248,4832,3368,4700,7284,43.497126341863094,23.699123751092888,2584,0,447304,87360,1892,0,784,916
8605,0,0,0,0,57,1,111,1,0,3816990,5796840,44.83302354291979,1369,4550,3909,2010,32915,654668,418180,2243,4894,3525,4783,7434,43.57751713900185,25.818807698945292,2651,1,291450,140379,1899,0,874,985
8606,0,0,0,0,52,1,1057,1,0,4785438,4518528,41.49698784249286,1602,4621,4501,1722,35712,503808,488064,2504,4346,2744,5403,7245,52.716221412388805,11.009004714545675,1842,1,320292,16560,2779,0,902,155
8607,0,0,0,0,52,1,1235,1,0,4465296,4177008,39.7994974842648,1414,4573,4403,1584,35820,524763,474660,2467,4221,2807,5456,7210,53.094255809833136,13.261035176436632,1754,1,285120,26180,2819,0,1053,182
8608,0,0,0,0,52,1,1307,1,0,4340610,4034610,39.11521443121589,1320,4577,4367,1530,42021,545859,535311,2427,4167,2847,5474,7214,53.2634959423431,14.684716722173809,1740,1,310590,28980,2837,0,1107,200
8609,0,0,1,0,67,1,1415,0,0,2602326,3543548,32.46536616149585,584,3993,3523,1054,51744,776622,753088,2892,4416,3832,5831,7355,49.68903299521938,21.718633856733028,1524,1,236096,66740,2469,0,2308,893
8610,0,0,1,0,65,1,1300,0,0,4945989,5447756,40.82891132518721,817,5484,4634,1667,41904,633992,705888,2418,4935,4118,6235,8752,54.47017532558529,29.403401226751043,2517,1,360072,90100,2967,0,1601,301
8611,0,0,1,0,61,1,1866,0,0,5925960,5159268,40.91454509095757,1279,5609,5214,1674,45938,634892,687286,2687,4756,3477,6622,8691,59.49789912257407,20.1736320288082,2069,1,373302,45030,3540,0,1408,458
8612,0,0,0,0,56,1,72,0,0,3832468,5595164,44.654227123532216,1462,4448,3916,1994,52974,681858,611708,2274,4800,3338,4728,7254,43.840620433565945,23.099297570560395,2526,0,434692,85652,1922,0,812,884
8613,0,0,0,0,56,1,59,1,0,3807482,5639907,44.50842616853577,1374,4510,3903,1981,33726,657657,415662,2240,4828,3454,4769,7357,43.840620433565945,24.771675064914348,2588,1,289226,134147,1922,0,866,925
8614,0,0,0,0,57,1,56,1,0,3809520,5662800,44.49719092257398,1362,4522,3904,1980,31692,652080,397540,2242,4840,3478,4784,7382,43.86342439892262,25.040461665189454,2598,1,275220,138432,1924,0,880,936
8615,0,0,0,0,58,1,49,1,0,3823380,5742000,44.49719092257398,1373,4518,3911,1980,38445,675700,478500,2293,4880,3507,4831,7418,43.94314508543966,25.274253989504945,2587,1,326700,125649,1931,0,920,969
8616,0,0,0,0,56,1,3,1,0,4155480,5713785,45.13313638558703,1579,4535,4077,2037,55161,681615,636735,2347,4842,3263,4845,7340,45.16635916254486,21.857850601570536,2495,1,462399,61830,2040,0,768,765
8617,0,0,0,0,56,1,30,1,0,4545199,5946653,46.010868281309364,1804,4577,4264,2117,53105,693823,603935,2496,4926,3122,4956,7386,46.33573135281238,18.55044919689019,2430,1,455155,46950,2147,0,692,662
8618,0,0,0,0,56,1,986,1,0,1885632,5524160,44.181444068749045,1802,3068,2918,1952,56628,662220,684860,2680,4782,2980,3796,5898,31.080540535840107,13.07479579843849,2102,1,472384,16800,966,0,878,1864
8619,0,0,0,0,56,1,1094,1,0,1847016,5679876,44.85532298401161,1878,3064,2930,2012,56640,666228,677520,2689,4835,2957,3741,5887,30.298514815086232,12.372354058352016,2146,1,482880,15410,918,0,811,1905
8620,0,0,0,0,55,1,1252,1,0,1786700,5883498,45.8475735453906,1982,3072,2952,2102,54500,610182,699750,2679,4901,2919,3649,5871,29.154759474226502,11.368551155324415,2222,1,525500,10200,850,0,697,1949
8621,0,0,1,0,63,1,1261,0,0,251300,4559300,37.89459064299283,1226,1821,1611,1436,48600,771525,635000,2965,4611,3385,3350,4996,13.228756555322953,14.492690977985127,1646,0,287200,38220,175,1,1739,3000
8622,0,0,1,0,64,1,800,0,0,533889,3952998,35.11409973215888,1191,1708,1666,1233,51088,795088,660436,3164,4439,3248,3639,4914,20.808652046684813,6.503581472166948,1275,0,253998,7518,433,0,1973,2773
8623,0,0,1,0,66,1,223,0,0,1885074,4179066,35.58089374931439,1176,2845,2755,1266,51273,802143,696511,3211,4567,3391,4790,6146,38.58756276314948,9.497356383238309,1356,0,267126,15300,1489,0,2035,1812
8624,0,0,0,1,66,1,401,0,0,1940856,3999998,34.741905532080416,1117,2905,2815,1207,50922,815244,685998,3224,4521,3404,4922,6219,40.099875311526844,9.489467114586667,1297,1,249849,15840,1608,0,2107,1706
8625,0,0,0,1,66,1,527,0,0,1985490,3887910,34.20526275297414,1080,2957,2867,1170,50264,810812,684538,3233,4493,3413,5020,6280,41.19465984809196,9.52871847115494,1260,1,241020,15840,1697,0,2153,1626
8626,0,0,1,0,67,1,1034,0,0,2283120,3625560,32.863353450309965,852,3422,3194,1080,51333,809037,715041,3129,4437,3585,5471,6779,45.9782557302906,15.123141956304947,1308,1,230040,37848,2114,0,2277,1243
8627,0,0,1,0,67,1,1360,0,0,2642244,3640930,32.89376840679705,597,4009,3524,1082,52210,773950,763855,2880,4447,3850,5807,7374,49.416596402423345,22.065866271156136,1567,1,245614,66445,2442,0,2283,923
8628,0,0,1,0,67,1,1383,0,0,2968420,3912070,34.132096331752024,534,4344,3713,1165,51959,782414,748834,2727,4523,3989,5906,7702,50.47771785649585,25.29182636210144,1796,1,259795,92126,2548,0,2193,810
8629,0,0,1,0,61,1,1348,0,0,3553728,8260812,51.73006862551025,2616,4064,4004,2676,39342,768663,487746,3027,5763,3147,4415,7151,36.4417343165772,7.759379671981613,2736,1,422808,13260,1328,0,411,1759
8630,0,0,1,0,66,1,1228,0,0,4622700,5365576,40.27406113120453,646,5448,4472,1622,46434,721144,704604,2332,4930,4284,6158,8756,53.38539126015655,31.538959822918248,2598,1,345486,137616,2850,0,1686,458
8631,0,1,0,1,65,0,676,0,0,930240,4471680,36.87817782917155,1198,2206,2044,1360,45492,733224,670752,3126,4648,3450,3972,5494,26.153393661244042,12.850301615905524,1522,1,277440,25272,684,0,1928,2604
8632,0,0,0,0,56,1,916,1,0,1939392,5439148,43.86342439892262,1804,3052,2932,1924,55692,661518,672826,2707,4751,2947,3835,5879,31.74901573277509,11.986232110808638,2044,1,457912,13200,1008,0,903,1819
8633,0,0,1,0,62,1,1008,0,0,1722820,5947740,43.70354676682432,1682,3040,2812,1910,43680,697536,607230,2886,5024,3342,4016,6154,30.033314835362415,15.123141956304947,2138,0,372450,38304,902,1,1204,2212
8634,0,0,1,0,62,1,1025,0,0,1572014,5821306,43.2087954009366,1582,2994,2709,1867,42624,692196,598656,2833,4985,3403,3960,6112,29.017236257093817,16.892118057288688,2152,0,358464,47880,842,1,1251,2276
8635,0,0,1,0,63,1,1214,0,0,518915,4910330,39.35733730830886,1281,2152,1884,1549,51012,741780,691060,2902,4719,3438,3505,5322,18.303005217723125,16.3871485565935,1817,0,337682,41004,335,1,1621,2835
8636,0,0,1,0,63,1,1056,0,0,361216,4232336,36.4417343165772,1220,1708,1600,1328,48070,733010,666083,3079,4515,3295,3459,4895,16.492422502470642,10.392304845413264,1436,0,277552,17172,272,1,1859,2915
8637,0,0,1,0,65,1,168,0,0,1719540,4584042,37.389838191679836,1278,2748,2628,1398,52216,800076,701706,3159,4677,3399,4509,6027,35.07135583350036,11.111005581829925,1518,0,299172,20040,1230,0,1881,2049
8638,0,0,1,0,64,1,710,0,0,3938231,5396589,40.755367744629666,1092,4601,4032,1661,54189,789507,724527,2680,4910,3818,5620,7850,48.692915295759406,24.20190117816004,2230,1,370403,88195,2371,0,1588,878
8639,0,0,1,0,62,1,1987,0,0,5605014,4931342,39.67366884975475,1050,5659,5135,1574,40788,620334,645398,2609,4707,3657,6694,8792,59.67411499134277,23.171170816408853,2098,1,324244,65500,3561,0,1559,428
8640,0,0,0,0,55,1,142,0,1,4587408,5753944,45.51922670696417,1825,4533,4286,2072,52756,672034,605386,2530,4849,3024,4991,7310,47.05316142407437,16.455853837162117,2319,1,451696,33592,2214,0,705,563
8641,0,0,0,0,54,1,162,0,1,5278840,6037396,47.095647357266465,2017,4799,4598,2218,55029,601562,677778,2521,4940,2923,5102,7521,48.78524367060187,14.64707172595852,2419,1,552282,17286,2380,0,504,342
8642,0,0,0,0,52,1,285,0,0,5906484,6048588,47.8748368143433,2250,4911,4869,2292,39790,606970,456547,2597,4931,2681,5216,7550,50.76416058598822,6.5252844928085345,2334,0,396516,8274,2577,0,347,62
8643,0,0,1,0,52,1,469,0,0,5616552,5644463,46.33573135281238,2023,4887,4763,2147,49266,544203,625702,2505,4776,2753,5245,7516,51.146847410177685,11.193732213226145,2271,1,510986,11780,2616,0,482,13
8644,0,0,1,0,60,1,2280,0,0,1954816,8864384,54.258639865002145,2474,4078,3608,2944,48323,761783,575101,2541,5955,3481,3675,7089,25.768197453450252,22.158129164842478,3414,1,562304,92590,664,0,67,2347
8645,0,0,0,1,66,1,481,0,0,2092782,4073998,35.014282800023196,1196,2963,2933,1226,49288,810812,671246,3293,4549,3353,5030,6286,41.31585652022719,5.514871952411144,1256,1,247652,5430,1707,0,2097,1616
8646,0,0,1,0,64,1,550,0,0,3734679,7186529,47.19110085598767,1950,4181,3904,2227,52212,735756,738983,2950,5454,3504,4904,7408,40.95119045888654,16.695186711087423,2504,0,509983,36564,1677,1,1000,1550
8647,0,0,1,0,64,1,725,0,0,3882606,5328327,40.50925820105819,1109,4539,4007,1641,54450,785774,730575,2715,4888,3779,5613,7786,48.641546028061235,23.438363781284306,2173,1,369225,80332,2366,0,1606,881
8648,0,0,0,0,56,1,508,0,0,4859445,5543265,44.328320518603,1965,4438,4438,1965,54240,677040,637546,2821,4786,2821,5294,7259,49.72926703662542,0.0,1965,0,444090,0,2473,0,856,348
8649,0,0,0,0,56,1,486,0,0,4833895,5552580,44.37341546466758,1939,4454,4424,1969,54432,685260,631680,2790,4789,2850,5275,7274,49.54795656734998,5.477225575051661,1999,0,441056,4620,2455,0,851,365
8650,0,0,0,0,56,1,465,0,0,4810174,5563860,44.41846462902562,1943,4441,4411,1973,54635,690900,628860,2790,4793,2850,5258,7261,49.37610758251404,5.490867587491313,2003,0,439979,4650,2438,0,847,382
8651,0,0,1,0,56,1,333,0,0,4700728,5636456,44.81071300481616,1966,4391,4349,2008,56386,679294,654031,2765,4815,2849,5148,7198,48.38388161361178,6.503581472166948,2050,1,467864,5796,2341,0,799,466
8652,0,0,0,0,55,1,270,0,0,4591384,5627564,44.85532298401161,1982,4324,4294,2012,53280,671280,620934,2767,4809,2827,5079,7121,47.77028364998475,5.477225575051661,2042,0,446664,4620,2282,0,785,515
8653,0,0,0,0,55,1,105,0,0,3844726,5337564,43.69210454990696,1472,4360,3923,1909,53037,696204,595548,2359,4705,3233,4810,7156,44.87761134463375,20.9460455256823,2346,0,406617,75164,2014,0,887,782
8654,0,0,0,0,56,1,114,0,0,3810960,5348616,43.54308211415448,1412,4390,3906,1896,35802,623441,457002,2337,4717,3305,4831,7211,44.83302354291979,22.095544081096477,2380,0,307152,95348,2010,0,925,811
8655,0,0,1,0,52,1,607,0,0,5186394,5248208,44.654227123532216,1874,4715,4595,1994,37948,557984,471128,2512,4626,2752,5233,7347,51.0,11.037374824906587,2114,1,356926,20400,2601,0,638,31
8656,0,0,0,0,53,1,740,1,0,4921101,4988745,43.347433603386484,1729,4648,4498,1879,28908,525690,387630,2505,4534,2805,5274,7303,51.176166327695945,12.502807054311965,2029,1,274334,27900,2619,0,776,36
8657,0,0,0,0,53,1,1093,1,0,4283078,4270326,39.92492955535426,1347,4528,4281,1594,36051,527763,490257,2432,4273,2926,5366,7207,51.836280730777744,16.039950221539115,1841,1,291702,36556,2687,0,1085,8
8658,0,0,0,0,56,1,450,1,0,2095600,4757350,41.10960958218893,1462,3158,2930,1690,55278,700935,624930,2587,4505,3043,4055,5973,35.21363372331802,15.285101559010016,1918,1,375180,35112,1240,0,1125,1575
8659,0,0,0,0,55,1,989,1,0,1986012,5514712,44.58699361921591,1928,3047,2987,1988,50175,618602,624150,2714,4762,2834,3773,5821,31.606961258558215,8.086478275311649,2048,1,447300,5700,999,0,786,1775
8660,0,0,0,0,55,1,1295,1,0,1889624,5974419,46.551047249229526,2137,3069,3039,2167,56386,642381,667194,2727,4924,2787,3629,5826,29.5296461204668,5.531194905403055,2197,1,524414,3240,872,0,590,1885
8661,0,0,0,0,56,1,1794,1,0,1752192,7038720,49.95998398718719,2369,3325,3198,2496,45384,699360,516060,2693,5316,2947,3522,6145,26.49528259898354,11.360716291379575,2623,1,456768,25654,702,0,324,2118
8662,0,0,0,0,58,1,2045,1,0,1788666,7847400,52.01922721455981,2406,3667,3367,2706,32743,693100,397300,2600,5606,3200,3561,6567,25.709920264364882,17.60608396191918,3006,1,370722,69900,661,0,194,2239
8663,0,0,1,0,64,1,810,0,0,675031,4237768,36.345563690772494,1321,1832,1832,1321,44690,699344,657640,3208,4529,3208,3719,5040,22.60530911091463,0.0,1321,0,270805,0,511,0,1887,2697
8664,0,0,1,0,64,1,772,0,0,3847005,5230959,40.162171256046406,1089,4522,3998,1613,54412,791292,723189,2719,4856,3767,5628,7765,48.83646178829912,23.251137393426575,2137,1,359699,81744,2385,0,1630,858
8665,0,0,0,0,56,1,541,0,0,4808720,5462163,44.034077712607996,1939,4419,4419,1939,53788,670446,636642,2817,4756,2817,5297,7236,49.79959839195493,0.0,1939,0,438214,0,2480,0,878,337
8666,0,0,0,0,56,1,498,0,0,4764808,5483620,44.13615298142782,1948,4394,4394,1948,54692,681230,636190,2815,4763,2815,5261,7209,49.457052075512955,0.0,1948,0,440248,0,2446,0,867,369
8667,0,0,0,0,56,1,169,0,0,3820752,5256576,43.266615305567875,1442,4343,3913,1872,38479,671112,452088,2378,4680,3238,4849,7151,45.17742799230607,20.798100354606355,2302,0,301392,92880,2041,0,936,767
8668,0,0,0,0,57,1,186,1,0,3805560,5358660,43.12771730569565,1357,4409,3906,1860,49053,717369,567557,2378,4741,3384,4927,7290,45.232731511594565,23.08467955363286,2363,1,366420,95067,2046,0,1021,835
8669,0,0,0,0,53,1,1001,1,0,4335522,4425777,40.50925820105819,1371,4553,4283,1641,34953,493551,515127,2427,4338,2967,5339,7250,51.40038910358559,16.898753070386416,1911,1,313431,32670,2642,0,1056,55
8670,0,0,0,0,56,1,492,1,0,2121013,4833015,41.50903516103452,1533,3144,2954,1723,54808,695640,619905,2615,4528,2995,4036,5949,35.08560958569767,13.941784393794311,1913,1,380783,30400,1231,0,1082,1574
8671,0,0,0,0,56,1,654,1,0,2098296,5075412,42.567593307585526,1704,3078,2970,1812,56069,635827,691847,2693,4613,2909,3959,5879,34.02939905434711,10.948360265819424,1920,1,447564,10368,1158,0,989,1643
8672,0,0,1,0,63,1,1325,0,0,434384,5073669,39.96248240537617,1262,2204,1869,1597,51840,762480,686232,2842,4774,3512,3449,5381,16.492422502470642,18.326445405478097,1932,0,344952,53935,272,1,1580,2905
8673,0,0,1,0,64,1,188,0,0,3314493,5588128,41.58124577258358,1595,3780,3646,1729,54948,736896,778912,3098,4961,3366,5149,7012,43.78355855797927,11.59897583714774,1863,1,416689,15410,1917,0,1503,1315
8674,0,0,1,0,64,1,2741,0,0,2496102,11213418,58.8387627334226,3207,4438,4183,3462,53592,748209,751448,2984,6701,3494,3960,7677,26.851443164195103,16.394926078342415,3717,1,803184,33405,721,0,223,2518
8675,0,0,0,0,56,1,509,0,0,4707270,5423300,43.93176527297759,1900,4399,4369,1930,53580,640680,660350,2780,4740,2840,5249,7209,49.38623289946298,5.490867587491313,1960,0,453550,3720,2439,0,880,371
8676,0,0,1,0,56,1,282,0,0,4227840,5393280,43.81780460041329,1745,4297,4122,1920,52070,713486,575845,2634,4729,2984,5011,7106,46.92547282660026,13.331335488514162,2095,1,393600,31150,2202,0,889,607
8677,0,0,0,0,55,1,223,0,0,3835050,5155950,43.01162633521314,1471,4302,3923,1850,50451,699537,560187,2408,4637,3166,4860,7089,45.53020975132884,19.490786894731354,2229,0,371850,70494,2073,0,937,714
8678,0,0,0,0,53,1,284,0,1,5648997,5935589,47.31807265728392,2209,4792,4762,2239,54780,583220,660099,2621,4890,2681,5174,7443,50.22947341949744,5.5965095842615735,2269,1,557511,2760,2523,0,412,128
8679,0,0,0,0,52,1,247,0,0,5732754,6003360,47.686476070265456,2274,4795,4795,2274,44051,572880,535920,2640,4914,2640,5161,7435,50.20956084253277,0.0,2274,0,461622,0,2521,0,366,119
8680,0,0,1,0,53,1,563,0,0,5030618,5254245,44.48595283907045,1799,4701,4521,1979,28650,507105,398250,2475,4634,2835,5197,7356,50.41825066382212,13.612485340686598,2159,1,296850,31140,2542,0,676,113
8681,0,0,0,0,53,1,697,1,0,4769280,5002155,43.162483709814474,1662,4624,4423,1863,23711,485985,351735,2484,4548,2886,5245,7309,50.59644256269407,14.635203064087827,2064,1,244053,35979,2560,0,822,125
8682,0,0,1,0,61,1,1544,0,0,3109641,8260911,51.93264869039514,2127,4420,3850,2697,42550,704490,566655,2493,5760,3633,4216,7483,33.95585369269929,23.954296699511993,3267,1,498945,105450,1153,0,366,1910
8683,0,0,1,0,67,1,1201,0,0,2990130,4145100,35.07135583350036,749,4142,3661,1230,51750,775100,758250,2889,4600,3851,5801,7512,49.3051721424842,21.986111007752946,1711,1,276750,66859,2431,0,2140,939
8684,0,0,1,0,64,1,1375,0,0,2845206,8094034,50.08991914547278,2308,3844,3643,2509,53500,806500,690364,3025,5735,3427,4360,7070,33.67491648096547,14.659070335440353,2710,1,536926,31959,1134,0,717,2092
8685,0,0,1,0,63,1,2342,0,0,2774055,10233537,56.630380539071076,2997,4282,4072,3207,45968,663728,705211,2981,6398,3401,4056,7473,29.410882339705484,14.60255500160762,3417,1,708747,24990,865,0,16,2326
8686,0,0,1,0,66,1,1384,0,0,4195380,4887750,38.34057902536163,429,5365,4324,1470,36408,738150,545300,2284,4795,4366,6179,8690,53.422841556772326,32.60322631999969,2511,1,241080,205077,2854,0,1855,471
8687,0,0,1,0,63,1,2035,0,0,5004000,4602240,37.94733192202055,867,5488,4915,1440,51528,722296,728688,2623,4636,3769,6671,8684,58.94913061275798,24.17490877611208,2013,1,328320,75636,3475,0,1756,279
8688,0,0,0,0,55,1,421,0,0,4469190,5349630,43.749285708454714,1914,4249,4249,1914,53312,665210,626080,2795,4709,2795,5130,7044,48.321837713398274,0.0,1914,0,428736,0,2335,0,881,460
8689,0,0,0,0,55,1,413,0,0,4432698,5333746,43.69210454990696,1879,4261,4231,1909,54692,676148,631444,2764,4703,2824,5116,7055,48.187135212627034,5.483301264452448,1939,0,431434,4470,2322,0,885,472
8690,0,0,0,0,56,1,277,1,0,4099688,5360985,43.485629810317796,1709,4241,4059,1891,53676,714420,603855,2653,4726,3017,5003,7076,46.561786907291264,13.810035044505925,2073,1,402783,30030,2168,0,944,667
8691,0,0,0,0,57,1,301,1,0,3785702,5188681,42.43819034784589,1358,4346,3903,1801,49551,717369,573319,2438,4682,3324,4983,7227,45.8475735453906,21.56854437870202,2244,1,358399,83284,2102,0,1080,779
8692,0,0,0,0,53,1,225,1,0,5639850,6036225,47.59201613716318,2180,4840,4755,2265,37714,580970,461045,2580,4930,2750,5155,7505,49.8998997994986,9.548881526149486,2350,1,391845,15640,2490,0,400,175
8693,0,0,0,0,53,1,255,1,0,5569876,5967884,47.286361670147556,2128,4835,4727,2236,46224,571166,576504,2561,4905,2777,5160,7504,49.90991885387112,10.715687343984417,2344,1,482976,14364,2491,0,433,178
8694,0,0,0,0,54,1,745,1,0,4567974,4882449,42.391036788453285,1541,4595,4339,1797,27972,513513,402116,2461,4514,2973,5259,7312,50.41825066382212,16.64564827386149,2053,1,265956,44288,2542,0,920,175
8695,0,1,0,1,66,0,460,0,0,826944,3883600,34.17601498127012,826,2218,1876,1168,36720,678300,598500,2983,4493,3667,4033,5543,26.60826939130014,18.643348745755766,1510,1,210240,54378,708,0,2157,2617
8696,0,1,1,0,64,0,0,0,0,933156,3091200,31.080540535840107,571,2327,1932,966,35621,572800,636800,2805,4166,3595,4166,5527,31.080540535840107,20.347138339415288,1361,0,192234,41870,966,1,2234,2234
8697,0,0,1,0,63,1,1450,0,0,200279,5033784,39.71145930332956,1226,2055,1704,1577,46200,737352,638400,2841,4769,3543,3319,5247,11.269427669584644,18.748703124714623,1928,0,315400,60021,127,1,1615,3065
8698,0,0,1,0,67,1,1147,0,0,3032820,4251240,35.4964786985977,772,4155,3667,1260,51736,782768,752402,2886,4634,3862,5781,7529,49.06118628814432,22.11907577222737,1748,1,280980,70760,2407,0,2114,967
8699,0,0,1,0,65,1,2601,0,0,2395162,10843008,57.63679380395825,2771,4594,4043,3322,53130,825792,685440,2713,6586,3815,3985,7858,26.851443164195103,24.013100525397743,3873,1,697620,95874,721,0,58,2543
8700,0,0,1,0,56,1,684,0,0,4705452,5228280,43.05810028322197,1764,4482,4392,1854,46655,611940,606300,2730,4674,2910,5358,7302,50.37856687124,9.48712577043745,1944,1,398610,12330,2538,0,966,282
8701,0,0,0,0,55,1,478,0,0,4450008,5265780,43.40506882842141,1884,4246,4246,1884,52899,645645,640055,2795,4679,2795,5157,7041,48.60041152089147,0.0,1884,0,431436,0,2362,0,911,433
8702,0,0,0,0,57,1,363,0,1,3775410,5078130,42.07136793592526,1340,4333,3903,1770,55902,694298,662739,2439,4639,3299,5002,7202,46.184412955021955,21.452575466988375,2200,1,408870,56330,2133,0,1099,736
8703,0,0,0,0,53,1,231,1,0,5488030,5965250,47.22287581247038,2103,4818,4691,2230,44690,548375,583150,2548,4905,2802,5136,7493,49.60846701924985,11.579381003458169,2357,1,486140,14986,2461,0,445,214
8704,0,0,0,0,54,1,618,1,0,4687488,5083746,43.3358973600409,1631,4621,4374,1878,26740,517037,378980,2460,4585,2954,5203,7328,49.95998398718719,16.278820596099706,2125,1,262920,45201,2496,0,829,211
8705,0,1,0,1,66,0,425,0,0,1037484,4158707,35.397740040855716,998,2336,2081,1253,36695,680395,594101,3064,4572,3574,4147,5655,28.77498913987632,16.020103680006212,1508,1,224287,41310,828,0,2066,2491
8706,0,0,1,0,67,1,1180,0,0,3190061,4348088,35.93048844644336,841,4212,3762,1291,52670,774640,771272,2918,4659,3818,5839,7580,49.70915408654627,21.268403820637722,1741,1,295639,60750,2471,0,2077,897
8707,0,0,1,0,63,1,807,0,0,3239368,7121664,47.41307836451879,2218,3719,3689,2248,54531,788832,693792,3138,5416,3198,4609,6887,37.960505792204614,5.652706486041966,2278,0,492312,4560,1441,1,920,1727
8708,0,0,1,0,64,1,1705,0,0,2775756,8746764,52.191953402799555,2468,3999,3743,2724,49647,793117,645411,2955,5935,3467,4230,7210,31.921779399024736,16.377083801087522,2980,1,547524,40960,1019,0,487,2192
8709,0,0,1,0,58,1,1207,0,0,5645640,5414640,42.988370520409354,1411,5340,4903,1848,40385,577210,600650,2493,4778,3367,5985,8270,55.27205442174191,20.969944174732834,2285,1,378840,54188,3055,0,1082,125
8710,0,0,1,0,56,1,738,0,0,4677475,5155625,42.720018726587654,1705,4508,4388,1825,46656,610200,610200,2705,4650,2945,5388,7333,50.62608023538856,10.96129127279285,1945,1,394200,16080,2563,0,1000,262
8711,0,0,0,0,55,1,402,0,0,3809043,4893819,41.96427051671457,1466,4219,3924,1761,45816,691971,511336,2484,4540,3074,4942,6998,46.50806381693394,17.206319387415466,2056,0,324024,59590,2163,0,1018,616
8712,0,0,0,0,56,1,416,1,0,3767040,4958192,41.7612260356422,1382,4266,3904,1744,47244,722122,528798,2481,4587,3205,5003,7109,46.475800154489,19.40729417274103,2106,1,324384,71676,2160,0,1099,683
8713,0,0,0,0,57,1,419,1,0,3764462,4966442,41.737273509418415,1366,4279,3903,1742,49022,724154,550243,2475,4593,3227,5012,7130,46.486557196677836,19.80723086975197,2118,1,336206,70312,2161,0,1109,690
8714,0,0,0,0,53,1,365,0,0,5085600,5522400,45.60701700396552,2050,4555,4525,2080,56406,631890,629235,2625,4735,2685,5100,7210,49.44694126030446,5.490867587491313,2110,0,492960,3900,2445,0,575,210
8715,0,0,0,0,53,1,345,0,0,5120874,5559147,45.79301256742124,2067,4569,4539,2097,54988,625636,617683,2621,4748,2681,5093,7220,49.416596402423345,5.490867587491313,2127,0,488601,4050,2442,0,554,209
8716,0,0,1,0,53,1,331,0,0,5132322,5618808,45.89117562233506,1864,4785,4543,2106,38874,557612,496248,2426,4774,2910,5105,7453,49.36598018878993,15.637067915878873,2348,1,391716,38478,2437,0,562,231
8717,0,1,1,0,64,0,91,0,0,914736,2943024,30.199337741083,458,2369,1915,912,37080,580860,664762,2773,4139,3681,4230,5596,31.670175244226233,21.873561998152525,1366,0,187872,45400,1003,1,2315,2224
8718,0,0,1,0,57,1,1133,0,0,5180448,5148426,42.17819341792628,1377,5093,4691,1779,50055,616422,680090,2492,4673,3296,5806,7987,53.96295025292817,20.121022086069488,2181,1,418065,43014,2912,0,1115,18
8719,0,0,0,0,56,1,468,1,0,3775093,4833015,41.50903516103452,1423,4214,3914,1723,35478,681615,409530,2505,4528,3105,4996,7019,46.8081189538738,17.480138223797354,2023,1,251558,68700,2191,0,1082,614
8720,0,0,0,0,56,1,481,0,1,3750512,4864373,41.36423575989287,1345,4269,3903,1711,53037,707907,605559,2477,4554,3209,5035,7112,46.8187996428785,19.594455952100883,2077,1,364443,57462,2192,0,1132,651
8721,0,0,0,0,53,1,524,1,0,4413045,4986240,43.069710934716056,1747,4342,4234,1855,56168,639744,634368,2580,4543,2796,5067,7030,48.774993593028796,10.471798365004291,1963,1,437780,14148,2379,0,833,309
8722,0,0,0,0,53,1,301,1,0,5069142,5589324,45.89117562233506,2076,4543,4513,2106,40205,570610,496298,2624,4760,2684,5061,7197,49.06118628814432,5.531194905403055,2136,1,393822,5010,2407,0,548,247
8723,0,0,0,0,53,1,224,1,0,5231556,5832684,46.66904755831214,1986,4772,4580,2178,39022,479362,583804,2486,4856,2870,5080,7450,49.01020301937138,14.042896465990824,2370,1,474804,15936,2402,0,500,276
8724,0,0,1,0,61,1,1607,0,0,3000578,8342475,52.08646657242167,2095,4437,3819,2713,47232,756450,590400,2457,5788,3693,4181,7512,33.25657829663178,24.859866147029937,3331,1,520896,119274,1106,0,362,1969
8725,0,0,1,0,63,1,1461,0,0,313690,5268341,40.63249930782009,1221,2271,1841,1651,53816,791368,692447,2761,4842,3621,3381,5462,13.784048752090222,20.7455194991212,2081,0,358267,70950,190,1,1540,3001
8726,0,0,1,0,67,1,1104,0,0,3312900,4552200,36.742346141747674,869,4285,3804,1350,52440,768816,775560,2891,4722,3853,5826,7657,49.53786430600334,21.99072008797959,1831,1,310500,63492,2454,0,2022,918
8727,0,0,0,1,67,1,1194,0,0,3426616,4533324,36.71511950137164,957,4281,3890,1348,52658,783579,760038,2972,4711,3754,5905,7644,50.41825066382212,19.82785262243367,1739,1,304648,55913,2542,0,2015,821
8728,0,0,1,0,63,1,2100,0,0,3095901,9873414,55.66866263886712,2768,4429,4098,3099,52152,675432,783756,2855,6285,3517,4185,7615,31.606961258558215,18.23576788271874,3430,1,762354,29459,999,0,87,2187
8729,0,0,1,0,60,1,1256,0,0,3589632,7958592,51.22499389946279,2594,4022,3992,2624,54000,727920,682425,3003,5657,3063,4401,7055,36.98648401781386,5.477225575051661,2654,0,590400,4500,1368,1,409,1665
8730,0,0,1,0,63,1,77,0,0,3830324,6359256,44.67661580737735,1634,4277,3915,1996,56386,771012,742338,2824,5182,3548,5105,7463,43.80639222761902,19.027604167166874,2358,1,465068,49594,1919,0,1190,1267
8731,0,0,0,0,56,1,530,1,0,3751800,4753970,41.10960958218893,1405,4195,3910,1690,44250,703250,497901,2528,4503,3098,5033,7008,47.11687595755899,17.15955522065883,1975,1,299130,59565,2220,0,1123,593
8732,0,0,0,0,56,1,539,0,1,3735722,4755014,41.012193308819754,1358,4227,3903,1682,54216,709577,610632,2503,4509,3151,5048,7054,47.12748667179272,18.414155186713394,2006,1,363312,52812,2221,0,1145,606
8733,0,0,0,0,53,1,335,1,0,4875954,5426597,45.24378410345447,2017,4459,4429,2047,46566,620334,527549,2621,4698,2681,5033,7110,48.80573736764972,5.477225575051661,2077,1,407353,5250,2382,0,604,269
8734,0,0,0,0,53,1,384,1,0,4772385,5400699,44.73253849269008,1671,4716,4386,2001,34776,558693,453432,2369,4700,3029,5084,7415,48.83646178829912,18.480580167238273,2331,1,336168,58080,2385,0,698,314
8735,0,0,0,0,54,1,582,1,0,4413960,5025180,42.77849927241488,1488,4584,4242,1830,37687,612358,464074,2404,4576,3088,5158,7330,49.1121166312347,19.174998510682574,2172,1,309270,66006,2412,0,916,334
8736,0,1,1,0,65,0,116,0,0,697205,2541098,27.910571473905726,202,2251,1674,779,46010,698068,701330,2685,4041,3839,4157,5513,29.916550603303182,24.62190898267061,1356,0,167485,77318,895,1,2483,2367
8737,0,0,0,1,65,1,680,0,0,1307649,4986849,39.153543900903784,1409,2510,2386,1533,45126,709154,673371,3129,4786,3377,4106,5763,29.206163733020468,11.247002231352543,1657,1,317331,18352,853,0,1720,2400
8738,0,0,1,0,62,1,774,0,0,3822280,7382760,48.78524367060187,2170,4196,3986,2380,33154,750684,424974,2892,5482,3312,4708,7298,40.07492981902776,14.888844614720798,2590,1,326060,48930,1606,0,722,1496
8739,0,0,1,0,57,1,1062,0,0,4744603,4896882,41.36423575989287,1434,4761,4484,1711,47304,618192,626778,2585,4573,3139,5635,7623,52.65928218272634,16.742690253690217,1988,1,374709,36287,2773,0,1151,89
8740,0,0,1,0,55,1,682,0,0,4268555,4873340,41.86884283091664,1711,4230,4188,1753,49952,619940,622720,2738,4533,2822,5215,7010,49.345719165901315,6.503581472166948,1795,1,392672,5628,2435,0,1027,345
8741,0,0,0,0,56,1,588,1,0,3743413,4656400,40.779897008207364,1416,4161,3914,1663,38710,686000,442400,2553,4463,3047,5051,6961,47.44470465710583,15.950577139723313,1910,1,262754,54587,2251,0,1137,549
8742,0,0,0,0,53,1,289,1,0,4830126,5494860,45.36518488885502,1991,4472,4405,2058,34344,576720,424530,2603,4728,2737,5017,7142,48.4458460551573,8.345174736691893,2125,1,327222,13065,2347,0,612,323
8743,0,0,0,0,53,1,269,1,0,4868220,5561604,45.56314299957807,1991,4506,4421,2076,32648,567948,412566,2594,4755,2764,5024,7185,48.425200051213004,9.443791641391353,2161,1,319704,16575,2345,0,603,334
8744,0,0,0,0,54,1,157,1,0,5112744,5918640,46.73328578219169,1972,4737,4525,2184,40885,501350,598910,2498,4894,2922,5051,7447,48.38388161361178,14.900873568745732,2396,1,482664,18444,2341,0,526,369
8745,0,0,0,0,53,1,245,1,0,4924500,5657400,45.8257569495584,1823,4722,4445,2100,35811,557658,466062,2417,4794,2971,5039,7416,48.425200051213004,16.84152879264993,2377,1,363300,47367,2345,0,594,349
8746,0,0,0,0,53,1,275,1,0,4862984,5590256,45.51922670696417,1775,4716,4419,2072,35670,553090,469452,2401,4770,2995,5045,7414,48.4458460551573,17.442619272651264,2369,1,360528,49896,2347,0,626,351
8747,0,0,0,0,54,1,525,1,0,4402204,5080036,43.034869582700026,1487,4594,4229,1852,36450,617175,444366,2378,4595,3108,5120,7337,48.75448697299562,19.70114934954347,2217,1,300024,73730,2377,0,891,366
8748,0,0,1,0,60,1,2007,0,0,3271680,9345024,55.42562584220407,2613,4596,4137,3072,51870,751374,638820,2583,6114,3501,4107,7638,32.63433774416144,21.654832365063704,3531,1,645120,79866,1065,0,30,1977
8749,0,0,0,0,55,1,699,0,0,4123510,4754869,41.36423575989287,1681,4151,4121,1711,50504,655844,594706,2749,4490,2809,5189,6930,49.09175083453431,5.483301264452448,1741,0,366154,4800,2410,0,1068,369
8750,0,0,0,0,55,1,644,1,0,3737916,4561830,40.47221268969612,1426,4132,3920,1638,36784,673970,423320,2573,4423,2997,5067,6917,47.77028364998475,14.72865131070837,1850,1,248976,47700,2282,0,1147,503
8751,0,0,0,0,56,1,650,1,0,3716400,4577040,40.3732584763727,1402,4138,3910,1630,44820,699192,505440,2580,4438,3036,5088,6946,47.74934554525329,15.555087290566727,1858,1,293400,46740,2280,0,1178,528
8752,0,0,0,0,56,1,653,1,0,3709560,4580005,40.33608806019741,1385,4149,3907,1627,51045,700935,577075,2573,4442,3057,5095,6964,47.74934554525329,16.04691241441268,1869,1,333535,43802,2280,0,1188,535
8753,0,0,0,0,53,1,242,1,0,4790223,5585487,45.50824101193101,1947,4508,4384,2071,35316,587946,436914,2573,4768,2821,5010,7205,48.093658625644196,11.485331950731227,2195,1,335502,24056,2313,0,626,384
8754,0,0,0,0,54,1,222,1,0,4832080,5653450,45.71651780264984,1956,4536,4402,2090,36520,595100,449030,2571,4795,2839,5017,7241,48.08326112068523,12.067284982291463,2224,1,346940,25862,2312,0,615,393
8755,0,0,0,0,54,1,443,1,0,4430510,5180930,43.53159771935783,1505,4623,4233,1895,37496,596012,470248,2344,4629,3124,5072,7357,48.35286961494633,20.222176573674133,2285,1,325940,71760,2338,0,839,396
8756,0,0,1,0,64,1,1180,0,0,733500,5276310,40.3732584763727,1268,2442,2080,1630,36400,673296,566475,2875,4867,3599,3687,5679,21.213203435596427,19.073165735500613,1992,1,285250,61540,450,0,1607,2787
8757,0,0,1,0,67,1,1005,0,0,3520800,4860000,37.94733192202055,916,4409,3885,1440,52884,789750,762750,2851,4815,3899,5820,7784,49.44694126030446,22.94936868765936,1964,1,325440,74932,2445,0,1935,930
8758,0,0,1,0,63,1,2618,0,0,3201608,11216206,59.38013135721409,3108,4852,4434,3526,53312,712544,757078,2763,6707,3599,4089,8033,30.133038346638727,20.790176033322734,3944,1,839188,37620,908,0,345,2273
8759,0,0,1,0,63,1,207,0,0,3793738,5818050,42.9767378938886,1517,4231,3901,1847,56169,746550,746550,2820,4997,3480,5204,7381,45.32107677449864,18.170946107335194,2177,1,437739,38280,2054,0,1303,1096
8760,0,0,1,0,62,1,829,0,0,3547302,4756988,38.91015291668744,1364,4007,3857,1514,47439,788642,593838,2992,4656,3292,5485,7149,48.40454524112379,12.384480471957746,1664,1,286146,29700,2343,0,1628,799
8761,0,0,0,0,55,1,731,0,0,4050480,4663680,40.98780306383839,1638,4133,4091,1680,52864,655136,621824,2734,4456,2818,5187,6909,49.10193478876367,6.484411467763075,1722,0,376320,6174,2411,0,1096,365
8762,0,0,0,0,55,1,704,1,0,3717696,4476672,40.099875311526844,1426,4102,3920,1608,38308,679296,437088,2602,4392,2966,5096,6886,48.08326112068523,13.692357929510283,1790,1,252456,40404,2312,0,1176,472
8763,0,0,0,0,53,1,298,1,0,4561680,5338560,44.63182720884279,1884,4390,4282,1992,32656,557440,420760,2572,4672,2788,4970,7070,47.853944456021594,10.62681426149494,2100,1,312744,20304,2290,0,688,390
8764,0,0,0,0,54,1,176,1,0,4810281,5712077,45.902069670114,1810,4687,4390,2107,36800,542200,498824,2414,4818,3008,4994,7398,47.78074926160116,17.448881411257393,2404,1,387688,44550,2283,0,604,428
8765,0,1,1,0,66,0,181,0,0,1146360,3864305,34.132096331752024,949,2365,2149,1165,53165,812665,719789,3101,4482,3533,4301,5682,31.368774282716245,14.867894671866425,1381,0,252805,31104,984,1,2152,2333
8766,0,0,1,0,61,1,1717,0,0,2127534,7900447,50.50742519669756,2186,3750,3385,2551,44640,768056,557460,2732,5648,3462,3931,6847,28.879058156387302,19.108557261216646,2916,1,459180,74825,834,0,546,2263
8767,0,0,1,0,67,1,503,0,0,2966088,5000062,38.58756276314948,1189,3781,3481,1489,47200,792488,671600,3058,4847,3658,5350,7139,44.63182720884279,17.425824187477687,1789,1,297800,52800,1992,0,1869,1366
8768,0,0,1,0,64,1,611,0,0,3687750,7233750,47.43416490252569,2097,4042,3889,2250,36036,585130,636570,3062,5465,3368,4854,7257,40.48456495999432,12.764261190342262,2403,1,445500,16983,1639,0,965,1576
8769,0,0,1,0,63,1,2072,0,0,3319920,10000476,55.96427431853289,2682,4642,4192,3132,55250,798250,705653,2743,6325,3643,4253,7835,32.55764119219941,21.25292540846898,3582,1,692172,71550,1060,0,61,2133
8770,0,0,1,0,62,1,328,0,0,3760020,5574096,42.21374183841087,1510,4164,3892,1782,55687,747592,728824,2856,4910,3400,5238,7292,45.93473631142341,16.496934755487974,2054,1,415206,33456,2110,0,1346,1018
8771,0,0,1,0,65,1,1588,0,0,3518933,4085741,35.25620512760839,433,4884,4074,1243,41360,772445,578512,2477,4530,4097,6118,8171,53.207142377692115,28.794328988057135,2053,1,218768,160380,2831,0,2044,456
8772,0,0,1,0,66,1,1693,0,0,3599444,4083227,35.08560958569767,301,5085,4155,1231,43739,759593,633547,2387,4548,4247,6241,8402,54.0740233383831,30.866788402840676,2161,1,235121,165540,2924,0,2086,393
8773,0,0,1,0,59,1,1232,0,0,4938180,5037890,41.10960958218893,1064,5238,4612,1690,49680,643896,685630,2355,4671,3607,5903,8219,54.055527006958314,25.178103689075044,2316,1,388700,73242,2922,0,1291,59
8774,0,0,0,0,54,1,208,1,0,4603088,5549460,45.21061822182926,1854,4486,4296,2044,40050,610875,483270,2525,4759,2905,4967,7201,47.45524207081869,14.159427997490724,2234,1,363832,35340,2252,0,671,463
8775,0,0,0,0,54,1,217,1,0,4604280,5575320,45.16635916254486,1679,4658,4297,2040,33864,557532,453678,2372,4773,3094,4990,7391,47.50789408087881,19.294892988731046,2401,1,338640,62814,2257,0,693,476
8776,0,0,0,0,55,1,407,1,0,4266288,5149872,43.266615305567875,1496,4527,4151,1872,42460,605220,530943,2375,4623,3127,5030,7278,47.738873049120045,19.497367510936833,2248,1,361296,62416,2279,0,879,472
8777,0,0,1,0,65,1,1056,0,0,1009441,5471270,40.779897008207364,1313,2620,2270,1663,52710,825790,690900,2940,4953,3640,3897,5910,24.63736998950984,18.86274944048376,2013,1,349230,61600,607,0,1627,2683
8778,0,0,1,0,63,1,1909,0,0,3425736,9651586,55.10898293381942,2556,4646,4165,3037,52398,676914,781788,2697,6215,3659,4306,7824,33.58571124749333,21.945349858135042,3518,1,747102,42809,1128,0,141,2050
8779,0,0,1,0,61,1,1506,0,0,4343647,4487021,38.24918299781056,894,5001,4432,1463,48760,650204,705410,2498,4530,3636,6036,8068,54.48853090330111,23.85462337509109,2032,1,336490,63728,2969,0,1604,98
8780,0,0,0,0,54,1,222,1,0,4448223,5436717,44.73253849269008,1800,4425,4224,2001,38896,600457,478192,2516,4718,2918,4940,7142,47.148700936505136,14.566775612304511,2202,1,352176,36984,2223,0,716,494
8781,0,0,0,0,54,1,136,1,0,4639401,5703771,45.68369512200168,1748,4649,4310,2087,37053,565731,489207,2394,4820,3072,4956,7382,47.148700936505136,18.68828665167905,2426,1,373573,55935,2223,0,646,510
8782,0,1,1,0,67,0,66,0,0,671311,2641172,28.053520278211074,318,2109,1640,787,50853,849068,674556,2887,4143,3825,4209,5465,29.206163733020468,22.190162009258344,1256,0,158187,82075,853,1,2569,2503
8783,0,0,1,0,67,1,738,0,0,3470040,5172930,39.11521443121589,1080,4248,3798,1530,49648,784392,723534,2931,4911,3831,5649,7629,47.62352359916263,21.27837533522874,1980,1,327420,70200,2268,0,1851,1113
8784,0,0,1,0,67,1,881,0,0,3688830,5166810,39.11521443121589,977,4494,3941,1530,52658,786841,763202,2824,4907,3930,5788,7871,49.10193478876367,23.543663015325162,2083,1,345780,79079,2411,0,1847,966
8785,0,0,0,0,55,1,869,1,0,3913860,4415025,39.88734135035826,1524,4118,4051,1591,41961,546675,591075,2708,4366,2842,5235,6893,49.59838707054898,8.345174736691893,1658,1,338883,7571,2460,0,1184,315
8786,0,0,0,0,54,1,872,0,0,3694745,4199760,39.179076048319466,1468,4009,3942,1535,56120,667584,629280,2669,4271,2803,5143,6745,49.06118628814432,8.187175587434018,1602,0,353050,9581,2407,0,1201,329
8787,0,0,0,0,54,1,257,1,0,4262180,5263220,44.04543109109048,1739,4338,4137,1940,36852,602286,450358,2512,4653,2914,4910,7051,46.87216658103186,14.545050792182467,2141,1,322040,38994,2197,0,773,516
8788,0,0,0,0,55,1,176,1,0,4440137,5563813,44.955533585978046,1617,4622,4218,2021,38804,600154,490034,2349,4774,3157,4950,7375,46.87216658103186,20.44332213409857,2425,1,359738,72316,2197,0,732,556
8789,0,0,0,0,55,1,239,1,0,4326692,5430460,44.31703961232068,1518,4613,4167,1964,42488,624890,519820,2319,4729,3211,4968,7378,46.93612681080534,21.509299748796135,2410,1,369232,79388,2203,0,801,562
8790,0,0,0,0,55,1,336,1,0,4161985,5189798,43.347433603386484,1500,4473,4094,1879,50160,629736,607640,2383,4641,3141,4977,7235,47.06378650300037,19.618272186961978,2258,1,413380,54576,2215,0,883,547
8791,0,0,1,0,67,1,860,0,0,3775200,5268120,39.496835316262995,987,4553,3980,1560,52884,790218,763202,2804,4937,3950,5797,7930,49.193495504995376,23.963694467363524,2133,1,352560,81939,2420,0,1817,957
8792,0,0,1,0,63,1,1164,0,0,3386176,4246200,36.71511950137164,1078,4130,3860,1348,45612,793800,570150,2880,4498,3420,5662,7280,50.11985634456667,16.521104118040164,1618,1,243988,55350,2512,0,1802,638
8793,0,0,0,0,54,1,272,1,0,4118660,5141682,43.56604182158393,1680,4286,4068,1898,37653,625779,441567,2491,4607,2927,4879,6995,46.58325879540846,15.01944364327442,2116,1,309374,45126,2170,0,811,539
8794,0,0,1,0,62,1,1847,0,0,1579188,7761858,49.82971001320397,2282,3320,3119,2483,50547,778374,634578,2925,5609,3327,3762,6446,25.219040425836983,14.190063084236025,2684,1,504049,36783,636,0,643,2490
8795,0,0,1,0,64,1,1434,0,0,780955,5991650,43.069710934716056,1219,2912,2276,1855,40222,713830,587860,2594,5085,3866,3651,6142,20.518284528683193,25.242714448841607,2491,0,337610,113844,421,1,1375,2809
8796,0,0,1,0,65,1,959,0,0,1361462,5687847,41.72529209005013,1362,2902,2523,1741,43425,735075,630531,2888,5008,3646,4049,6169,27.964262908219126,19.5192549123602,2120,1,336013,65188,782,0,1526,2485
8797,0,0,1,0,66,1,79,0,0,2951682,5599465,40.97560249709576,1411,3705,3437,1679,45548,787060,643655,3067,5014,3603,5093,7040,41.92851058647326,16.444059732878895,1947,1,324047,49044,1758,0,1656,1577
8798,0,0,1,0,56,1,1141,0,0,4312092,4495720,39.786932528155525,1241,4649,4307,1583,43860,610600,579360,2498,4423,3182,5564,7489,52.191953402799555,18.61597349115187,1925,1,322932,50274,2724,0,1257,116
8799,0,0,0,0,54,1,244,1,0,4049372,5164938,43.520110293977886,1638,4288,4032,1894,34048,610848,414504,2471,4621,2983,4865,7015,46.238512086787566,16.341452435068074,2150,1,287888,53760,2138,0,833,589
8800,0,0,0,0,54,1,222,1,0,4084255,5232055,43.73785545725808,1645,4316,4048,1913,37570,604435,464950,2467,4648,3003,4870,7051,46.20606020859169,16.75875397828464,2181,1,325210,50652,2135,0,822,600
8801,0,0,0,0,54,1,200,1,0,4123089,5296420,43.965895873961216,1650,4349,4066,1933,37668,600060,471280,2457,4673,3023,4873,7089,46.184412955021955,17.259468159879052,2216,1,332476,52638,2133,0,807,607
8802,0,0,0,0,55,1,135,1,0,4282414,5536292,44.75488800120049,1557,4587,4141,2003,45600,630192,552800,2318,4767,3210,4902,7351,46.238512086787566,21.47303186068273,2449,1,400600,74482,2138,0,761,626
8803,0,0,1,0,63,1,1574,0,0,1391355,7033950,46.95742752749558,1882,3159,2836,2205,42140,685850,625240,2867,5395,3513,3821,6349,25.11971337416094,18.091971033075197,2528,1,432180,50388,631,0,985,2559
8804,0,0,1,0,64,1,1301,0,0,958650,5919892,42.731721238442994,1262,2915,2351,1826,44232,739176,628948,2678,5068,3806,3767,6157,22.9128784747792,23.763303805039097,2390,0,354244,98136,525,1,1416,2717
8805,0,0,1,0,67,1,790,0,0,3904200,5473980,40.24922359499622,1025,4625,4030,1620,52206,780549,763654,2784,4999,3974,5789,8004,49.09175083453431,24.42742831800231,2215,1,366120,83300,2410,0,1759,969
8806,0,0,1,0,61,1,375,0,0,3915000,5565600,42.42640687119285,1465,4310,3975,1800,56376,717344,751356,2757,4892,3427,5267,7402,46.636895265444075,18.534096587088996,2135,1,437400,35845,2175,0,1292,917
8807,0,0,1,0,63,1,1331,0,0,3287802,4000560,35.58089374931439,935,4194,3863,1266,41796,767880,543520,2829,4426,3491,5757,7354,50.96076922496363,18.296314776186556,1597,1,217752,69510,2597,0,1894,563
8808,0,0,0,0,54,1,419,1,0,3690666,4679668,41.50903516103452,1483,4105,3865,1723,43263,562212,567644,2476,4439,2956,4858,6821,46.281745861624536,15.720868487830314,1963,1,360107,31440,2142,0,993,574
8809,0,0,0,0,54,1,214,1,0,3980555,5185122,43.485629810317796,1596,4291,3996,1891,37518,608724,463398,2447,4633,3037,4847,7033,45.880278987817846,17.570335756864036,2186,1,319579,56640,2105,0,851,637
8810,0,0,0,0,55,1,149,1,0,4101152,5383616,44.181444068749045,1617,4388,4053,1952,41420,601244,524020,2423,4710,3093,4859,7146,45.83666654546336,18.79432244570278,2287,1,370880,55610,2101,0,806,657
8811,0,0,1,0,58,1,1411,0,0,3001040,7475552,50.75431016179808,2449,3868,3741,2576,36480,551380,557184,2775,5478,3029,4067,6770,34.132096331752024,11.360716291379575,2703,1,494592,16256,1165,0,326,1737
8812,0,0,1,0,61,1,1989,0,0,1828332,8278281,51.70106381884226,2255,3775,3357,2673,45760,681340,644176,2679,5770,3515,3781,6872,26.153393661244042,20.46794443520355,3091,0,555984,62282,684,1,424,2413
8813,0,0,0,1,67,1,741,0,0,3945150,5580300,40.620192023179804,1050,4641,4041,1650,51290,777860,754186,2782,5032,3982,5773,8023,48.8978527135906,24.54254030884065,2250,1,367950,85800,2391,0,1732,991
8814,0,0,1,0,63,1,1248,0,0,3903808,8535536,51.92301994298868,2546,4294,4144,2696,41032,582544,706018,3016,5862,3316,4614,7460,38.05259518088089,12.514175867137965,2846,1,601208,12750,1448,0,470,1718
8815,0,0,1,0,62,1,1660,0,0,3530016,3848256,34.9857113690718,893,4439,4108,1224,52210,713688,723120,2813,4368,3475,6028,7583,53.70288632839021,18.387913555578198,1555,1,281520,42699,2884,0,1920,260
8816,0,0,0,0,53,1,916,0,0,3313365,3828462,37.66961640367472,1389,3784,3754,1419,45450,607050,544996,2668,4117,2728,5033,6482,48.321837713398274,5.478746393072713,1449,0,286638,4830,2335,0,1279,363
8817,0,0,0,0,53,1,695,0,0,3355604,4091349,38.948684188300895,1409,3837,3729,1517,40762,617613,480066,2589,4214,2805,4909,6534,47.031904065219386,10.394308954048586,1625,0,270026,20520,2212,0,1180,485
8818,0,0,0,0,54,1,602,1,0,3413783,4284117,39.63584236521283,1437,3878,3744,1571,37064,616302,447228,2593,4298,2861,4900,6605,46.61544808322666,11.9305333824295,1705,1,257644,26934,2173,0,1156,554
8819,0,0,0,0,54,1,555,1,0,3448000,4382400,40.0,1430,3925,3755,1600,47560,635448,561495,2569,4339,2909,4894,6664,46.42197755374064,13.36696240183447,1770,1,328000,28050,2155,0,1139,584
8820,0,0,1,0,58,1,1782,0,0,3495160,8711242,54.42425929675111,2920,4184,4142,2962,47970,723486,573495,2899,5903,2983,4121,7125,34.351128074635334,6.538739683827756,3004,0,577590,7938,1180,1,21,1761
8821,0,0,0,1,67,1,694,0,0,3988320,5686800,40.98780306383839,1073,4661,4054,1680,51067,775165,754855,2778,5065,3992,5759,8046,48.72371086031933,24.695356644896613,2287,1,374640,86194,2374,0,1705,1011
8822,0,0,1,0,60,1,1020,0,0,3913749,7702401,50.52722038663912,2383,4256,4086,2553,56643,721063,715029,2847,5570,3187,4550,7273,39.153543900903784,13.038855942866585,2723,1,605061,21760,1533,0,464,1484
8823,0,0,1,0,58,1,1316,0,0,3889277,4137952,37.69615364994153,907,4672,4158,1421,44622,585312,646464,2398,4333,3426,5649,7584,52.316345438113316,22.854882869708433,1935,1,315462,55512,2737,0,1491,175
8824,0,0,0,0,55,1,177,1,0,3816148,5152920,43.2087954009366,1505,4273,3911,1867,39900,629280,483000,2398,4627,3122,4804,7033,45.21061822182926,19.40021058678249,2229,1,326725,69866,2044,0,893,716
8825,0,0,0,1,68,1,506,0,0,3797216,5834496,41.376321731154405,1220,4422,3930,1712,50175,759984,766800,2916,5120,3900,5626,7830,47.095647357266465,22.312223424282628,2204,1,385200,64944,2218,0,1696,1190
8826,0,0,0,0,55,1,544,1,0,3027137,5641575,45.088801270381985,2003,3552,3522,2033,49815,568875,674325,2745,4808,2805,4264,6327,38.58756276314948,5.490867587491313,2063,1,494019,2580,1489,0,742,1286
8827,0,0,1,0,67,1,209,0,0,3529122,5999152,42.15447781671598,1482,4058,3763,1777,45927,820368,638064,3081,5153,3671,5362,7434,44.56455991031439,17.356288989682643,2072,1,335853,56935,1986,0,1599,1390
8828,0,0,0,1,67,1,628,0,0,4120320,5902080,41.71330722922842,1167,4681,4108,1740,51980,766592,780160,2819,5132,3965,5760,8073,48.662100242385755,23.97104863958354,2313,1,400200,73917,2368,0,1652,1024
8829,0,0,1,0,60,1,966,0,0,3573112,4459784,38.31448812133603,1468,3902,3902,1468,46184,762538,558992,3038,4506,3038,5472,6940,49.33558553417604,0.0,1468,0,270112,0,2434,1,1570,604
8830,0,0,1,0,62,1,1575,0,0,3310150,3742740,34.56877203488721,771,4389,3965,1195,49704,682776,714096,2708,4327,3556,5902,7521,52.630789467763066,20.683670177525183,1619,1,272460,51728,2770,0,1937,362
8831,0,0,0,0,54,1,620,1,0,3097269,4039595,38.43175770115127,1265,3786,3574,1477,41125,642725,478625,2523,4212,2947,4832,6521,45.79301256742124,14.694496548602537,1689,1,258475,42400,2097,0,1258,638
8832,0,0,0,0,54,1,571,1,0,3131546,4133701,38.82009788756334,1279,3813,3585,1507,48930,639119,576030,2515,4250,2971,4821,6556,45.58508528016593,15.29964203757375,1735,1,316470,36936,2078,0,1236,665
8833,0,0,0,0,54,1,546,1,0,3151087,4177589,39.02563260217571,1281,3834,3592,1523,49665,633633,589745,2501,4266,2985,4812,6577,45.48626166217664,15.79777293046628,1765,1,327445,37026,2069,0,1220,674
8834,0,0,0,1,66,1,150,0,0,3284971,6243145,43.46262762420146,1829,3688,3628,1889,50264,806420,680830,3245,5194,3365,5044,6993,41.701318923986086,7.754559014766193,1949,1,389134,10560,1739,0,1416,1566
8835,0,0,1,0,60,1,2247,0,0,4319154,10593954,59.04235767650204,3396,4815,4725,3486,55104,747594,680736,2949,6525,3129,4278,7854,35.199431813596085,9.494144610579708,3576,0,780864,13860,1239,1,447,1800
8836,0,0,1,0,61,1,1405,0,0,4019994,8715641,53.16954015223378,2526,4550,4249,2827,54880,690592,755335,2782,5910,3384,4505,7633,37.70941526992961,17.901674988437307,3128,1,692615,26789,1422,0,256,1661
8837,0,0,1,0,61,1,1351,0,0,3529712,4089816,36.345563690772494,625,4689,3993,1321,50388,684216,705888,2400,4417,3792,5768,7785,51.69139193328034,26.38781420037686,2017,1,301188,87000,2672,0,1775,424
8838,0,0,0,0,54,1,970,1,0,2911851,3507369,35.90264614203248,1259,3578,3548,1289,48391,606783,590457,2691,4010,2751,4980,6299,47.52893855326458,5.531194905403055,1319,1,279713,4260,2259,0,1432,462
8839,0,0,1,0,59,1,1340,0,0,3459629,7840414,51.44900387762624,2400,4201,3954,2647,38247,542046,619058,2715,5609,3209,4269,7163,36.15245496505044,15.914415857597147,2894,1,553223,24700,1307,0,315,1655
8840,0,0,1,0,61,1,2184,0,0,2263417,9100884,54.323107422164284,2505,4164,3718,2951,49800,767916,616800,2638,6035,3530,3851,7248,27.694764848252458,21.198548527030937,3397,1,590200,82956,767,0,133,2317
8841,0,0,1,0,66,1,662,0,0,2603048,6566960,44.474711915874174,1560,3712,3294,1978,45540,730400,687240,2902,5298,3738,4636,7032,36.27671429443411,20.50936481761953,2396,1,409446,62700,1316,0,1342,2004
8842,0,0,1,0,67,1,273,0,0,3809260,6177080,42.661458015403085,1501,4232,3913,1820,46872,841712,641466,3075,5214,3713,5487,7626,45.749316934791494,18.08381773621633,2139,1,343980,62843,2093,0,1574,1301
8843,0,0,1,0,68,1,536,0,0,4204800,6120000,42.42640687119285,1312,4624,4136,1800,53361,785400,785400,2912,5200,3888,5736,8024,48.33218389437829,22.150795061097874,2288,1,415800,64416,2336,0,1600,1064
8844,0,0,1,0,67,1,564,0,0,4255200,6112800,42.42640687119285,1291,4673,4164,1800,53130,781080,784476,2887,5196,3905,5760,8069,48.620983124572874,22.608965816416916,2309,1,415800,67188,2364,0,1596,1032
8845,0,0,1,0,61,1,1651,0,0,4121222,9295377,54.92722457943783,2827,4573,4383,3017,52750,770250,650091,2891,6098,3271,4447,7654,36.959437225152655,14.126287489501577,3207,1,636587,30210,1366,0,64,1715
8846,0,0,0,0,54,1,974,0,0,2811347,3430775,35.482389998420345,1259,3492,3492,1259,48124,618575,577700,2725,3984,2725,4958,6217,47.25462940284264,0.0,1259,0,266908,0,2233,0,1466,492
8847,0,0,0,0,54,1,740,0,0,2842176,3669336,36.823905279043935,1116,3692,3452,1356,48438,633204,560142,2466,4062,2946,4802,6398,45.78209256903839,15.503284344161868,1596,0,280692,39840,2096,0,1350,610
8848,0,0,0,0,54,1,641,1,0,2891910,3853530,37.54996671103717,1142,3729,3461,1410,41949,647721,483741,2465,4143,3001,4784,6462,45.28796749689701,16.428745738047,1678,1,249570,53600,2051,0,1323,682
8849,0,0,0,0,54,1,615,1,0,2907000,3904500,37.749172176353746,1153,3737,3465,1425,44454,654860,509640,2468,4165,3012,4780,6477,45.16635916254486,16.580875864653027,1697,1,265050,52496,2040,0,1315,700
8850,0,0,1,0,66,1,69,0,0,3542616,6374025,43.78355855797927,1850,3832,3765,1917,43188,811300,588525,3258,5242,3392,5173,7157,42.988370520409354,8.314029025396882,1984,1,339309,13735,1848,0,1408,1477
8851,0,0,1,0,61,1,1899,0,0,4376956,10052712,56.9824534396335,3152,4690,4595,3247,48138,659448,699696,3001,6343,3191,4444,7786,36.71511950137164,9.779300676839927,3342,0,733822,11305,1348,1,151,1748
8852,0,0,0,0,54,1,1042,0,0,2735315,3307851,34.828149534535996,1213,3468,3468,1213,49050,613575,594486,2727,3940,2727,4982,6195,47.486840282335066,0.0,1213,0,264434,0,2255,0,1514,472
8853,0,0,0,0,54,1,613,1,0,2814788,3836058,37.403208418530085,1098,3712,3411,1399,45600,658080,520980,2441,4141,3043,4754,6454,44.85532298401161,17.42927208216113,1700,1,265810,56889,2012,0,1343,730
8854,0,0,0,0,55,1,535,1,0,2871384,3983448,38.05259518088089,1125,3754,3431,1448,49115,646485,574959,2428,4199,3074,4734,6505,44.53088815642464,18.11051775988222,1771,1,302632,53295,1983,0,1303,768
8855,0,0,1,0,65,1,1244,0,0,1615341,6699693,45.13313638558703,1312,3555,2830,2037,43800,720291,657800,2564,5326,4014,4082,6844,28.160255680657446,26.97335131632644,2762,1,407400,113825,793,0,1252,2496
8856,0,0,0,1,66,1,290,0,0,3442296,6621806,44.78839135311738,1964,3764,3722,2006,49275,742725,722919,3259,5307,3343,5017,7065,41.42463035441596,6.481658975540136,2048,1,439314,5964,1716,0,1295,1585
8857,0,0,1,0,59,1,1311,0,0,3129202,3663456,35.08560958569767,518,4486,3773,1231,43416,598176,642816,2263,4207,3689,5518,7462,50.41825066382212,27.020007724725136,1944,1,265896,82708,2542,0,1745,434
8858,0,0,0,0,54,1,636,1,0,2707852,3718204,36.851051545376556,1035,3675,3352,1358,44454,654382,509268,2415,4096,3061,4732,6413,44.654227123532216,18.040713851564195,1681,1,252588,62016,1994,0,1380,744
8859,0,0,0,0,54,1,558,1,0,2761384,3865094,37.49666651850535,1064,3712,3370,1406,49680,659760,569043,2407,4155,3091,4713,6461,44.31703961232068,18.587425917322303,1748,1,291042,58824,1964,0,1343,785
8860,0,0,0,0,55,1,401,1,0,2895882,4169828,38.897300677553446,1087,3853,3427,1513,49350,647660,578760,2330,4269,3182,4670,6609,43.749285708454714,20.806320949236934,1939,1,317730,69438,1914,0,1243,842
8861,0,0,0,0,55,1,323,1,0,2978940,4338720,39.64845520319802,1091,3948,3467,1572,46740,629280,565800,2279,4332,3241,4655,6708,43.53159771935783,22.081834707777595,2053,1,322260,77441,1895,0,1188,865
8862,0,0,1,0,59,1,2107,0,0,4004520,9911850,57.57603668193913,3315,4523,4523,3315,41358,675740,547170,2990,6305,2990,4198,7513,34.75629439396553,0.0,3315,0,606645,0,1208,1,325,1782
8863,0,0,1,0,60,1,2228,0,0,3253404,9766680,56.868268832451726,3100,4374,4240,3234,49000,739900,604000,2886,6254,3154,4026,7394,31.71750305430741,11.59192030070629,3368,1,646800,24656,1006,0,214,2014
8864,0,0,1,0,63,1,2281,0,0,774300,8192094,50.80354318352215,2190,3272,2881,2581,41300,749064,555450,2783,5755,3565,3474,6446,17.320508075688775,19.797250223118017,2972,0,451675,78200,300,1,593,2874
8865,0,0,1,0,64,1,1653,0,0,1479268,7412419,47.92702786528704,1581,3657,2941,2297,49400,797069,645400,2511,5524,3943,3871,6884,25.37715508089904,26.863251039162858,3013,0,459400,132460,644,1,930,2583
8866,0,0,1,0,67,1,866,0,0,2401392,6877456,45.18849411078001,1411,3849,3218,2042,46830,751064,707280,2737,5410,3999,4544,7217,34.292856398964496,25.42330300087935,2673,1,428820,95281,1176,0,1326,2192
8867,0,0,1,0,60,1,86,0,0,4066440,5961480,44.429719783046124,1716,4292,4034,1974,48636,761040,582860,2762,4994,3278,5080,7312,45.387222871640866,16.84351718533759,2232,0,380982,46698,2060,1,1046,960
8868,0,0,0,0,54,1,1093,0,0,2565894,3138894,33.85262175962151,1146,3385,3385,1146,47817,632709,566973,2739,3885,2739,4978,6124,47.31807265728392,0.0,1146,0,237222,0,2239,0,1593,500
8869,0,0,1,0,60,1,2282,0,0,2790648,9628052,56.24944444170093,2930,4280,4046,3164,50451,763793,611643,2809,6207,3277,3925,7323,29.698484809834994,15.34052413788951,3398,1,635964,43524,882,0,121,2161
8870,0,0,1,0,67,1,495,0,0,4636800,6514560,43.81780460041329,1496,4759,4335,1920,53280,814320,753246,2969,5313,3817,5808,8152,49.14264950122246,20.646474403859205,2344,1,426240,64872,2415,0,1473,978
8871,0,0,0,0,54,1,1077,0,0,2460640,3071040,33.46640106136302,1090,3347,3317,1120,47700,616950,581304,2712,3862,2772,4939,6089,46.87216658103186,5.490867587491313,1150,0,237440,4530,2197,0,1622,545
8872,0,0,0,0,54,1,790,0,0,2458664,3328728,34.95711658589707,980,3476,3234,1222,46782,615624,563868,2482,3946,2966,4736,6200,44.85532298401161,15.569348747395024,1464,0,252954,37994,2012,0,1502,712
8873,0,0,0,0,59,1,290,1,0,2727939,4475454,38.897300677553446,1363,3466,3316,1513,55029,653718,736542,2808,4471,3108,4761,6424,42.46174749112429,12.613010185831968,1663,1,376737,13350,1803,0,1445,1155
8874,0,0,1,0,61,1,2338,0,0,2350623,9492305,55.65069631190611,2774,4179,3856,3097,44744,729470,576220,2742,6162,3388,3824,7244,27.54995462791182,18.027756377319946,3420,1,582236,61047,759,0,32,2306
8875,0,0,0,0,54,1,792,1,0,2371284,3257232,34.55430508634199,936,3438,3180,1194,45627,619256,548328,2470,3922,2986,4714,6166,44.56455991031439,16.072563944740665,1452,1,239994,42570,1986,0,1534,742
8876,0,0,0,0,54,1,765,1,0,2380204,3296317,34.741905532080416,924,3462,3179,1207,45000,614475,546200,2448,3938,3014,4703,6193,44.40720662234904,16.845714063547693,1490,1,241400,46129,1972,0,1524,759
8877,0,0,1,0,60,1,1922,0,0,4085123,9600199,56.55970296951709,3079,4596,4476,3199,37632,672224,504168,2881,6200,3121,4278,7597,35.73513677041127,10.97739094653235,3319,1,537432,23520,1277,0,198,1724
8878,0,0,1,0,67,1,773,0,0,2949978,7209626,46.33573135281238,1610,4058,3521,2147,44064,725328,685032,2821,5505,3895,4732,7416,37.067505985701274,23.307179821956986,2684,1,437988,80013,1374,0,1211,1984
8879,0,0,0,0,59,1,1316,1,0,2728320,3351040,33.46640106136302,305,4371,3556,1120,42848,616352,622336,2177,4112,3807,5428,7363,49.35585071701227,29.041252253385945,1935,1,232960,107580,2436,0,1872,556
8880,0,0,0,0,54,1,1150,0,0,2316504,2888792,32.43454948045371,1052,3254,3254,1052,48600,617850,593136,2746,3798,2746,4948,6000,46.92547282660026,0.0,1052,0,227232,0,2202,0,1694,544
8881,0,0,1,0,66,1,1242,0,0,2047959,7264911,46.70117771534247,1327,3974,3120,2181,39424,746144,586256,2477,5512,4185,4270,7305,30.643106892089126,29.328977696727325,3035,1,383856,159698,939,0,1150,2392
8882,0,0,1,0,67,1,256,0,0,4588932,6816804,44.9221548904324,1806,4504,4292,2018,51088,837744,695868,3166,5396,3590,5652,7882,47.686476070265456,14.627860319333173,2230,1,415708,37736,2274,0,1360,1104
8883,0,0,1,0,60,1,1783,0,0,4924500,9947490,57.29746940310715,3163,4903,4783,3283,47064,642360,672660,2910,6313,3150,4530,7933,38.72983346207417,10.981735174982626,3403,0,728826,14760,1500,1,253,1530
8884,0,0,1,0,58,1,127,0,0,4245750,6207125,46.09772228646444,2035,4213,4123,2125,53383,739013,616331,2831,5046,3011,4919,7134,44.69899327725402,9.505517133991825,2215,1,448375,15210,1998,0,796,923
8885,0,0,1,0,60,1,1281,0,0,2584390,3310330,33.015148038438355,137,4414,3461,1090,50838,674214,695473,2084,4127,3990,5408,7451,48.692915295759406,31.26685110103837,2043,1,249610,119125,2371,0,1947,666
8886,0,0,1,0,59,1,1597,0,0,4544850,9218850,55.452682532047085,2895,4733,4553,3075,41184,623584,593604,2818,6073,3178,4476,7731,38.44476557348217,13.698197470491724,3255,1,608850,26280,1478,0,77,1520
8887,0,0,1,0,57,1,10,0,0,3713304,5533438,43.840620433565945,1855,3921,3854,1922,46224,621864,616106,2812,4801,2946,4811,6800,43.95452195167182,8.187175587434018,1989,0,411308,9179,1932,1,957,947
8888,0,0,1,0,60,1,1404,0,0,4623840,8912748,54.4426303552648,2687,4801,4524,2964,36477,568323,580351,2730,5971,3284,4567,7808,39.496835316262995,16.84796235830073,3241,1,572052,35179,1560,0,43,1447
8889,0,0,1,0,67,1,1123,0,0,2441978,7474808,47.138094997570704,1377,4166,3321,2222,44100,756900,659344,2519,5586,4209,4463,7530,33.15116890850155,29.25533125217095,3067,1,435512,141960,1099,0,1142,2265
8890,0,0,1,0,62,1,1913,0,0,5292680,10695696,58.71967302361279,3266,5165,4983,3448,36816,549054,645216,2920,6550,3284,4637,8267,39.179076048319466,13.8897392285711,3630,1,717184,16744,1535,0,346,1567
8891,0,0,0,0,56,1,1641,1,0,2825550,2985150,32.4037034920393,604,4187,3741,1050,54858,633989,699378,2397,3893,3289,5534,7030,51.87484939737175,21.254982472894696,1496,1,258300,44600,2691,0,1793,152
8892,0,0,1,0,64,1,2501,0,0,468300,8571228,51.73006862551025,2050,3477,2851,2676,45548,755908,618179,2577,5879,3829,3378,6680,13.228756555322953,25.069898306808735,3302,0,516468,113932,175,1,527,3028
8893,0,0,1,0,64,1,2205,0,0,955696,8366848,50.75431016179808,1958,3565,2947,2576,44688,740544,636608,2630,5824,3866,3619,6813,19.261360284258224,24.87059878184851,3194,1,504896,105678,371,0,672,2877
8894,0,0,1,0,65,1,1913,0,0,1436730,8142300,49.8998997994986,1943,3614,3067,2490,46605,781530,637650,2723,5760,3817,3847,6884,24.020824298928627,23.38834378559127,3037,1,485550,100648,577,0,780,2693
8895,0,0,1,0,66,1,1297,0,0,2254308,7633128,47.791212581394085,1541,4014,3271,2284,36750,701820,584850,2599,5626,4085,4329,7356,31.416556144810016,27.293950436960895,3027,1,399700,127053,987,0,1058,2355
8896,0,0,0,0,55,1,1296,0,0,2076496,2566728,30.528675044947494,902,3190,3160,932,50151,630666,603126,2724,3686,2784,4982,5944,47.20169488482379,5.478746393072713,962,0,204108,4410,2228,0,1822,526
8897,0,0,1,0,63,1,2657,0,0,812718,9245034,54.16641025580336,2334,3811,3211,2934,45504,746787,604992,2551,6085,3751,3428,6962,16.64331697709324,24.663257145596607,3534,1,563328,111000,277,0,217,2874
8898,0,0,1,0,57,1,173,0,0,4034628,6049845,45.79301256742124,1907,4211,4021,2097,47000,577000,677975,2695,4982,3075,4809,7096,43.86342439892262,14.750199322570479,2287,1,492795,17100,1924,0,788,961
8899,0,0,0,1,67,1,320,0,0,5356800,7320240,46.475800154489,1913,4887,4640,2160,48720,813360,687967,3142,5549,3636,5869,8276,49.79959839195493,15.818277562199736,2407,1,438480,43472,2480,0,1229,909
8900,0,0,0,1,67,1,371,0,0,5466960,7337520,46.475800154489,1854,4997,4691,2160,46560,815280,659018,3091,5557,3703,5928,8394,50.309044912421065,17.599483741842185,2466,1,419040,56916,2531,0,1237,866
8901,0,0,1,0,61,1,1676,0,0,5428332,10190550,57.56735185849702,3044,5222,4952,3314,35208,501225,664200,2805,6389,3345,4713,8297,40.47221268969612,16.605609298489938,3584,1,715824,17010,1638,0,239,1437
8902,0,0,0,0,55,1,1331,0,0,1930250,2413250,29.58039891549808,875,3081,3081,875,50328,642614,595728,2758,3633,2758,4964,5839,46.968074263269514,0.0,875,0,189000,0,2206,0,1883,552
8903,0,0,1,0,60,1,1194,0,0,4828320,8725464,53.60970061472084,2483,4945,4554,2874,49266,722568,628452,2645,5910,3427,4716,7981,40.98780306383839,20.03621402205904,3265,1,594918,66470,1680,0,162,1356
8904,0,0,1,0,63,1,2789,0,0,259110,9195526,53.65631370118525,2194,3654,2969,2879,45600,766560,606860,2509,6073,3879,3284,6848,9.486832980505138,26.434115788640167,3564,1,547010,130150,90,0,315,3104
8905,0,0,1,0,63,1,2816,0,0,85380,9104354,53.34791467339656,2175,3547,2876,2846,46648,761362,627004,2528,6045,3870,3229,6746,5.477225575051661,25.935381944742343,3517,1,557816,121451,30,0,353,3169
8906,0,0,1,0,66,1,1687,0,0,2022570,8267567,49.969990994595946,2047,3757,3307,2497,46098,774774,652267,2861,5808,3761,4121,7068,28.460498941515414,21.247063405172966,2947,1,491909,79650,810,0,814,2501
8907,0,0,1,0,63,1,2012,0,0,6063564,11577228,60.54750201288241,3324,5662,5320,3666,42824,669496,637916,2816,6824,3500,4812,8820,40.66939881532551,18.906699469446448,4008,1,740532,49590,1654,0,508,1504
8908,0,0,0,0,57,1,352,0,0,4278800,5487200,43.58898943540674,1900,4152,4152,1900,53680,704672,635360,2888,4788,2888,5140,7040,47.45524207081869,0.0,1900,0,418000,0,2252,0,988,636
8909,0,0,1,0,59,1,1307,0,0,3623094,4036230,36.864617182333525,1264,4120,4025,1359,46482,754380,543510,2875,4329,3065,5636,7090,51.633322573702344,9.773682308767459,1454,0,248697,19190,2666,1,1611,304
8910,0,0,0,0,55,1,1424,0,0,1998945,2403960,29.512709126747414,841,3196,3166,871,51051,637560,609960,2730,3631,2790,5055,5956,47.90615826801394,5.478746393072713,901,0,192491,4380,2295,0,1889,465
8911,0,0,0,0,55,1,1391,0,0,1932750,2369981,29.30870177950569,859,3109,3109,859,49880,640088,593185,2759,3618,2759,5009,5868,47.43416490252569,0.0,859,0,184685,0,2250,0,1900,509
8912,0,0,0,0,55,1,1375,0,0,1900484,2353427,29.206163733020468,853,3081,3081,853,49396,642847,584908,2759,3612,2759,4987,5840,47.20169488482379,0.0,853,0,180836,0,2228,0,1906,531
8913,0,0,0,0,59,1,134,1,0,2410427,4799781,40.26164427839479,1497,3232,3108,1621,51408,604044,746172,2837,4582,3085,4448,6193,38.561638969317684,11.350985329980674,1745,1,408492,8060,1487,0,1340,1474
8914,0,0,0,0,56,1,302,1,0,4370415,6388221,47.40253157796533,2123,4316,4192,2247,38479,457723,679477,2719,5090,2967,4788,7159,44.10215414239989,11.718395466430005,2371,1,537033,3348,1945,0,596,898
8915,0,0,1,0,59,1,124,0,0,3583392,5817144,44.22668877499196,1714,4030,3788,1956,29928,511528,517476,2732,4930,3216,4806,7004,42.80186911806539,15.86330957408423,2198,1,340344,30008,1832,0,1018,1142
8916,0,0,1,0,60,1,1533,0,0,3904758,8744580,53.72150407425317,2525,4600,4239,2886,42924,663570,593880,2669,5916,3391,4383,7630,36.78314831549904,19.014562633801113,3247,1,565656,58482,1353,0,144,1677
8917,0,0,1,0,65,1,2245,0,0,1234814,8808520,51.980765673468106,2285,3576,3159,2702,51728,795440,691120,2843,5962,3677,3717,6836,21.37755832643195,20.426329719357806,3119,0,572824,70473,457,1,558,2803
8918,0,0,0,1,67,1,190,0,0,5645859,7723389,47.78074926160116,2133,4906,4756,2283,44969,788239,652919,3233,5666,3533,5856,8289,49.72926703662542,12.30702509692623,2433,1,440619,27000,2473,0,1100,910
8919,0,1,1,0,65,0,815,0,0,1499334,2875048,29.715315916207253,627,2837,2581,883,50621,739112,726088,3000,4139,3512,4954,6093,41.20679555607303,16.359068810614975,1139,0,196909,35840,1698,1,2373,1558
8920,0,0,1,0,59,1,341,0,0,1388220,4025838,36.89173349139343,1276,2466,2381,1361,54280,680340,698088,2873,4319,3043,3978,5424,31.937438845342623,9.257905235465769,1446,1,321196,10540,1020,0,1597,1938
8921,0,0,1,0,58,1,207,0,0,2618550,5043900,41.53311931459037,1630,3338,3243,1725,52405,652052,687140,2829,4649,3019,4442,6262,38.961519477556315,9.74706432789427,1820,0,405375,11305,1518,1,1199,1406
8922,0,0,0,1,67,1,151,0,0,5708790,7833960,48.11444689487763,2207,4889,4781,2315,43290,791856,626040,3276,5699,3492,5850,8273,49.658836071740545,10.498474454302341,2423,1,428275,20412,2466,0,1069,918
8923,0,0,0,1,68,1,303,0,0,6036030,7867860,48.062459362791664,2054,5179,4923,2310,47034,797004,684606,3150,5716,3662,6019,8585,51.11751167652823,16.066057076420652,2566,1,464310,44032,2613,0,1096,793
8924,0,0,1,0,59,1,534,0,0,5004720,7494480,50.19960159204453,2453,4573,4506,2520,48150,669150,636436,2907,5494,3041,4960,7547,44.56455991031439,8.189452396126915,2587,0,539280,9916,1986,1,454,988
8925,0,0,1,0,59,1,93,0,0,4739344,6571920,47.15930449020638,2014,4565,4355,2224,43255,605775,623505,2745,5179,3165,5086,7520,46.16275555033516,14.585423422348626,2434,0,469264,26670,2131,1,731,824
8926,0,0,1,0,60,1,1432,0,0,3914160,8584080,53.103672189407014,2420,4608,4208,2820,43878,648372,627064,2644,5864,3444,4432,7652,37.255872020394314,20.024455109496696,3220,1,580920,57200,1388,0,224,1656
8927,0,0,0,1,68,1,241,0,0,6039540,7965360,48.373546489791295,2150,5111,4921,2340,45630,796536,663780,3214,5744,3594,5985,8515,50.80354318352215,13.874881522629007,2530,1,456300,34010,2581,0,1064,823
8928,0,0,1,0,62,1,1474,0,0,5974640,10343760,57.358521598799946,2860,5536,5106,3290,48000,603648,786000,2714,6434,3574,4960,8680,42.61455150532503,21.194847225312195,3720,1,822500,23650,1816,0,146,1328
8929,0,0,0,1,67,1,76,0,0,5840445,8017230,48.774993593028796,2349,4864,4834,2379,39884,795320,569530,3340,5749,3400,5825,8234,49.54795656734998,5.572104574801163,2409,1,402051,6210,2455,0,991,915
8930,0,0,1,0,57,1,482,0,0,4478819,5462988,43.46262762420146,1794,4355,4260,1889,51984,659376,659376,2797,4781,2987,5263,7247,48.692915295759406,9.76859066112806,1984,0,430692,12635,2371,1,1003,521
8931,0,0,1,0,58,1,324,0,0,2699557,5341098,42.579337712087536,1633,3482,3302,1813,38150,642228,515550,2766,4759,3126,4435,6428,38.58756276314948,13.45762619345434,1993,0,317275,32760,1489,1,1133,1457
8932,0,0,0,0,55,1,747,1,0,4403790,6986445,50.049975024968795,2475,4293,4263,2505,49922,608002,638681,2759,5294,2819,4547,7082,41.92851058647326,5.501408174353464,2535,1,573645,3630,1758,0,284,1031
8933,0,0,1,0,66,1,1955,0,0,2035664,8968291,52.028838157314254,2467,3699,3459,2707,46031,798433,632783,3073,6020,3553,4065,7012,27.422618401604176,15.588127267775322,2947,0,517037,45600,752,1,606,2561
8934,0,0,1,0,67,1,1545,0,0,2842414,8879260,51.254268114957995,2266,4070,3709,2627,49848,838240,679380,3019,6007,3741,4462,7450,32.89376840679705,19.276176726200813,2988,1,528027,66785,1082,0,753,2298
8935,0,0,0,1,67,1,65,0,0,5959866,8125557,49.08156476723211,2409,4883,4883,2409,41001,799401,583529,3373,5782,3373,5847,8256,49.73932046178355,0.0,2409,1,416757,0,2474,0,964,899
8936,0,0,0,0,57,1,1304,1,0,3834992,4055264,37.57658845611187,1370,4170,4128,1412,54189,697896,640456,2830,4284,2914,5588,7042,52.11525688318153,6.488991180673202,1454,1,314876,6510,2716,0,1460,156
8937,0,0,0,0,59,1,504,1,0,1618705,4597432,39.35733730830886,1429,2714,2594,1549,48132,747936,566888,2848,4517,3088,4013,5682,32.32645975048923,11.009004714545675,1669,1,295859,21720,1045,0,1419,1923
8938,0,0,1,0,65,1,2339,0,0,1356420,9167820,53.103672189407014,2564,3557,3301,2820,49600,806248,650200,2995,6071,3507,3732,6808,21.93171219946131,16.032190321965594,3076,0,564000,47360,481,1,431,2770
8939,0,0,1,0,65,1,1363,0,0,6790500,11005875,58.09475019311125,2618,6144,5387,3375,43621,785901,590241,2504,6636,4018,5273,9405,44.85532298401161,27.937071795820067,4132,1,610875,151400,2012,0,114,1249
8940,0,1,1,0,65,0,973,0,0,1557578,2779074,29.206163733020468,583,2949,2679,853,51750,749340,733050,2988,4111,3528,5084,6207,42.731721238442994,16.432183852193692,1123,0,191925,37800,1826,1,2405,1432
8941,0,0,1,0,61,1,335,0,0,3625776,6359661,45.59605246071199,1695,4207,3823,2079,39672,523089,709688,2675,5138,3443,4803,7266,41.7612260356422,20.16702112342979,2463,1,482328,20352,1744,0,980,1315
8942,0,0,1,0,60,1,324,0,0,3815356,6425416,46.06517122512408,1692,4350,3920,2122,40365,590460,626796,2598,5150,3458,4826,7378,42.40283009422838,21.04453473308553,2552,1,439254,50740,1798,0,906,1230
8943,0,0,1,0,61,1,1070,0,0,3998675,7973905,51.03920062069938,2035,4710,4140,2605,35697,670359,498943,2491,5666,3631,4596,7771,39.179076048319466,25.063295216948053,3175,1,424615,111150,1535,0,456,1526
8944,0,0,0,1,67,1,43,0,0,6202128,8342751,49.68903299521938,2439,5011,4981,2469,41474,787307,601462,3349,5848,3409,5891,8390,50.11985634456667,5.490867587491313,2499,1,439482,5850,2512,0,910,867
8945,0,1,1,0,65,0,900,0,0,1891309,3260190,31.575306807693888,729,3162,2894,997,55225,768450,768450,3002,4267,3538,5167,6432,43.55456348076513,16.383511463652106,1265,0,234295,34840,1897,1,2273,1373
8946,0,0,0,1,67,1,58,0,0,6374784,8458944,49.95998398718719,2429,5117,5050,2496,41992,786248,613409,3322,5885,3456,5943,8506,50.53711507397311,8.261328108906353,2563,1,451776,12797,2554,0,893,835
8947,0,0,1,0,63,1,1505,0,0,6742656,11028096,58.787753826796276,2982,5881,5407,3456,51750,660537,797750,2717,6647,3665,5142,9072,44.170125650715555,22.470596734382955,3930,1,864000,34602,1951,0,265,1240
8948,0,0,0,0,59,1,569,1,0,2052120,5156475,41.773197148410844,1369,3297,2921,1745,56628,715110,691470,2579,4700,3331,4131,6252,34.292856398964496,19.41043994499176,2121,1,408330,50760,1176,0,1210,1779
8949,0,0,0,1,67,1,22,0,0,6451479,8570781,50.28916384272063,2439,5170,5080,2529,42676,769303,637132,3299,5918,3479,5940,8559,50.50742519669756,9.535934250532243,2619,1,475452,16020,2551,0,860,838
8950,0,0,1,0,65,1,1760,0,0,7485476,12320628,61.26989472816156,3130,6372,5748,3754,47403,679374,751578,2658,7036,3906,5276,9654,44.654227123532216,25.877508159915465,4378,1,859666,66768,1994,0,472,1288
8951,0,0,1,0,60,1,498,0,0,2958643,5980870,44.57577817604534,1652,3811,3476,1987,26164,635110,373240,2675,4997,3345,4499,6821,38.58756276314948,18.584154950164088,2322,1,246388,74035,1489,0,1023,1521
8952,0,0,0,1,68,1,110,0,0,6793424,8715080,50.51732376126036,2382,5384,5214,2552,42966,788865,635190,3245,5967,3585,6077,8799,51.59457335805772,13.206671381360312,2722,1,474672,31450,2662,0,863,753
8953,0,0,1,0,64,1,1560,0,0,7355284,11674082,60.01666435249463,3105,6141,5644,3602,51750,670887,810250,2744,6843,3738,5283,9382,45.18849411078001,23.24492961901667,4099,1,900500,36778,2042,0,361,1199
8954,0,1,0,1,65,0,902,0,0,2424240,3836430,34.20526275297414,954,3458,3242,1170,52200,760728,737775,3063,4449,3495,5351,6737,45.51922670696417,14.706458146888055,1386,1,263250,30672,2072,0,2109,1207
8955,0,1,1,0,65,0,1155,0,0,1591650,2640600,28.460498941515414,690,2895,2775,810,48614,726980,710680,3140,4070,3380,5225,6155,44.328320518603,10.95920259392275,930,0,176580,16920,1965,1,2450,1295
8956,0,0,1,0,58,1,669,0,0,2239732,5499392,43.22036556994862,1438,3497,3067,1868,53312,700672,659456,2514,4812,3374,4143,6441,34.62657938636157,20.741178046223347,2298,0,418432,64070,1199,1,1076,1745
8957,0,0,1,0,64,1,2718,0,0,1022755,9870349,55.25395913416522,2891,3550,3388,3053,54250,808250,701561,3071,6286,3395,3568,6783,18.303005217723125,12.748363342157862,3215,0,662501,26892,335,1,180,2898
8958,0,1,1,0,64,0,1415,0,0,1058196,1744725,23.259406699226016,446,2592,2497,541,52779,706275,777225,3130,3766,3320,5181,5817,44.22668877499196,9.76859066112806,636,0,130381,9975,1956,1,2684,1269
8959,0,0,1,0,64,1,2768,0,0,1001808,9959332,55.60575509783138,2942,3566,3416,3092,54500,805250,702178,3071,6313,3371,3545,6787,18.0,12.247584794411392,3242,1,674056,24300,324,0,129,2897
8960,0,1,1,0,64,0,1415,0,0,1139124,1850790,23.93741840717165,488,2646,2561,573,54675,726750,784890,3145,3803,3315,5218,5876,44.58699361921591,9.28144526553527,658,0,139239,9180,1988,1,2657,1242
8961,0,0,1,0,68,1,1080,0,0,5188681,9798281,53.67494760127857,2520,5043,4682,2881,56628,823042,795834,3040,6282,3762,5202,8444,42.43819034784589,19.073381915508193,3242,1,674154,48735,1801,0,520,1600
8962,0,0,1,0,58,1,483,0,0,3864058,6534902,47.138094997570704,2010,4173,3961,2222,53703,649961,714663,2729,5163,3153,4680,7114,41.701318923986086,14.973857663119091,2434,1,539946,22048,1739,0,719,1202
8963,0,0,1,0,61,1,331,0,0,5525702,6748280,46.8081189538738,1597,5307,4713,2191,41976,609840,652960,2486,5271,3674,5602,8387,50.21951811795888,24.539631017998694,2785,1,464492,69498,2522,0,889,558
8964,0,0,1,0,58,1,1157,0,0,4636008,4860544,40.63249930782009,1393,4717,4459,1651,37878,521088,630016,2686,4595,3202,5752,7661,52.99056519796708,16.391464461441167,1909,1,353314,21930,2808,0,1293,136
8965,0,0,1,0,56,1,742,0,0,3171120,6188940,46.79743582719036,2123,3705,3638,2190,38233,624546,488898,2759,5016,2893,4274,6531,38.05259518088089,8.47749576439433,2257,1,378870,12529,1448,0,636,1378
8966,0,0,1,0,57,1,1617,0,0,4149000,4009317,37.1887079635741,1275,4491,4383,1383,37758,539214,588497,2791,4282,3007,5899,7390,54.772255750516614,10.73170258584833,1491,1,280749,11880,3000,0,1516,101
8967,0,1,1,0,63,0,1791,0,0,729486,1090296,18.49324200890693,208,2609,2475,342,50160,701360,726864,3054,3530,3322,5321,5797,46.184412955021955,11.586137991427458,476,0,77976,16616,2133,1,2846,1055
8968,0,0,1,0,58,1,1023,0,0,1921374,5843682,44.598206241955516,1704,3240,2955,1989,44943,619918,625794,2653,4927,3223,3904,6178,31.080540535840107,16.88448850132384,2274,0,423657,37620,966,1,949,1972
8969,0,0,1,0,62,1,340,0,0,5697549,6902415,47.148700936505136,1607,5402,4786,2223,40205,580635,667575,2489,5328,3721,5668,8507,50.62608023538856,25.0402228233064,2839,1,477945,60368,2563,0,882,542
8970,0,0,1,0,60,1,967,0,0,4998884,5453492,42.473521163190604,1400,4979,4575,1804,47916,598554,731566,2619,4827,3427,5794,8002,52.640288753007425,20.810399855786336,2208,1,436568,30704,2771,0,1219,252
8971,0,0,0,0,56,1,714,1,0,3016080,6027900,46.151923036857305,2063,3613,3546,2130,38070,665050,458460,2763,4960,2897,4246,6443,37.62977544445356,8.47749576439433,2197,1,345060,14204,1416,0,700,1414
8972,0,0,1,0,61,1,1560,0,0,2302036,7622076,49.85980344927164,2456,3442,3412,2486,43870,656124,628530,3036,5552,3096,3992,6508,30.430248109405877,6.459511753224862,2516,0,509630,4350,926,1,580,2140
8973,0,0,1,0,57,1,829,0,0,2685980,6072925,45.880278987817846,1849,3637,3381,2105,35192,611620,478910,2629,4990,3141,4161,6522,35.7211421989835,16.423838460433444,2361,1,349430,46848,1276,0,780,1609
8974,0,0,1,0,58,1,912,0,0,2564289,6176352,46.05431575867782,1739,3712,3330,2121,40887,672672,515424,2530,5033,3294,4121,6624,34.77067730142742,19.96616423236415,2503,1,375417,73726,1209,0,791,1703
8975,0,0,1,0,65,1,2379,0,0,2575096,10485230,56.45352070508977,2975,4207,3995,3187,52117,812630,694190,3078,6477,3502,4098,7497,28.42534080710379,14.64762860497819,3399,0,672457,36676,808,1,103,2482
8976,0,0,1,0,67,1,1044,0,0,6042685,10224915,55.09083408335728,2860,5201,5026,3035,56404,795084,805191,3194,6404,3544,5360,8570,44.62062303464621,13.246969194075609,3210,1,725365,21700,1991,0,334,1378
8977,0,0,1,0,60,1,889,0,0,7645220,9855065,56.96490147450446,3178,5668,5601,3245,54282,662066,756213,2970,6282,3104,5393,8705,48.53864439804639,8.250220863768833,3312,0,808005,5963,2356,1,208,681
8978,0,0,1,0,59,1,1198,0,0,4880720,5058170,41.10960958218893,1329,4939,4578,1690,41881,577649,649481,2632,4683,3354,5881,7932,53.74011537017761,19.623137530621083,2051,1,366730,37544,2888,0,1303,105
8979,0,1,1,0,63,0,1819,0,0,898092,1291588,20.09975124224178,186,2845,2627,404,47088,690552,696946,2979,3601,3415,5420,6042,47.148700936505136,14.772583974080817,622,0,88072,28994,2223,1,2793,974
8980,0,0,1,0,61,1,301,0,0,6828656,8539280,52.61178575186362,2500,5503,5235,2768,33069,675615,465835,2817,5853,3353,5552,8588,49.66890375275057,16.67419489778013,3036,1,417968,55208,2467,0,317,618
8981,0,0,1,0,61,1,1581,0,0,2115790,7523896,49.457052075512955,2326,3431,3311,2446,41514,682872,575212,2956,5522,3196,3941,6507,29.410882339705484,11.232917923179112,2566,0,457402,20880,865,1,630,2211
8982,0,1,1,0,64,0,1771,0,0,1160520,1635926,22.561028345356956,262,3036,2789,509,48841,710294,710294,2967,3723,3461,5494,6250,47.74934554525329,15.727106176144607,756,0,112489,33345,2280,1,2705,934
8983,0,0,1,0,58,1,2073,0,0,3932074,3538146,34.655446902326915,1051,4625,4475,1201,38808,577416,583308,2796,4147,3096,6220,7571,57.21887800367987,13.168301036937951,1351,1,237798,19650,3274,0,1745,328
8984,0,1,0,1,65,0,1282,0,0,2690240,3676960,33.46640106136302,970,3672,3522,1120,45980,722260,686147,3133,4403,3433,5685,6955,49.01020301937138,12.24962545775264,1270,1,234080,22200,2402,0,2163,881
8985,0,0,0,0,57,1,775,1,0,2392274,5743836,44.51965857910413,1802,3369,3189,1982,22366,611478,307188,2718,4880,3078,4105,6267,34.741905532080416,14.250140054524833,2162,1,210092,42120,1207,0,916,1691
8986,0,0,1,0,62,1,2238,0,0,1503439,8748292,52.716221412388805,2719,3380,3320,2779,41064,742928,547752,3088,5927,3208,3689,6528,23.259406699226016,7.952707287670506,2839,1,483546,12060,541,0,369,2607
8987,0,0,1,0,66,1,2137,0,0,3565038,10704828,56.90342696182718,2888,4689,4339,3238,51612,836418,674424,2956,6544,3656,4407,7995,33.18132004607411,18.83111931185242,3588,1,660552,61250,1101,0,68,2205
8988,0,0,1,0,66,1,2071,0,0,3721650,10690875,56.789083458002736,2902,4702,4379,3225,55552,822120,742560,2992,6540,3638,4469,8017,33.97057550292606,18.156929296565615,3548,1,722400,48127,1154,0,90,2161
8989,0,0,1,0,63,1,1141,0,0,2468442,7080236,47.34976240700686,1945,3640,3343,2242,53550,751604,710550,2861,5400,3455,4259,6798,33.18132004607411,17.908164456931132,2539,1,504450,43956,1101,0,916,2057
8990,0,0,1,0,60,1,881,0,0,8423120,10266416,58.1033561853358,3376,5871,5871,3376,55221,708553,720717,3041,6417,3041,5536,8912,49.949974974968704,0.0,3376,0,800112,0,2495,1,335,546
8991,0,0,1,0,60,1,651,0,0,7968172,9589676,56.27610505356603,3125,5725,5683,3167,51750,696440,681300,2986,6195,3070,5544,8753,50.15974481593781,6.48074069840786,3209,0,712575,5880,2516,1,139,512
8992,0,0,1,0,65,1,1289,0,0,9712926,12441577,61.862751312886175,3456,6736,6365,3827,40800,552670,780240,2880,7078,3622,5789,9987,50.37856687124,20.695300402905296,4198,1,918480,14469,2538,0,576,713
8993,0,0,1,0,59,1,1134,0,0,1014847,5124202,41.50903516103452,1363,2672,2312,1723,43968,681046,571008,2614,4697,3334,3563,5646,24.269322199023193,19.075651361919974,2083,1,330816,63720,589,0,1251,2385
8994,0,0,0,0,61,1,1172,1,0,1695788,6221246,44.87761134463375,1271,3599,2856,2014,43848,778428,537486,2346,5103,3832,3931,6688,29.017236257093817,28.17190261249103,2757,1,350436,156030,842,0,1075,2247
8995,0,0,1,0,62,1,237,0,0,7806370,9045245,53.99073994677235,2714,5794,5593,2915,28222,639218,425111,2902,6018,3304,5781,8897,51.749396131742444,14.733734538837195,3116,1,399355,40803,2678,0,188,425
8996,0,0,1,0,61,1,349,0,0,8169182,9350964,55.11805511808268,2904,5861,5727,3038,33048,664848,470934,2944,6116,3212,5767,8939,51.85556864985669,11.959283984848298,3172,1,464814,26934,2689,0,40,389
8997,0,0,1,0,57,1,389,0,0,2444370,5115300,42.07136793592526,1770,3151,3151,1770,44919,598230,627130,2890,4660,2890,4271,6041,37.16180835212409,0.0,1770,1,384090,0,1381,0,1120,1509
8998,0,0,0,1,66,1,1220,0,0,7217925,11249195,58.008620049092706,3245,5630,5510,3365,46440,718745,722088,3223,6708,3463,5488,8973,46.314144707637645,10.966602528904897,3485,1,726840,16080,2145,0,22,1198
8999,0,0,1,0,64,1,61,0,0,7553322,8732934,52.1344415909483,2300,5915,5497,2718,29596,629748,485163,2795,5931,3631,5992,9128,52.716221412388805,21.44730650540546,3136,1,410418,74822,2779,0,495,434
9000,0,0,1,0,60,1,2437,0,0,3589014,3110272,32.155870381627054,704,4835,4505,1034,41944,643712,589568,2678,4042,3338,6479,7843,58.915193286621744,19.028366212642688,1364,1,202664,51150,3471,0,1974,463
9001,0,1,1,0,62,0,1817,0,0,860730,1219920,19.748417658131498,240,2747,2597,390,51296,716312,700672,2978,3518,3278,5335,5875,46.97871858618538,12.26699777646566,540,0,87360,21150,2207,1,2738,921
9002,0,0,1,0,58,1,226,0,0,2686680,5157372,41.90465367951393,1632,3410,3286,1756,51726,652014,684321,2813,4693,3061,4467,6347,39.11521443121589,11.187488446066107,1880,1,409148,14880,1530,0,1181,1407
9003,0,0,1,0,64,1,1953,0,0,2371600,9002000,52.91502622129181,2410,4037,3647,2800,48265,787675,633355,2825,6015,3605,4062,7252,29.103264421710495,19.835609259888148,3190,1,551600,72930,847,0,415,2368
9004,0,0,1,0,64,1,1078,0,0,10271979,12170268,61.554853586049575,3488,6801,6500,3789,49022,619916,815848,2911,7001,3513,5923,10013,52.06726418777925,18.6594545266598,4090,1,962406,12943,2711,0,577,501
9005,0,0,1,0,60,1,1058,0,0,628368,4471194,38.49675310984031,912,2476,1906,1482,42845,630553,618485,2447,4499,3587,3441,5493,20.591260281974,24.042206242316123,2052,1,303810,78660,424,0,1535,2593
9006,0,0,1,0,58,1,322,0,0,2281440,4897200,40.98780306383839,1620,3098,3038,1680,43818,635470,585915,2855,4595,2975,4273,6013,36.851051545376556,7.745966692414834,1740,1,337680,9300,1358,0,1235,1557
9007,0,0,1,0,66,1,1518,0,0,6665400,11474700,58.73670062235365,3326,5506,5382,3450,45696,791588,638592,3202,6776,3450,5258,8832,43.95452195167182,11.214528750203367,3574,1,662400,23064,1932,0,124,1394
9008,0,0,1,0,60,1,618,0,0,9360144,10314432,58.172158288995945,3342,6192,6150,3384,46800,685800,633984,3006,6432,3090,5814,9240,52.592775169218825,6.503581472166948,3426,0,703872,6468,2766,1,336,282
9009,0,1,1,0,62,0,1667,0,0,1030560,1496640,21.908902300206645,420,2687,2627,480,56644,742084,742084,3058,3598,3178,5265,5805,46.33573135281238,7.748117453886108,540,0,114240,7680,2147,1,2638,971
9010,0,0,1,0,57,1,410,0,0,2046000,4775100,40.620192023179804,1523,3017,2890,1650,45888,555648,691666,2767,4544,3021,4134,5911,35.21363372331802,11.270126310527191,1777,1,394350,9144,1240,0,1244,1654
9011,0,0,0,0,57,1,768,1,0,1480720,4745940,40.74309757492672,1448,2764,2552,1660,45250,714750,517479,2647,4519,3071,3751,5623,29.866369046136157,14.774444774483948,1872,1,300460,43672,892,0,1199,1967
9012,0,0,1,0,63,1,1710,0,0,2272264,8263484,50.872389367907616,2209,3845,3466,2588,53000,798250,676916,2814,5781,3572,4071,7038,29.631064780058107,19.558902071467248,2967,1,548656,65567,878,0,605,2315
9013,0,0,1,0,64,1,1854,0,0,2830912,9127840,53.36665625650534,2578,4112,3842,2848,55527,798045,714715,2935,6053,3475,4199,7317,31.52776554086889,16.530188773321882,3118,1,635104,42120,994,0,357,2211
9014,0,0,1,0,61,1,625,0,0,9552686,10438207,58.47221562417487,3359,6273,6213,3419,47712,683872,650289,2993,6472,3113,5847,9326,52.85830114561004,7.745966692414834,3479,0,728247,8880,2794,1,366,259
9015,0,1,1,0,62,0,1628,0,0,1090380,1590180,22.58317958127243,480,2678,2648,510,55404,710904,757674,3088,3628,3148,5256,5796,46.238512086787566,5.483301264452448,540,0,123930,3300,2138,1,2608,980
9016,0,1,1,0,62,0,1470,0,0,817000,1342460,20.73644135332772,296,2464,2330,430,56644,743036,743036,2988,3552,3256,5022,5586,43.58898943540674,11.607297633161403,564,0,102340,17152,1900,1,2692,1222
9017,0,0,1,0,61,1,2285,0,0,2561816,2538744,28.705400188814647,400,4357,3933,824,40365,637767,600795,2657,3905,3505,6190,7438,55.758407437802596,21.87697719547428,1248,1,160680,62328,3109,0,2257,28
9018,0,0,1,0,62,1,1168,0,0,2002905,6636870,45.98912915026767,1584,3593,3062,2115,55575,775086,706050,2607,5253,3669,4085,6731,30.773365106858236,23.088438222953595,2646,1,475875,80181,947,0,1023,2191
9019,0,0,0,1,68,1,634,0,0,11767536,12802086,61.335144900782616,3477,7175,6890,3762,52416,707824,857556,3118,7165,3688,6531,10578,55.92852581643825,18.273413871518187,4047,1,948024,17670,3128,0,359,275
9020,0,0,0,1,67,1,768,0,0,11782660,12907194,61.95159400693416,3568,7178,6908,3838,55458,797031,786942,3093,7201,3633,6433,10541,55.40758070878027,17.36154631383278,4108,1,898092,31860,3070,0,475,293
9021,0,0,1,0,59,1,180,0,0,2275021,4785389,40.01249804748511,1431,3192,3022,1601,45202,579866,696437,2819,4590,3159,4410,6181,37.69615364994153,13.057424488445035,1771,1,373033,14280,1421,0,1388,1568
9022,0,0,1,0,57,1,419,0,0,1782662,4487875,39.50949253027682,1408,2856,2703,1561,41184,506000,672750,2722,4436,3028,4017,5731,33.793490497431605,12.939497000677182,1714,1,365274,8568,1142,0,1314,1733
9023,0,0,0,0,61,1,1174,1,0,994080,5368032,41.7612260356422,1228,2830,2314,1744,38640,738720,495558,2562,4822,3594,3648,5908,23.874672772626646,24.1036559565902,2260,1,280784,111972,570,0,1334,2508
9024,0,0,1,0,62,1,1005,0,0,1834074,6098004,44.12482294582042,1347,3489,2889,1947,56350,767340,720360,2532,5079,3732,4074,6621,30.692018506445613,24.64699331137373,2547,1,447810,85200,942,0,1185,2190
9025,0,0,0,1,68,1,443,0,0,11981430,12671460,60.74537019394976,3308,7319,6937,3690,56876,810424,827594,3052,7124,3816,6681,10753,56.9824534396335,20.720722560347973,4072,1,889290,45458,3247,0,256,187
9026,0,1,0,1,68,0,1316,0,0,4738112,5494400,40.19950248448356,1388,4776,4548,1616,54044,802400,778600,3172,5016,3628,6332,8176,54.147945482723536,15.285101559010016,1844,1,370064,32148,2932,0,1784,468
9027,0,1,1,0,62,0,1414,0,0,1208400,1864200,24.49489742783178,570,2644,2614,600,54656,758108,695968,3077,3707,3137,5121,5751,44.87761134463375,5.501408174353464,630,0,134400,4620,2014,1,2507,1093
9028,0,0,1,0,60,1,297,0,0,2096428,4860120,40.049968789001575,1370,3145,2911,1604,44238,612060,663570,2796,4634,3264,4337,6175,36.15245496505044,15.44274944957253,1838,1,351276,26442,1307,0,1426,1723
9029,0,0,1,0,63,1,1488,0,0,2467108,7875386,49.8196748283246,2212,3746,3476,2482,51562,805942,644119,2903,5655,3443,4167,6919,31.52776554086889,16.57077561114505,2752,1,503846,49140,994,0,691,2179
9030,0,0,1,0,64,1,1778,0,0,4449200,10233160,56.37375275782161,3136,4620,4578,3178,45384,785680,598920,3178,6398,3262,4620,7840,37.416573867739416,6.5135556243263055,3220,0,591108,8274,1400,1,42,1820
9031,0,0,0,1,68,1,415,0,0,12175464,12708696,60.852280154485584,3319,7375,6991,3703,56350,789360,840840,3048,7135,3816,6720,10807,57.3410847473258,20.741822434079033,4087,1,907235,41472,3288,0,271,144
9032,0,0,1,0,61,1,560,0,0,10110464,10648624,58.92367945062494,3472,6384,6384,3472,47380,705410,631802,3067,6539,3067,5979,9451,53.96295025292817,0.0,3472,0,715232,0,2912,1,405,155
9033,0,0,1,0,63,1,722,0,0,7492800,7634400,48.98979485566356,1589,6333,5522,2400,47286,677553,706182,2370,5581,3992,6303,9514,55.87486017879597,28.509573695724452,3211,1,532800,100564,3122,0,781,59
9034,0,0,1,0,61,1,2218,0,0,3213783,3083913,31.606961258558215,676,4539,4216,999,54587,762489,682227,2764,4086,3410,6304,7626,56.71860364994893,17.9861379732897,1322,1,220779,51357,3217,0,2088,130
9035,0,0,1,0,61,1,2190,0,0,2506600,2566360,28.809720581775867,465,4215,3850,830,53217,751356,677148,2727,3922,3457,6112,7307,54.954526656136345,19.125589927562057,1195,1,181770,58400,3020,0,2262,72
9036,0,1,0,1,67,0,1376,0,0,4562192,5281064,39.44616584663204,1261,4783,4488,1556,54858,834924,756862,3099,4950,3689,6326,8177,54.147945482723536,17.297609256991084,1851,1,346988,46020,2932,0,1838,462
9037,0,1,0,1,67,0,1407,0,0,4391398,5110237,38.82009788756334,1184,4744,4421,1507,55926,810449,793494,3068,4898,3714,6305,8135,53.98147830506312,18.070613906473763,1830,1,352638,43928,2914,0,1884,477
9038,0,1,0,1,67,0,1439,0,0,4223826,4938246,38.18376618407357,1128,4685,4355,1458,55660,819654,779010,3057,4845,3717,6284,8072,53.823786563191554,18.39607091692012,1788,1,335340,47520,2897,0,1929,490
9039,0,1,0,1,67,0,1487,0,0,3986238,4689447,37.242448899072144,1057,4591,4261,1387,54918,821583,764106,3051,4768,3711,6255,7972,53.60970061472084,18.361276395823488,1717,1,313462,49830,2874,0,1994,507
9040,0,0,0,1,67,1,1477,0,0,7873320,12263160,60.332412515993425,3264,6179,5803,3640,51940,825405,714228,2993,7009,3745,5532,9548,46.50806381693394,19.48632853779304,4016,1,771680,64296,2163,0,271,1206
9041,0,0,0,1,67,1,1330,0,0,8378675,12340825,60.29096117993144,3161,6414,5940,3635,50508,828380,702765,2921,7030,3869,5700,9809,48.010415536631214,21.841841340995526,4109,1,752445,83424,2305,0,240,1090
9042,0,0,0,1,68,1,416,0,0,12361220,12778980,61.07372593840988,3364,7410,7044,3730,55860,781128,839370,3060,7156,3792,6740,10836,57.56735185849702,20.284496844359232,4096,1,913850,39162,3314,0,304,112
9043,0,0,1,0,64,1,13,0,0,9039000,9683782,54.89080068645383,2637,6389,6013,3013,27559,697438,408178,2838,6227,3590,6214,9603,54.772255750516614,20.385728117148574,3389,1,382651,84224,3000,0,201,214
9044,0,0,1,0,63,1,856,0,0,7395825,7377225,48.218253804964775,1593,6238,5506,2325,47085,682195,694887,2441,5498,3905,6354,9411,56.4003546088143,27.08216998421725,3057,1,509175,95160,3181,0,848,8
9045,0,1,0,1,68,0,1210,0,0,5804231,6435575,43.347433603386484,1726,5121,4968,1879,54988,798025,808300,3272,5304,3578,6514,8546,55.57877292636101,12.639835959643802,2032,1,443444,19584,3089,0,1546,336
9046,0,1,0,1,67,0,1418,0,0,4483608,5160264,39.03844259188627,1223,4767,4466,1524,56160,812640,792324,3085,4910,3687,6328,8153,54.24020648928247,17.605763289500135,1825,1,356616,40635,2942,0,1862,444
9047,0,1,1,0,62,0,1200,0,0,1075204,1853800,24.454038521274967,538,2456,2396,598,54432,753300,694400,3040,3698,3160,4898,5556,42.40283009422838,7.750803389552748,658,0,133952,9180,1798,1,2502,1302
9048,0,0,0,0,59,1,1096,1,0,804297,4771416,39.98749804626441,1257,2444,2102,1599,35178,734064,426712,2642,4583,3326,3487,5428,22.427661492005804,19.508859164271403,1941,1,228657,75924,503,0,1385,2481
9049,0,0,1,0,62,1,980,0,0,1725504,5882228,43.497126341863094,1298,3398,2804,1892,55209,743051,718179,2515,5001,3703,4021,6507,30.199337741083,24.436119582157808,2486,1,437052,83754,912,0,1217,2197
9050,0,0,1,0,62,1,1343,0,0,1749860,6719290,46.42197755374064,1860,3262,2967,2155,52416,785736,648544,2823,5273,3413,3930,6380,28.495613697550013,17.211421103174878,2450,1,448240,52510,812,0,963,2306
9051,0,0,1,0,66,1,1701,0,0,7169940,12184140,60.4979338490167,3329,5950,5619,3660,49735,815605,675787,2998,6989,3660,5288,9279,44.26059195266146,18.200417265508182,3991,1,742980,59911,1959,0,331,1370
9052,0,0,0,1,67,1,1382,0,0,8361248,12435616,60.530983801686226,3161,6449,5946,3664,50225,831530,695770,2891,7058,3897,5676,9843,47.77028364998475,22.504408854855598,4167,1,751120,89534,2282,0,270,1112
9053,0,0,0,1,69,1,336,0,0,12581377,12856583,60.983604353957304,3289,7532,7102,3719,52961,729427,867707,3027,7176,3887,6840,10989,58.16356247686347,21.967173974273358,4149,1,933469,33540,3383,0,262,74
9054,0,0,1,0,67,1,576,0,0,12519556,12922546,61.95159400693416,3626,7312,7100,3838,48880,700336,791245,3155,7205,3579,6629,10679,57.113921245174545,15.904668956604429,4050,1,901930,13568,3262,0,471,105
9055,0,0,1,0,64,1,211,0,0,8712032,9233216,53.36665625650534,2296,6459,5907,2848,53118,758628,735934,2690,6090,3794,6301,9701,55.308227236099334,24.32426096213147,3400,1,646496,78384,3059,0,394,183
9056,0,1,1,0,62,0,1212,0,0,1278853,2099377,26.019223662515376,677,2566,2566,677,53775,741139,697725,3101,3778,3101,4990,5667,43.46262762420146,0.0,677,0,152325,0,1889,1,2424,1212
9057,0,0,1,0,61,1,561,0,0,1726312,4993800,40.29888335921977,1263,3048,2687,1624,45066,682650,624225,2714,4699,3436,4138,6123,32.60368077380221,19.13419628540056,1985,1,329672,56677,1063,0,1451,2012
9058,0,0,1,0,62,1,1053,0,0,1234468,5494524,41.90465367951393,1006,3209,2459,1756,55890,760347,719670,2379,4885,3879,3832,6338,26.514147167125703,27.488572142270264,2506,1,403880,108750,703,0,1373,2426
9059,0,0,1,0,66,1,1745,0,0,7177050,12291390,60.74537019394976,3395,5930,5635,3690,48216,819426,652876,3036,7021,3626,5276,9261,44.10215414239989,17.186654990277734,3985,1,723240,55460,1945,0,359,1386
9060,0,0,0,1,68,1,364,0,0,12761805,12930960,61.310684223877324,3369,7544,7154,3759,50094,681120,870320,3050,7199,3830,6835,10984,58.26662852782886,20.95729893833533,4149,1,951027,21840,3395,0,319,45
9061,0,0,1,0,67,1,522,0,0,12719655,12953712,61.94352266379432,3603,7386,7152,3837,49698,668448,847376,3142,7213,3610,6691,10762,57.57603668193913,16.482158661538314,4071,1,963087,10062,3315,0,461,61
9062,0,0,1,0,65,1,732,0,0,12725440,12915136,62.864934582006846,3832,7292,7172,3952,47740,718960,709156,3148,7220,3388,6488,10560,56.74504383644443,11.232917923179112,4072,1,857584,11520,3220,0,684,48
9063,0,0,1,0,64,1,480,0,0,8329216,8552320,51.536394906900505,1934,6514,5792,2656,52440,740600,734160,2498,5876,3942,6356,9734,56.0,27.351983558249,3378,1,605568,98192,3136,0,564,84
9064,0,0,1,0,62,1,1900,0,0,5549100,4973520,39.87480407475377,1219,5451,5080,1590,45570,678776,656880,2757,4718,3499,6618,8579,59.07622195096772,19.309076840943675,1961,1,333900,53424,3490,0,1538,362
9065,0,1,0,1,67,0,1291,0,0,5593182,6122340,42.49705872175156,1559,5150,4903,1806,56144,786480,820380,3143,5196,3637,6487,8540,55.65069631190611,15.728841120111328,2053,1,437052,25935,3097,0,1584,293
9066,0,1,0,1,67,0,1306,0,0,5497947,6025123,42.20189569201838,1525,5124,4868,1781,56144,784856,818686,3127,5164,3639,6470,8507,55.560777532356404,16.006100026270712,2037,1,431002,27136,3087,0,1602,296
9067,0,0,1,0,61,1,611,0,0,1650390,5004828,40.32369030731191,1242,3025,2641,1626,45878,695628,624834,2694,4704,3462,4093,6103,31.85906464414798,19.7183890308245,2010,1,330078,61824,1015,0,1452,2063
9068,0,0,1,0,60,1,81,0,0,2044690,4423297,38.353617821530214,1363,2969,2861,1471,53500,643498,751750,2899,4478,3115,4397,5976,37.282703764614496,10.471798365004291,1579,1,367750,8964,1390,0,1536,1617
9069,0,0,1,0,60,1,167,0,0,1752630,4235640,37.54996671103717,1260,2803,2653,1410,35820,597796,540720,2854,4414,3154,4247,5807,35.25620512760839,12.639835959643802,1560,1,253800,23100,1243,0,1594,1761
9070,0,0,1,0,63,1,1548,0,0,3465180,8838720,52.820450584977024,2760,4062,4032,2790,54168,772992,703296,3138,5958,3198,4410,7230,35.24202037341219,5.483301264452448,2820,0,619380,4710,1242,1,378,1926
9071,0,0,1,0,64,1,1633,0,0,4928918,10296952,56.40921910468182,2992,4921,4731,3182,46795,792820,618076,3046,6418,3426,4785,8157,39.35733730830886,13.858285473715528,3372,0,607762,36670,1549,1,54,1687
9072,0,0,0,1,67,1,1580,0,0,8078400,12618760,61.155539405682624,3356,6284,5900,3740,51336,836752,698418,2990,7114,3758,5534,9658,46.475800154489,19.685142587227237,4124,1,774180,68352,2160,0,366,1214
9073,0,0,0,1,69,1,312,0,0,12978900,13008996,61.335144900782616,3325,7649,7212,3762,54093,757302,854126,3021,7220,3895,6908,11107,58.73670062235365,22.11907577222737,4199,1,929214,41952,3450,0,304,8
9074,0,0,0,1,68,1,417,0,0,12934534,13010754,61.73329733620261,3488,7528,7205,3811,54900,768150,833016,3091,7225,3737,6808,10942,58.25804665451803,19.179110502909086,4134,1,929884,34238,3394,0,397,20
9075,0,0,1,0,64,1,832,0,0,12953073,13086360,63.55312738174259,3949,7336,7246,4039,52080,777600,703080,3150,7279,3330,6447,10576,56.630380539071076,9.625480693201963,4129,1,876463,12060,3207,0,799,33
9076,0,0,1,0,64,1,858,0,0,12963835,13134145,63.67888189973188,3965,7342,7252,4055,53297,774121,722297,3149,7294,3329,6436,10581,56.542019772908716,9.69343894498722,4145,1,904265,11340,3197,0,816,42
9077,0,1,1,0,62,0,1123,0,0,1404750,2327250,27.386127875258307,665,2708,2623,750,51296,710587,695072,3018,3853,3188,4976,5811,43.278170016764804,9.220820253968727,835,0,168000,11985,1873,1,2353,1230
9078,0,0,1,0,61,1,771,0,0,1205122,4770920,39.35733730830886,942,2934,2327,1549,44030,733040,569800,2473,4629,3687,3858,6014,27.892651361962706,24.70345320136044,2156,1,286565,117151,778,0,1531,2302
9079,0,0,1,0,59,1,232,0,0,1584240,4130340,37.14835124201342,1138,2770,2528,1380,36188,496838,652474,2751,4373,3235,4141,5763,33.88214869219483,15.739623448814104,1622,1,300840,15488,1148,0,1613,1845
9080,0,0,1,0,63,1,1548,0,0,3903808,9232448,53.81449618829484,2836,4304,4244,2896,46605,761932,621660,3128,6084,3248,4536,7492,36.71511950137164,7.789174875971784,2956,0,564720,11040,1348,1,292,1840
9081,0,0,1,0,66,1,1769,0,0,6926612,12183808,60.50619802962338,3419,5795,5553,3661,49980,815360,678912,3086,6989,3570,5220,9123,43.497126341863094,15.565903057519908,3903,1,746844,43560,1892,0,333,1436
9082,0,0,0,1,66,1,1726,0,0,7624680,12578844,61.28621378417825,3514,6028,5786,3756,53000,837250,709988,3107,7105,3591,5379,9377,45.05552130427524,15.628168044365268,3998,1,796272,41624,2030,0,407,1319
9083,0,0,0,1,68,1,366,0,0,13150672,13093462,61.75759062657804,3443,7633,7262,3814,48888,666002,865116,3062,7247,3804,6881,11066,58.71967302361279,20.47254941623697,4185,1,961128,20034,3448,0,381,15
9084,0,0,0,1,68,1,391,0,0,13142310,13077268,61.85466837676846,3484,7603,7261,3826,51792,710944,851082,3076,7244,3760,6853,11021,58.60887304837041,19.65900277136432,4168,1,952674,27018,3435,0,408,17
9085,0,0,1,0,66,1,547,0,0,13105728,12992512,62.48199740725323,3729,7436,7261,3904,43596,575744,838656,3153,7232,3503,6685,10764,57.9396237474839,14.028067812123815,4079,1,983808,0,3357,0,576,29
9086,0,1,0,1,67,0,1286,0,0,5997575,6381042,43.46262762420146,1604,5349,5064,1889,56640,797208,810720,3093,5267,3663,6553,8727,56.34713834792323,16.882410640555065,2174,1,453360,33915,3175,0,1489,203
9087,0,1,1,0,65,0,1630,0,0,3095496,3653000,33.52610922848042,824,4178,3878,1124,56880,770250,780000,2950,4374,3550,6004,7428,52.478567053607705,17.321710763476855,1424,0,269760,35700,2754,1,2126,496
9088,0,1,1,0,59,0,1228,0,0,408000,813008,16.492422502470642,5,2049,1772,272,56406,708393,711382,2712,3261,3266,4489,5038,38.72983346207417,16.79359465994813,549,0,64736,35179,1500,1,2717,1489
9089,0,0,0,1,67,1,1687,0,0,8029400,12802200,61.644140029689765,3450,6263,5913,3800,49848,835512,677169,3019,7169,3719,5482,9632,45.967379738244816,18.79206254388765,4150,1,763800,64400,2113,0,431,1256
9090,0,0,0,1,67,1,1561,0,0,8333910,12776148,61.40846847137616,3286,6466,5981,3771,49551,843612,674212,2903,7159,3873,5598,9854,47.01063709417264,22.123971652083423,4256,1,750429,90695,2210,0,383,1178
9091,0,0,0,1,68,1,418,0,0,13329968,13183060,62.177166226839255,3560,7620,7314,3866,52704,736560,832040,3104,7276,3716,6858,11030,58.71967302361279,18.73571627890532,4172,1,943304,29376,3448,0,456,38
9092,0,0,1,0,64,1,751,0,0,13324230,13024900,63.60031446463138,4015,7369,7339,4045,54755,756700,750260,3190,7265,3250,6514,10589,57.39337940912697,5.483301264452448,4075,1,942485,4050,3294,0,825,74
9093,0,0,1,0,63,1,970,0,0,12811319,12950617,64.00781202322104,4007,7314,7224,4097,53250,673293,790250,3071,7258,3251,6288,10475,55.91958512006326,9.491514370027666,4187,0,1024250,7290,3127,1,936,34
9094,0,0,1,0,62,1,512,0,0,11130180,11209424,60.01666435249463,3517,6777,6692,3602,40301,656632,594392,3027,6714,3197,6202,9889,55.58776843874919,9.265143265380413,3687,1,687982,13260,3090,0,490,22
9095,0,0,1,0,67,1,469,0,0,13513182,13266348,62.5939294181153,3676,7609,7367,3918,48576,650112,856658,3144,7304,3628,6835,10995,58.728187440104094,16.842470750656727,4160,1,991254,11374,3449,0,532,63
9096,0,0,1,0,65,1,623,0,0,13500624,13048737,63.23764701504951,3932,7442,7375,3999,53676,695019,822276,3196,7262,3330,6639,10705,58.1033561853358,8.456490803821907,4066,1,1007748,4891,3376,0,736,113
9097,0,0,1,0,64,1,724,0,0,13514592,13072488,63.686733312362634,4056,7388,7388,4056,53088,721952,763851,3223,7279,3223,6555,10611,57.723478758647246,0.0,4056,0,961272,0,3332,1,833,109
9098,0,0,0,0,61,1,1188,1,0,488053,4614594,38.87158345115362,1027,2318,1834,1511,49276,775716,592476,2570,4565,3538,3377,5372,17.97220075561143,23.22394157774412,1995,1,293134,90024,323,0,1543,2731
9099,0,0,0,1,66,1,1831,0,0,7027080,12406200,60.991802727907626,3600,5729,5609,3720,55029,830415,737035,3215,7055,3455,5224,9064,43.46262762420146,11.02247049704286,3840,1,822120,18840,1889,0,385,1446
9100,0,0,0,1,67,1,1776,0,0,8056132,13018802,62.14499175315739,3511,6299,5948,3862,49164,812411,687684,3020,7233,3722,5457,9670,45.67274898667694,18.825613524806947,4213,1,787848,61776,2086,0,491,1285
9101,0,0,1,0,67,1,470,0,0,13716296,13345372,62.81719509815764,3706,7662,7422,3946,47564,635816,855646,3142,7328,3622,6858,11044,58.957611891934704,16.72978454591016,4186,1,998338,9600,3476,0,564,94
9102,0,0,1,0,64,1,822,0,0,13751440,13275110,64.35837163881635,4112,7492,7462,4142,54466,772405,724330,3175,7347,3235,6525,10697,57.619441163551734,5.501408174353464,4172,0,936092,4470,3320,1,937,115
9103,0,0,1,0,64,1,895,0,0,13791084,13405788,64.71475874945375,4158,7511,7481,4188,55671,771441,739431,3171,7389,3231,6494,10712,57.38466694161429,5.531194905403055,4218,0,967428,4260,3293,1,987,92
9104,0,1,1,0,62,0,833,0,0,1365368,2555224,28.705400188814647,654,2651,2481,824,51756,707028,703927,2931,3925,3271,4758,5752,40.70626487409524,13.03851759791075,994,0,187048,22950,1657,1,2277,1444
9105,0,0,0,1,66,1,1866,0,0,7337736,12677724,61.62791575252241,3648,5880,5730,3798,49446,821148,670938,3188,7136,3488,5270,9218,43.95452195167182,12.282138241571156,3948,1,763398,27600,1932,0,460,1406
9106,0,0,0,1,68,1,419,0,0,13932492,13438992,62.83311228962003,3647,7778,7477,3948,52750,718244,851000,3103,7352,3705,6933,11182,59.405386961116584,18.54021917667712,4249,1,987000,23779,3529,0,544,125
9107,0,0,1,0,64,1,770,0,0,13936784,13278842,64.32728814430156,4078,7566,7506,4138,46144,661054,718816,3149,7347,3269,6577,10775,58.034472514187634,7.83531632499182,4198,0,926912,6720,3368,1,929,159
9108,0,0,1,0,62,1,852,0,0,13024480,12736220,63.71812928829596,4060,7268,7268,4060,51948,696414,734058,3137,7197,3137,6345,10405,56.639209034025185,0.0,4060,0,950040,0,3208,1,923,71
9109,0,1,1,0,61,0,859,0,0,998186,2015454,25.65151067676132,361,2472,2175,658,52392,722868,679986,2766,3721,3360,4580,5535,38.948684188300895,17.30016879296595,955,0,146076,44550,1517,1,2405,1546
9110,0,0,0,1,67,1,1898,0,0,7920299,13203111,62.601916903558156,3613,6246,5940,3919,48923,811929,683907,3063,7288,3675,5390,9615,44.955533585978046,17.595125361206108,4225,1,795557,53856,2021,0,550,1348
9111,0,0,1,0,66,1,519,0,0,14111650,13383125,63.4428877022476,3835,7721,7531,4025,40662,538650,834575,3135,7350,3515,6831,11046,59.21148537234985,14.455839300922326,4215,1,1010275,0,3506,0,700,181
9112,0,0,1,0,64,1,541,0,0,9262910,9045680,52.773099207835045,2043,6853,6111,2785,46652,708064,695072,2506,6033,3990,6574,10101,57.67148342118486,27.32653618322851,3527,1,595990,103880,3326,0,463,78
9113,0,1,0,1,69,0,1212,0,0,7636005,7698249,47.148700936505136,1828,6053,5658,2223,52371,716841,876139,3068,5686,3858,6898,9516,58.60887304837041,20.028843792657735,2618,1,562419,26465,3435,0,1240,28
9114,0,1,0,1,67,0,1381,0,0,6244266,6377406,43.61192497471305,1712,5375,5185,1902,51754,757778,767837,3163,5255,3543,6636,8728,57.29746940310715,13.874881522629007,2092,1,435558,24890,3283,0,1451,70
9115,0,1,1,0,62,0,1027,0,0,1869378,2970739,30.773365106858236,917,2951,2921,947,48930,730921,658770,3107,4084,3167,5111,6088,44.429719783046124,5.501408174353464,977,0,198870,4860,1974,1,2190,1163
9116,0,0,1,0,62,1,1488,0,0,1228689,6449058,45.59605246071199,2079,2670,2670,2079,49200,744480,635910,3102,5181,3102,3693,5772,24.310491562286437,0.0,2079,0,426195,0,591,1,1023,2511
9117,0,0,1,0,65,1,1661,0,0,5053482,10497431,56.806689746895124,2930,5090,4793,3227,50676,800238,670118,2956,6480,3550,4819,8343,39.57271787481876,17.23959494577348,3524,0,664762,52866,1566,1,26,1687
9118,0,0,0,1,67,1,1896,0,0,7441840,12869780,61.93545026880809,3624,5988,5776,3836,46170,815265,637450,3143,7191,3567,5295,9343,44.04543109109048,14.64762860497819,4048,1,728840,40704,1940,0,481,1415
9119,0,0,1,0,61,1,1782,0,0,4723920,4496472,38.18376618407357,1368,4788,4698,1458,54264,733992,703152,2994,4542,3174,6324,7872,56.92099788303083,9.491514370027666,1548,0,332424,12960,3240,1,1626,156
9120,0,1,0,1,70,0,1175,0,0,8230956,8233297,48.38388161361178,1946,6252,5857,2341,46990,650645,893318,3122,5858,3912,7033,9769,59.295868321494375,20.347138339415288,2736,1,594614,11850,3516,0,1176,1
9121,0,1,0,1,67,0,1391,0,0,6362352,6444955,43.829214001622255,1739,5415,5233,1921,52658,758230,781715,3173,5276,3537,6667,8770,57.54997827975264,13.60027811201657,2103,1,447593,22750,3312,0,1434,43
9122,0,1,0,1,66,0,1499,0,0,5635860,5768100,41.71330722922842,1710,5009,4979,1740,54522,775710,772395,3285,5055,3345,6554,8324,56.91221310052878,5.478746393072713,1770,1,405420,3990,3239,0,1575,76
9123,0,0,0,0,59,1,1201,1,0,248580,4093284,37.16180835212409,1058,1884,1561,1381,46482,752856,542412,2641,4345,3287,3144,4848,13.416407864998739,18.84921316572436,1704,1,252723,62985,180,0,1583,2784
9124,0,0,1,0,66,1,544,0,0,14526057,13531458,63.97655820689325,3901,7834,7642,4093,49852,681036,800052,3114,7399,3498,6855,11140,59.57348403442592,14.271861578069773,4285,1,990506,16896,3549,0,787,243
9125,0,0,1,0,62,1,524,0,0,12420512,11900460,61.61168720299745,3662,7202,7068,3796,38088,648945,576840,3001,6931,3269,6407,10337,57.201398584300364,11.709062801829726,3930,1,698464,21440,3272,0,661,137
9126,0,1,0,1,70,0,1162,0,0,8596560,8541176,49.07137658554119,1988,6398,5978,2408,45466,634913,900938,3127,5955,3967,7117,9945,59.74947698515862,21.15049097876389,2828,1,611632,8820,3570,0,1139,23
9127,0,1,0,1,66,0,1494,0,0,5837832,5910894,42.21374183841087,1782,5058,5058,1782,53352,756276,776178,3317,5099,3317,6593,8375,57.23635208501674,0.0,1782,1,416988,0,3276,0,1535,41
9128,0,1,1,0,62,0,772,0,0,1744380,3086820,31.464265445104548,840,2902,2752,990,54635,763910,695314,2968,4108,3268,4880,6020,41.97618372363071,12.27795318108085,1140,0,220770,23400,1762,1,2128,1356
9129,0,0,1,0,56,1,469,0,0,775842,3258078,33.85262175962151,912,2057,1823,1146,41584,523112,642518,2609,3989,3077,3520,4900,26.019223662515376,15.355460297504811,1380,1,258996,18954,677,0,1697,2166
9130,0,0,1,0,64,1,1606,0,0,4526267,9966403,55.47071299343465,2782,4843,4548,3077,46176,719058,673712,2944,6316,3534,4710,8082,38.353617821530214,17.257911955985243,3372,0,640016,44250,1471,1,162,1768
9131,0,0,1,0,64,1,30,0,0,11122000,10820500,57.879184513951124,2917,7103,6670,3350,32742,691220,494190,2797,6580,3663,6550,10333,57.619441163551734,21.354207851783755,3783,1,512550,86167,3320,0,120,90
9132,0,0,1,0,62,1,1475,0,0,5465946,5333968,41.400483088968905,1629,4988,4903,1714,56160,728208,746880,3027,4826,3197,6301,8100,56.471231613982,9.28144526553527,1799,1,411360,10200,3189,0,1398,77
9133,0,0,1,0,61,1,1757,0,0,4534350,4381875,37.749172176353746,1395,4637,4607,1425,52664,713400,698025,3045,4500,3105,6257,7712,56.40921910468182,5.483301264452448,1455,0,323475,4170,3182,1,1650,107
9134,0,1,0,1,70,0,1197,0,0,8465668,8313860,48.703182647543684,1922,6391,5941,2372,48006,662445,890270,3055,5877,3955,7074,9896,59.74110812497538,21.51228869178191,2822,1,602488,17550,3569,0,1133,64
9135,0,1,1,0,63,0,1191,0,0,2626182,3569436,33.63034344160047,897,3687,3453,1131,55200,757440,725880,2922,4287,3390,5478,6843,48.187135212627034,15.297128382228511,1365,0,260130,33228,2322,1,2025,834
9136,0,1,1,0,62,0,932,0,0,2081100,3294900,32.4037034920393,916,3166,3032,1050,55209,749982,724878,3004,4188,3272,5120,6304,44.51965857910413,11.579864037853417,1184,0,242550,18894,1982,1,2088,1156
9137,0,0,1,0,61,1,422,0,0,1039160,3818600,35.38361202590826,532,2802,2082,1252,42300,716750,549000,2330,4302,3770,3880,5852,28.809720581775867,26.833863825452084,1972,0,225360,140400,830,1,1798,2220
9138,0,0,1,0,66,1,1898,0,0,6728043,12376185,60.91797764207213,3577,5658,5524,3711,46948,807070,646990,3201,7046,3469,5148,8993,42.579337712087536,11.602978935530418,3845,1,719934,25058,1813,0,376,1522
9139,0,1,0,1,68,0,1291,0,0,7765790,7581945,47.06378650300037,1880,6056,5721,2215,53352,739368,845481,3088,5638,3758,6929,9479,59.21148537234985,18.330505732079796,2550,1,547105,30485,3506,0,1208,83
9140,0,1,0,1,67,0,1393,0,0,6916008,6804688,44.98888751680797,1777,5688,5441,2024,51067,749726,769898,3115,5386,3609,6779,9050,58.45511098270193,15.818277562199736,2271,1,463496,31369,3417,0,1338,55
9141,0,1,0,1,66,0,1444,0,0,6527741,6462019,43.965895873961216,1799,5444,5310,1933,50388,738803,762204,3209,5276,3477,6720,8787,58.111960903070546,11.64626725886957,2067,1,440724,16750,3377,0,1410,34
9142,0,0,1,0,57,1,388,0,0,754464,3120836,32.92415526630866,789,2075,1780,1084,38092,512462,616106,2584,3963,3174,3575,4954,26.38181191654584,17.386572529291875,1379,1,231976,25075,696,0,1795,2183
9143,0,0,0,0,60,1,966,1,0,546400,4140346,36.959437225152655,813,2319,1766,1366,44250,757750,536487,2478,4397,3584,3431,5350,20.0,23.629113924839828,1919,1,241782,115577,400,0,1665,2631
9144,0,0,0,0,61,1,885,1,0,971674,4645150,39.02563260217571,1162,2522,2161,1523,56394,735050,713700,2689,4573,3411,3688,5572,25.25866188063018,19.086914556656602,1884,1,356382,49096,638,0,1527,2412
9145,0,0,0,1,67,1,1935,0,0,7343950,12961495,62.00806399170998,3532,6068,5755,3845,45504,798927,647232,3058,7216,3684,5281,9439,43.70354676682432,17.799220410962196,4158,1,738240,57905,1910,0,474,1461
9146,0,0,1,0,68,1,275,0,0,15249650,13894575,63.60031446463138,3870,7990,7815,4045,54718,748830,862185,3260,7480,3610,7205,11425,61.40032573203501,13.75618628213112,4220,1,1015295,14700,3770,0,610,335
9147,0,1,0,1,67,0,1388,0,0,7141485,6961656,45.46427168667722,1782,5807,5522,2067,49932,737592,767904,3083,5435,3653,6823,9175,58.77924803874238,16.990833215166347,2352,1,471276,35055,3455,0,1301,87
9148,0,1,0,1,67,0,1401,0,0,7041580,6876016,45.21061822182926,1788,5745,5489,2044,50388,743444,766992,3108,5408,3620,6809,9109,58.69412236331676,16.10659602217231,2300,1,466032,32256,3445,0,1320,81
9149,0,1,0,1,67,0,1414,0,0,6942135,6790560,44.955533585978046,1793,5684,5456,2021,50358,732480,776160,3132,5381,3588,6795,9044,58.60887304837041,15.203452770714037,2249,1,466851,26904,3435,0,1339,75
9150,0,1,0,1,66,0,1433,0,0,6385130,6369850,43.70354676682432,1802,5361,5253,1910,51480,733700,780390,3227,5245,3443,6678,8696,57.81868210189506,10.429745618880121,2018,1,446940,12636,3343,0,1425,8
9151,0,1,1,0,61,0,650,0,0,1193975,2497975,28.548204847240395,653,2442,2280,815,56643,732535,726405,2903,3880,3227,4530,5507,38.27531841800928,12.865825024943737,977,0,193155,20736,1465,1,2250,1600
9152,0,0,1,0,61,1,341,0,0,1237680,4016304,36.0,707,2840,2251,1296,26880,595008,433860,2510,4395,3688,4054,5939,30.903074280724887,24.327942746119618,1885,1,181440,108376,955,0,1803,2144
9153,0,0,1,0,64,1,1730,0,0,4578639,10299558,56.32938842203065,3023,4766,4616,3173,51205,795270,678414,3096,6419,3396,4689,8012,37.986839826445156,12.26699777646566,3323,0,663157,25950,1443,1,73,1803
9154,0,0,1,0,69,1,132,0,0,15574453,13941162,63.34824385884742,3771,8136,7894,4013,56628,812916,840708,3232,7487,3716,7355,11610,62.297672508690084,15.84624764074158,4255,1,971146,27346,3881,0,539,407
9155,0,0,1,0,61,1,1470,0,0,5010511,5015374,40.26164427839479,1579,4754,4712,1621,47300,680680,665210,3052,4715,3136,6185,7848,55.59676249567055,6.484411467763075,1663,0,348515,5922,3091,1,1473,3
9156,0,1,0,1,70,0,1194,0,0,9210240,8845824,49.95998398718719,2046,6636,6186,2496,42588,598936,893088,3094,6040,3994,7234,10180,60.74537019394976,21.75779218831967,2946,1,628992,6300,3690,0,1048,146
9157,0,1,0,1,67,0,1427,0,0,6952010,6772408,44.9221548904324,1802,5679,5463,2018,49680,724896,771880,3140,5374,3572,6801,9035,58.69412236331676,14.787141465807673,2234,1,464140,25488,3445,0,1338,89
9158,0,1,0,1,67,0,1421,0,0,6820332,6688596,44.67661580737735,1804,5605,5413,1996,50609,740571,767379,3159,5347,3543,6768,8956,58.45511098270193,13.93476779920133,2188,1,457084,23808,3417,0,1355,66
9159,0,1,1,0,62,0,636,0,0,1743040,3227120,32.2490309931942,865,2891,2716,1040,55440,744720,716793,2928,4143,3278,4779,5994,40.93897898091744,13.228756555322953,1215,0,240240,24675,1676,1,2063,1427
9160,0,1,1,0,61,0,627,0,0,1253124,2603034,29.13760456866693,722,2452,2325,849,56880,726642,735840,2939,3915,3193,4542,5518,38.41874542459709,11.444189009687426,976,0,203760,15367,1476,1,2217,1590
9161,0,0,1,0,65,1,1833,0,0,5160078,10996722,58.01723881744115,3336,4929,4899,3366,48500,816750,633798,3237,6633,3297,4800,8196,39.153543900903784,5.490867587491313,3396,1,653004,5790,1533,0,99,1734
9162,0,0,1,0,67,1,445,0,0,15604386,14037261,64.64518543557594,4071,8021,7913,4179,54880,752416,822955,3251,7538,3467,7093,11380,61.106464469808756,10.392304845413264,4287,1,1023855,11124,3734,0,820,375
9163,0,0,1,0,66,1,468,0,0,15603093,14035659,64.73793323855806,4064,8041,7914,4191,52290,703290,833901,3222,7540,3476,7072,11390,61.0163912403872,11.275710766281223,4318,1,1043559,10160,3723,0,842,374
9164,0,0,0,1,65,1,109,0,0,11499302,10895305,57.766772456144714,2771,7349,6783,3337,38409,708505,577905,2699,6602,3831,6711,10614,58.70264048575669,24.298284703432508,3903,1,590649,100748,3446,0,72,181
9165,0,1,0,1,68,0,1285,0,0,8482500,8054280,48.373546489791295,2057,6248,5965,2340,53568,743472,853616,3159,5782,3725,7067,9690,60.207972893961475,16.927947446898056,2623,1,580320,25187,3625,0,1102,183
9166,0,1,0,1,67,0,1344,0,0,7917865,7546958,47.12748667179272,1981,6026,5786,2221,54189,757754,825714,3158,5619,3638,6963,9424,59.70762095411272,15.49200062368612,2461,1,539703,25440,3565,0,1177,167
9167,0,1,0,1,67,0,1403,0,0,7133780,6929840,45.387222871640866,1802,5781,5523,2060,49042,729988,760264,3106,5424,3622,6827,9145,58.84725991921799,16.167753428646282,2318,1,465560,31992,3463,0,1304,99
9168,0,1,1,0,63,0,1159,0,0,3543110,4432710,37.282703764614496,1348,3981,3939,1390,52430,682446,781305,3147,4579,3231,5738,7170,50.48762224545735,6.5135556243263055,1432,0,340550,3906,2549,1,1799,640
9169,0,0,0,1,67,1,1959,0,0,7268872,13056264,62.03224967708329,3446,6139,5737,3848,43848,787176,641277,2991,7241,3795,5282,9532,43.46262762420146,20.204498347212244,4250,1,727272,73566,1889,0,455,1504
9170,0,0,1,0,69,1,5,0,0,16164414,14022820,63.387695966961914,3817,8242,8041,4018,55692,830620,816660,3289,7508,3691,7513,11732,63.42712353559792,14.74661454265269,4219,1,940212,24120,4023,0,528,533
9171,0,0,1,0,68,1,160,0,0,15985601,14060313,63.86704940734306,3889,8188,7998,4079,56153,803151,830727,3257,7526,3637,7366,11635,62.601916903558156,13.934305809385554,4269,1,983039,20520,3919,0,632,472
9172,0,0,1,0,65,1,566,0,0,9125067,9070047,52.44997616777342,2270,6549,6068,2751,47286,702261,731934,2816,6048,3778,6614,9846,57.59340239992772,22.321692707211003,3232,1,610722,59163,3317,0,546,20
9173,0,1,0,1,68,0,1342,0,0,8158115,7703252,47.57099956906519,2051,6080,5868,2263,52030,731860,823768,3192,5667,3616,7009,9484,60.0416522091123,14.5641867111093,2475,1,547646,20988,3605,0,1141,201
9174,0,1,0,1,66,0,1339,0,0,6534576,6574036,44.41846462902562,1783,5475,5285,1973,53703,736372,809676,3142,5305,3522,6644,8807,57.54997827975264,13.793584592280734,2163,1,479439,19570,3312,0,1359,20
9175,0,1,0,1,66,0,1324,0,0,6285405,6414782,43.94314508543966,1751,5366,5186,1931,56165,780670,793958,3142,5253,3502,6577,8688,57.05260730238365,13.416407864998739,2111,1,461509,22320,3255,0,1391,67
9176,0,1,1,0,60,0,661,0,0,813330,1910160,25.099800796022265,268,2283,1921,630,54036,718584,691296,2670,3662,3394,4323,5315,35.93048844644336,19.18718499514319,992,0,143640,52128,1291,1,2402,1741
9177,0,1,1,0,59,0,950,0,0,203400,537840,13.416407864998739,46,1444,1310,180,51075,678276,672300,2854,3168,3122,4118,4432,33.61547262794322,11.675279088410905,314,0,40500,18224,1130,1,2808,1858
9178,0,0,1,0,63,1,164,0,0,1447712,4061064,35.888716889852724,864,2836,2412,1288,49494,690507,712578,2729,4441,3577,4277,5989,33.52610922848042,20.9414193014061,1712,1,291088,53424,1124,0,1865,2029
9179,0,0,1,0,62,1,148,0,0,1537088,4121712,36.27671429443411,951,2849,2484,1316,44585,579420,754812,2767,4448,3497,4300,5981,34.17601498127012,19.395175498515076,1681,1,317156,21900,1168,0,1816,1964
9180,0,0,0,0,59,1,944,1,0,330752,3621248,34.87119154832539,724,1980,1488,1216,39928,738544,479458,2486,4194,3470,3250,4958,16.492422502470642,22.725374355616005,1708,1,195776,108240,272,0,1762,2706
9181,0,0,1,0,63,1,1475,0,0,2803164,8121988,50.665570163573605,2537,3689,3659,2567,54340,781508,696080,3134,5731,3194,4256,6853,33.04542328371661,5.483301264452448,2597,0,564740,4800,1092,1,597,2072
9182,0,0,1,0,68,1,233,0,0,16150848,14148540,64.319514923544,3984,8194,8041,4137,56619,796860,831060,3267,7557,3573,7324,11614,62.48199740725323,12.777823675816368,4290,1,1005291,17136,3904,0,717,484
9183,0,0,1,0,65,1,38,0,0,12298688,11491234,59.38013135721409,3010,7530,7014,3526,33231,681131,518181,2743,6785,3775,6747,10789,59.0592922409336,23.2366448420508,4042,1,560634,97008,3488,0,267,229
9184,0,0,1,0,66,1,417,0,0,10110310,9863136,54.57105459856901,2465,6886,6373,2978,42230,678960,682272,2799,6290,3825,6707,10198,58.26662852782886,22.814316459104212,3491,1,613468,68229,3395,0,334,83
9185,0,0,1,0,66,1,497,0,0,9341670,9321944,53.08483775994799,2359,6592,6133,2818,45990,724452,694680,2849,6126,3767,6623,9900,57.57603668193913,21.601457685653532,3277,1,591780,66555,3315,0,490,7
9186,0,0,0,1,64,1,672,0,0,7964068,8101898,50.05996404313531,2223,5967,5684,2506,54560,711260,801784,2950,5739,3516,6411,9200,56.37375275782161,17.17324454564194,2789,1,621488,26319,3178,0,727,55
9187,0,0,1,0,62,1,1065,0,0,5948956,6123752,44.31703961232068,1964,4993,4993,1964,50380,714022,685960,3118,5082,3118,6147,8111,55.036351623268054,0.0,1964,0,432080,0,3029,1,1154,89
9188,0,0,1,0,65,1,1653,0,0,3666208,9507680,53.96295025292817,2656,4427,4171,2912,47580,796660,636675,3009,6177,3521,4524,7692,35.482389998420345,16.267217723015353,3168,1,567840,47872,1259,0,353,2006
9189,0,0,1,0,68,1,210,0,0,16391475,14201790,64.45928947793328,3985,8270,8100,4155,56882,816902,813484,3248,7573,3588,7363,11688,62.80923498976882,13.087862625269288,4325,1,988890,21420,3945,0,737,527
9190,0,0,1,0,67,1,351,0,0,16302922,14181771,64.93843238021688,4217,8083,8083,4217,55842,763401,827298,3363,7580,3363,7229,11446,62.177166226839255,0.0,4217,1,1037382,0,3866,0,854,503
9191,0,0,0,1,65,1,108,0,0,12720573,11782734,60.174745533321534,3137,7618,7134,3621,33734,657308,543418,2770,6875,3738,6767,10872,59.270566050949775,22.503684965692585,4105,1,604707,82764,3513,0,367,259
9192,0,0,0,1,64,1,598,0,0,8158983,8357104,50.724747411889595,2276,6041,5744,2573,52290,682080,808752,2951,5821,3545,6419,9289,56.31163290120435,17.59204960723483,2870,1,640677,24057,3171,0,675,77
9193,0,0,1,0,62,1,1085,0,0,2496264,3496800,33.58571124749333,682,3787,3341,1128,38194,700600,523900,2654,4228,3546,5313,6887,47.042533945356304,21.52174964766925,1574,1,190632,87416,2213,0,1972,887
9194,0,1,0,1,69,0,1278,0,0,9232704,8576748,49.658836071740545,2183,6493,6210,2466,44408,632996,848632,3195,5944,3761,7222,9971,61.18823416311342,17.157031228936447,2749,1,601704,14433,3744,0,1012,266
9195,0,1,0,1,68,0,1313,0,0,8874558,8230572,48.92851929090027,2182,6313,6101,2394,49938,697914,845748,3226,5832,3650,7145,9751,60.88513775955508,14.694496548602537,2606,1,588924,16324,3707,0,1044,269
9196,0,1,0,1,68,0,1324,0,0,8760845,8125417,48.692915295759406,2179,6258,6066,2371,51414,716243,843042,3235,5798,3619,7122,9685,60.78651166171653,13.940215812117822,2563,1,583266,16320,3695,0,1056,268
9197,0,1,0,1,68,0,1359,0,0,8421660,7839507,47.968739820845826,2148,6114,5961,2301,52836,756354,810866,3254,5708,3560,7067,9521,60.4979338490167,12.382505769060717,2454,1,547638,17442,3660,0,1106,253
9198,0,1,0,1,67,0,1312,0,0,7286948,7170238,46.06517122512408,1894,5784,5556,2122,49725,746759,760275,3151,5501,3607,6813,9163,58.60034129593445,15.113881704305674,2350,1,477450,29640,3434,0,1257,55
9199,0,1,0,1,66,0,1270,0,0,6508416,6620080,44.654227123532216,1752,5500,5258,1994,53680,730400,810080,3078,5314,3562,6584,8820,57.1314274283428,15.556415593152641,2236,1,486536,24442,3264,0,1326,56
9200,0,1,1,0,61,0,673,0,0,1585880,2988997,31.096623610932426,787,2787,2607,967,54984,717112,732567,2911,4058,3271,4731,5878,40.496913462633174,13.416511385466217,1147,0,229179,22500,1640,1,2124,1451
9201,0,0,1,0,62,1,62,0,0,1485000,3927500,35.35533905932738,860,2828,2438,1250,51546,669246,760364,2752,4392,3532,4330,5970,34.46737587922817,20.07152168319841,1640,1,302500,37830,1188,0,1892,1954
9202,0,0,1,0,56,1,707,0,0,319260,2884560,31.937438845342623,990,1363,1333,1020,44650,537320,664580,2798,3848,2858,3141,4191,17.69180601295413,5.753771868478424,1050,1,239700,2250,313,0,1808,2515
9203,0,0,1,0,68,1,96,0,0,16725796,14189202,64.32728814430156,4048,8270,8180,4138,56404,809244,819531,3339,7567,3519,7471,11699,63.57672530100933,9.625480693201963,4228,1,988982,10260,4042,0,709,613
9204,0,0,0,1,65,1,175,0,0,13158356,12088148,60.959002616512684,3299,7674,7257,3716,34600,650600,562769,2836,6969,3670,6794,10927,59.50630218724736,20.950614314350315,4133,1,642868,67554,3541,0,463,288
9205,0,0,0,1,65,1,28,0,0,12503100,11566248,59.34644049983116,2940,7654,7072,3522,38448,709344,584552,2702,6806,3866,6834,10938,59.58187643906493,24.69399537618434,4104,1,626916,103014,3550,0,238,266
9206,0,0,1,0,66,1,440,0,0,9041825,9237475,52.86775955154521,2404,6421,6030,2795,52056,713880,796505,2914,6100,3696,6540,9726,56.87706040223949,19.98253964851412,3186,1,673595,39491,3235,0,510,70
9207,0,0,0,1,65,1,496,0,0,8576217,8834553,51.87484939737175,2329,6240,5878,2691,53799,745241,778071,2921,5974,3645,6470,9523,56.45352070508977,19.49696274230846,3053,1,637767,43440,3187,0,592,96
9208,0,0,1,0,61,1,1522,0,0,4265280,4443840,37.94733192202055,1200,4642,4402,1440,47742,672748,675834,2846,4526,3326,6048,7728,54.42425929675111,15.503284344161868,1680,1,315360,32160,2962,0,1646,124
9209,0,1,0,1,71,0,1221,0,0,10128130,9420660,51.28352561983234,2300,6811,6481,2630,50298,723564,891918,3252,6212,3912,7433,10393,62.056425936400814,18.42711417794422,2960,1,654870,23100,3851,0,952,269
9210,0,0,1,0,65,1,1880,0,0,4700169,10790901,57.47173218200405,3150,4879,4726,3303,39105,774279,539055,3114,6570,3420,4690,8146,37.72267222772003,12.555809127227581,3456,1,544995,32283,1423,0,36,1844
9211,0,0,1,0,69,1,16,0,0,17089892,14251204,64.2339474110069,3992,8402,8268,4126,56876,815144,832414,3320,7580,3588,7596,11856,64.35837163881635,11.916523028262294,4260,1,994366,15678,4142,0,672,688
9212,0,0,1,0,68,1,214,0,0,16839576,14341860,64.89992295835181,4078,8344,8210,4212,56153,820605,793365,3271,7617,3539,7403,11749,63.229739838148944,11.586137991427458,4346,1,981396,18358,3998,0,807,593
9213,0,0,0,1,65,1,213,0,0,13505310,12328797,61.506097258727124,3399,7737,7353,3783,38130,668095,606174,2875,7042,3643,6829,10996,59.74947698515862,20.16702112342979,4167,1,703638,59520,3570,0,524,311
9214,0,0,0,1,65,1,13,0,0,12834264,11761153,59.90826320300064,3025,7729,7165,3589,38675,724217,573475,2713,6866,3841,6853,11006,59.799665550904216,24.282585537156173,4153,1,628075,103776,3576,0,312,299
9215,0,0,0,1,65,1,77,0,0,12561998,11548764,59.21148537234985,2882,7713,7089,3506,42112,737856,619272,2670,6800,3918,6877,11007,59.85816569190874,25.551332341373147,4130,1,659128,109200,3583,0,212,289
9216,0,0,0,1,66,1,130,0,0,12168896,11316320,58.51495535331117,2788,7614,6978,3424,43200,743625,634560,2669,6729,3941,6859,10919,59.61543424315552,25.27496625916434,4060,1,657408,109392,3554,0,119,249
9217,0,0,1,0,66,1,204,0,0,11118492,10808028,56.868268832451726,2683,7223,6672,3234,44312,775344,638322,2791,6576,3893,6780,10565,58.63446085707619,23.691626153325767,3785,1,617694,99180,3438,0,108,96
9218,0,0,1,0,66,1,309,0,0,9882886,9960704,54.70831746635972,2575,6713,6295,2993,49504,745472,735488,2910,6321,3746,6630,10041,57.463031594234565,20.75436202802063,3411,1,661453,57684,3302,0,335,26
9219,0,1,0,1,71,0,1253,0,0,10004898,9228096,50.97057974949863,2292,6755,6449,2598,43542,628704,873792,3246,6150,3858,7403,10307,62.056425936400814,17.60846555152559,2904,1,639108,11934,3851,0,954,299
9220,0,1,0,1,69,0,1307,0,0,9385494,8597172,49.78955713801841,2251,6493,6265,2479,40698,593028,825384,3240,5947,3696,7254,9961,61.53048025166064,15.453125209005169,2707,1,590002,9576,3786,0,989,318
9221,0,1,0,1,67,0,1275,0,0,7804684,7544008,47.20169488482379,2094,5865,5731,2228,51504,785552,751692,3252,5614,3520,6889,9251,59.18614702783076,11.59192030070629,2362,1,494616,19564,3503,0,1158,117
9222,0,1,0,1,66,0,1208,0,0,6610065,6764877,45.13313638558703,1855,5464,5282,2037,49350,697410,780435,3139,5358,3503,6566,8785,56.96490147450446,13.507912311643002,2219,1,478695,18746,3245,0,1284,76
9223,0,1,1,0,61,0,651,0,0,1297090,2637989,29.30870177950569,735,2493,2369,859,53361,709401,709401,2947,3930,3195,4581,5564,38.8587184554509,11.15359010904883,983,0,198429,16368,1510,1,2212,1561
9224,0,0,1,0,60,1,1354,0,0,339120,4749250,39.6232255123179,1570,1786,1786,1570,42720,726000,538450,3025,4595,3025,3241,4811,14.696938456699069,0.0,1570,0,279460,0,216,1,1455,2809
9225,0,0,0,1,67,1,1966,0,0,6109311,12324269,60.35726965329032,3261,5702,5320,3643,42716,798388,612323,3001,7026,3765,5060,9085,40.95119045888654,19.720866780635053,4025,1,659383,74490,1677,0,260,1706
9226,0,0,1,0,68,1,216,0,0,17070025,14419400,65.12296062065974,4117,8390,8266,4241,56144,822800,788800,3276,7641,3524,7425,11790,63.4428877022476,11.137157851700797,4365,1,983912,17236,4025,0,841,625
9227,0,0,1,0,66,1,154,0,0,11223272,10935160,57.21887800367987,2737,7239,6702,3274,44506,794920,624580,2803,6614,3877,6768,10579,58.54912467321779,23.375534063411138,3811,1,612238,102030,3428,0,66,88
9228,0,1,0,1,67,0,1259,0,0,8144736,7777856,47.885279575251516,2208,5930,5845,2293,52670,780160,776768,3307,5685,3477,6944,9322,59.59865770300536,9.224644470006377,2378,1,525097,11475,3552,0,1099,160
9229,0,1,0,1,67,0,1223,0,0,7446480,7380930,46.74398357008097,2035,5743,5593,2185,55660,776940,817476,3228,5563,3528,6786,9121,58.378078077305695,12.24962545775264,2335,1,528770,17100,3408,0,1193,30
9230,0,1,0,1,67,0,1201,0,0,7045962,7105350,46.05431575867782,1946,5618,5443,2121,52364,710200,827450,3175,5471,3525,6672,8968,57.63679380395825,13.30116108744132,2296,1,523887,15400,3322,0,1229,28
9231,0,0,0,1,67,1,1971,0,0,6011596,12284408,60.23288138550239,3224,5689,5285,3628,42480,799096,609480,2982,7014,3790,5043,9075,40.70626487409524,20.318587727407923,4032,1,653040,79184,1657,0,242,1729
9232,0,0,1,0,67,1,195,0,0,17316900,14462700,65.26867548832288,4170,8415,8325,4260,55596,835170,767270,3305,7655,3485,7460,11810,63.75735251718032,9.48712577043745,4350,0,962760,13680,4065,1,865,670
9233,0,0,0,1,65,1,231,0,0,14015430,12656358,62.13694553162394,3479,7873,7491,3861,37810,652322,622820,2896,7139,3660,6908,11151,60.249481325568276,20.103813899844663,4243,1,733590,54626,3630,0,583,352
9234,0,0,0,1,65,1,203,0,0,13913790,12564574,61.91122676865643,3429,7867,7463,3833,38164,665434,616264,2874,7111,3682,6908,11145,60.249481325568276,20.69369253534785,4237,1,720604,60196,3630,0,555,352
9235,0,0,0,1,66,1,56,0,0,12088745,11436884,58.728187440104094,2870,7533,6954,3449,43811,752732,639988,2737,6765,3895,6821,10849,59.20304046246274,24.128912769745444,4028,1,665657,100167,3505,0,133,189
9236,0,0,0,1,66,1,85,0,0,11629704,11198600,58.034472514187634,2816,7373,6821,3368,44352,768075,638400,2773,6693,3877,6778,10698,58.762232769015846,23.617090769900248,3920,1,646656,98808,3453,0,43,128
9237,0,0,1,0,62,1,1069,0,0,5080482,5570532,42.21374183841087,1514,4901,4633,1782,44720,672090,650208,2858,4908,3394,5977,8027,53.39475629684998,16.383511463652106,2050,1,370656,38056,2851,0,1344,275
9238,0,1,0,1,67,0,1202,0,0,7636383,7522806,47.19110085598767,2119,5764,5656,2227,55448,783696,807342,3270,5605,3486,6807,9142,58.557663887829406,10.39586690415236,2335,1,532253,13284,3429,0,1151,51
9239,0,1,0,1,67,0,1194,0,0,7500400,7440838,46.968074263269514,2086,5726,5606,2206,55404,769044,819639,3253,5579,3493,6773,9099,58.309518948453004,10.95920259392275,2326,1,536058,13320,3400,0,1167,27
9240,0,1,0,1,66,0,1139,0,0,6584682,6842057,45.37620521815371,1939,5377,5257,2059,47880,697830,757644,3203,5382,3443,6521,8700,56.55086206239477,10.97739094653235,2179,1,469452,13440,3198,0,1264,125
9241,0,0,1,0,56,1,750,0,0,240064,2798432,31.496031496047245,907,1319,1234,992,49504,671398,586768,2736,3813,2906,3063,4140,15.556349186104045,9.219863456115478,1077,0,206336,14365,242,1,1829,2579
9242,0,0,0,1,67,1,1969,0,0,5669112,12018375,59.67411499134277,3177,5537,5153,3561,44880,810000,631125,2991,6936,3759,4967,8912,39.89987468652001,19.837146685531184,3945,1,665907,74112,1592,0,186,1783
9243,0,0,0,1,68,1,1174,0,0,12265032,14267824,64.32728814430156,3505,7735,7102,4138,54216,865448,744768,2815,7586,4081,6412,11183,54.4426303552648,25.44494013271076,4771,1,893808,105078,2964,0,690,484
9244,0,0,1,0,67,1,310,0,0,17465099,14594005,65.85590330410783,4270,8431,8364,4337,55370,760490,824425,3298,7702,3432,7392,11796,63.45864795282043,8.2732738280919,4404,0,1062565,7035,4027,1,972,662
9245,0,0,1,0,64,1,889,0,0,17556002,15045340,68.24954212300622,4598,8487,8427,4658,52948,700910,788120,3170,7888,3290,6999,11717,61.39218191268331,7.772191019407321,4718,0,1136552,5940,3769,1,1428,539
9246,0,0,0,1,66,1,19,0,0,12051222,11497302,58.8387627334226,2910,7495,6943,3462,42147,740583,627669,2769,6783,3873,6802,10816,59.0,23.578202867799913,4014,1,654318,96048,3481,0,141,160
9247,0,0,0,1,66,1,28,0,0,11895405,11417940,58.60887304837041,2894,7439,6898,3435,41664,744576,618264,2783,6759,3865,6787,10763,58.84725991921799,23.353424473239443,3976,1,638910,95757,3463,0,111,139
9248,0,0,0,1,66,1,48,0,0,11593449,11258730,58.146367040426526,2857,7334,6810,3381,43392,752580,639360,2806,6711,3854,6759,10664,58.557663887829406,23.040167522984248,3905,1,649152,90652,3429,0,51,99
9249,0,0,1,0,66,1,187,0,0,9785028,10125060,55.09990925582364,2701,6594,6259,3036,54253,757045,797065,3000,6371,3670,6558,9929,56.77147170894903,18.78591902438533,3371,1,725604,39530,3223,0,299,112
9250,0,0,0,1,66,1,259,0,0,9046340,9515943,53.67494760127857,2604,6298,6021,2881,55328,739872,815841,3026,6184,3580,6443,9601,56.0357029044876,16.97189250944288,3158,1,711607,27700,3140,0,422,163
9251,0,1,0,1,68,0,1231,0,0,8847566,8256598,49.21381919745713,2362,6135,6075,2422,48410,702254,801115,3349,5831,3469,7062,9544,60.440052945046304,7.822290851349969,2482,1,569170,5940,3653,0,987,244
9252,0,1,1,0,60,0,784,0,0,108480,361080,10.954451150103322,81,1225,1024,120,43044,634899,613836,2808,3129,3210,3913,4234,30.066592756745816,14.336946952226079,321,0,24480,28542,904,1,2889,2105
9253,0,0,1,0,66,1,1948,0,0,4893213,11244556,58.23229344616267,3068,5157,4834,3391,38936,822368,520612,2993,6707,3639,4759,8473,37.986839826445156,18.14606063366204,3714,1,532387,71706,1443,0,75,1873
9254,0,0,0,1,66,1,139,0,0,14129010,12635700,61.87891401761993,3362,7986,7519,3829,36616,656700,607200,2833,7129,3767,6990,11286,60.74537019394976,22.175137387927386,4296,1,704536,69583,3690,0,529,390
9255,0,0,0,1,66,1,81,0,0,13135360,12116490,60.53924347066124,3065,7849,7249,3665,37260,684342,595080,2706,6971,3906,6890,11155,59.86651818838306,25.057401997842554,4265,1,659700,98400,3584,0,359,278
9256,0,0,0,1,66,1,10,0,0,11553176,11325778,58.25804665451803,2899,7293,6798,3394,42211,737477,637367,2842,6731,3832,6741,10630,58.34380858325929,22.39968641862707,3889,1,648254,83160,3404,0,57,67
9257,0,0,1,0,67,1,59,0,0,10826520,10953699,57.105166141076936,2831,7011,6581,3261,47520,806160,665082,2929,6620,3789,6679,10370,57.619441163551734,21.128896935500308,3691,1,645678,77830,3320,0,98,39
9258,0,0,0,1,66,1,111,0,0,10144330,10472980,55.94640292279746,2769,6732,6371,3130,55216,776272,796348,2985,6476,3707,6587,10078,56.929781309961136,19.43398462811111,3491,1,744940,44764,3241,0,216,105
9259,0,0,0,1,66,1,123,0,0,10010278,10367123,55.70457790882182,2761,6671,6329,3103,55454,778453,795158,2999,6444,3683,6567,10012,56.79788728465171,18.922216461064046,3445,1,738514,42750,3226,0,238,115
9260,0,0,0,1,66,1,192,0,0,9256720,9754932,54.29548784199291,2680,6356,6088,2948,56376,767688,804087,3041,6257,3577,6449,9665,56.0357029044876,16.767723161690192,3216,1,716364,30016,3140,0,361,169
9261,0,0,0,1,66,1,204,0,0,9134172,9648444,54.055527006958314,2666,6304,6048,2922,56364,762762,805688,3046,6224,3558,6428,9606,55.910642993977454,16.359068810614975,3178,1,712968,27648,3126,0,380,176
9262,0,0,1,0,63,1,403,0,0,7568720,8136374,50.566787519082126,2472,5602,5517,2557,52710,668220,798682,3097,5739,3267,6142,8784,54.405882034941776,9.321211371972165,2642,1,641807,6375,2960,0,625,222
9263,0,1,0,1,70,0,1249,0,0,10013850,9189333,51.0,2367,6685,6451,2601,47530,685402,865585,3299,6134,3767,7383,10218,62.048368229954285,15.36373936684579,2835,1,637245,15678,3850,0,932,317
9264,0,1,0,1,69,0,1230,0,0,9525384,8801232,50.3189825016365,2352,6474,6294,2532,35313,517924,823812,3296,6008,3656,7238,9950,61.335144900782616,14.020454400761464,2712,1,600084,1980,3762,0,944,286
9265,0,1,0,1,67,0,1159,0,0,8024952,7816872,48.08326112068523,2282,5813,5783,2312,54990,794535,791154,3351,5693,3411,6852,9194,58.915193286621744,5.478746393072713,2342,1,541008,3990,3471,0,1069,90
9266,0,1,1,0,60,0,636,0,0,657517,1682226,23.515952032609693,419,1876,1742,553,49504,723996,632736,2908,3595,3176,4231,4918,34.48187929913333,11.607297633161403,687,0,115024,22512,1189,1,2489,1853
9267,0,0,0,0,59,1,507,1,0,721620,3385800,33.76388603226827,990,1923,1773,1140,56386,718740,692010,2820,4110,3120,3603,4893,25.15949125081825,12.30152264982736,1290,1,265620,20700,633,0,1830,2337
9268,0,0,1,0,62,1,1443,0,0,1563130,6748305,46.52956049652737,2123,2929,2887,2165,52002,757431,667038,3075,5282,3159,3839,6046,26.870057685088806,6.484411467763075,2207,0,463310,6972,722,1,952,2395
9269,0,0,0,1,68,1,45,0,0,18313614,14575968,65.24568951279464,4067,8749,8559,4257,56640,808064,821760,3234,7681,3614,7726,12173,65.58963332722634,13.811553506833443,4447,1,1021680,22610,4302,0,833,878
9270,0,0,1,0,68,1,1,0,0,18245712,14576923,65.35288822997802,4137,8677,8543,4271,56619,795229,829359,3279,7684,3547,7685,12090,65.36053855347276,11.581634647011523,4405,0,1037853,15142,4272,1,858,859
9271,0,0,1,0,68,1,22,0,0,18215703,14578553,65.41406576570516,4171,8644,8536,4279,56628,797238,824494,3299,7686,3515,7664,12051,65.24568951279464,10.392304845413264,4387,0,1035518,12528,4257,1,872,850
9272,0,0,1,0,67,1,110,0,0,18102000,14610900,65.6505902486794,4250,8570,8510,4310,54990,796650,793260,3330,7700,3450,7590,11960,64.8074069840786,7.789174875971784,4370,0,1008540,7920,4200,1,920,810
9273,0,0,1,0,66,1,557,0,0,17861898,14905228,67.1863081289633,4419,8566,8471,4514,52245,802386,709930,3207,7816,3397,7259,11868,62.90468980926621,9.785443037298442,4609,0,970510,15770,3957,1,1212,655
9274,0,0,0,1,66,1,156,0,0,13951612,12628154,61.75759062657804,3305,7981,7472,3814,37600,662200,622468,2802,7125,3820,6969,11292,60.481402100149765,23.13170325720972,4323,1,717032,74314,3658,0,503,347
9275,0,0,0,1,66,1,148,0,0,13773468,12535446,61.53048025166064,3255,7955,7424,3786,37788,665511,622468,2780,7097,3842,6949,11266,60.315835400000886,23.645166732800906,4317,1,711768,78588,3638,0,475,327
9276,0,0,1,0,67,1,10,0,0,10936224,11084814,57.463031594234565,2885,7031,6614,3302,45784,792252,651258,2940,6659,3774,6669,10388,57.54997827975264,20.779289655667366,3719,1,640588,75477,3312,0,55,45
9277,0,0,1,0,62,1,816,0,0,5403136,6146848,44.181444068749045,1657,5015,4720,1952,46652,686482,673886,2854,5101,3444,5917,8164,52.61178575186362,17.21691018983201,2247,1,417728,41300,2768,0,1197,381
9278,0,1,0,1,70,0,1210,0,0,9740016,9014148,50.73460357586329,2362,6570,6358,2574,39688,574328,847484,3290,6076,3714,7286,10072,61.514225996918796,15.38108197761382,2786,1,622908,5512,3784,0,928,282
9279,0,1,0,1,66,0,1029,0,0,6353046,6814038,45.36518488885502,2028,5175,5145,2058,48464,688688,771463,3281,5369,3341,6398,8486,55.560777532356404,5.652706486041966,2088,1,479514,3090,3087,0,1253,224
9280,0,1,1,0,61,0,699,0,0,1067040,2276352,27.2213151776324,741,2181,2181,741,48741,648192,709632,3072,3813,3072,4512,5253,37.94733192202055,0.0,741,1,171171,0,1440,0,2331,1632
9281,0,1,1,0,59,0,549,0,0,366210,1167270,19.748417658131498,282,1437,1329,390,55695,709341,703355,2885,3383,3101,3932,4430,30.643106892089126,10.44206354473662,498,0,91650,14256,939,1,2603,2054
9282,0,0,1,0,62,1,662,0,0,997143,2248078,26.851443164195103,438,2387,2104,721,50268,735848,664134,2835,3839,3401,4501,5505,37.1887079635741,17.002492836528845,1004,1,153573,45280,1383,0,2397,1735
9283,0,0,1,0,59,1,933,0,0,467134,3839298,35.9722114972099,1294,1655,1655,1294,53382,729882,643839,2967,4261,2967,3328,4622,19.0,0.0,1294,0,280798,0,361,1,1673,2606
9284,0,0,1,0,65,1,1927,0,0,4100474,10419500,56.621550667568265,3026,4665,4485,3206,43076,786500,578500,3070,6456,3430,4529,7915,35.76310948449533,13.461829731744027,3386,1,570668,36540,1279,0,44,1971
9285,0,0,1,0,68,1,1295,0,0,12393564,14481702,65.01538279515087,3669,7717,7159,4227,54216,859926,740016,2868,7653,3984,6358,11143,54.147945482723536,23.864746359516285,4785,1,913032,91512,2932,0,801,494
9286,0,0,1,0,68,1,1262,0,0,12497120,14473016,64.97691897897283,3681,7723,7182,4222,54718,860428,747304,2887,7650,3969,6388,11151,54.405882034941776,23.522255094204485,4763,1,920396,87101,2960,0,794,468
9287,0,0,1,0,68,1,910,0,0,13690959,14293311,64.67611614808051,3848,7791,7456,4183,56619,796161,830331,3082,7600,3752,6690,11208,57.21013896155121,18.48335216920125,4518,1,1016469,37520,3273,0,766,144
9288,0,0,1,0,67,1,787,0,0,14144900,14174125,64.61423991660043,3947,7791,7563,4175,56880,814800,804615,3167,7570,3623,6783,11186,58.20652884342099,15.137937485589164,4403,1,989475,29184,3388,0,780,7
9289,0,0,1,0,68,1,610,0,0,14845200,14178000,64.57553716385176,4103,7797,7730,4170,54531,846600,744600,3333,7570,3467,6960,11197,59.665735560705194,8.19263674150144,4237,1,913230,10921,3560,0,770,160
9290,0,0,1,0,67,1,46,0,0,18420735,14658055,65.68865959965997,4207,8692,8584,4315,55932,805089,801692,3289,7712,3505,7666,12089,65.33758489567853,10.393195703494003,4423,0,1018340,14040,4269,1,918,872
9291,0,0,1,0,66,1,446,0,0,18114915,14926080,66.97014260101288,4425,8584,8524,4485,53482,735488,805376,3268,7813,3388,7367,11912,63.55312738174259,7.849311256600636,4545,0,1085370,6420,4039,1,1157,711
9292,0,0,0,1,66,1,176,0,0,13564112,12526812,61.41661013113635,3199,7941,7368,3772,37168,670842,611064,2748,7093,3894,6917,11262,59.9666574022598,24.538226745810032,4345,1,694048,87669,3596,0,451,275
9293,0,0,0,1,66,1,168,0,0,13388544,12441312,61.18823416311342,3150,7914,7320,3744,36946,674569,604786,2729,7067,3917,6899,11237,59.799665550904216,24.942779850855743,4338,1,681408,92664,3576,0,421,253
9294,0,0,0,1,66,1,152,0,0,13055220,12272940,60.74537019394976,3132,7786,7228,3690,37698,685156,608658,2768,7016,3884,6864,11112,59.481089431852205,23.627503052824338,4248,1,675270,88722,3538,0,364,212
9295,0,0,0,1,65,1,159,0,0,8710936,9374599,53.600373133029585,2693,6085,5905,2873,56619,760279,792909,3083,6136,3443,6295,9348,55.06359959174482,13.571165968259688,3053,1,698139,19800,3032,0,390,231
9296,0,0,1,0,63,1,346,0,0,7319592,8030232,50.37856687124,2538,5422,5422,2538,51920,746704,696080,3164,5702,3164,6048,8586,53.70288632839021,0.0,2538,0,558360,0,2884,1,626,280
9297,0,1,1,0,59,0,513,0,0,271188,962928,18.0,294,1191,1161,324,43316,656812,582512,2942,3296,3002,3809,4163,28.930952282978865,5.501408174353464,354,0,63504,4890,837,1,2648,2135
9298,0,0,1,0,62,1,717,0,0,996138,2190240,26.49528259898354,460,2363,2121,702,45173,708240,620880,2878,3822,3362,4539,5483,37.66961640367472,15.79777293046628,944,1,139698,40414,1419,0,2418,1701
9299,0,0,0,0,59,1,433,1,0,631280,3075280,32.2490309931942,850,1837,1647,1040,53965,742207,635755,2767,3997,3147,3564,4794,24.63736998950984,13.843326152603932,1230,1,223600,31730,607,0,1917,2350
9300,0,0,1,0,62,1,1349,0,0,2024100,7046117,47.4236228055175,2141,3257,3149,2249,41064,739388,545142,3025,5382,3241,4033,6390,30.0,10.419152549993726,2357,0,391326,21816,900,1,884,2233
9301,0,0,1,0,68,1,1367,0,0,12331334,14555576,65.27633568147036,3708,7708,7155,4261,54216,857416,737856,2863,7677,3969,6310,11124,53.79591062525106,23.80613070188146,4814,1,920376,90692,2894,0,845,522
9302,0,0,1,0,68,1,1236,0,0,12758701,14519546,65.13831437794502,3759,7734,7250,4243,54718,858922,745996,2938,7665,3906,6429,11156,54.83611948342078,22.27874825024631,4727,1,924974,78892,3007,0,821,415
9303,0,0,1,0,67,1,826,0,0,14208695,14246540,64.8459713474939,3989,7800,7584,4205,56870,819896,796180,3172,7593,3604,6767,11188,58.12916651733448,14.717057516055787,4421,1,988175,28728,3379,0,817,9
9304,0,0,0,1,68,1,533,0,0,15409268,14304405,64.81512169239521,4171,7899,7869,4201,50451,854655,684405,3375,7606,3435,7073,11304,60.56401571890688,5.483301264452448,4231,1,844401,5580,3668,0,796,263
9305,0,0,1,0,67,1,27,0,0,18692470,14728452,65.85590330410783,4187,8797,8647,4337,55695,798060,804852,3246,7733,3546,7706,12193,65.6505902486794,12.248673275118406,4487,0,1027869,19200,4310,1,941,914
9306,0,0,1,0,67,1,225,0,0,18473044,14868440,66.42288762166245,4382,8629,8599,4412,55696,795320,795320,3340,7782,3400,7557,11999,64.70703207534712,5.501408174353464,4442,0,1041232,3900,4187,1,1042,817
9307,0,0,0,1,66,1,218,0,0,13692923,12698252,61.73329733620261,3238,7977,7404,3811,38178,673064,629748,2759,7143,3905,6925,11309,59.941638282582836,24.544501804695408,4384,1,720279,84804,3593,0,479,261
9308,0,0,1,0,60,0,785,0,0,1088054,2171054,26.870057685088806,598,2353,2229,722,48645,706645,622449,2883,3729,3131,4514,5360,38.82009788756334,11.135528725660043,846,0,149454,20584,1507,1,2285,1500
9309,0,0,1,0,61,1,480,0,0,699300,1949220,25.099800796022265,83,2287,1740,630,50995,671398,727090,2547,3724,3641,4204,5381,33.31666249791537,23.411932861357585,1177,1,148050,60717,1110,0,2464,1984
9310,0,0,1,0,68,1,1407,0,0,12375244,14619437,65.50572494064927,3760,7706,7175,4291,54216,855157,735912,2876,7698,3938,6291,11113,53.70288632839021,23.309015947856864,4822,1,926856,87084,2884,0,884,523
9311,0,0,1,0,68,1,1242,0,0,12914968,14583756,65.3299318842443,3825,7737,7294,4268,54467,857667,741489,2974,7685,3860,6443,11154,55.00909015790027,21.337140017978346,4711,1,926156,73095,3026,0,851,391
9312,0,0,1,0,67,1,745,0,0,14749266,14317704,65.04613747179766,4136,7812,7717,4231,52961,849384,714024,3289,7615,3479,6870,11196,59.04235767650204,9.749223385359247,4326,1,892741,16435,3486,0,847,102
9313,0,0,0,1,68,1,571,0,0,15485460,14385400,65.04613747179766,4189,7933,7891,4231,50904,856800,686800,3358,7631,3442,7060,11333,60.4979338490167,6.481658975540136,4273,1,854662,7770,3660,0,831,260
9314,0,0,1,0,67,1,314,0,0,18646392,15028168,66.91786009728644,4436,8684,8642,4478,48391,748388,728252,3314,7834,3398,7520,12040,64.52906321960671,6.48074069840786,4520,0,971726,5922,4164,1,1122,808
9315,0,0,0,1,66,1,239,0,0,13311870,12606880,61.40032573203501,3218,7853,7301,3770,37720,685520,615296,2792,7114,3896,6875,11197,59.42221806698232,23.49660767599411,4322,1,693680,86664,3531,0,426,187
9316,0,0,0,1,66,1,218,0,0,12811680,12350430,60.74537019394976,3198,7654,7162,3690,37925,686135,619195,2855,7037,3839,6819,11001,58.92367945062494,22.18494349780822,4182,1,682650,76752,3472,0,343,125
9317,0,0,0,1,67,1,161,0,0,11707026,11770080,59.18614702783076,3103,7245,6845,3503,41256,725760,641760,2960,6863,3760,6702,10605,57.810033731178535,20.182760839572822,3903,1,669073,65200,3342,0,143,18
9318,0,0,1,0,63,1,198,0,0,7663099,8493780,51.6817182376902,2611,5600,5540,2671,53775,715500,760020,3120,5851,3240,6049,8780,53.563046963368315,7.746504550744806,2731,1,638369,6900,2869,0,509,311
9319,0,1,1,0,62,0,794,0,0,2086395,3426312,33.18132004607411,1016,3081,2996,1101,47424,709536,647296,3027,4213,3197,5007,6193,43.53159771935783,9.239893968762086,1186,0,229008,13515,1895,1,2011,1217
9320,0,1,1,0,60,0,635,0,0,391296,1154688,19.595917942265423,324,1463,1403,384,55680,721680,697624,2947,3391,3067,4026,4470,31.921779399024736,7.746504550744806,444,0,89088,8400,1019,1,2623,1988
9321,0,0,1,0,61,1,401,0,0,611856,1861669,24.63736998950984,56,2278,1615,607,47586,631802,708477,2404,3674,3730,4075,5345,31.74901573277509,25.749723565571138,1270,1,140217,68289,1008,0,2460,2059
9322,0,0,1,0,67,1,2009,0,0,5634486,12067758,59.84981202978001,3085,5652,5155,3582,53965,845619,724335,2872,6951,3866,4942,9021,39.66106403010388,22.474055296485215,4079,1,770130,83496,1573,0,213,1796
9323,0,0,0,1,67,1,2039,0,0,10059512,14667221,65.96211033616193,3577,7437,6663,4351,56376,819153,782072,2597,7722,4145,5683,10808,48.08326112068523,27.918605319671425,5125,1,1009432,106038,2312,0,980,1059
9324,0,0,0,1,67,1,1789,0,0,11348580,14804400,66.18156843109719,3736,7615,6971,4380,55552,838240,757120,2736,7760,4024,5971,10995,50.90186637049765,25.58752263817637,5024,1,981120,99820,2591,0,1000,789
9325,0,0,1,0,67,1,1581,0,0,11988262,14736748,65.89385403814228,3778,7667,7103,4342,54180,855288,729710,2830,7736,3958,6155,11061,52.54521862167861,23.987620633581965,4906,1,933530,94188,2761,0,948,633
9326,0,0,1,0,67,1,1480,0,0,12311796,14695422,65.7723346096214,3802,7696,7172,4326,54718,852647,740546,2873,7723,3921,6243,11093,53.34791467339656,23.117450210526297,4850,1,943068,84888,2846,0,929,551
9327,0,0,0,1,67,1,608,0,0,15565433,14470356,65.27633568147036,4201,7974,7914,4261,50953,852396,689388,3336,7657,3456,7049,11370,60.440052945046304,7.745966692414834,4321,1,864983,10980,3653,0,865,257
9328,0,0,1,0,67,1,141,0,0,19035162,14947014,66.58828725834597,4404,8757,8727,4434,55695,798927,792185,3341,7805,3401,7664,12128,65.52098900352466,5.490867587491313,4464,0,1041990,3960,4293,1,1063,922
9329,0,0,0,1,67,1,386,0,0,16389560,14245330,65.16133823057964,3870,8482,8106,4246,40180,687775,657580,2979,7601,3731,7215,11837,62.12889826803627,20.224231986271054,4622,1,832216,53768,3860,0,891,505
9330,0,0,0,1,66,1,348,0,0,15242188,13666536,63.89053137985315,3625,8273,7816,4082,39592,676296,656208,2891,7430,3805,7082,11621,61.106464469808756,22.027231516371174,4539,1,800072,63523,3734,0,734,386
9331,0,0,0,1,67,1,323,0,0,14501450,13309550,63.0317380372777,3457,8139,7623,3973,39360,686750,643200,2834,7323,3866,7000,11489,60.41522986797286,23.349301385290207,4489,1,762816,76884,3650,0,623,300
9332,0,0,0,1,67,1,303,0,0,13960908,13038741,62.37788069500277,3318,8052,7479,3891,40128,700359,643392,2778,7242,3924,6939,11403,59.89991652748775,24.60883477506568,4464,1,747072,87096,3588,0,540,237
9333,0,0,0,1,67,1,282,0,0,13441680,12771120,61.72519744804386,3258,7890,7338,3810,37904,690512,616768,2800,7162,3904,6880,11242,59.39696961966999,23.500923392209042,4362,1,701040,87216,3528,0,458,176
9334,0,0,1,0,63,1,895,0,0,4655156,5533156,41.90465367951393,1242,4921,4407,1756,44908,686918,649106,2637,4907,3665,5802,8072,51.487862647424,22.716827699152017,2270,1,361736,76586,2651,0,1395,500
9335,0,0,1,0,62,1,757,0,0,3156410,4486560,37.92097045171708,759,4312,3633,1438,45540,717600,617760,2441,4558,3799,5315,7432,46.850827100489916,26.212031458296885,2117,1,284724,116788,2195,0,1682,925
9336,0,1,1,0,60,0,634,0,0,487800,1358100,21.213203435596427,450,1534,1534,450,54755,703194,709230,3018,3468,3018,4102,4552,32.92415526630866,0.0,450,0,105750,0,1084,1,2568,1934
9337,0,1,1,0,60,0,636,0,0,359917,1084444,19.0,331,1388,1358,361,55687,717956,699932,2974,3365,3034,4001,4392,31.575306807693888,5.477225575051661,391,0,84113,4110,997,1,2643,2007
9338,0,1,1,0,59,0,564,0,0,225180,804600,16.431676725154983,270,1104,1104,270,48300,685400,625800,2980,3250,2980,3814,4084,28.879058156387302,0.0,270,0,56700,0,834,1,2710,2146
9339,0,0,1,0,59,0,450,0,0,900000,2235750,27.386127875258307,720,1980,1950,750,45741,706497,575333,2951,3731,3011,4181,4961,34.64101615137755,5.501408174353464,780,0,144750,5520,1200,1,2231,1781
9340,0,0,1,0,58,1,535,0,0,591854,3181080,32.89376840679705,1082,1629,1629,1082,51706,737940,605640,2940,4022,2940,3487,4569,23.388031127053,0.0,1082,0,222892,0,547,1,1858,2393
9341,0,0,1,0,64,1,1709,0,0,2288736,8379936,50.91168824543142,2202,3865,3475,2592,53784,805017,698328,2843,5825,3623,4116,7098,29.715315916207253,19.928524000693372,2982,1,559872,65130,883,0,641,2350
9342,0,0,0,1,67,1,2039,0,0,9801176,14518504,65.66582063752801,3580,7317,6585,4312,56619,818181,784511,2635,7679,4099,5640,10684,47.67598976424087,27.152728082123282,5044,1,1004696,99552,2273,0,945,1094
9343,0,0,0,1,67,1,2039,0,0,9986340,14599760,65.87867636800242,3583,7398,6641,4340,56350,824180,773720,2607,7704,4121,5665,10762,47.968739820845826,27.599948897757372,5097,1,998200,108251,2301,0,976,1063
9344,0,0,0,1,67,1,2040,0,0,10356976,14796936,66.3023378170031,3646,7502,6752,4396,54500,841500,733788,2616,7762,4116,5722,10868,48.53864439804639,27.5803675182853,5146,1,958328,123000,2356,0,1030,1010
9345,0,0,1,0,67,1,1032,0,0,14052400,14512500,65.57438524302,4066,7802,7568,4300,56088,769500,830250,3141,7675,3609,6643,11177,57.16642371182581,15.359532512939644,4534,1,1057800,23400,3268,0,925,107
9346,0,0,0,1,67,1,466,0,0,17052207,14710423,66.09841147864296,4072,8569,8272,4369,32005,622895,582491,3070,7736,3664,7270,11936,62.473994589749104,18.458915620886906,4666,1,755837,42174,3903,0,1002,536
9347,0,0,0,1,67,1,421,0,0,16565390,14422390,65.46754921333164,3920,8517,8151,4286,39390,679730,656175,2999,7651,3731,7230,11882,62.16912416947821,20.0574085956361,4652,1,835770,51606,3865,0,921,500
9348,0,0,1,0,62,1,1306,0,0,1486280,6352320,45.12205669071391,1916,2886,2766,2036,43092,711360,589680,3000,5156,3240,3850,6006,27.018512172212592,11.015556749295067,2156,0,384804,21480,730,1,1084,2390
9349,0,0,0,1,67,1,1986,0,0,10923352,14954060,66.66333324999583,3785,7561,6902,4444,55278,837885,747030,2706,7809,4024,5823,10926,49.57822102496216,25.867576745458038,5103,1,986568,103463,2458,0,1079,907
9350,0,0,1,0,67,1,1833,0,0,11518768,14926976,66.57326790837296,3855,7608,7031,4432,54780,838632,740960,2791,7800,3945,5967,10976,50.98038838612354,24.23616496362775,5009,1,975040,92320,2599,0,1064,769
9351,0,0,1,0,67,1,1763,0,0,11736864,14892030,66.47555941848101,3868,7626,7075,4419,54500,842500,734660,2819,7789,3921,6026,10996,51.536394906900505,23.695667096512565,4970,1,963342,89813,2656,0,1049,714
9352,0,0,1,0,67,1,1196,0,0,13644960,14721280,65.87867636800242,4057,7767,7484,4340,56643,803904,810688,3109,7732,3675,6536,11159,56.07138307550475,17.074212406068007,4623,1,1037260,33677,3144,0,948,248
9353,0,0,1,0,67,1,1009,0,0,14356986,14538720,65.77993615077473,4157,7815,7645,4327,55596,826560,759360,3190,7687,3530,6678,11175,57.60208329565867,13.06370857217659,4497,1,977902,25500,3318,0,967,42
9354,0,0,1,0,67,1,948,0,0,14597824,14532964,65.75712889109438,4197,7827,7700,4324,54560,833528,739420,3234,7685,3488,6737,11188,58.1033561853358,11.290504321766129,4451,1,951280,20447,3376,0,963,15
9355,0,0,0,1,67,1,769,0,0,15340320,14575680,65.72670690061993,4320,7871,7871,4320,51336,836752,698418,3374,7694,3374,6925,11245,59.590267661758325,0.0,4320,1,894240,0,3551,0,946,177
9356,0,0,0,1,67,1,438,0,0,15928048,14212136,64.9307323229917,3759,8451,7994,4216,39382,684313,653974,2914,7587,3828,7149,11822,61.465437442517235,22.137741198542393,4673,1,817904,65808,3778,0,845,407
9357,0,0,0,1,67,1,374,0,0,13885392,13195824,62.5939294181153,3345,8035,7462,3918,38728,693808,633184,2795,7286,3941,6912,11403,59.531504264548865,23.944705759233695,4491,1,736584,88242,3544,0,550,176
9358,0,0,0,1,67,1,347,0,0,13194030,12854940,61.72519744804386,3322,7761,7273,3810,38502,698418,627564,2886,7184,3862,6837,11135,58.84725991921799,22.12773372804317,4298,1,708660,77104,3463,0,436,89
9359,0,1,1,0,63,0,826,0,0,3450840,4726280,38.600518131237564,1248,4048,3806,1490,50470,653432,777140,2930,4662,3414,5488,7220,48.12483766206386,15.641708141339256,1732,0,365050,19602,2316,1,1682,856
9360,0,1,1,0,59,0,625,0,0,194484,682176,15.0996688705415,198,1111,1081,228,50328,697136,646272,2962,3220,3022,3845,4103,29.206163733020468,5.483301264452448,258,0,49248,4620,853,1,2764,2139
9361,0,0,1,0,62,1,699,0,0,616590,1581510,22.58317958127243,30,2199,1719,510,54502,710129,738038,2621,3611,3581,4310,5300,34.77067730142742,21.95071744408215,990,1,121380,58080,1209,0,2591,1892
9362,0,0,1,0,64,1,1551,0,0,1928290,7611422,48.641546028061235,2124,3423,3181,2366,47765,749561,659485,2975,5583,3459,4032,6640,28.548204847240395,15.632554439556412,2608,1,485030,40656,815,0,851,2402
9363,0,0,0,1,67,1,2040,0,0,9659041,14379141,65.50572494064927,3591,7242,6542,4291,56088,824346,764028,2651,7642,4051,5602,10593,47.44470465710583,26.527214609341872,4991,1,978348,102200,2251,0,940,1100
9364,0,0,0,1,67,1,83,0,0,19849758,15172878,67.05967491719595,4455,8953,8911,4497,56165,792890,806386,3332,7871,3416,7788,12327,66.43794096749237,6.538739683827756,4539,1,1074783,5208,4414,0,1123,1040
9365,0,0,1,0,67,1,318,0,0,19626208,15406160,67.76429738438966,4525,8933,8866,4592,54312,832040,734745,3288,7947,3422,7629,12288,65.37583651472461,8.18535277187245,4659,0,1005648,10921,4274,1,1237,919
9366,0,0,1,0,67,1,403,0,0,19579868,15560160,68.05145112339633,4631,8859,8859,4631,45570,729120,705600,3360,7991,3360,7588,12219,65.02307282803544,0.0,4631,0,972510,0,4228,1,1271,868
9367,0,0,0,1,67,1,444,0,0,14935357,13822061,63.97655820689325,3542,8293,7742,4093,38391,678777,645007,2826,7470,3928,7026,11670,60.40695324215582,24.128610229024098,4644,1,781763,79344,3649,0,716,272
9368,0,0,0,1,67,1,433,0,0,14564634,13639703,63.55312738174259,3462,8222,7645,4039,38745,692285,638253,2800,7416,3954,6983,11599,60.049979184009715,24.659806898531908,4616,1,763371,87127,3606,0,662,229
9369,0,0,1,0,66,1,2009,0,0,4450212,11095461,57.8013840664737,2875,5139,4673,3341,46686,833571,617706,2855,6662,3787,4653,8460,36.49657518178932,21.794373971576842,3807,1,621426,93666,1332,0,20,1989
9370,0,0,0,1,67,1,872,0,0,15365040,14743080,66.18156843109719,4380,7888,7888,4380,50200,844866,673200,3366,7746,3366,6874,11254,59.22837157984339,0.0,4380,1,876000,0,3508,0,1014,142
9371,0,0,1,0,67,1,383,0,0,19841550,15628650,68.19090848492928,4650,8917,8917,4650,42550,773030,621785,3361,8011,3361,7628,12278,65.32227797620043,0.0,4650,0,860250,0,4267,1,1289,906
9372,0,0,0,1,67,1,558,0,0,18326259,15511755,67.59437846448475,4301,8848,8580,4569,21285,560175,437955,3127,7964,3663,7406,12243,63.33245613427605,17.623876709234448,4837,1,589401,43148,4011,0,1174,616
9373,0,0,0,1,67,1,473,0,0,14708874,13815573,63.86704940734306,3488,8276,7685,4079,37989,680787,640143,2796,7466,3978,6993,11663,60.049979184009715,24.965689431697463,4670,1,770931,86877,3606,0,692,219
9374,0,1,1,0,62,0,793,0,0,1196520,2386137,27.694764848252458,587,2507,2327,767,55216,740418,721752,2931,3878,3291,4671,5618,39.496835316262995,13.418995158121604,947,0,177944,24840,1560,1,2344,1551
9375,0,0,0,1,66,1,2040,0,0,9704884,14338128,65.55913361233506,3634,7220,6556,4298,55552,827328,747264,2672,7634,4000,5594,10556,47.51841748206689,25.924799543052654,4962,1,962752,101592,2258,0,962,1078
9376,0,0,0,1,67,1,67,0,0,20379588,15331308,67.43886120034946,4518,9059,9029,4548,53124,785443,768588,3341,7919,3401,7852,12430,66.94027188471824,5.483301264452448,4578,1,1036944,4140,4481,0,1177,1110
9377,0,0,1,0,67,1,320,0,0,20125521,15597395,68.18357573492314,4582,9045,8978,4649,45507,775005,660935,3288,8004,3422,7684,12400,65.79513659838392,8.18535277187245,4716,0,915853,11591,4329,1,1294,974
9378,0,0,0,1,68,1,685,0,0,19529750,16277975,69.10137480542626,4533,9107,8865,4775,20989,514759,473851,3167,8184,3651,7499,12516,63.953107821277925,16.489969848905996,5017,1,663725,31944,4090,0,1366,681
9379,0,0,0,1,68,1,642,0,0,19239363,16096509,68.69497798238238,4463,9052,8796,4719,18900,477540,460485,3155,8130,3667,7488,12463,63.85138996137829,17.12401793006818,4975,1,637065,31232,4077,0,1308,666
9380,0,0,0,1,67,1,501,0,0,14487660,13808805,63.75735251718032,3447,8247,7629,4065,38784,686194,652224,2779,7462,4015,6961,11644,59.6992462263972,24.898584561747754,4683,1,780480,89610,3564,0,668,167
9381,0,0,0,1,68,1,450,0,0,12916576,13016052,61.85466837676846,3422,7606,7202,3826,39537,704214,649782,2998,7228,3806,6778,11008,58.1033561853358,20.248938533435386,4230,1,730766,61812,3376,0,424,26
9382,0,0,0,1,68,1,437,0,0,12586728,12843292,61.424750711744856,3412,7470,7109,3773,39936,708032,653568,3043,7177,3765,6740,10874,57.758116312774604,19.176133117591966,4134,1,724416,54872,3336,0,369,68
9383,0,0,0,1,68,1,425,0,0,12264416,12662563,61.0,3402,7336,7017,3721,41790,714630,677197,3084,7124,3722,6699,10739,57.41080037762929,18.065909402207875,4040,1,740479,46893,3296,0,318,107
9384,0,0,1,0,63,1,745,0,0,4516050,5662020,42.24926034855522,1130,4970,4315,1785,46870,691496,681980,2517,4957,3827,5702,8142,50.299105359837164,25.943975986440197,2440,1,383775,91700,2530,0,1387,642
9385,0,1,0,1,66,0,915,0,0,4823986,5908088,42.261093218230876,1486,4787,4487,1786,46200,661600,764148,3008,5094,3608,6009,8095,51.97114584074513,17.329930438643213,2086,1,412566,28500,2701,0,1522,607
9386,0,1,1,0,62,0,853,0,0,3190830,4440090,37.54996671103717,1075,4008,3673,1410,53965,677035,790399,2814,4559,3484,5412,7157,47.57099956906519,18.4996026760834,1745,0,353910,27135,2263,1,1739,886
9387,0,1,1,0,62,0,811,0,0,1867620,3177300,31.937438845342623,1020,2851,2851,1020,53824,722680,722680,3115,4135,3115,4946,5966,42.790185790669334,0.0,1020,0,236640,0,1831,1,2095,1284
9388,0,0,1,0,61,1,981,0,0,657166,1411673,21.37755832643195,172,2180,1895,457,55000,772250,679580,2804,3546,3374,4527,5269,37.92097045171708,16.928514335822324,742,0,100540,45030,1438,1,2632,1651
9389,0,0,1,0,58,1,80,0,0,400356,1736856,24.372115213907882,338,1524,1268,594,37584,508776,631584,2668,3518,3180,3598,4448,25.96150997149434,16.657181906610685,850,1,128304,20224,674,0,2330,2250
9390,0,0,0,1,66,1,2039,0,0,7713342,13298454,63.071388124885914,3574,6321,5917,3978,56069,825721,758861,2939,7321,3747,5282,9664,44.034077712607996,20.224685301752483,4382,1,903006,60196,1939,0,635,1404
9391,0,0,0,1,66,1,2040,0,0,8563401,13740984,64.17943595888016,3594,6723,6198,4119,56334,820656,763944,2811,7455,3861,5415,10059,45.59605246071199,22.980104882165897,4644,1,943251,76125,2079,0,783,1257
9392,0,0,1,0,66,1,1126,0,0,14752955,14832965,66.67083320313314,4378,7831,7764,4445,55056,827576,740814,3270,7782,3404,6656,11168,57.61076288333631,8.185808589931957,4512,1,986790,10519,3319,0,1108,18
9393,0,0,0,1,67,1,800,0,0,16177764,14996192,66.64833081180653,4280,8246,8084,4442,52290,840624,708960,3214,7818,3538,7018,11622,60.34898507845845,12.728407017715496,4604,1,932820,28350,3642,0,1066,266
9394,0,0,1,0,67,1,131,0,0,20548332,15494031,67.8159273327439,4557,9109,9067,4599,49235,771501,724335,3327,7968,3411,7837,12478,66.84309986827361,6.484411467763075,4641,0,988785,6342,4468,1,1230,1099
9395,0,0,1,0,67,1,152,0,0,20524185,15511769,67.87488489861327,4540,9129,9062,4607,49283,750841,744107,3300,7974,3434,7822,12496,66.74578638386096,8.185808589931957,4674,0,1018147,9179,4455,1,1240,1088
9396,0,0,0,1,68,1,757,0,0,20409360,16823600,70.08566187174092,4694,9285,9067,4912,27552,575400,561700,3207,8337,3643,7580,12710,64.45928947793328,15.790158320479412,5130,1,805568,28340,4155,0,1487,730
9397,0,0,0,1,68,1,514,0,0,13735176,13536576,63.02380502635492,3473,7929,7430,3972,39537,705456,650928,2909,7380,3907,6866,11337,58.80476171195663,22.41861435870624,4471,1,758652,75848,3458,0,564,50
9398,0,0,0,1,64,1,283,0,0,9115484,10248196,56.24944444170093,3164,6045,6045,3164,53336,764404,732014,3239,6403,3239,6120,9284,53.67494760127857,0.0,3164,1,715064,0,2881,0,75,358
9399,0,1,0,1,66,0,926,0,0,4897752,5962168,42.40283009422838,1513,4807,4522,1798,54208,742784,802472,3031,5114,3601,6040,8123,52.191953402799555,17.11050945863731,2083,1,435116,31065,2724,0,1518,592
9400,0,1,1,0,61,0,778,0,0,658679,1568259,22.60530911091463,319,1992,1800,511,54145,678249,751905,2877,3580,3261,4358,5061,35.90264614203248,14.004371130261445,703,0,125195,19200,1289,1,2558,1780
9401,0,0,0,1,67,1,836,0,0,16260192,15079584,66.87301398920195,4297,8283,8108,4472,52250,843000,704748,3197,7844,3547,7008,11655,60.29925372672534,13.228756555322953,4647,1,934648,30975,3636,0,1100,264
9402,0,0,0,1,68,1,607,0,0,15935900,14738554,65.62773803811922,3776,8538,8007,4307,37430,674134,650180,2891,7729,3953,7122,11960,60.8276253029822,23.998444582595123,4838,1,818330,74340,3700,0,885,278
9403,0,0,0,1,68,1,594,0,0,15348832,14452920,65.00769185258002,3631,8453,7858,4226,38600,684000,660060,2825,7646,4015,7052,11873,60.266076693277455,25.207467125973753,4821,1,815618,84490,3632,0,806,212
9404,0,0,0,1,68,1,560,0,0,14051681,13797224,63.55312738174259,3502,8055,7518,4039,39360,700280,655872,2879,7455,3953,6895,11471,58.98304841223451,23.26560289552331,4576,1,775488,79476,3479,0,623,63
9405,0,1,0,1,65,0,928,0,0,4602729,5710569,41.60528812542944,1448,4673,4390,1731,54834,732378,814853,3016,5030,3582,5958,7972,51.56549233741495,16.990680309670477,2014,1,427557,27451,2659,0,1568,640
9406,0,1,0,1,65,0,925,0,0,4484150,5609450,41.291645644125154,1410,4630,4335,1705,52824,700770,815920,2995,4995,3585,5920,7920,51.28352561983234,17.302485883351352,2000,1,422840,25370,2630,0,1585,660
9407,0,0,1,0,61,1,1045,0,0,973566,1822986,24.372115213907882,441,2386,2233,594,50175,690525,684387,2916,3663,3222,4708,5455,40.48456495999432,12.37406973724078,747,0,132462,20961,1639,1,2475,1430
9408,0,0,0,1,66,1,2040,0,0,8439841,13608680,64.02343321003646,3602,6655,6158,4099,56105,813400,760280,2823,7419,3817,5379,9975,45.37620521815371,22.331329548171528,4596,1,938671,71071,2059,0,779,1261
9409,0,0,1,0,66,1,1198,0,0,14898035,14979125,67.11929677819934,4475,7842,7812,4505,54858,817950,741475,3295,7830,3355,6632,11167,57.5065213693195,5.477225575051661,4535,1,1004615,4710,3307,0,1180,18
9410,0,0,0,1,67,1,928,0,0,16074000,15129000,67.08203932499369,4350,8222,8072,4500,51000,840500,685848,3212,7862,3512,6934,11584,59.76621118993574,12.248673275118406,4650,1,918000,27450,3572,0,1138,210
9411,0,0,0,1,67,1,900,0,0,16208101,15145865,67.08949247087803,4331,8272,8102,4501,52041,837885,703285,3195,7866,3535,6966,11637,60.00833275470999,13.038404810405298,4671,1,940709,29920,3601,0,1136,236
9412,0,0,0,1,68,1,614,0,0,14751360,14260480,64.4980619863884,3524,8342,7706,4160,38200,685600,654748,2792,7588,4064,6974,11770,59.54829972383762,25.318208869531702,4796,1,794560,90948,3546,0,732,118
9413,0,0,0,1,68,1,586,0,0,13663415,13703425,63.25345840347388,3531,7886,7416,4001,39936,712400,657600,2955,7426,3895,6840,11311,58.43800133474792,21.823512140728035,4471,1,768192,70970,3415,0,576,10
9414,0,0,1,0,68,1,560,0,0,12809700,13262490,62.20932405998316,3528,7522,7180,3870,41790,719670,681973,3085,7297,3769,6737,10949,57.532599454570104,18.735146061865894,4212,1,770130,50274,3310,0,443,117
9415,0,0,0,1,64,1,357,0,0,8923194,10283553,56.31163290120435,3129,6027,5985,3171,49032,736161,700488,3201,6414,3285,6057,9270,53.04714883949938,6.484411467763075,3213,1,684936,6216,2814,0,72,429
9416,0,0,1,0,64,1,274,0,0,8012787,9584446,54.506880299646575,2941,5698,5668,2971,44220,709720,648426,3196,6197,3256,5923,8924,51.93264869039514,5.5503012171862105,3001,0,597171,4710,2697,1,255,529
9417,0,1,0,1,66,0,944,0,0,4930116,5945986,42.40283009422838,1580,4758,4540,1798,56386,800294,770531,3089,5105,3525,6049,8065,52.364109846344185,15.045716501099893,2016,1,418934,28340,2742,0,1509,565
9418,0,0,1,0,66,1,2031,0,0,4465440,11131680,57.96550698475775,2984,5065,4689,3360,54093,818311,725547,2937,6673,3689,4642,8378,36.45545226711637,19.48277993099125,3736,1,735840,61288,1329,0,47,1984
9419,0,0,1,0,66,1,2035,0,0,4984356,11520249,58.915193286621744,3194,5184,4907,3471,54587,819793,733499,3042,6790,3596,4755,8503,37.89459064299283,16.729410795602917,3748,1,767091,44043,1436,0,152,1883
9420,0,0,0,1,66,1,2040,0,0,6878196,12748050,61.91930232165088,3579,5883,5628,3834,55552,824600,744800,3070,7159,3580,5119,9208,42.35563716909474,16.09707439961077,4089,1,858816,39015,1794,0,509,1531
9421,0,0,0,1,68,1,630,0,0,13985784,13973580,63.7808748764079,3555,8019,7506,4068,39984,700740,673260,2922,7503,3948,6873,11454,58.63446085707619,22.810631260465524,4581,1,797328,72846,3438,0,633,3
9422,0,0,0,1,64,1,407,0,0,9009660,10432576,56.674509261219015,3152,6077,6017,3212,47712,727552,691824,3188,6460,3308,6053,9325,52.96225070746144,7.750803389552748,3272,1,684156,8880,2805,0,36,443
9423,0,0,1,0,64,1,319,0,0,7980630,9660448,54.67174773134658,2989,5659,5659,2989,42211,714272,617312,3232,6221,3232,5902,8891,51.67204273105525,0.0,2989,0,570899,0,2670,1,243,562
9424,0,0,1,0,63,1,430,0,0,4680051,6264882,44.26059195266146,1170,5137,4348,1959,47722,713154,684372,2409,5157,3987,5587,8335,48.877397639399746,28.164687916713564,2748,1,419226,114405,2389,0,1239,809
9425,0,1,0,1,65,0,952,0,0,4885545,5881575,42.24926034855522,1595,4712,4522,1785,55647,800685,754555,3105,5080,3485,6032,8007,52.316345438113316,14.007737751789053,1975,1,408765,25270,2737,0,1510,558
9426,0,0,0,1,66,1,2039,0,0,8150612,13388555,63.647466563878254,3605,6509,6063,4051,56628,799810,773370,2859,7356,3751,5317,9814,44.85532298401161,21.13663182142413,4497,1,947934,59318,2012,0,746,1293
9427,0,0,1,0,65,1,2034,0,0,11976160,15249952,68.0,4282,7556,7214,4624,55822,814606,745348,2956,7922,3640,5888,10854,50.89204259999789,18.629328203726292,4966,1,1045024,49590,2590,0,1326,708
9428,0,0,0,1,66,1,1088,0,0,15832320,15244080,67.52777206453653,4433,8159,8032,4560,50430,822378,685315,3216,7903,3470,6815,11502,58.92367945062494,11.270999429035628,4687,1,934800,22733,3472,0,1217,129
9429,0,0,0,1,65,1,467,0,0,9220548,10676424,57.262553208881634,3219,6151,6091,3279,46225,700040,700040,3196,6535,3316,6068,9407,53.028294334251406,7.746504550744806,3339,1,704985,8160,2812,0,23,444
9430,0,0,1,0,64,1,152,0,0,5128980,7067130,46.79743582719036,1465,5257,4532,2190,43215,648627,693805,2502,5417,3952,5569,8484,48.394214530251446,27.047984515410636,2915,1,470850,84825,2342,0,1037,885
9431,0,0,1,0,64,1,2017,0,0,2976930,9742680,54.83611948342078,2698,4306,3997,3007,48312,790560,641520,2931,6247,3549,4230,7546,31.464265445104548,17.674987570472922,3316,1,595386,57165,990,0,233,2250
9432,0,0,1,0,66,1,2039,0,0,5557812,11861928,59.89991652748775,3454,5271,5137,3588,55552,819888,740544,3172,6894,3440,4855,8577,39.35733730830886,11.691581880872027,3722,1,803712,20636,1549,0,282,1757
9433,0,0,0,1,66,1,2039,0,0,7921662,13242900,63.34824385884742,3605,6395,5987,4013,56882,788700,785400,2892,7313,3708,5274,9695,44.429719783046124,20.212374519405795,4421,1,955094,51408,1974,0,713,1326
9434,0,0,0,1,69,1,683,0,0,13216830,13775850,63.190189111918315,3614,7682,7303,3993,44457,755550,700350,3071,7443,3829,6760,11132,57.532599454570104,19.811251059137184,4372,1,810579,57987,3310,0,543,140
9435,0,0,0,1,65,1,516,0,0,9309280,10836480,57.619441163551734,3253,6191,6124,3320,44944,691968,691968,3197,6584,3331,6068,9455,52.952809179494906,8.187175587434018,3387,1,703840,9045,2804,0,56,460
9436,0,0,1,0,64,1,436,0,0,8241117,10055959,55.65069631190611,3067,5788,5758,3097,47736,701352,717587,3217,6344,3277,5908,9035,51.58488150611572,5.514871952411144,3127,0,684437,3870,2661,1,150,586
9437,0,1,1,0,64,0,948,0,0,3843613,4986976,39.28103868280471,1325,4252,4034,1543,53286,691648,804768,3014,4775,3450,5723,7484,49.90991885387112,14.787218784396567,1761,1,384207,18530,2491,0,1689,741
9438,0,1,1,0,62,0,866,0,0,2053520,3309040,32.61901286060018,889,3169,2994,1064,56400,730850,746400,2935,4174,3285,5040,6279,43.93176527297759,13.229728356877892,1239,0,255360,21350,1930,1,2046,1180
9439,0,0,0,1,66,1,2039,0,0,7361922,12937236,62.5939294181153,3605,6110,5797,3918,56400,792480,775970,2989,7220,3615,5181,9412,43.347433603386484,17.715640272041846,4231,1,920730,41942,1879,0,616,1423
9440,0,0,0,1,69,1,732,0,0,13704444,14129388,63.92182725798755,3627,7899,7440,4086,43044,729638,705432,2999,7544,3917,6812,11357,57.91372894228103,21.725487843157854,4545,1,833544,65178,3354,0,628,104
9441,0,0,0,1,69,1,719,0,0,13182312,13851648,63.30876716537765,3637,7668,7297,4008,45126,753408,715392,3085,7464,3827,6745,11124,57.34980383575867,19.657061117059968,4379,1,829656,54537,3289,0,552,167
9442,0,0,1,0,65,1,507,0,0,8547028,10386504,56.462376853972415,3103,5954,5869,3188,46655,706986,700470,3173,6446,3343,5939,9212,51.778373863998475,9.219863456115478,3273,0,685420,11645,2681,1,70,577
9443,0,0,1,0,65,1,479,0,0,8205390,10123614,55.80322571321482,3114,5749,5749,3114,47085,711969,698965,3251,6365,3251,5886,9000,51.332251070842396,0.0,3114,0,669510,0,2635,1,137,616
9444,0,0,1,0,65,1,81,0,0,5495040,7806105,48.83646178829912,1685,5389,4689,2385,46866,700422,716787,2573,5658,3973,5577,8662,48.0,26.659412567895885,3085,1,522315,90300,2304,0,888,969
9445,0,0,0,1,64,1,43,0,0,5109398,7258838,47.31807265728392,1459,5301,4521,2239,43215,651642,697030,2462,5481,4022,5524,8543,47.77028364998475,28.06138675106952,3019,1,481385,91260,2282,0,1003,960
9446,0,0,0,1,64,1,175,0,0,4821350,6789980,45.93473631142341,1240,5265,4395,2110,45154,688652,678998,2348,5328,4088,5503,8483,47.80167361086848,29.57966481133247,2980,1,445210,120060,2285,0,1108,933
9447,0,0,1,0,63,1,493,0,0,4301070,5863086,42.91852746774987,960,5059,4177,1842,40530,668430,614319,2301,5025,4065,5518,8242,48.321837713398274,29.958060283092834,2724,1,355506,134946,2335,0,1341,848
9448,0,0,1,0,61,0,223,0,0,1225224,3059056,31.63858403911275,718,2508,2225,1001,48090,699824,641760,2773,4057,3339,4280,5564,34.9857113690718,16.860755267703738,1284,0,210210,44431,1224,1,2055,1832
9449,0,0,1,0,61,0,1100,0,0,1426725,2345490,27.65863337187866,585,2810,2630,765,47385,745038,597870,2886,3831,3246,4931,5876,43.18564576337837,13.485847547000814,945,1,149175,33840,1865,0,2301,1201
9450,0,0,1,0,58,1,475,0,0,576414,3031855,32.14031735997639,863,1761,1591,1033,49692,722010,592870,2765,3968,3105,3493,4696,23.62202362203543,13.078932278133562,1203,0,208666,30940,558,1,1902,2377
9451,0,0,0,1,69,1,763,0,0,13496400,14115800,63.835726674018524,3651,7811,7387,4075,43452,737832,706656,3040,7539,3888,6776,11275,57.54997827975264,20.966201832233704,4499,1,831300,61480,3312,0,611,152
9452,0,0,0,1,69,1,755,0,0,13147164,13927626,63.42712353559792,3658,7656,7291,4023,45360,747792,727020,3097,7485,3827,6730,11118,57.16642371182581,19.554757627072746,4388,1,844830,51830,3268,0,561,194
9453,0,0,0,1,65,1,635,0,0,9894276,11477221,58.98304841223451,3419,6383,6323,3479,45305,676295,729079,3239,6778,3359,6143,9682,53.32916650389353,7.746504550744806,3539,1,768859,6900,2844,0,180,455
9454,0,0,1,0,65,1,415,0,0,7061834,9440678,53.600373133029585,2631,5573,5331,2873,39936,683488,630912,3044,6159,3528,5744,8859,49.57822102496216,15.837884755288831,3115,1,551616,36784,2458,0,413,828
9455,0,0,0,1,64,1,255,0,0,4634236,6527293,45.044422518220834,1127,5215,4313,2029,44290,691655,662702,2315,5246,4119,5501,8432,47.791212581394085,30.395837243261607,2931,1,417974,130790,2284,0,1188,933
9456,0,0,1,0,63,1,396,0,0,4130560,5887892,42.941821107167776,902,5026,4084,1844,39123,660951,603477,2251,5037,4135,5433,8219,47.32863826479693,30.956430336044953,2786,1,348516,146010,2240,0,1349,953
9457,0,0,1,0,61,0,1075,0,0,1460100,2406810,28.0178514522438,610,2820,2645,785,47190,741972,597870,2891,3851,3241,4926,5886,43.12771730569565,13.232642477343864,960,1,153075,32725,1860,0,2281,1206
9458,0,0,1,0,62,1,927,0,0,1361448,5332338,41.46082488325576,1442,2788,2511,1719,53463,778602,660726,2825,4821,3379,3894,5890,28.142494558940577,16.65896666554177,1996,1,366147,47090,792,0,1383,2310
9459,0,0,1,0,65,1,2039,0,0,6454526,12386829,61.29437168288782,3604,5628,5475,3757,52041,820953,689073,3144,7054,3450,5015,8925,41.44876355212541,12.41189691052956,3910,1,785213,26928,1718,0,460,1579
9460,0,0,1,0,65,1,2029,0,0,10752846,14532796,66.68583057891684,4124,7188,6865,4447,55596,803928,738568,2945,7715,3591,5686,10456,49.17316341257699,18.03406811021435,4770,1,1005022,48450,2418,0,1179,850
9461,0,0,1,0,65,1,1895,0,0,13379306,15430390,68.74590896918885,4618,7665,7557,4726,54500,816250,711770,3157,7991,3373,6096,10930,53.207142377692115,10.403202108104866,4834,1,1030268,17604,2831,0,1461,434
9462,0,0,0,1,69,1,810,0,0,13996144,14496304,64.5600495662759,3657,8037,7526,4168,43680,730380,723424,2967,7646,3989,6836,11515,57.94825277780168,22.96251221159378,4679,1,866944,69496,3358,0,690,120
9463,0,0,1,0,65,1,576,0,0,8246052,10347240,56.3382640840131,3174,5772,5772,3174,47073,720460,694380,3260,6434,3260,5858,9032,50.97057974949863,0.0,3174,0,676062,0,2598,1,86,662
9464,0,0,0,1,64,1,181,0,0,4650932,6669300,45.47526800360829,1128,5257,4317,2068,44064,696600,657900,2285,5293,4165,5474,8482,47.4236228055175,31.02801577350623,3008,1,421872,140060,2249,0,1157,976
9465,0,1,1,0,61,0,874,0,0,1575272,2749144,29.866369046136157,832,2718,2658,892,53592,715024,711942,3022,3974,3142,4848,5800,42.02380277890139,7.748117453886108,952,0,206052,8100,1766,1,2190,1316
9466,0,0,1,0,61,0,409,0,0,1636500,3343915,33.03028912982749,911,2771,2591,1091,46410,677365,643650,2885,4156,3245,4565,5836,38.72983346207417,13.514804416149667,1271,0,229110,26640,1500,1,1974,1565
9467,0,0,1,0,63,1,1697,0,0,989604,6886264,46.4327470649756,2071,2700,2615,2156,49750,798500,635606,3109,5350,3279,3653,5894,21.42428528562855,9.332611979058527,2241,1,429044,15895,459,0,1038,2735
9468,0,0,1,0,65,1,2039,0,0,4002890,10692875,57.14017850864661,2923,4833,4491,3265,53714,822025,700850,2933,6540,3617,4501,8108,35.014282800023196,18.541474343042776,3607,1,698710,57798,1226,0,10,2049
9469,0,0,1,0,65,1,2024,0,0,11735040,14930088,67.70524351924303,4368,7360,7144,4584,56105,797965,745853,3041,7841,3473,5817,10617,50.59644256269407,14.745912866802176,4800,1,1049736,31536,2560,0,1327,697
9470,0,0,0,1,68,1,571,0,0,19984410,16277240,69.02897942168927,4315,9409,8959,4765,49140,799344,717360,2966,8181,3866,7610,12825,64.76109943476871,21.233705978698662,5215,1,1000650,73350,4194,0,1349,778
9471,0,0,0,1,69,1,837,0,0,13607514,14371749,64.27285585688566,3681,7875,7425,4131,45156,737548,741027,3029,7610,3929,6773,11354,57.39337940912697,21.649019872714156,4581,1,879903,59850,3294,0,652,185
9472,0,0,0,1,66,1,733,0,0,10237298,11933949,59.89156868875618,3497,6531,6441,3587,43400,665400,721959,3237,6914,3417,6181,9858,53.422841556772326,9.497356383238309,3677,1,778379,10170,2854,0,260,473
9473,0,0,0,1,65,1,666,0,0,8919136,10951978,57.77542730261716,3211,6137,6010,3338,47742,715258,718539,3154,6619,3408,5953,9418,51.69139193328034,11.269427669584644,3465,1,731022,17018,2672,0,57,609
9474,0,0,1,0,65,1,410,0,0,6258075,8943210,52.10566188045211,2223,5512,5020,2715,44642,727974,665388,2802,6009,3786,5599,8806,48.010415536631214,22.42943415643043,3207,1,548430,77244,2305,0,579,989
9475,0,0,0,1,65,1,386,0,0,6113151,8812881,51.70106381884226,2139,5494,4960,2673,44800,738528,659400,2763,5970,3831,5584,8791,47.82258880487337,23.371833905097134,3207,1,534600,87042,2287,0,624,1010
9476,0,0,0,1,65,1,137,0,0,5109690,7619100,48.27007354458868,1476,5377,4523,2330,40788,647460,673620,2416,5600,4124,5463,8647,46.82947789587238,29.383525455218923,3184,1,479980,105042,2193,0,940,1077
9477,0,0,0,1,64,1,23,0,0,4776278,7037238,46.62617290749907,1214,5331,4371,2174,41612,666822,653874,2277,5411,4197,5434,8568,46.87216658103186,31.086908524550026,3134,1,439148,133440,2197,0,1063,1040
9478,0,0,1,0,65,1,2040,0,0,5021044,11396586,59.00847396772772,3374,5032,4924,3482,55575,808431,736425,3165,6755,3381,4715,8305,37.97367509209505,10.424232425346673,3590,0,783450,16416,1442,1,209,1831
9479,0,0,1,0,64,1,2019,0,0,12979732,15426497,68.92749814116279,4656,7578,7483,4751,55056,805256,720834,3152,7998,3342,5979,10825,52.26853738148792,9.764028217990806,4846,1,1054722,15105,2732,0,1504,515
9480,0,0,0,1,66,1,748,0,0,9650765,11622954,59.18614702783076,3350,6411,6258,3503,39936,637056,690144,3165,6821,3471,6073,9729,52.48809388804284,12.37406973724078,3656,1,728624,17442,2755,0,185,563
9481,0,0,0,1,66,1,471,0,0,6307546,9101400,52.51666402200353,2270,5533,5045,2758,44690,719400,676500,2812,6058,3788,5587,8833,47.82258880487337,22.33738830177793,3246,1,565390,72712,2287,0,542,1013
9482,0,0,1,0,61,1,808,0,0,1300884,4969506,40.17461885320133,1356,2678,2420,1614,56153,742039,717407,2821,4693,3337,3885,5757,28.39013913315678,16.08188871827646,1872,1,376062,35346,806,0,1465,2273
9483,0,0,1,0,64,1,2019,0,0,11650950,14821836,67.59437846448475,4399,7289,7119,4569,55860,794780,739632,3074,7813,3414,5794,10533,50.49752469181039,13.054616162192646,4739,1,1041732,24990,2550,0,1325,694
9484,0,0,0,1,68,1,535,0,0,20863644,16606647,69.59166616772443,4397,9597,9151,4843,44038,778383,665226,2983,8272,3875,7737,13026,65.63535632568775,21.213622449422108,5289,1,939542,76712,4308,0,1414,879
9485,0,0,0,1,66,1,817,0,0,10308060,12199815,60.37383539249432,3518,6600,6473,3645,43264,696176,696176,3220,6992,3474,6175,9947,53.178943201233324,11.33196341945808,3772,1,758160,17018,2828,0,298,519
9486,0,0,0,1,66,1,805,0,0,10023666,12000366,59.94997914928745,3441,6536,6383,3594,41818,677817,687834,3186,6933,3492,6128,9875,52.81098370604357,12.37776262367691,3747,1,740364,19890,2789,0,255,550
9487,0,0,0,1,66,1,463,0,0,5921988,8854884,51.73006862551025,2058,5507,4889,2676,44622,734598,665109,2691,5985,3927,5522,8816,47.042533945356304,25.11800978877661,3294,1,537876,98880,2213,0,633,1096
9488,0,0,0,1,66,1,361,0,0,5445360,8336947,50.20956084253277,1736,5466,4681,2521,39984,674628,648172,2522,5828,4092,5467,8773,46.475800154489,28.247451959573517,3306,1,494116,111470,2160,0,786,1147
9489,0,1,1,0,64,0,1010,0,0,4598184,5486238,41.20679555607303,1698,4406,4406,1698,49560,678510,762516,3231,4929,3231,5939,7637,52.03844732503075,0.0,1698,1,400728,0,2708,0,1533,523
9490,0,0,1,0,61,0,151,0,0,1043900,2928614,30.805843601498726,491,2507,2049,949,48517,737554,626458,2628,4035,3544,4186,5593,33.166247903554,21.483326420130094,1407,0,192647,80150,1100,1,2137,1986
9491,0,0,1,0,63,1,1801,0,0,780482,6844892,46.49731175025068,1970,2715,2523,2162,55842,778836,718682,2974,5328,3358,3527,5881,19.0,13.856406460551018,2354,1,490774,27072,361,0,1004,2805
9492,0,0,0,1,68,1,745,0,0,19828736,16512651,69.57729514719583,4374,9404,8937,4841,45410,815229,648090,2944,8252,3878,7507,12815,64.0,21.62327537901098,5308,1,919790,88263,4096,0,1430,685
9493,0,0,0,1,68,1,693,0,0,20152444,16588429,69.63476143421474,4338,9516,9005,4849,46728,807356,677358,2910,8270,3932,7577,12937,64.4670458451448,22.62884108982759,5360,1,960102,90958,4156,0,1428,735
9494,0,0,0,1,70,1,959,0,0,14611836,15213984,65.81793068761733,3696,8341,7705,4332,46010,755080,751568,2876,7844,4148,6885,11853,58.077534382926416,25.628195115572044,4968,1,927048,85860,3373,0,820,139
9495,0,0,0,1,67,1,871,0,0,10710242,12548846,61.1310068623117,3642,6698,6603,3737,44091,695106,715254,3263,7095,3453,6224,10056,53.53503525729669,9.773682308767459,3832,1,795981,11970,2866,0,379,492
9496,0,0,0,1,66,1,570,0,0,6244000,9273600,52.91502622129181,2275,5555,5030,2800,43460,702144,678960,2787,6112,3837,5542,8867,47.22287581247038,23.147200055873345,3325,1,574000,74550,2230,0,512,1082
9497,0,0,0,1,66,1,549,0,0,6097390,9135049,52.52618394667559,2186,5542,4969,2759,43600,721798,662200,2738,6070,3884,5521,8853,47.01063709417264,24.17490877611208,3332,1,551800,88815,2210,0,552,1101
9498,0,0,0,1,66,1,413,0,0,5421264,8435904,50.438080851673966,1738,5481,4675,2544,39576,676464,643304,2510,5860,4122,5447,8797,46.16275555033516,28.626481480875814,3350,1,493536,116870,2131,0,772,1185
9499,0,0,1,0,64,1,36,0,0,4592125,6897750,46.09772228646444,1098,5313,4286,2125,42387,691398,645954,2219,5371,4273,5407,8559,46.486557196677836,32.43796324647532,3152,1,422875,155077,2161,0,1121,1085
9500,0,1,1,0,64,0,1019,0,0,4832202,5670762,41.79712908801273,1687,4573,4513,1747,46652,694644,707628,3186,4993,3306,6012,7819,52.592775169218825,7.780166052320878,1807,1,380846,7860,2766,0,1499,480
9501,0,1,1,0,64,0,1016,0,0,4573140,5467150,41.10960958218893,1660,4426,4396,1690,47299,656705,753755,3205,4925,3265,5941,7661,52.01922721455981,5.501408174353464,1720,1,393770,2910,2706,0,1545,529
9502,0,1,1,0,64,0,1011,0,0,4072950,5043150,39.68626966596886,1575,4161,4161,1575,52598,707642,762076,3202,4777,3202,5788,7363,50.85272854036448,0.0,1575,1,374850,0,2586,0,1627,616
9503,0,1,1,0,63,0,1010,0,0,3951576,4941016,39.319206502675,1546,4102,4102,1546,54240,722296,767040,3196,4742,3196,5752,7298,50.556898639058154,0.0,1546,1,371040,0,2556,0,1650,640
9504,0,1,1,0,62,0,997,0,0,3058440,4156680,36.3318042491699,1260,3697,3637,1320,52371,651843,796697,3089,4469,3209,5466,6846,48.13522618623496,7.750803389552748,1380,1,333960,3720,2317,0,1829,832
9505,0,0,1,0,63,1,1870,0,0,728531,6944155,46.9148164229596,1946,2787,2532,2201,56376,766665,731960,2900,5356,3410,3486,5942,18.193405398660254,15.990836858020131,2456,1,510632,35445,331,0,954,2824
9506,0,0,0,1,68,1,551,0,0,21430506,16935111,70.09279563550022,4455,9733,9275,4913,42112,772128,648036,2989,8360,3905,7809,13180,66.04543890383347,21.554453062019462,5371,1,923644,80150,4362,0,1466,915
9507,0,0,0,1,67,1,914,0,0,10820192,12728082,61.465437442517235,3658,6762,6642,3778,46161,697383,751287,3249,7147,3489,6233,10131,53.51635264103861,11.037374824906587,3898,1,842494,13800,2864,0,409,505
9508,0,0,1,0,66,1,846,0,0,9020160,11422080,58.787753826796276,3371,6151,6066,3456,52297,717185,796505,3220,6761,3390,5915,9456,51.088159097779204,9.235136611923052,3541,0,832896,8755,2610,1,151,695
9509,0,0,0,1,66,1,599,0,0,6068142,9230139,52.73518749374084,2189,5555,4963,2781,41764,703628,653843,2727,6100,3911,5501,8874,46.71188285650665,24.553542278423993,3373,1,547857,89392,2182,0,538,1137
9510,0,0,0,1,65,1,72,0,0,4612608,7106736,46.73328578219169,1113,5367,4296,2184,44496,702864,670324,2183,5438,4325,5366,8621,45.95650117230423,33.119620987198516,3255,1,449904,157437,2112,0,1070,1142
9511,0,0,0,1,65,1,38,0,0,4596375,7036239,46.50806381693394,1102,5349,4288,2163,43000,699395,650600,2192,5416,4314,5378,8602,46.09772228646444,32.96862266683221,3224,1,432600,161272,2125,0,1090,1128
9512,0,0,1,0,65,1,85,0,0,4498956,6767145,45.59605246071199,1029,5293,4243,2079,41128,690060,631470,2205,5334,4305,5419,8548,46.51881339845203,32.81212428455221,3129,1,403326,161700,2164,0,1176,1091
9513,0,0,0,1,65,1,146,0,0,4617171,7249203,47.148700936505136,1117,5406,4300,2223,44075,701115,668505,2155,5484,4367,5338,8667,45.574115460423364,33.65405250274624,3329,1,455715,162582,2077,0,1038,1184
9514,0,0,0,1,65,1,40,0,0,4506729,6988323,46.292547996410825,1056,5333,4246,2143,42372,697854,645678,2174,5404,4348,5364,8594,45.858477951192405,33.37737140229156,3230,1,424314,167398,2103,0,1118,1158
9515,0,0,1,0,65,1,228,0,0,4271904,6409812,44.22668877499196,874,5222,4140,1956,37572,661954,609522,2195,5233,4359,5461,8499,46.73328578219169,33.358658124851544,3038,1,363816,163382,2184,0,1321,1093
9516,0,0,1,0,58,1,83,0,0,62540,617980,14.560219778561036,65,784,507,212,50328,629640,679195,2638,3127,3192,3210,3699,17.175564037317667,16.660858965059326,489,1,49396,31301,295,0,2703,2620
9517,0,0,1,0,61,1,716,0,0,1205861,4643397,38.897300677553446,1271,2552,2310,1513,54978,730422,708939,2827,4582,3311,3866,5621,28.231188426986208,15.560597523821299,1755,1,349503,33638,797,0,1556,2272
9518,0,0,1,0,63,1,2040,0,0,1866625,8670950,52.20153254455275,2509,3626,3410,2725,46812,792318,598216,2966,5907,3398,3867,6808,26.1725046566048,14.827567958307,2941,1,512300,42768,685,0,457,2497
9519,0,0,1,0,64,1,2032,0,0,4551513,10954718,58.12916651733448,3259,4846,4726,3379,55890,787806,745660,3122,6621,3362,4589,8088,36.701498607005135,10.955211796648204,3499,0,777170,17280,1347,1,137,1895
9520,0,0,0,1,67,1,1029,0,0,19038132,16647936,70.05711955254797,4653,9042,8787,4908,47760,814080,675008,3137,8300,3647,7271,12434,62.281618476080084,16.01663663177248,5163,1,976692,46155,3879,0,1516,487
9521,0,0,0,1,67,1,1002,0,0,19197099,16672845,70.07852738178792,4634,9097,8820,4911,47874,804615,685790,3118,8306,3672,7304,12492,62.52199612936234,16.695186711087423,5188,1,992022,48475,3909,0,1516,514
9522,0,0,0,1,67,1,1001,0,0,11211110,13185198,62.3377895020348,3696,6961,6771,3886,46144,698958,760032,3203,7279,3583,6278,10354,53.71219600798314,13.973411963356208,4076,1,870464,21280,2885,0,493,508
9523,0,0,0,1,67,1,986,0,0,10600800,12789108,61.53048025166064,3604,6768,6586,3786,44732,716136,712758,3196,7164,3560,6178,10146,52.91502622129181,13.581456357942667,3968,1,798846,24570,2800,0,408,578
9524,0,0,0,1,67,1,981,0,0,10455580,12693375,61.326992425847855,3581,6721,6541,3761,44943,712125,718875,3195,7136,3555,6155,10096,52.72570530585627,13.416511385466217,3941,1,801093,23940,2780,0,386,595
9525,0,0,0,1,67,1,959,0,0,9739886,12198498,60.30754513325841,3484,6468,6315,3637,49712,697632,801606,3201,6991,3507,6032,9822,51.749396131742444,12.385270088696593,3790,1,869243,14535,2678,0,283,676
9526,0,0,1,0,66,1,929,0,0,8949996,11537568,59.09314681077663,3432,6115,6055,3492,53799,750008,783048,3244,6796,3364,5867,9419,50.62608023538856,7.765259411425052,3552,0,827604,7200,2563,1,188,741
9527,0,0,1,0,65,1,913,0,0,8579868,11275616,58.489315263559035,3421,5929,5929,3421,50838,754784,731712,3296,6717,3296,5804,9225,50.07993610219566,0.0,3421,0,759462,0,2508,1,125,788
9528,0,0,1,0,65,1,907,0,0,8458530,11189718,58.283788483591216,3367,5917,5887,3397,49720,744444,724680,3264,6691,3324,5784,9211,49.8998997994986,5.477225575051661,3427,0,747340,4260,2490,1,103,804
9529,0,0,1,0,61,0,83,0,0,693000,2425896,28.142494558940577,258,2201,1667,792,50718,725931,655482,2529,3855,3597,3938,5264,29.58039891549808,23.34547084689276,1326,0,169488,85974,875,1,2271,2188
9530,0,0,1,0,65,1,2000,0,0,13899600,15843600,69.7137002317335,4752,7828,7720,4860,48278,779140,658520,3152,8120,3368,6120,11088,53.47896782848375,10.45608800483739,4968,1,981720,19008,2860,0,1600,400
9531,0,0,0,1,66,1,1770,0,0,15570711,16265700,70.20683727387241,4779,8238,8088,4929,48822,782100,679800,3150,8229,3450,6459,11538,56.20498198558558,12.282138241571156,5079,1,1015374,25500,3159,0,1629,141
9532,0,0,0,1,68,1,1045,0,0,11495324,13479730,62.8728876384726,3763,7051,6861,3953,49280,750200,763840,3220,7363,3600,6318,10461,53.925875050851054,13.784144208499974,4143,1,885472,24700,2908,0,543,502
9533,0,0,0,1,67,1,1031,0,0,10866492,13050576,62.0644825967316,3677,6848,6673,3852,49060,745360,755524,3213,7240,3563,6209,10236,53.113086899558006,13.249871956203288,4027,1,858996,22925,2821,0,464,567
9534,0,0,0,1,67,1,1027,0,0,10715600,12958222,61.862751312886175,3665,6789,6627,3827,49504,758464,748306,3224,7213,3548,6186,10175,52.91502622129181,12.745345677861021,3989,1,845767,22518,2800,0,441,586
9535,0,0,1,0,66,1,933,0,0,8073898,11058530,57.844619455918284,3238,5867,5759,3346,33338,697355,522190,3197,6651,3413,5718,9172,49.122296363260546,10.45608800483739,3454,1,528668,20412,2413,0,41,892
9536,0,0,0,1,65,1,115,0,0,4354350,7022730,46.314144707637645,991,5329,4175,2145,43000,703910,654800,2120,5419,4428,5304,8603,45.05552130427524,34.38416960606145,3299,1,429000,175408,2030,0,1129,1244
9537,0,0,1,0,59,1,381,0,0,110016,572352,13.856406460551018,305,1262,765,192,50600,685630,655820,2484,3173,3478,3554,4243,23.93741840717165,22.46621065562339,689,1,42240,73059,573,0,2789,2408
9538,0,0,1,0,62,1,1988,0,0,539660,6975440,47.22287581247038,2068,2634,2472,2230,56870,756976,735080,2966,5358,3290,3370,5762,15.556349186104045,12.835667595140963,2392,1,524050,21708,242,0,898,2886
9539,0,0,0,1,65,1,1834,0,0,15513047,16361378,70.43436661176133,4781,8268,8088,4961,48240,791520,662898,3118,8259,3478,6425,11566,55.91958512006326,13.436652244415649,5141,1,997161,32220,3127,0,1663,171
9540,0,0,0,1,66,1,1739,0,0,15943452,16379580,70.39886362719217,4794,8335,8173,4956,47705,776675,670915,3143,8261,3467,6522,11640,56.71860364994893,12.727922061357855,5118,1,1006068,27864,3217,0,1651,88
9541,0,0,0,1,67,1,1317,0,0,18009108,16607409,70.37755323965163,4911,8631,8589,4953,50882,828191,690718,3311,8306,3395,6989,11984,60.29925372672534,6.495386533491135,4995,1,1020318,7518,3636,0,1600,283
9542,0,0,0,1,67,1,1231,0,0,18469782,16685262,70.40596565632774,4833,8807,8683,4957,49600,834768,673200,3242,8323,3490,7092,12173,61.04096984812741,11.15359010904883,5081,1,991400,22940,3726,0,1591,360
9543,0,0,0,1,68,1,1075,0,0,11145636,13328519,62.601916903558156,3769,6913,6763,3919,50095,731215,792433,3251,7320,3551,6245,10314,53.32916650389353,12.254111330655777,4069,1,913127,16950,2844,0,518,557
9544,0,0,0,1,67,1,1047,0,0,9949954,12528607,61.0,3601,6515,6395,3721,54984,781144,797979,3247,7088,3487,6041,9882,51.710733895391584,11.06238981080611,3841,1,881877,15000,2674,0,354,693
9545,0,0,0,1,67,1,919,0,0,7097772,10596050,56.24055476255546,2844,5726,5407,3163,42098,726950,649900,3031,6513,3669,5594,9076,47.37087712930804,18.169487535835472,3482,1,613622,51040,2244,0,187,1106
9546,0,0,1,0,60,1,901,0,0,1019180,4741132,39.44616584663204,1436,2331,2211,1556,54990,716045,712998,2927,4603,3167,3702,5378,25.592967784139454,11.037374824906587,1676,1,364104,15960,655,0,1491,2392
9547,0,0,1,0,64,1,2021,0,0,4750896,10993273,58.42088667591412,3353,4865,4805,3413,56133,782703,744051,3161,6634,3281,4613,8086,37.30951621235526,7.822290851349969,3473,0,788403,8520,1392,1,192,1829
9548,0,0,0,1,66,1,1465,0,0,17504700,16628220,70.5691150575094,4938,8537,8495,4980,48616,788004,687834,3297,8319,3381,6854,11876,59.28743543112655,6.484411467763075,5022,1,1025880,7056,3515,0,1641,176
9549,0,0,0,1,69,1,807,0,0,21343594,17421696,71.0,4583,9733,9275,5041,43548,787968,660096,2998,8497,3914,7690,13189,65.06919393998976,21.435767094332864,5499,1,962831,81066,4234,0,1585,778
9550,0,0,0,1,67,1,1090,0,0,10058499,12677547,61.34329629226001,3673,6526,6436,3763,55225,791715,791715,3279,7132,3459,6042,9895,51.70106381884226,9.491514370027666,3853,1,884305,11700,2673,0,394,696
9551,0,0,1,0,66,1,1059,0,0,8970352,11823581,59.75784467331465,3541,6113,6083,3571,50794,721798,771463,3281,6882,3341,5823,9424,50.11985634456667,5.478746393072713,3601,0,832043,3480,2512,1,260,799
9552,0,0,1,0,66,1,1030,0,0,8232000,11387600,58.56620185738529,3335,5925,5830,3430,31980,647400,544480,3225,6750,3415,5720,9245,48.98979485566356,9.874922862703322,3525,1,562520,15675,2400,0,110,920
9553,0,0,1,0,66,1,1020,0,0,7999776,11275488,58.172158288995945,3234,5898,5748,3384,28032,639744,486472,3182,6716,3482,5696,9230,48.620983124572874,12.429640165330436,3534,1,494064,26700,2364,0,52,968
9554,0,0,0,1,65,1,44,0,0,4063772,6707058,45.14421336118285,835,5235,4032,2038,41710,707565,638454,2088,5329,4494,5285,8526,44.654227123532216,35.125619460057266,3241,1,395372,191277,1994,0,1253,1297
9555,0,1,1,0,61,0,1002,0,0,1001160,1913328,24.859605789312106,448,2408,2238,618,46800,696600,643968,2926,3714,3266,4716,5504,40.24922359499622,13.067183365512706,788,0,128544,26180,1620,1,2478,1476
9556,0,0,1,0,61,0,656,0,0,1886160,3330048,32.92415526630866,1084,2824,2824,1084,45372,700416,611328,3072,4156,3072,4812,5896,41.71330722922842,0.0,1084,0,215716,0,1740,1,1988,1332
9557,0,0,1,0,61,1,1159,0,0,214002,499122,12.727922061357855,255,1900,1483,162,55692,733278,720954,2664,3243,3498,4402,4981,36.345563690772494,20.487886642892835,579,1,37908,56295,1321,0,2919,1760
9558,0,0,0,1,66,1,1833,0,0,15974128,16611287,70.83078426785913,4789,8429,8201,5017,42180,735042,629090,3083,8328,3539,6495,11740,56.42694391866354,15.100830606950982,5245,1,953230,38760,3184,0,1706,127
9559,0,0,0,1,67,1,1380,0,0,18212229,16808589,70.80254232723568,4983,8676,8646,5013,47705,787955,680659,3323,8366,3383,6986,12029,60.27437266367855,5.501408174353464,5043,1,1017639,5130,3633,0,1660,280
9560,0,0,0,1,67,1,1266,0,0,18836307,16924068,70.84490101623405,4934,8857,8772,5019,42770,792420,613704,3287,8391,3457,7125,12229,61.26173356998641,9.239893968762086,5104,1,913458,16405,3753,0,1647,381
9561,0,0,0,1,68,1,1152,0,0,11235025,13565547,63.06346010171025,3882,6897,6802,3977,50624,764064,770886,3316,7388,3506,6236,10308,53.150729063673246,9.747874142570481,4072,1,898802,12540,2825,0,566,586
9562,0,0,1,0,66,1,1068,0,0,8078508,11442840,58.532042506647585,3292,5918,5784,3426,27594,631260,487640,3206,6766,3474,5698,9258,48.55924216871593,11.850228582282101,3560,1,500196,23450,2358,0,86,982
9563,0,0,1,0,62,1,985,0,0,212394,566202,13.490737563232042,149,1680,1349,182,53360,715530,721752,2780,3293,3442,4278,4791,34.161381705077446,18.440883114201913,513,1,42224,43361,1167,0,2929,1944
9564,0,0,1,0,60,1,1212,0,0,781948,5116222,40.963398296528084,1618,2204,2144,1678,47311,771397,570163,2989,4727,3109,3515,5253,21.587033144922902,7.780166052320878,1738,1,313786,11940,466,0,1371,2583
9565,0,0,0,1,66,1,31,0,0,3843320,6532656,44.45222154178574,715,5182,3921,1976,42120,714096,644670,2045,5282,4567,5251,8488,44.10215414239989,35.967946327288786,3237,1,385320,200499,1945,0,1330,1361
9566,0,0,0,1,66,1,1,0,0,3816162,6458571,44.19275958796871,693,5167,3907,1953,41040,714312,628330,2047,5260,4567,5261,8474,44.204072210600685,35.95750798892221,3213,1,371070,206640,1954,0,1354,1353
9567,0,0,1,0,65,1,1983,0,0,13324234,15615754,69.0941386804988,4573,7766,7565,4774,44946,742517,647658,3070,8045,3472,6062,11037,52.82991576748916,14.30246497974513,4975,1,945252,33768,2791,0,1503,480
9568,0,0,0,1,66,1,1928,0,0,16003929,16867359,71.26710321038733,4784,8525,8230,5079,41070,737262,614385,3026,8400,3616,6472,11846,56.133768802744754,17.176797426721855,5374,1,939615,52215,3151,0,1758,170
9569,0,0,0,1,67,1,1559,0,0,17800770,17009850,71.20393247567159,4975,8676,8581,5070,42624,744810,644160,3260,8425,3450,6866,12031,59.253691868102194,9.779300676839927,5165,1,973440,15960,3511,0,1715,156
9570,0,0,0,1,68,1,1108,0,0,20350109,17474273,71.40728254176881,4857,9332,9090,5099,43659,791637,647703,3185,8526,3669,7418,12759,63.17436188834834,15.58026706699109,5341,1,963711,44044,3991,0,1672,564
9571,0,0,0,1,69,1,924,0,0,21530125,17758125,71.58910531638176,4759,9692,9326,5125,43092,790020,654885,3099,8590,3831,7666,13157,64.81512169239521,19.185202730889724,5491,1,968625,65514,4201,0,1660,736
9572,0,0,0,1,67,1,1156,0,0,8006460,11680420,58.872744118140105,3304,5938,5776,3466,28200,633560,505500,3208,6836,3532,5680,9308,48.062459362791664,13.226055982240474,3628,1,519900,27540,2310,0,96,1060
9573,0,0,0,0,57,1,216,1,0,431892,2242278,27.820855486487112,640,1466,1332,774,41666,727147,480902,2763,3671,3031,3455,4363,23.62202362203543,12.168439873279091,908,1,128484,27738,558,0,2123,2339
9574,0,0,1,0,64,1,2005,0,0,4393646,10656504,57.67148342118486,3266,4707,4647,3326,55632,781776,730512,3144,6530,3264,4525,7911,36.345563690772494,7.746504550744806,3386,0,758328,8880,1321,1,122,1883
9575,0,0,0,1,66,1,1832,0,0,16691913,17033814,71.43528539874394,4820,8657,8374,5103,43844,754388,647572,3055,8441,3621,6609,11995,57.19265687131522,16.822603841260722,5386,1,989982,48676,3271,0,1765,67
9576,0,0,0,1,67,1,1359,0,0,19158750,17304183,71.47726911403373,5079,8889,8859,5109,42120,792558,609660,3357,8496,3417,7137,12276,61.237243569579455,5.623413251903491,5139,1,919620,5820,3750,0,1722,363
9577,0,0,0,1,69,1,829,0,0,22528650,18074710,71.96526940128828,4733,9975,9529,5179,42488,788740,656120,3044,8669,3936,7840,13465,65.95452979136459,21.156935193388193,5625,1,973652,79388,4350,0,1689,860
9578,0,0,1,0,61,0,168,0,0,2012185,4132667,36.565010597564445,1157,3022,2842,1337,52192,720203,692384,2911,4428,3271,4596,6113,38.79432948254165,13.420133093141946,1517,0,299488,25920,1505,1,1754,1586
9579,0,0,1,0,61,0,560,0,0,1853700,3439890,33.31666249791537,990,2900,2780,1110,45901,722067,610503,2979,4209,3219,4769,5999,40.8656334834051,11.045361017187261,1230,1,218670,21120,1670,0,1989,1429
9580,0,0,1,0,60,1,903,0,0,903904,4546592,38.781438859330635,1474,2135,2105,1504,53357,692267,704359,2993,4527,3053,3624,5158,24.515301344262525,5.478746393072713,1534,1,350432,3840,601,0,1519,2422
9581,0,0,0,1,66,1,1832,0,0,16935600,17176804,71.63797875428926,4837,8727,8432,5132,42676,759769,629236,3052,8479,3642,6647,12074,57.445626465380286,17.176797426721855,5427,1,964816,52510,3300,0,1785,47
9582,0,0,0,1,67,1,1740,0,0,17390700,17226540,71.62401831787993,4902,8748,8520,5130,41610,735402,638020,3130,8488,3586,6748,12106,58.22370651203855,15.118224566217636,5358,1,974700,38076,3390,0,1772,32
9583,0,0,1,0,63,1,2005,0,0,2389800,9047100,53.33854141237835,2548,3982,3685,2845,52459,798180,664620,2883,6025,3477,4020,7162,28.982753492378876,17.237642888340194,3142,1,594605,52272,840,0,335,2340
9584,0,0,0,1,66,1,1924,0,0,16731360,17278744,71.86097689288673,4814,8754,8404,5164,44916,762888,659162,2996,8510,3696,6586,12100,56.92099788303083,18.71072998663751,5514,1,1017308,59500,3240,0,1818,106
9585,0,0,0,1,68,1,1363,0,0,19709130,17593373,71.92357054540605,5131,9025,8983,5173,42720,816240,605378,3359,8574,3443,7211,12426,61.72519744804386,6.5252844928085345,5215,1,920794,8442,3810,0,1772,409
9586,0,0,0,1,68,1,1335,0,0,19872000,17641575,71.93747284969079,5108,9082,9015,5175,42781,814751,610211,3342,8584,3476,7249,12491,61.96773353931867,8.286047041568583,5242,1,926325,13400,3840,0,1766,431
9587,0,0,0,1,70,1,888,0,0,22785300,18333000,72.37402849088892,4830,9996,9588,5238,44121,808500,668500,3092,8738,3908,7850,13496,65.95452979136459,20.24737255078314,5646,1,1000458,73440,4350,0,1738,850
9588,0,0,1,0,60,0,0,0,0,104976,975888,18.0,114,858,648,324,42488,680712,566256,2802,3336,3222,3336,3870,18.0,14.530975064444453,534,0,60912,37380,324,1,2688,2688
9589,0,0,1,0,64,1,1978,0,0,6800400,12142492,61.465437442517235,3566,5790,5578,3778,55932,758504,761718,3002,6992,3426,5014,9004,42.42640687119285,14.707715565889083,3990,1,895386,27348,1800,0,564,1414
9590,0,0,1,0,63,1,1977,0,0,7308630,12370533,62.185207244167,3717,5907,5757,3867,54366,706979,786954,3049,7066,3349,5089,9106,43.474130238568314,12.286588609993126,4017,1,951282,14850,1890,0,668,1309
9591,0,0,0,1,67,1,1954,0,0,16828560,17399900,72.069410986909,4818,8810,8434,5194,45113,767150,659950,2974,8544,3726,6590,12160,56.92099788303083,19.392913570512842,5570,1,1023218,64296,3240,0,1844,110
9592,0,0,0,1,67,1,1831,0,0,17441760,17483288,72.04859471218019,4908,8834,8551,5191,40182,747696,609608,3085,8559,3651,6728,12202,57.96550698475775,16.852769642656046,5474,1,939571,50940,3360,0,1823,8
9593,0,0,0,1,67,1,1710,0,0,18061200,17547390,72.04165461731151,4998,8862,8670,5190,39130,726915,615342,3189,8571,3573,6861,12243,58.9915248150105,13.914767815144769,5382,1,944580,32832,3480,0,1809,99
9594,0,1,1,0,62,0,1087,0,0,1167498,2091906,25.80697580112788,410,2675,2419,666,47952,697302,678456,2885,3807,3397,4894,5816,41.86884283091664,16.122189342008447,922,0,143856,36608,1753,1,2475,1388
9595,0,0,1,0,61,1,1827,0,0,208980,5913360,43.98863489584554,1785,2193,2043,1935,55056,757888,678432,2906,4991,3206,3164,5249,10.392304845413264,12.331628572798303,2085,1,429570,23550,108,0,1121,2948
9596,0,0,1,0,61,1,1961,0,0,121260,6178197,44.955533585978046,1913,2189,2081,2021,54467,767307,663369,2949,5078,3165,3117,5246,7.745966692414834,10.39586690415236,2129,1,438557,17604,60,0,1036,2997
9597,0,0,1,0,63,1,1982,0,0,3696488,10042336,56.16048432839589,3064,4416,4326,3154,54531,792816,697296,3094,6338,3274,4356,7600,34.23448553724738,9.570344002193607,3244,1,690726,14670,1172,0,30,2012
9598,0,0,0,1,66,1,1959,0,0,15366220,16761780,70.8519583356734,4566,8535,8081,5020,39528,721224,611037,2885,8359,3793,6400,11874,55.326304774492215,21.310996284050827,5474,1,918660,77634,3061,0,1681,278
9599,0,0,0,1,67,1,1769,0,0,18014220,17674920,72.24956747275377,4986,8905,8671,5220,39804,724604,629796,3152,8606,3620,6837,12291,58.74521257089806,15.359532512939644,5454,1,970920,38844,3451,0,1834,65
9600,0,0,0,1,69,1,1048,0,0,22325940,18409664,72.64984514780468,5001,9785,9508,5278,44132,823168,652256,3211,8766,3765,7718,13273,65.0384501660364,16.71315513208887,5555,1,986986,52353,4230,0,1790,742
9601,0,0,0,1,69,1,997,0,0,22681230,18488639,72.71175970914196,4963,9901,9577,5287,44460,818298,664430,3173,8784,3821,7787,13398,65.49809157525127,18.058400013542542,5611,1,1004530,59616,4290,0,1790,793
9602,0,0,1,0,61,0,242,0,0,1945359,3958505,35.76310948449533,1249,2830,2800,1279,48616,730420,637570,3065,4374,3125,4616,5925,39.0,5.501408174353464,1309,1,263474,5040,1521,0,1816,1574
9603,0,0,1,0,63,1,1962,0,0,8916088,13155560,64.21837743200929,4057,6353,6286,4124,39550,720940,558250,3123,7314,3257,5352,9543,46.49731175025068,8.20759886765899,4191,0,721700,12797,2162,1,934,1028
9604,0,0,0,1,67,1,1859,0,0,17802750,17787000,72.4568837309472,4953,8938,8641,5250,38055,728420,599676,3091,8638,3685,6779,12326,58.23229344616267,17.283487247627516,5547,1,929250,52272,3391,0,1862,3
9605,0,0,0,1,67,1,1829,0,0,17960250,17808000,72.4568837309472,4973,8948,8671,5250,39775,729280,627520,3115,8642,3669,6813,12340,58.489315263559035,16.71315513208887,5527,1,971250,46536,3421,0,1858,29
9606,0,0,0,1,67,1,1950,0,0,16580344,17401102,71.84705978674423,4704,8832,8374,5162,36366,704539,586554,2913,8533,3829,6583,12203,56.674509261219015,21.422352902084246,5620,1,898188,78776,3212,0,1791,159
9607,0,0,0,1,67,1,1949,0,0,17596292,17881466,72.67048919609665,4920,8974,8613,5281,36594,724604,579006,3025,8667,3747,6718,12360,57.723478758647246,19.041994986743525,5642,1,903051,65341,3332,0,1895,54
9608,0,0,0,1,72,1,1464,0,0,19858432,19149952,72.44308110509934,4193,10087,9032,5248,44702,791833,751694,2594,8897,4704,7433,13736,61.514225996918796,33.093791995823956,6303,1,1081088,156140,3784,0,1599,135
9609,0,0,1,0,62,1,1959,0,0,1500772,7957404,50.47771785649585,2301,3384,3137,2548,52164,786996,646461,2876,5671,3370,3712,6507,24.269322199023193,15.73481264800746,2795,1,527436,44213,589,0,575,2534
9610,0,0,0,1,68,1,1827,0,0,18494730,18123030,72.86974680894672,5027,9076,8793,5310,40205,733795,638231,3130,8723,3696,6896,12489,59.016946718718,16.932635452148716,5593,1,992970,47261,3483,0,1897,70
9611,0,0,0,1,68,1,1428,0,0,21094108,18370212,73.22567855609124,5362,9296,9296,5362,43621,825666,620106,3426,8788,3426,7360,12722,62.72160712226688,0.0,5362,1,970522,0,3934,0,1936,508
9612,0,0,0,1,73,1,1580,0,0,18385500,18952000,71.76350047203663,3942,9928,8720,5150,42228,761760,750720,2472,8830,4888,7250,13608,59.74947698515862,35.36884554251708,6358,1,1050600,165496,3570,0,1470,110
9613,0,0,0,1,73,1,1581,0,0,18154332,18840948,71.58212067269312,3945,9846,8667,5124,42640,753785,764816,2498,8801,4856,7220,13523,59.52310475773252,34.77177150437446,6303,1,1065792,153270,3543,0,1447,134
9614,0,0,0,1,73,1,1583,0,0,17928084,18733726,71.40728254176881,3949,9765,8615,5099,42640,753170,764192,2524,8773,4824,7190,13439,59.295868321494375,34.353132372893086,6249,1,1060592,149500,3516,0,1425,158
9615,0,1,1,0,63,0,1118,0,0,2781600,3804000,34.64101615137755,1092,3626,3518,1200,43956,703740,627660,3062,4370,3278,5488,6796,48.14561246884289,10.45608800483739,1308,1,237600,17496,2318,0,1970,852
9616,0,0,1,0,62,0,82,0,0,1902719,4413626,37.69615364994153,1354,2827,2760,1421,48530,714380,655366,3039,4527,3173,4445,5933,36.59234892706397,8.19263674150144,1488,0,299831,10452,1339,1,1685,1767
9617,0,0,1,0,62,0,104,0,0,1809012,4033398,35.9722114972099,1227,2759,2692,1294,47800,744963,623400,3050,4411,3184,4515,5876,37.389838191679836,8.19263674150144,1361,1,258800,11926,1398,0,1823,1719
9618,0,0,1,0,60,1,1788,0,0,614485,6309407,45.639894828976104,1975,2486,2378,2083,51359,766337,614887,2921,5112,3137,3324,5515,17.175564037317667,10.403202108104866,2191,1,422849,19764,295,0,946,2734
9619,0,0,0,1,73,1,1602,0,0,19321423,19432072,72.58787777583802,4056,10149,8936,5269,43537,815048,726536,2475,8957,4901,7355,13837,60.55575942881073,35.466581065824606,6482,1,1037993,195293,3667,0,1581,21
9620,0,0,1,0,61,0,312,0,0,76788,495882,12.727922061357855,102,696,636,162,44544,710152,587712,3001,3223,3121,3535,3757,21.77154105707724,7.914659756013729,222,0,31104,10800,474,1,2899,2587
9621,0,0,1,0,62,0,72,0,0,1859200,4354000,37.416573867739416,1370,2758,2728,1400,48024,721520,643770,3080,4510,3140,4438,5868,36.4417343165772,5.478746393072713,1430,0,289800,4890,1328,1,1710,1782
9622,0,0,1,0,57,1,186,0,0,197467,1038958,19.0,208,1061,908,361,47304,621648,630282,2725,3239,3031,3425,3939,23.388031127053,12.395127579391273,514,1,79059,20196,547,0,2517,2331
9623,0,0,1,0,63,1,1903,0,0,3270540,9494150,54.72659317004851,2953,4129,4087,2995,48111,751290,643510,3128,6165,3212,4262,7299,33.04542328371661,6.503581472166948,3037,0,607985,7308,1092,1,175,2078
9624,0,0,1,0,63,1,1915,0,0,6500646,11654046,60.67124524847005,3621,5507,5447,3681,55632,772504,721848,3106,6847,3226,4932,8673,42.02380277890139,7.810249675906654,3741,1,839268,8880,1766,0,515,1400
9625,0,0,0,1,64,1,1918,0,0,9506760,13543992,64.71475874945375,3911,6735,6458,4188,34650,747054,485100,2957,7422,3511,5504,9969,47.644516998286385,16.782604634904654,4465,1,628200,60386,2270,0,954,964
9626,0,0,0,1,66,1,1919,0,0,10895766,14558467,66.30987860040162,4007,7265,6875,4397,34476,731731,516516,2921,7708,3701,5789,10576,49.77951385861457,20.229639563684994,4787,1,685932,79170,2478,0,1086,833
9627,0,0,1,0,62,0,121,0,0,1847300,4423573,37.69615364994153,1379,2763,2721,1421,48048,719103,647504,3071,4534,3155,4413,5876,36.05551275463989,6.484411467763075,1463,0,295568,6762,1300,1,1692,1813
9628,0,0,0,1,66,1,1913,0,0,10908390,14595795,66.29479617586888,3977,7295,6877,4395,31861,700731,501471,2903,7716,3739,5803,10616,49.8196748283246,20.965876316427124,4813,1,663645,82346,2482,0,1074,839
9629,0,0,0,1,66,1,1913,0,0,11115600,14730825,66.52067347825036,3995,7367,6937,4425,32956,712406,512666,2899,7754,3759,5841,10696,50.11985634456667,21.280035892080402,4855,1,681450,84710,2512,0,1096,817
9630,0,0,0,1,73,1,1650,0,0,20040079,19851884,73.32803011127464,4176,10305,9104,5377,46284,841776,749476,2491,9069,4893,7419,13997,61.04916051838878,35.0133567836699,6578,1,1091531,196964,3727,0,1685,35
9631,0,0,1,0,59,1,704,0,0,673545,3695160,35.2845575287547,1017,2014,1786,1245,54808,736064,655928,2740,4213,3196,3509,4982,23.259406699226016,15.203452770714037,1473,1,275145,36480,541,0,1723,2427
9632,0,0,0,1,66,1,1906,0,0,11125752,14760636,66.4981202741852,3965,7395,6938,4422,34720,724346,534080,2881,7760,3795,5854,10733,50.15974481593781,21.952938992457266,4879,1,707520,89115,2516,0,1084,822
9633,0,0,1,0,62,0,156,0,0,1797565,4432099,37.69615364994153,1391,2716,2686,1421,48697,726727,651871,3089,4540,3149,4384,5835,35.566838487557476,5.477225575051661,1451,0,296989,4860,1265,1,1698,1854
9634,0,0,0,1,74,1,1712,0,0,19060865,19660330,72.83543093852057,4151,10052,8898,5305,50032,874616,785672,2552,9011,4860,7299,13758,59.941638282582836,34.393704053964164,6459,1,1124660,186948,3593,0,1599,113
9635,0,0,0,1,73,1,1731,0,0,16979220,18750744,71.2460525222275,3989,9508,8421,5076,47945,823762,794210,2607,8770,4781,7039,13202,57.83597496368502,33.52224743926711,6163,1,1091340,157615,3345,0,1382,349
9636,0,1,1,0,62,0,1144,0,0,287472,661864,14.560219778561036,205,1985,1568,212,44814,605668,721182,2705,3334,3539,4478,5107,36.823905279043935,20.588081104424617,629,0,48972,36279,1356,1,2910,1766
9637,0,0,1,0,60,0,383,0,0,108870,577790,13.784048752090222,70,883,763,190,51170,723758,653815,2921,3231,3161,3614,3924,23.93741840717165,10.966602528904897,310,0,40850,19320,573,1,2851,2468
9638,0,0,1,0,61,0,241,0,0,352110,1498165,22.02271554554524,106,1590,1211,485,48930,719737,648690,2710,3574,3468,3815,4679,26.94438717061496,19.53922595799218,864,0,101850,61398,726,1,2604,2363
9639,0,0,1,0,61,0,224,0,0,413865,1672231,23.259406699226016,104,1743,1306,541,48697,720203,646019,2654,3632,3528,3856,4834,27.65863337187866,20.967313896858315,978,0,113069,70794,765,1,2550,2326
9640,0,0,1,0,62,0,357,0,0,1743694,4732452,38.87158345115362,1216,2960,2665,1511,46800,704700,651456,2837,4643,3427,4286,6092,33.97057550292606,17.219799652250742,1806,1,314288,45725,1154,0,1621,1978
9641,0,0,0,1,65,1,1890,0,0,9565731,13606824,64.64518543557594,3818,6829,6468,4179,34164,761904,475376,2895,7435,3617,5545,10085,47.843494855622744,19.229093296006578,4540,1,610134,80864,2289,0,923,967
9642,0,0,0,1,68,1,1898,0,0,14223720,16570150,69.55573304911681,4140,8476,7778,4838,37516,774050,568550,2727,8263,4123,6365,11901,54.22176684690383,27.008975353930854,5536,1,803108,138902,2940,0,1413,485
9643,0,0,0,1,74,1,1753,0,0,17648720,19131936,71.88880302244571,4001,9750,8583,5168,49494,836652,810738,2535,8870,4869,7117,13452,58.43800133474792,34.56514035266507,6335,1,1131792,166881,3415,0,1466,287
9644,0,0,1,0,62,0,166,0,0,893712,2690662,29.427877939124322,187,2577,1898,866,48204,727038,640042,2428,3973,3786,4139,5684,32.12475680841802,26.1431718501347,1545,0,178396,113393,1032,1,2241,2075
9645,0,0,0,1,74,1,1760,0,0,19538649,19964222,73.39618518697004,4300,10101,9014,5387,49059,878322,767142,2619,9093,4793,7333,13807,60.22457969965419,33.431456630931315,6474,1,1115109,183703,3627,0,1681,79
9646,0,0,0,1,74,1,1777,0,0,17877288,19304554,72.17340230306452,4080,9770,8641,5209,49704,844968,807908,2577,8915,4835,7138,13476,58.58327406350724,34.03749771185958,6338,1,1135562,164834,3432,0,1503,274
9647,0,0,1,0,58,1,671,0,0,518670,3304120,33.61547262794322,980,1739,1589,1130,52371,739772,605268,2774,4054,3074,3383,4663,21.42428528562855,12.849476832533073,1280,1,233910,26250,459,0,1794,2465
9648,0,0,0,1,74,1,1816,0,0,16958625,19003500,71.58910531638176,3997,9562,8434,5125,43416,800928,745308,2580,8833,4836,7017,13270,57.52390807307862,34.16072950701985,6253,1,1030125,171456,3309,0,1417,399
9649,0,1,1,0,64,0,1154,0,0,2122560,3192750,31.464265445104548,630,3494,3134,990,39277,699825,583725,2865,4215,3585,5369,6719,46.3033476111609,19.18704342521298,1350,1,179190,62640,2144,0,2235,1081
9650,0,0,1,0,63,1,1861,0,0,8336292,12637232,62.960304954788775,3709,6322,6067,3964,41536,752368,561088,2933,7152,3443,5291,9510,45.858477951192405,16.01663663177248,4219,0,697664,51000,2103,1,776,1085
9651,0,0,1,0,57,1,320,0,0,112784,1541204,23.065125189341593,405,871,744,532,46144,596782,648928,2770,3429,3024,3109,3768,14.560219778561036,11.66725943004119,659,1,119168,14351,212,0,2365,2685
9652,0,0,0,1,74,1,1856,0,0,16905041,19157675,71.71471257698799,4056,9517,8430,5143,40301,785975,711475,2638,8868,4812,7012,13242,57.33236433289665,33.49976684056181,6230,1,982313,169572,3287,0,1418,438
9653,0,0,0,1,74,1,1846,0,0,15721112,18617632,70.66823897621902,3962,9174,8142,4994,39576,760512,723232,2696,8722,4760,6876,12902,56.10704055642215,32.866064961217134,6026,1,968836,149640,3148,0,1266,580
9654,0,0,0,1,74,1,1844,0,0,15487680,18500828,70.45565981523414,3956,9092,8084,4964,39576,760308,723038,2719,8691,4735,6847,12819,55.85696017507576,32.51109263552084,5972,1,963016,146160,3120,0,1237,607
9655,0,0,0,1,74,1,1842,0,0,15255928,18389018,70.24243731534378,3950,9010,8026,4934,39780,760308,726765,2743,8661,4711,6819,12737,55.60575509783138,32.157554501887745,5918,1,962130,140712,3092,0,1207,635
9656,0,0,1,0,62,0,110,0,0,1150451,3533770,33.60059523282288,696,2581,2148,1129,46487,716770,635390,2697,4259,3563,4149,5711,31.921779399024736,20.892082102410015,1562,0,229187,71445,1019,1,2001,2111
9657,0,0,0,0,60,1,1562,1,0,1383783,6618474,46.82947789587238,2163,2854,2824,2193,38078,727338,476844,2988,5211,3048,3649,5872,25.11971337416094,5.623413251903491,2223,1,346494,6600,631,0,825,2387
9658,0,0,0,1,68,1,1866,0,0,13867432,16325012,69.07966415668217,3979,8471,7678,4772,41064,807356,595254,2628,8193,4214,6327,11892,53.907327887774215,28.72500741473282,5565,1,830328,160186,2906,0,1351,515
9659,0,0,0,1,74,1,1865,0,0,19547286,20223210,73.83088784512888,4484,10004,9037,5451,48616,875560,764260,2743,9161,4677,7296,13714,59.88321968631947,31.660537658082617,6418,1,1122906,163423,3586,0,1741,124
9660,0,0,0,1,74,1,1870,0,0,17814104,19586050,72.5120679611332,4243,9661,8646,5258,43232,834400,718925,2710,8983,4740,7113,13386,58.20652884342099,32.44452402730966,6273,1,1014794,172550,3388,0,1533,337
9661,0,0,1,0,58,1,162,0,0,136323,1335231,21.42428528562855,247,968,756,459,53124,677797,663252,2697,3368,3121,3206,3877,17.233687939614086,14.852658030956366,671,1,104652,29256,297,0,2450,2612
9662,0,0,0,1,74,1,1886,0,0,19541151,20278656,73.91210996852952,4525,9978,9040,5463,45936,861184,734976,2774,9175,4650,7289,13690,59.80802621722272,31.2247846974625,6401,1,1081674,162274,3577,0,1751,135
9663,0,0,0,1,74,1,1876,0,0,17748012,19602674,72.48448109768049,4267,9619,8632,5254,40920,820820,693966,2744,8985,4718,7109,13350,58.12056434688156,32.051890856923166,6241,1,977244,170751,3378,0,1523,353
9664,0,0,0,1,65,1,1836,0,0,10126620,13887090,65.0384501660364,3696,7158,6624,4230,40356,774788,561393,2749,7513,3817,5677,10441,48.92851929090027,23.371833905097134,4764,1,723330,108936,2394,0,947,889
9665,0,0,0,1,68,1,1850,0,0,13698600,16215540,68.84765791223403,3908,8462,7630,4740,40482,800514,591833,2589,8161,4253,6311,11883,53.75872022286245,29.384904968086193,5572,1,820020,167232,2890,0,1319,531
9666,0,0,0,1,74,1,1891,0,0,19216770,20210460,73.68853370776216,4518,9881,8969,5430,40848,826284,684848,2810,9152,4634,7261,13603,59.48949487094339,30.86824195663004,6342,1,999120,161424,3539,0,1708,183
9667,0,0,0,1,74,1,1881,0,0,17438140,19542203,72.2564875980005,4252,9530,8561,5221,38700,804745,673740,2774,8964,4712,7083,13273,57.79273310719956,31.835419842811394,6190,1,939780,166668,3340,0,1478,403
9668,0,0,0,1,75,1,1864,0,0,15059457,18480942,70.16409338115899,3882,9023,7982,4923,39585,762062,732030,2713,8677,4795,6813,12777,55.308227236099334,33.11615215972034,5964,1,959985,147822,3059,0,1169,695
9669,0,1,1,0,64,0,1153,0,0,4696454,5404504,40.8166632639171,1516,4635,4485,1666,37558,684484,577432,3094,4910,3394,6063,7879,53.094255809833136,12.561867176898298,1816,1,296548,25500,2819,0,1578,425
9670,0,1,1,0,65,0,1154,0,0,4191200,5051450,39.370039370059054,1316,4488,4254,1550,39312,677872,615951,3025,4809,3493,5963,7747,52.0,15.646931621159402,1784,1,292950,36504,2704,0,1709,555
9671,0,0,1,0,62,0,348,0,0,445824,1607856,22.715633383201094,306,1590,1380,516,44622,691752,626316,2906,3632,3326,3980,4706,29.393876913398138,14.569686477165773,726,0,103716,33600,864,1,2600,2252
9672,0,0,1,0,62,1,1770,0,0,5049000,10329000,57.445626465380286,3233,4897,4830,3300,48175,735550,641650,3063,6430,3197,4660,8027,39.11521443121589,8.189452396126915,3367,0,676500,11323,1530,0,170,1600
9673,0,0,0,1,67,1,1840,0,0,12622500,15509610,67.74953874381728,3785,8145,7340,4590,43120,827855,594704,2574,7969,4184,6129,11524,52.44044240850758,28.78809627549796,5395,1,807840,166635,2750,0,1211,629
9674,0,0,0,1,67,1,1841,0,0,12838980,15671040,67.97058187186572,3804,8215,7399,4620,41968,827648,583424,2576,8012,4208,6171,11607,52.716221412388805,29.031683657197565,5436,1,794640,171360,2779,0,1228,613
9675,0,0,1,0,62,1,1732,0,0,4196220,9609900,55.58776843874919,3060,4478,4448,3090,53424,783720,659320,3080,6200,3140,4468,7588,36.851051545376556,5.501408174353464,3120,0,655080,5160,1358,1,20,1752
9676,0,0,0,1,68,1,1836,0,0,13536540,16075230,68.62943974709395,3835,8459,7584,4710,42978,843011,593862,2538,8123,4288,6287,11872,53.60970061472084,30.08285978397274,5585,1,819540,183750,2874,0,1297,539
9677,0,0,0,1,68,1,1837,0,0,13760220,16225020,68.84765791223403,3854,8529,7643,4740,44954,845481,622986,2537,8163,4309,6326,11952,53.879495172096775,30.288766829822414,5626,1,862680,179858,2903,0,1317,520
9678,0,0,0,1,75,1,1896,0,0,17565505,19684485,72.42237223399962,4343,9496,8594,5245,40950,844425,683046,2851,8998,4655,7102,13249,57.87054518492115,30.867672460020653,6147,1,954590,165066,3349,0,1492,404
9679,0,0,0,1,75,1,1870,0,0,13809999,17938221,69.04346457123947,3788,8643,7664,4767,37249,726259,726259,2784,8530,4742,6660,12406,53.823786563191554,32.26509728363091,5746,1,920031,129228,2897,0,1004,866
9680,0,0,0,1,75,1,1882,0,0,14192208,18220248,69.45502141674135,3783,8807,7766,4824,39794,762954,744069,2736,8601,4818,6719,12584,54.24020648928247,33.22846490470496,5865,1,950328,143658,2942,0,1047,835
9681,0,0,1,0,62,0,345,0,0,604656,1952496,24.979991993593593,354,1863,1593,624,48124,710283,663348,2859,3753,3399,4098,4992,31.12876483254676,16.53970051798896,894,0,132288,41040,969,1,2505,2160
9682,0,0,1,0,63,0,547,0,0,1103508,4303953,36.864617182333525,1169,2361,2171,1359,44352,709408,627066,2977,4526,3357,3979,5528,28.495613697550013,13.814873398238463,1549,1,269082,31350,812,0,1808,2355
9683,0,0,1,0,59,1,854,0,0,1315847,4926584,40.63249930782009,1368,2731,2448,1651,35916,653496,489376,2701,4635,3267,3781,5715,28.231188426986208,17.020926117136145,1934,1,270764,54902,797,0,1333,2187
9684,0,0,1,0,62,1,1592,0,0,2660609,8180263,51.09794516416487,2399,3842,3630,2611,50800,795782,626600,2921,5744,3345,4152,6975,31.921779399024736,15.088691753432045,2823,0,522200,38372,1019,1,522,2114
9685,0,0,1,0,62,0,84,0,0,885600,2821500,30.0,498,2286,1884,900,46740,714780,642675,2733,4035,3537,4119,5421,31.368774282716245,20.104429239209527,1302,0,184500,64722,984,1,2235,2151
9686,0,0,0,1,67,1,1813,0,0,13425108,15910719,68.4178339323893,3732,8498,7549,4681,43318,822558,608421,2450,8080,4348,6267,11897,53.55371135598354,31.190212866670574,5630,1,837899,191698,2868,0,1282,531
9687,0,0,0,1,75,1,1905,0,0,15458814,18952416,70.69653456853455,4056,9033,8091,4998,42874,838032,735648,2850,8790,4734,6885,12825,55.614746245937326,31.678600920546746,5940,1,969612,155430,3093,0,1206,699
9688,0,0,1,0,62,1,1620,0,0,3517749,8941302,53.41348144429457,2768,4171,4086,2853,53750,783500,673810,3049,5987,3219,4367,7305,35.11409973215888,9.370214040084857,2938,0,613395,13345,1233,1,281,1901
9689,0,0,1,0,62,1,1567,0,0,3190578,8513676,52.28766584960549,2607,4028,3901,2734,52250,778500,650826,2987,5848,3241,4281,7142,34.161381705077446,11.423450032283785,2861,0,571406,20447,1167,1,380,1947
9690,0,0,0,1,67,1,1792,0,0,12636740,15414998,67.54257916307313,3638,8256,7332,4562,38988,770412,577809,2455,7941,4303,6149,11635,52.630789467763066,30.761202060036332,5486,1,780102,181104,2770,0,1183,609
9691,0,0,0,1,76,1,1910,0,0,13972139,18347156,69.3757882838098,3795,8734,7716,4813,40768,792896,747152,2794,8625,4830,6715,12546,53.879495172096775,32.87527204583122,5831,1,943348,150664,2903,0,1001,909
9692,0,0,0,1,76,1,1903,0,0,12877304,17769840,68.2934843158555,3614,8475,7425,4664,41808,792480,765810,2760,8474,4860,6571,12285,52.54521862167861,33.525611650132724,5714,1,937464,149100,2761,0,854,1049
9693,0,1,1,0,66,0,1248,0,0,2631268,3677314,33.37663853655727,456,4134,3476,1114,46434,719618,703113,2643,4415,3959,5663,7435,48.60041152089147,25.894515114144475,1772,0,237282,92778,2362,1,2187,939
9694,0,0,1,0,62,0,211,0,0,864030,2612010,28.809720581775867,560,2141,1871,830,46350,708075,648282,2877,3977,3417,4188,5288,32.264531609803356,16.482158661538314,1100,0,170980,42660,1041,1,2317,2106
9695,0,0,1,0,58,1,174,0,0,315055,1902120,25.592967784139454,413,1378,1136,655,45144,574992,662112,2662,3559,3146,3385,4282,21.93171219946131,15.760547165865924,897,1,149340,23474,481,0,2249,2423
9696,0,0,0,1,68,1,1789,0,0,13552602,15969030,68.4324484437025,3650,8610,7577,4683,41064,791120,603570,2377,8093,4443,6304,12020,53.79591062525106,32.52479773082957,5716,1,828891,201435,2894,0,1273,516
9697,0,0,0,1,76,1,1908,0,0,12397788,17542824,67.83804242458652,3555,8343,7296,4602,44517,811956,796708,2765,8414,4859,6506,12155,51.90375708944392,33.49449888284914,5649,1,961818,145533,2694,0,790,1118
9698,0,0,0,1,67,1,420,0,0,1561189,5007030,38.43175770115127,777,3234,2534,1477,54635,755970,830550,2690,4867,4090,4447,6624,32.51153641401772,27.161727593988832,2177,1,361865,72100,1057,0,1913,2333
9699,0,0,1,0,63,0,373,0,0,874380,3608100,33.76388603226827,816,2231,1907,1140,46029,724785,636165,2841,4305,3489,3932,5396,27.694764848252458,18.01712232972779,1464,1,229140,54432,767,0,2025,2398
9700,0,0,1,0,63,0,63,0,0,1261260,3683295,33.98529093593286,1155,2247,2247,1155,49405,768549,653745,3189,4344,3189,4281,5436,33.04542328371661,0.0,1155,1,236775,0,1092,0,2034,2097
9701,0,0,1,0,61,1,1495,0,0,3053144,8145248,51.45872132107443,2540,3909,3801,2648,51612,778228,627504,2968,5724,3184,4229,6985,33.95585369269929,10.748049169056976,2756,0,540192,18792,1153,1,428,1923
9702,0,0,1,0,64,1,1693,0,0,6570738,11474856,59.54829972383762,3155,5790,5399,3546,33598,692504,508052,2845,6782,3627,5089,9026,43.04648650006177,20.14717987125415,3937,1,556722,76245,1853,0,310,1383
9703,0,0,0,1,68,1,1782,0,0,13600555,15999275,68.4470598345904,3628,8645,7588,4685,44268,812770,635190,2358,8100,4472,6318,12060,53.879495172096775,32.899484644989606,5742,1,871410,204001,2903,0,1270,512
9704,0,0,0,1,76,1,1918,0,0,12777720,17815180,68.26419266350405,3568,8494,7402,4660,44310,806653,802830,2731,8483,4915,6565,12317,52.364109846344185,33.974554188214036,5752,1,978600,148512,2742,0,837,1081
9705,0,0,1,0,65,0,323,0,0,522258,1885224,24.06241883103193,307,1753,1481,579,50298,810744,657712,2984,3835,3528,4158,5009,30.033314835362415,16.580875864653027,851,1,116958,50048,902,0,2677,2354
9706,0,0,1,0,57,1,340,0,0,550221,2684073,30.512292604784715,889,1564,1522,931,39072,507408,640026,2841,3814,2925,3474,4447,24.310491562286437,6.919919043981043,973,1,206682,3150,591,0,1952,2292
9707,0,0,1,0,63,1,1659,0,0,5909122,10849814,58.29236656715869,3074,5461,5137,3398,42480,766320,565161,2869,6591,3517,4932,8654,41.701318923986086,18.230282392466727,3722,1,601446,65772,1739,0,205,1454
9708,0,0,0,1,76,1,1933,0,0,14279778,18645477,69.76388750635962,3955,8713,7801,4867,43120,842820,750876,2919,8698,4743,6765,12544,54.16641025580336,31.44472856085661,5779,1,953932,148656,2934,0,1036,897
9709,0,0,0,1,76,1,1924,0,0,12514112,17711356,68.0294054067798,3544,8416,7332,4628,44730,815151,803670,2743,8455,4911,6531,12243,52.0,32.94235966169825,5712,1,971880,149592,2704,0,801,1123
9710,0,0,0,1,76,1,1941,0,0,14467680,18781056,69.9714227381436,4026,8721,7851,4896,44946,870772,759528,2966,8732,4706,6791,12557,54.35991169970753,30.857603315606543,5766,1,969408,146160,2955,0,1060,881
9711,0,0,0,1,76,1,1933,0,0,12900558,17989554,68.45436436049933,3654,8471,7439,4686,46872,833063,829224,2807,8525,4871,6592,12310,52.46903848937962,33.21495791831233,5718,1,1012176,139320,2753,0,847,1086
9712,0,0,0,1,76,1,1916,0,0,10231157,16436025,65.55150646628954,3456,7519,6678,4297,42174,757350,814725,2984,8122,4666,6206,11344,48.79549159502341,29.024580236419574,5138,1,915261,95874,2381,0,472,1444
9713,0,0,0,1,68,1,570,0,0,1441531,5164600,38.97435053981015,893,3094,2468,1519,52800,748000,816000,2774,4919,4026,4349,6494,30.805843601498726,25.91350021907068,2145,1,364560,68234,949,0,1881,2451
9714,0,0,0,1,65,1,131,0,0,1368122,3640952,33.25657829663178,488,2961,2343,1106,55860,750576,806540,2674,4398,3910,4529,6253,35.17101079013795,25.151010236348657,1724,1,270970,64890,1237,0,2186,2055
9715,0,0,1,0,65,0,357,0,0,700018,2200250,26.019223662515376,524,1864,1711,677,40800,780000,552500,3097,3927,3403,4284,5114,32.155870381627054,12.519275369364598,830,1,115090,31824,1034,0,2573,2216
9716,0,0,0,1,76,1,1941,0,0,12855640,17999770,68.4470598345904,3670,8444,7429,4685,49050,864450,837556,2827,8527,4857,6586,12286,52.38320341483518,32.99132167396337,5700,1,1021330,145145,2744,0,843,1098
9717,0,0,0,1,76,1,1922,0,0,9992895,16300830,65.30696746902278,3466,7407,6608,4265,47234,798798,863772,3023,8087,4621,6165,11229,48.40454524112379,28.28998161487986,5064,1,963890,90287,2343,0,443,1479
9718,0,0,0,1,76,1,1920,0,0,9804025,16169230,65.07687761409578,3453,7332,6550,4235,47722,817052,851414,3036,8053,4600,6133,11150,48.11444689487763,27.98440753421755,5017,1,944405,96186,2315,0,417,1503
9719,0,0,0,1,67,1,543,0,0,1398870,5038605,38.535697735995385,896,3016,2427,1485,52297,736281,817713,2804,4878,3982,4335,6409,30.692018506445613,25.189701848971602,2074,1,357885,60078,942,0,1908,2451
9720,0,0,1,0,64,1,441,0,0,1261260,3001152,30.397368307141328,266,2947,2289,924,55932,766528,769776,2590,4172,3906,4613,6195,36.945906403822335,25.773295272801498,1582,1,218988,75012,1365,0,2324,1883
9721,0,1,1,0,64,0,1387,0,0,1351020,2131140,25.69046515733026,120,3247,2707,660,54560,710380,800792,2689,3889,3769,5276,6476,45.24378410345447,23.401152003476653,1200,0,163680,50760,2047,1,2569,1182
9722,0,0,1,0,63,0,169,0,0,871766,3233608,31.96873472629156,852,2045,1875,1022,45854,718228,639128,2994,4186,3334,4017,5209,29.206163733020468,13.057424488445035,1192,0,206444,27710,853,1,2142,2311
9723,0,0,0,1,76,1,1949,0,0,13251942,18241578,68.86944169949398,3794,8486,7537,4743,51429,911502,834582,2897,8589,4795,6640,12332,52.85830114561004,32.07324969424087,5692,1,1029231,148993,2794,0,897,1052
9724,0,0,0,1,76,1,1948,0,0,13031445,18126198,68.65129277733959,3740,8451,7478,4713,50561,896118,834582,2873,8559,4819,6611,12297,52.583267300539625,32.417200274194194,5686,1,1022721,149842,2765,0,867,1081
9725,0,0,1,0,63,0,509,0,0,808520,3784587,34.48187929913333,858,2200,1869,1189,46512,725724,649332,2852,4372,3514,3863,5383,26.076809620810597,18.193571453700986,1520,1,242556,53953,680,0,1994,2503
9726,0,0,0,1,76,1,1951,0,0,12345362,17785456,67.98529252713413,3614,8301,7293,4622,46989,873496,796536,2840,8470,4856,6519,12149,51.6817182376902,31.789434676139027,5630,1,956754,159264,2671,0,774,1177
9727,0,0,0,1,76,1,1950,0,0,12132064,17674608,67.76429738438966,3608,8218,7234,4592,45696,862176,785196,2865,8441,4833,6491,12067,51.40038910358559,31.411846645014347,5576,1,936768,155472,2642,0,743,1207
9728,0,0,0,1,67,1,382,0,0,1325408,4568312,36.851051545376556,847,2845,2334,1358,51062,709804,814088,2853,4722,3875,4340,6209,31.240998703626616,23.480518394043425,1869,1,328636,47523,976,0,2006,2388
9729,0,0,1,0,65,1,1624,0,0,7231137,11844291,60.174745533321534,3048,6191,5618,3621,45198,794853,608406,2698,6892,3844,5268,9462,44.68780594300866,24.32703982174869,4194,1,673506,112308,1997,0,350,1274
9730,0,0,1,0,67,1,1684,0,0,9899085,13789036,64.02343321003646,3307,7306,6514,4099,39380,740080,602156,2572,7463,4156,5779,10670,49.14264950122246,28.679703268124072,4891,1,733721,142560,2415,0,735,949
9731,0,0,0,1,67,1,348,0,0,1294525,4445375,36.40054944640259,845,2782,2302,1325,50996,701195,818620,2875,4680,3835,4332,6137,31.25699921617557,22.786707776062748,1805,1,323300,42240,977,0,2030,2378
9732,0,0,0,1,65,1,30,0,0,1278936,3771486,33.85262175962151,658,2750,2262,1146,52208,684528,826041,2803,4437,3779,4407,6041,33.406586176980134,22.495849331714503,1634,1,287646,35624,1116,0,2145,2175
9733,0,0,1,0,59,1,703,0,0,112158,399052,11.575836902790225,163,1268,971,134,45080,684940,583688,2681,3112,3275,3815,4246,28.930952282978865,17.241936539744138,431,0,26264,51381,837,0,2844,2141
9734,0,0,1,0,58,1,755,0,0,503106,1237530,20.639767440550294,87,1946,1607,426,34342,647815,447370,2566,3331,3244,4086,4851,34.36568055487916,19.092484803090688,765,1,65604,70173,1181,0,2479,1724
9735,0,1,1,0,65,0,1422,0,0,1928079,2775381,29.13760456866693,383,3586,3120,849,56334,748601,804174,2803,4118,3735,5540,6855,47.65501022977542,22.00143205400733,1315,0,208854,48464,2271,1,2420,998
9736,0,0,1,0,58,1,312,0,0,926289,3311568,33.63034344160047,1046,2035,1950,1131,22168,477264,398208,2843,4059,3013,3747,4963,28.61817604250837,9.67057657670449,1216,1,153816,12920,819,0,1797,2109
9737,0,0,1,0,64,1,1585,0,0,6567750,11231200,58.94913061275798,2966,5874,5365,3475,38704,762752,530048,2723,6707,3741,5122,9106,43.474130238568314,22.9311453562188,3984,1,569900,106890,1890,0,243,1342
9738,0,0,1,0,62,1,965,0,0,954204,1904159,24.63736998950984,174,2612,2179,607,55680,752880,727784,2704,3744,3570,4709,5749,39.64845520319802,21.354207851783755,1040,1,140824,54125,1572,0,2530,1565
9739,0,0,1,0,58,1,744,0,0,495232,1230024,20.591260281974,85,1931,1592,424,32631,635319,432249,2562,3325,3240,4069,4832,34.17601498127012,19.161260884325106,763,1,63176,70173,1168,0,2477,1733
9740,0,1,1,0,66,0,1365,0,0,4744000,5320000,40.0,1258,4907,4565,1600,56635,801325,781375,2983,4925,3667,6290,8232,54.45181356024793,18.63392795707676,1942,1,376000,46170,2965,0,1725,360
9741,0,0,0,1,67,1,643,0,0,1217988,4995516,38.353617821530214,1025,2745,2299,1471,52185,723348,832020,2950,4867,3842,4224,6141,28.77498913987632,22.49446572251334,1917,1,360395,41032,828,0,1925,2568
9742,0,0,0,1,65,1,5,0,0,1230984,3632904,33.34666400106613,675,2656,2219,1112,48514,623997,829818,2830,4379,3704,4374,5923,33.27160951922825,21.2280893800758,1549,1,282448,15732,1107,0,2155,2160
9743,0,1,1,0,63,0,1517,0,0,1197570,1830735,23.93741840717165,183,3053,2663,573,54635,712485,782775,2805,3768,3585,5285,6248,45.71651780264984,19.853044475053803,963,0,140385,39780,2090,1,2622,1105
9744,0,0,1,0,62,1,1455,0,0,4948684,9532276,55.389529696504916,2785,4964,4681,3068,45312,733252,596544,2824,6175,3390,4720,8071,40.162171256046406,16.876120436594682,3351,1,589056,52072,1613,0,39,1494
9745,0,0,0,1,68,1,1096,0,0,1120560,5956020,41.71330722922842,1252,2872,2384,1740,56643,818097,811251,2935,5163,3911,4067,6295,25.37715508089904,23.554899878810577,2228,1,412380,60512,644,0,1683,2779
9746,0,0,0,1,68,1,1051,0,0,1126890,5846490,41.352146256270665,1226,2853,2369,1710,56882,817141,813722,2935,5129,3903,4078,6272,25.67099530598687,23.439586888960402,2194,1,406980,59532,659,0,1709,2760
9747,0,0,0,1,67,1,612,0,0,1192320,4874400,37.94733192202055,1032,2676,2268,1440,54189,754855,822555,2977,4825,3793,4213,6061,28.77498913987632,21.619070522564346,1848,1,349920,43656,828,0,1945,2557
9748,0,1,1,0,64,0,1503,0,0,1753254,2494956,27.76688675382964,406,3410,3045,771,56144,750752,783112,2871,4007,3601,5510,6646,47.686476070265456,19.440350862957754,1136,0,186582,42705,2274,1,2465,962
9749,0,0,1,0,62,0,831,0,0,740340,1696140,23.2379000772445,234,2217,1911,540,47163,744417,625059,2835,3681,3447,4512,5358,37.027017163147235,17.494023177843896,846,0,107460,54468,1371,1,2601,1770
9750,0,0,1,0,64,0,106,0,0,997191,3045552,30.773365106858236,827,2120,2000,947,51513,717168,742896,3096,4163,3336,4269,5336,32.449961479175904,10.981735174982626,1067,1,218757,15000,1053,0,2269,2163
9751,0,0,1,0,67,1,1641,0,0,10160752,13931456,64.1248781675256,3222,7473,6583,4112,39388,775852,582736,2498,7500,4278,5859,10861,49.70915408654627,30.40469996420891,5002,1,707264,175330,2471,0,724,917
9752,0,0,0,1,68,1,936,0,0,1108080,5512860,40.24922359499622,1190,2734,2304,1620,55822,840541,769078,2973,5023,3833,4087,6137,26.153393661244042,22.235212896088154,2050,1,366120,63210,684,0,1783,2719
9753,0,0,0,1,67,1,685,0,0,1153950,4984770,38.34057902536163,1080,2645,2255,1470,55328,759584,837577,3001,4861,3781,4176,6036,28.0178514522438,21.326374464449728,1860,1,363090,38610,785,0,1921,2606
9754,0,0,0,1,63,1,304,0,0,1147620,2931360,30.495901363953813,473,2621,2164,930,52460,677680,769088,2695,4082,3609,4386,5773,35.12833614050059,21.377660684617958,1387,1,226920,33361,1234,0,2222,1918
9755,0,0,1,0,59,1,726,0,0,916807,1956560,25.709920264364882,88,2621,2048,661,42900,651200,577200,2387,3621,3533,4347,5581,37.242448899072144,24.55713879218026,1234,1,128895,93972,1387,0,2299,1573
9756,0,0,0,1,68,1,1647,0,0,11158888,14599936,65.29931086925804,3261,7884,6881,4264,40362,743008,636864,2421,7688,4427,6041,11308,51.15662224971465,32.278307724755095,5267,1,793104,170510,2617,0,840,807
9757,0,0,0,1,67,1,959,0,0,1070820,5495040,40.24922359499622,1220,2681,2281,1620,55029,844608,749632,2992,5012,3792,4053,6073,25.709920264364882,21.515426996685903,2020,1,358020,60400,661,0,1772,2731
9758,0,0,1,0,58,1,500,0,0,614829,1687485,23.93741840717165,127,2092,1646,573,39919,615505,562495,2499,3518,3391,4018,5037,32.7566787083184,21.28657055878542,1019,1,109443,68684,1073,0,2372,1872
9759,0,0,1,0,60,1,217,0,0,716690,2267035,27.294688127912362,570,1882,1707,745,53788,724234,687718,2868,3788,3218,4005,4925,31.016124838541646,13.259855783968089,920,1,168370,25550,962,0,2298,2081
9760,0,1,1,0,65,0,1477,0,0,3849930,4436586,36.851051545376556,1045,4506,4193,1358,56133,793881,754677,2954,4625,3580,6102,7773,53.24471804789655,17.756640208179427,1671,0,313698,44759,2835,1,1909,432
9761,0,0,1,0,64,1,1502,0,0,6655968,11008476,58.63446085707619,2865,5947,5374,3438,45034,810106,569956,2629,6640,3775,5138,9149,44.0,23.953805602993906,4011,1,611964,118611,1936,0,236,1266
9762,0,0,0,1,68,1,1640,0,0,11424084,14767928,65.55913361233506,3253,8001,6956,4298,37022,735304,594428,2391,7734,4481,6094,11437,51.55579501860097,32.947980754914155,5343,1,743554,186010,2658,0,862,778
9763,0,0,0,1,67,1,1263,0,0,966600,6114600,42.42640687119285,1382,2755,2337,1800,54978,808486,784707,2979,5197,3815,3934,6152,23.173260452512935,21.93187808766587,2218,1,415800,50578,537,0,1597,2860
9764,0,0,0,1,62,1,279,0,0,1124370,2907180,30.495901363953813,528,2541,2139,930,55842,709602,768996,2724,4056,3528,4335,5667,34.77067730142742,20.057873316005786,1332,1,228780,38994,1209,0,2196,1917
9765,0,0,0,0,60,1,240,1,0,742500,2281500,27.386127875258307,616,1874,1740,750,51376,751374,632736,2908,3792,3176,4032,4916,31.464265445104548,11.616877517762624,884,1,156000,23584,990,0,2292,2052
9766,0,1,1,0,65,0,1216,0,0,4549860,5293680,40.124805295477756,1430,4616,4436,1610,56595,805560,759528,3108,4898,3468,6114,7904,53.16013544000805,13.508622280193736,1790,0,371910,25200,2826,1,1678,462
9767,0,1,1,0,64,0,1555,0,0,2028000,2731040,29.068883707497267,545,3545,3245,845,56628,782144,756288,2932,4077,3532,5632,6777,48.98979485566356,17.730818743733963,1145,0,197730,40500,2400,1,2387,832
9768,0,0,1,0,65,1,1553,0,0,8346120,12400488,61.38403701289123,2957,6794,5983,3768,44226,799713,598962,2480,7059,4102,5506,10085,47.06378650300037,28.80759798791333,4579,1,685776,162200,2215,0,477,1076
9769,0,0,0,1,68,1,1619,0,0,10928522,14446377,64.90762667052309,3198,7822,6807,4213,37518,761238,579501,2414,7642,4444,6023,11251,50.93132631298737,32.49447788269504,5228,1,711997,194880,2594,0,784,835
9770,0,0,0,1,68,1,1630,0,0,11494944,14820390,65.58963332722634,3234,8042,6974,4302,35404,730340,575315,2377,7747,4513,6117,11487,51.69139193328034,33.32712901800614,5370,1,718434,195444,2672,0,857,773
9771,0,0,0,1,67,1,851,0,0,1041080,5153346,39.1279950930277,1201,2541,2211,1531,52560,807840,737154,3036,4897,3696,4046,5907,26.076809620810597,19.73701446735616,1861,1,335289,43230,680,0,1835,2686
9772,0,0,0,1,62,1,93,0,0,1139530,3211124,31.96873472629156,687,2472,2137,1022,55056,697524,779216,2807,4164,3477,4257,5614,33.391615714128,18.308873708469367,1357,1,253456,31825,1115,0,2120,2027
9773,0,0,1,0,59,1,464,0,0,1149585,2584620,29.410882339705484,49,3010,2194,865,38412,591624,579672,2172,3853,3804,4317,5998,36.45545226711637,29.053472408015374,1681,1,167810,111792,1329,0,2123,1659
9774,0,0,0,1,67,1,1178,0,0,914208,5740336,41.376321731154405,1377,2581,2246,1712,51296,767837,751072,3018,5065,3688,3887,5934,23.108440016582687,19.6753359514119,2047,1,383488,35510,534,0,1641,2819
9775,0,0,0,1,67,1,925,0,0,997194,5236050,39.534794801541594,1262,2502,2201,1563,50481,793950,713550,3049,4913,3651,3988,5852,25.25866188063018,18.880826884264273,1864,1,332919,38829,638,0,1787,2712
9776,0,0,0,1,66,1,489,0,0,1103382,4367223,36.373066958946424,1083,2397,2157,1323,52170,732822,775735,3061,4624,3541,4135,5698,28.879058156387302,16.72978454591016,1563,1,310905,20880,834,0,1978,2467
9777,0,0,0,1,65,1,433,0,0,1111980,4253970,35.958309192730404,1053,2393,2153,1293,49405,674450,792890,3050,4583,3530,4150,5683,29.32575659723036,16.564673580665133,1533,1,311613,13440,860,0,1997,2430
9778,0,0,1,0,59,1,472,0,0,1015529,2389809,28.26658805020514,17,2852,2070,799,34780,562308,553335,2209,3790,3773,4262,5843,35.651086939951774,28.11166622733743,1581,1,147815,104788,1271,0,2192,1720
9779,0,0,0,1,66,1,1252,0,0,858048,5814496,41.7612260356422,1431,2549,2236,1744,48832,746816,726812,3021,5078,3647,3826,5883,22.181073012818835,18.936738255899407,2057,1,380192,31926,492,0,1590,2842
9780,0,0,0,1,69,1,1588,0,0,11155053,14583150,65.01538279515087,3136,7957,6866,4227,37742,779700,576150,2359,7677,4541,6089,11407,51.37119815616529,33.71053273977492,5318,1,705909,216018,2639,0,777,811
9781,0,0,0,1,69,1,1591,0,0,11704836,14974608,65.63535632568775,3168,8165,7025,4308,38060,764720,601348,2336,7784,4616,6193,11641,52.124850119688595,34.482629293789685,5448,1,745284,212040,2717,0,832,759
9782,0,0,0,1,66,1,1419,0,0,765612,6108372,42.8485705712571,1512,2577,2253,1836,52140,731940,788499,3003,5163,3651,3744,5904,20.42057785666214,18.81897769113125,2160,1,435132,27216,417,0,1491,2910
9783,0,0,0,1,65,1,636,0,0,1043776,4541536,37.255872020394314,1198,2330,2140,1388,48384,706752,732928,3082,4660,3462,4024,5602,27.422618401604176,14.902762265604592,1578,1,310912,15960,752,0,1884,2520
9784,0,0,1,0,68,1,1560,0,0,10507156,14041082,64.1404708432983,3054,7728,6668,4114,39330,784990,583623,2353,7527,4473,5967,11141,50.53711507397311,33.13465373662151,5174,1,703494,209880,2554,0,701,859
9785,0,0,1,0,68,1,1564,0,0,10684797,14173203,64.36614016701638,3070,7795,6722,4143,34804,773146,526834,2348,7564,4494,6000,11216,50.78385570237849,33.35093754921048,5216,1,638022,224257,2579,0,722,842
9786,0,0,0,1,66,1,1353,0,0,757854,5870700,42.17819341792628,1511,2473,2205,1779,54510,782100,759000,3032,5079,3568,3726,5773,20.639767440550294,17.088809085922392,2047,1,409170,32160,426,0,1521,2874
9787,0,0,0,1,65,1,1252,0,0,802773,5657229,41.46082488325576,1472,2433,2186,1719,54522,766803,770094,3044,5010,3538,3758,5724,21.61018278497431,16.406713169188357,1966,1,402246,27170,467,0,1572,2824
9788,0,0,0,1,64,1,654,0,0,1027296,4521216,37.30951621235526,1230,2292,2130,1392,48399,711312,717808,3086,4640,3410,3986,5540,27.16615541441225,13.631179030466164,1554,1,307632,14904,738,0,1856,2510
9789,0,0,0,1,63,1,311,0,0,1094126,3863405,34.828149534535996,1060,2268,2115,1213,54450,716625,770770,3032,4398,3338,4087,5453,30.033314835362415,12.471607409700377,1366,1,293546,14076,902,0,1972,2283
9790,0,0,1,0,58,1,222,0,0,613360,1986960,26.076809620810597,230,2032,1582,680,45450,590244,657450,2472,3602,3372,3824,4954,30.033314835362415,21.49096207913445,1130,1,153000,47250,902,0,2242,2020
9791,0,0,1,0,59,1,670,0,0,899811,2006961,25.903667693977237,160,2523,2012,671,38675,661011,523425,2480,3662,3502,4332,5514,36.61966684720111,23.603813639066587,1182,1,117425,94535,1341,0,2320,1650
9792,0,0,1,0,60,1,708,0,0,1093500,2262750,27.386127875258307,132,2826,2208,750,36050,621502,527975,2399,3767,3635,4475,5843,38.18376618407357,25.870984740449597,1368,1,131250,103824,1458,0,2267,1559
9793,0,1,1,0,64,0,1681,0,0,2260566,2825046,29.698484809834994,707,3620,3445,882,56394,771923,749502,3028,4085,3378,5766,6823,50.62608023538856,13.511562386610331,1057,0,206388,23800,2563,1,2321,640
9794,0,0,0,1,64,0,594,0,0,793512,2074944,25.337718918639855,552,1968,1878,642,48800,788608,646400,3142,3874,3322,4468,5200,35.156791662493895,9.491514370027666,732,1,128400,16380,1236,0,2590,1996
9795,0,0,0,1,65,1,1476,0,0,674172,6071232,42.91852746774987,1565,2485,2208,1842,54466,744896,794336,3019,5138,3573,3662,5781,19.131126469708992,17.285423816236207,2119,1,443922,26038,366,0,1454,2930
9796,0,0,0,1,65,1,1428,0,0,695808,5957856,42.567593307585526,1554,2454,2196,1812,55458,769392,779256,3030,5100,3546,3672,5742,19.595917942265423,16.67850737580723,2070,1,429444,28380,384,0,1476,2904
9797,0,0,0,1,64,1,897,0,0,936270,4919205,38.92300091205713,1335,2313,2133,1515,46870,698105,707846,3067,4762,3427,3865,5560,24.859605789312106,14.154846399092119,1695,1,330270,15660,618,0,1732,2629
9798,0,0,0,1,69,1,1489,0,0,11400026,14589344,64.82283548256741,3019,8098,6915,4202,38744,805504,579824,2289,7674,4655,6185,11570,52.08646657242167,35.0919287295293,5385,1,701734,242515,2713,0,730,759
9799,0,0,0,1,65,1,1455,0,0,655576,5949216,42.61455150532503,1582,2411,2177,1816,56169,776412,776412,3042,5092,3510,3637,5687,19.0,15.856729691750894,2050,1,430392,27144,361,0,1460,2915
9800,0,0,0,1,65,1,1352,0,0,709424,5740364,41.90465367951393,1555,2361,2160,1756,56406,778022,774753,3068,5025,3470,3673,5630,20.09975124224178,14.772739067640114,1957,1,416172,23919,404,0,1513,2865
9801,0,0,0,1,64,1,1083,0,0,844200,5206704,40.099875311526844,1446,2295,2133,1608,50838,741502,718836,3076,4846,3400,3763,5533,22.9128784747792,13.425198563041231,1770,1,356976,17334,525,0,1630,2713
9802,0,0,0,1,63,1,573,0,0,1031998,4283664,36.6333181680284,1252,2201,2111,1342,51076,721392,721392,3102,4534,3282,3961,5393,27.730849247724095,9.82680210338744,1432,1,303292,9000,769,0,1850,2423
9803,0,0,1,0,62,1,793,0,0,537510,1360818,20.904544960366874,74,2178,1667,437,51529,706878,706878,2603,3551,3625,4344,5292,35.07135583350036,22.680273146950242,948,1,99199,68985,1230,0,2677,1884
9804,0,0,1,0,56,1,433,0,0,619800,1691400,24.49489742783178,480,1753,1633,600,30784,586352,417212,2699,3419,2939,3852,4572,32.14031735997639,11.368551155324415,720,0,88800,23520,1033,1,2219,1786
9805,0,0,1,0,66,0,481,0,0,653652,3588040,32.92415526630866,723,2048,1687,1084,46860,705030,728200,2949,4394,3671,3913,5358,24.55605831561735,19.073381915508193,1445,1,238480,45486,603,0,2226,2707
9806,0,0,1,0,68,1,1468,0,0,10610165,13954098,63.8200595424354,2933,7818,6678,4073,36738,801684,537882,2286,7499,4566,6031,11244,51.03920062069938,34.33755745770495,5213,1,639461,245100,2605,0,647,821
9807,0,0,0,1,64,1,1103,0,0,822630,5187408,40.162171256046406,1479,2257,2123,1613,53124,733248,749328,3082,4829,3350,3726,5473,22.58317958127243,12.067284982291463,1747,1,375829,13400,510,0,1603,2706
9808,0,0,0,1,63,1,646,0,0,1006587,4370598,37.107950630558946,1310,2175,2108,1377,54225,764934,714150,3107,4551,3241,3905,5349,27.03701166919155,8.314029025396882,1444,1,309825,8710,731,0,1797,2443
9809,0,0,1,0,60,1,689,0,0,1246712,2511552,28.705400188814647,145,3016,2337,824,35260,624840,524256,2369,3872,3727,4561,6064,38.897300677553446,27.066121089755374,1503,1,141728,115430,1513,0,2224,1535
9810,0,0,1,0,58,1,503,0,0,1128120,2463720,28.982753492378876,810,2213,2183,840,50820,645260,677523,2903,3773,2963,4276,5146,36.64696440361739,5.490867587491313,870,0,194040,3630,1343,0,2093,1590
9811,0,1,1,0,63,0,1744,0,0,2330180,2823682,29.765752132274432,796,3606,3516,886,56635,768067,748945,3097,4073,3277,5817,6793,51.28352561983234,9.590813010750445,976,0,208210,11610,2630,1,2301,557
9812,0,0,1,0,68,1,1435,0,0,10319166,13666681,63.31666447310692,2869,7723,6583,4009,36024,777252,538622,2269,7418,4549,5983,11132,50.73460357586329,34.2973436705056,5149,1,633422,238260,2574,0,600,835
9813,0,0,0,1,64,1,1345,0,0,678776,5619432,41.66533331199932,1602,2261,2127,1736,54240,731562,776880,3103,4973,3371,3628,5498,19.77371993328519,12.004193403260864,1870,1,416640,12462,391,0,1501,2846
9814,0,0,0,1,63,1,719,0,0,978516,4470392,37.57658845611187,1345,2172,2105,1412,56619,769338,737678,3099,4578,3233,3859,5338,26.324893162176366,8.222029866439447,1479,1,328996,9112,693,0,1754,2473
9815,0,0,1,0,60,1,841,0,0,956340,1937796,25.37715508089904,577,2196,2129,644,53360,698088,692070,2942,3653,3076,4494,5205,38.535697735995385,8.185808589931957,711,0,148120,9045,1485,1,2365,1524
9816,0,0,1,0,59,1,252,0,0,1367100,3134250,32.4037034920393,1008,2394,2352,1050,55454,695505,710430,2943,4035,3027,4287,5379,36.08323710533743,6.538739683827756,1092,1,249900,5250,1302,0,1935,1683
9817,0,1,1,0,63,0,1522,0,0,2592840,3241560,31.937438845342623,1020,3562,3562,1020,54492,759542,724584,3178,4198,3178,5720,6740,50.41825066382212,0.0,1020,0,232560,0,2542,1,2158,636
9818,0,0,0,1,68,1,1345,0,0,11131556,14045896,63.84355879804947,2815,8068,6807,4076,50451,864946,692646,2185,7522,4707,6177,11514,52.25897052181568,36.072365954008895,5337,1,819276,234546,2731,0,630,715
9819,0,0,0,1,64,1,1761,0,0,374976,6341391,44.19275958796871,1737,2361,2145,1953,56870,785774,763045,3031,5200,3463,3439,5608,13.856406460551018,14.734906844635344,2169,1,458955,28512,192,0,1294,3055
9820,0,0,1,0,60,1,434,0,0,832755,2183909,26.851443164195103,321,2276,1876,721,47880,575510,763308,2629,3750,3429,4184,5305,33.98529093593286,20.019502704788522,1121,1,181692,18800,1155,0,2308,1874
9821,0,0,1,0,58,1,483,0,0,877734,2127906,26.94438717061496,441,2220,1935,726,27379,612579,383961,2646,3657,3216,4140,5151,34.77067730142742,18.105928538731167,1011,1,95106,60420,1209,0,2205,1722
9822,0,1,1,0,63,0,1664,0,0,2211392,2759008,29.5296461204668,872,3408,3408,872,53572,746704,718228,3164,4036,3164,5700,6572,50.35871324805669,0.0,872,0,197944,0,2536,1,2292,628
9823,0,1,1,0,63,0,1899,0,0,1770040,2159120,26.1725046566048,655,3299,3269,685,45792,668224,680832,3122,3837,3182,5736,6451,50.83306010855534,5.478746393072713,715,0,147960,3900,2584,1,2467,568
9824,0,0,1,0,64,0,463,0,0,480038,1599794,22.338307903688676,319,1641,1461,499,47034,750204,644406,3026,3705,3386,4168,4847,31.016124838541646,13.4968426155072,679,0,100299,30960,962,1,2707,2244
9825,0,0,1,0,62,0,602,0,0,937595,2239533,26.70205984563738,136,2605,2028,713,43197,725571,587367,2564,3854,3718,4456,5746,36.26292872893749,24.07133210488876,1290,0,133331,106168,1315,1,2428,1826
9826,0,0,1,0,65,1,1339,0,0,8705420,12163940,60.78651166171653,2696,7050,6051,3695,29025,740700,424668,2293,6987,4291,5648,10342,48.53864439804639,31.900823151349154,4694,1,476655,229770,2356,0,403,936
9827,0,0,0,1,64,1,1839,0,0,298350,6450327,44.598206241955516,1788,2340,2139,1989,56640,765348,778320,3042,5232,3444,3393,5583,12.24744871391589,14.205786169941657,2190,1,477360,24321,150,0,1254,3093
9828,0,1,1,0,64,0,1194,0,0,3114360,4080318,35.58089374931439,1206,3786,3726,1266,45990,676830,705837,3163,4489,3283,5683,7009,49.59838707054898,7.810249675906654,1326,0,277254,7380,2460,1,1957,763
9829,0,1,1,0,63,0,1680,0,0,2089984,2633280,28.844410203711913,802,3374,3344,832,46428,693135,670980,3135,3997,3195,5677,6539,50.11985634456667,5.478746393072713,862,0,176384,4290,2512,1,2333,653
9830,0,1,1,0,63,0,1714,0,0,2027795,2547020,28.372521918222215,775,3354,3324,805,45526,699244,651784,3134,3969,3194,5683,6518,50.18964036531842,5.483301264452448,835,0,165830,4590,2519,1,2359,645
9831,0,0,0,1,64,1,1761,0,0,338800,6264896,44.0,1786,2261,2111,1936,53536,773404,724864,3086,5172,3386,3411,5497,13.228756555322953,12.263881625621906,2086,1,433664,22650,175,0,1300,3061
9832,0,0,0,1,64,1,1477,0,0,560270,5731580,42.30839160261236,1723,2170,2103,1790,49815,656410,778086,3135,4992,3269,3515,5372,17.69180601295413,8.2143728690235,1857,1,434970,5695,313,0,1412,2889
9833,0,0,0,1,62,1,543,0,0,1042480,4180544,36.4417343165772,1261,2180,2113,1328,48024,651636,730336,3081,4476,3215,3933,5328,28.0178514522438,8.222029866439447,1395,1,308096,6901,785,0,1820,2363
9834,0,0,1,0,62,1,426,0,0,1073995,3964249,35.651086939951774,1229,2158,2116,1271,46184,573896,782869,3077,4390,3161,3964,5277,29.068883707497267,6.609134537568676,1313,0,319021,1680,845,1,1848,2274
9835,0,0,1,0,62,1,657,0,0,1570408,3010271,31.096623610932426,168,3390,2591,967,31816,603922,510532,2314,4080,3912,4737,6503,40.29888335921977,29.49417428569734,1766,1,158588,131036,1624,0,2146,1489
9836,0,1,1,0,63,0,1567,0,0,2216934,2857921,29.9833287011299,839,3425,3365,899,43054,654874,664411,3119,4078,3239,5645,6604,49.658836071740545,7.780166052320878,959,0,187891,7800,2466,1,2280,713
9837,0,0,1,0,58,1,656,0,0,3976857,6814449,48.46648326421054,2319,4072,4042,2349,50394,644022,658527,2871,5250,2931,4594,6973,41.14608122288197,5.483301264452448,2379,1,533223,3840,1693,0,552,1208
9838,0,0,1,0,61,1,1150,0,0,6202511,9587122,55.95533933415113,2600,5643,5112,3131,47765,713446,627710,2531,6193,3593,5043,8705,44.50842616853577,23.444807211617427,3662,0,641855,89208,1981,1,69,1081
9839,0,0,0,1,65,1,1993,0,0,138020,6701180,45.387222871640866,1870,2317,2127,2060,46299,595299,823009,3063,5313,3443,3320,5570,8.18535277187245,13.858285473715528,2250,1,521180,6270,67,0,1193,3186
9840,0,0,0,1,64,1,1608,0,0,458185,5984230,43.069710934716056,1770,2187,2102,1855,50820,677460,780692,3141,5081,3311,3473,5413,15.716233645501712,9.332611979058527,1940,1,448910,7905,247,0,1371,2979
9841,0,0,0,1,64,1,1549,0,0,505802,5874242,42.731721238442994,1759,2170,2103,1826,48800,643400,784948,3150,5043,3284,3494,5387,16.64331697709324,8.314029025396882,1893,1,445544,5159,277,0,1391,2940
9842,0,0,1,0,63,0,346,0,0,778272,2314488,26.94438717061496,726,1798,1798,726,40586,710924,580216,3188,3914,3188,4260,4986,32.7414110874898,0.0,726,1,132132,0,1072,0,2462,2116
9843,0,0,1,0,66,0,152,0,0,616745,2855365,29.410882339705484,738,1705,1578,865,53568,713016,818648,3174,4166,3428,4014,5006,26.70205984563738,11.377048979465448,992,1,214520,11303,713,0,2436,2588
9844,0,0,1,0,61,1,1161,0,0,6832026,10041156,57.07889277132134,2666,5947,5355,3258,45927,748926,582498,2490,6340,3674,5179,9029,45.79301256742124,24.795832527738444,3850,1,615762,114256,2097,0,176,985
9845,0,0,0,1,70,1,2081,0,0,3671940,11321815,56.753854494650845,3101,4481,4361,3221,54984,815480,833055,3395,6736,3635,4655,7996,33.76388603226827,11.206010841342998,3341,1,763377,12720,1140,0,294,2375
9846,0,0,0,1,63,1,637,0,0,1040250,4392629,37.242448899072144,1253,2271,2137,1387,47488,671404,709408,3033,4554,3301,3917,5438,27.386127875258307,11.633585509503979,1521,1,310688,16080,750,0,1780,2417
9847,0,0,1,0,57,1,383,0,0,1090110,2513430,29.49576240750525,700,2293,2123,870,21122,517131,340902,2719,3759,3059,4142,5182,35.397740040855716,13.78643456762778,1040,1,102660,31960,1253,0,2019,1636
9848,0,0,1,0,62,1,491,0,0,2049486,3793601,34.741905532080416,420,3692,2905,1207,33286,587741,559454,2356,4350,3930,4841,6835,41.20679555607303,28.05489031259387,1994,1,214846,110967,1698,0,1936,1445
9849,0,0,1,0,67,1,1122,0,0,10034368,12830088,61.465437442517235,2484,7728,6434,3778,41912,842208,573924,2102,7174,4690,6052,11124,51.536394906900505,36.11406684388255,5072,1,638482,276916,2656,0,382,740
9850,0,0,0,1,68,1,2089,0,0,2690100,10273193,54.67174773134658,2904,3974,3889,2989,55860,783636,842065,3352,6426,3522,4337,7411,30.0,9.220820253968727,3074,1,732305,8925,900,0,448,2537
9851,0,0,0,1,68,1,2090,0,0,2352711,9921420,53.86093203798092,2871,3742,3712,2901,55454,813960,796860,3390,6321,3450,4231,7162,28.478061731796284,5.483301264452448,2931,1,675933,4080,811,0,519,2609
9852,0,0,0,1,64,1,1870,0,0,247256,6434638,44.654227123532216,1927,2185,2118,1994,53680,787388,709940,3160,5221,3294,3351,5412,11.135528725660043,8.187175587434018,2061,1,438680,10720,124,0,1233,3103
9853,0,0,0,1,63,1,705,0,0,1028146,4527550,37.76241517699841,1273,2300,2147,1426,44895,695325,650875,3022,4601,3328,3896,5475,26.851443164195103,12.457665419166299,1579,1,292330,22950,721,0,1749,2454
9854,0,0,1,0,61,1,468,0,0,1426333,3014861,31.352830813181765,325,3092,2434,983,38475,690075,524457,2409,4050,3725,4518,6159,38.09199390948182,26.899403629795742,1641,1,168093,126994,1451,0,2084,1616
9855,0,0,1,0,66,0,184,0,0,578292,2845128,29.29163703175362,708,1682,1532,858,51865,679780,838948,3166,4174,3466,3990,4998,25.96150997149434,12.420125667085228,1008,1,217074,9750,674,0,2458,2642
9856,0,0,1,0,65,0,744,0,0,537300,1474650,21.213203435596427,216,1878,1644,450,45800,750433,655400,3043,3727,3511,4471,5155,34.55430508634199,15.368080525904801,684,1,90000,39312,1194,0,2827,2083
9857,0,0,0,1,68,1,2094,0,0,2472112,10041120,54.18486873657626,2876,3838,3778,2936,55458,800280,810540,3360,6356,3480,4262,7258,29.017236257093817,7.748117453886108,2996,1,695832,7620,842,0,484,2578
9858,0,0,0,1,68,1,2097,0,0,1829880,9403320,52.53570214625479,2700,3483,3423,2760,56376,827901,790424,3347,6167,3467,4070,6890,25.748786379167466,7.772191019407321,2820,1,640320,8100,663,0,647,2744
9859,0,0,0,1,68,1,2097,0,0,1728090,9292920,52.24940191045253,2670,3423,3363,2730,55671,820364,786324,3344,6134,3464,4037,6827,25.15949125081825,7.789174875971784,2790,1,630630,7740,633,0,674,2771
9860,0,0,0,1,67,1,2099,0,0,1531056,9063424,51.69139193328034,2587,3330,3245,2672,55224,793728,800512,3307,6064,3477,3965,6722,23.93741840717165,9.245276771705237,2757,1,630592,9350,573,0,720,2819
9861,0,0,0,1,64,1,1924,0,0,219456,6553200,45.077710678338576,1972,2200,2140,2032,52884,754650,728850,3165,5257,3285,3333,5425,10.392304845413264,7.748117453886108,2092,1,459232,8580,108,0,1193,3117
9862,0,0,0,1,64,1,1235,0,0,766806,5438580,41.09744517606904,1562,2270,2143,1689,38130,598920,660100,3093,4909,3347,3674,5490,21.307275752662516,11.345682528620664,1816,1,346245,13843,454,0,1531,2766
9863,0,0,1,0,63,1,1354,0,0,891915,1548120,22.02271554554524,12,2821,2324,485,31930,657552,494760,2695,3677,3689,5031,6013,42.883563284783136,22.41934651933988,982,1,75175,92939,1839,0,2707,1353
9864,0,0,1,0,55,1,73,0,0,950268,2614176,30.643106892089126,777,2113,1951,939,30618,451008,526176,2622,3723,2946,3796,4897,31.811947441173732,13.05562736842334,1101,1,177471,15066,1012,0,1845,1772
9865,0,0,1,0,55,1,359,0,0,1421010,3810135,37.21558813185679,1355,2441,2411,1385,45732,610722,566706,2721,4136,2781,3777,5192,32.03123475609393,5.572104574801163,1415,1,285310,4620,1026,0,1366,1725
9866,0,0,0,1,69,1,2093,0,0,3443868,10998774,56.36488268416781,3053,4385,4261,3177,55860,848190,789336,3338,6639,3586,4546,7847,32.92415526630866,11.214528750203367,3301,1,724356,17236,1084,0,285,2378
9867,0,0,0,1,68,1,2096,0,0,2830020,10395930,55.04543577809154,2880,4114,3964,3030,56386,799423,830302,3281,6461,3581,4365,7545,30.56141357987225,12.256148736246766,3180,1,733260,17550,934,0,401,2497
9868,0,0,0,1,68,1,2099,0,0,2154770,9726432,53.422841556772326,2854,3609,3609,2854,55216,790656,811104,3408,6262,3408,4163,7017,27.477263328068172,0.0,2854,1,679252,0,755,0,554,2653
9869,0,0,0,1,67,1,2101,0,0,1740732,9286641,52.316345438113316,2707,3403,3373,2737,56643,810927,804141,3363,6130,3423,4029,6796,25.219040425836983,5.490867587491313,2767,1,648669,3690,636,0,656,2757
9870,0,0,0,1,67,1,2102,0,0,1357160,8858220,51.18593556827891,2512,3246,3138,2620,52668,852012,706629,3273,6001,3489,3899,6627,22.759613353482084,10.406531168715494,2728,1,547580,18252,518,0,761,2863
9871,0,0,0,1,64,1,1913,0,0,259080,6581040,45.16635916254486,2010,2197,2167,2040,51525,738754,725850,3196,5266,3256,3353,5423,11.269427669584644,5.478746393072713,2070,1,459000,4170,127,0,1186,3099
9872,0,0,0,1,63,1,781,0,0,1027992,4699814,38.43175770115127,1297,2353,2173,1477,48399,696858,703222,3002,4659,3362,3878,5535,26.38181191654584,13.846246556523738,1657,1,326417,23760,696,0,1705,2486
9873,0,0,0,1,63,1,668,0,0,1074365,4525140,37.72267222772003,1303,2298,2178,1423,48000,636000,763200,3060,4603,3300,3935,5478,27.477263328068172,11.661903789690601,1543,1,341520,9960,755,0,1757,2425
9874,0,0,1,0,64,1,1337,0,0,906840,1586475,22.24859546128699,65,2757,2327,495,45173,727535,637795,2775,3700,3635,5037,5962,42.80186911806539,20.95023369611294,925,1,98505,71810,1832,0,2710,1373
9875,0,1,1,0,65,0,997,0,0,2822754,4096818,35.41186241925155,969,3790,3505,1254,51504,725274,757944,2982,4521,3552,5518,7057,47.44470465710583,17.036974657315184,1539,0,290928,34485,2251,1,2013,1016
9876,0,0,1,0,64,0,686,0,0,566280,1554124,22.0,165,1973,1654,484,48880,754585,667888,2892,3695,3530,4381,5184,34.20526275297414,17.930366866901547,803,1,100672,53273,1170,0,2727,2041
9877,0,0,0,1,64,1,1693,0,0,468270,6248115,43.98863489584554,1893,2219,2177,1935,46920,742670,658716,3187,5164,3271,3471,5448,15.556349186104045,6.495386533491135,1977,1,394740,6930,242,0,1294,2987
9878,0,0,0,1,64,1,1301,0,0,759506,5632858,41.689327171351664,1588,2325,2175,1738,42000,680610,648200,3091,4979,3391,3678,5566,20.904544960366874,12.401817263524045,1888,1,347600,21900,437,0,1503,2804
9879,0,0,1,0,64,1,508,0,0,2158565,3968296,35.17101079013795,706,3513,2982,1237,44730,673680,683304,2677,4445,3739,4953,6721,41.773197148410844,23.157513989100032,1768,1,263481,70092,1745,0,1971,1463
9880,0,0,1,0,59,1,955,0,0,1348274,2304436,27.892651361962706,376,2913,2511,778,48608,642754,663488,2560,3740,3364,4695,5875,41.6293165929973,20.051922454229167,1180,1,174272,51054,1733,0,2184,1229
9881,0,0,1,0,57,1,1466,0,0,723840,1118520,19.748417658131498,330,2306,2246,390,47722,613752,639564,2808,3258,2928,4724,5174,43.08131845707603,7.896951773353783,450,1,86970,7440,1856,0,2478,1012
9882,0,0,1,0,64,0,652,0,0,662853,1773669,23.473389188611005,254,2051,1754,551,45308,775779,605172,2922,3770,3516,4422,5270,34.68429039204925,17.315213270817324,848,1,103588,57321,1203,0,2668,2016
9883,0,0,1,0,59,1,520,0,0,4593681,7169916,49.18333050943175,2227,4510,4318,2419,42903,560196,672828,2772,5383,3156,4863,7474,43.57751713900185,14.142135623730951,2611,1,549113,16320,1899,0,545,1065
9884,0,0,1,0,62,1,934,0,0,7661160,10290182,57.21887800367987,2553,6335,5614,3274,42822,735462,575169,2422,6417,3864,5483,9478,48.373546489791295,27.46641108810411,3995,1,599142,137711,2340,0,131,803
9885,0,0,0,1,67,1,2103,0,0,1585588,9055888,51.884487084291386,2662,3311,3281,2692,56120,773720,820816,3334,6056,3394,3953,6675,24.269322199023193,5.572104574801163,2722,1,656848,3270,589,0,672,2775
9886,0,0,0,1,67,1,2103,0,0,1491280,8947680,51.60426338976267,2621,3265,3223,2663,55596,826560,759360,3318,6023,3402,3920,6625,23.664319132398465,6.484411467763075,2705,1,601838,6342,560,0,697,2800
9887,0,0,0,1,65,1,2055,0,0,390250,7356770,47.22287581247038,2145,2490,2405,2230,45540,593820,834647,3214,5529,3384,3474,5789,13.228756555322953,9.692340849365527,2315,1,564190,2550,175,0,1069,3124
9888,0,0,0,1,64,1,1790,0,0,424424,6462456,44.74371464239419,1972,2244,2214,2002,47424,735984,671424,3198,5230,3258,3440,5472,14.560219778561036,5.483301264452448,2032,1,416416,4740,212,0,1226,3016
9889,0,0,0,1,64,1,1359,0,0,742786,5768142,42.15447781671598,1627,2345,2195,1777,41610,710874,616740,3096,5023,3396,3664,5591,20.445048300260872,12.338422017092807,1927,1,337630,25050,418,0,1469,2828
9890,0,0,1,0,57,1,326,0,0,1411032,2974356,32.18695387886216,886,2548,2398,1036,29256,608652,396198,2721,3907,3021,4233,5419,36.90528417449187,12.574334296829354,1186,1,142968,31350,1362,0,1835,1509
9891,0,0,1,0,57,1,703,0,0,772310,1696345,24.392621835300936,487,2001,1893,595,47740,618667,627220,2743,3446,2959,4149,4852,36.02776706930364,10.400314334861214,703,1,130900,14148,1298,0,2256,1553
9892,0,0,1,0,55,1,302,0,0,1574895,3922380,37.61648574760805,1355,2588,2528,1415,44426,537768,634788,2712,4187,2832,3885,5360,33.36165463522455,7.9730082341141015,1475,1,324035,5400,1113,0,1357,1659
9893,0,0,1,0,65,0,185,0,0,578966,2214764,25.96150997149434,644,1563,1533,674,43068,729492,637484,3256,3960,3316,4145,4849,29.30870177950569,5.531194905403055,704,1,130756,4980,859,0,2612,2427
9894,0,0,1,0,62,0,848,0,0,1198500,2360250,27.386127875258307,66,3032,2348,750,56165,752133,739545,2463,3897,3831,4745,6179,39.97499218261337,26.15792042794946,1434,0,176250,91656,1598,1,2397,1549
9895,0,0,1,0,63,1,1390,0,0,716000,1267200,20.0,198,2788,2190,400,29100,614592,475200,2570,3568,3766,4958,5956,42.30839160261236,24.59747011679111,998,1,60000,105846,1790,0,2768,1378
9896,0,0,1,0,63,1,1042,0,0,1067208,2005308,25.219040425836983,260,2690,2314,636,32712,548622,592764,2777,3789,3529,4831,5843,40.963398296528084,19.590899291657315,1012,1,119568,42112,1678,0,2517,1475
9897,0,0,0,1,68,1,2102,0,0,2433560,10012780,54.147945482723536,2847,3847,3762,2932,52891,795695,775205,3330,6347,3500,4245,7262,28.809720581775867,9.251281740554573,3017,1,665564,11985,830,0,483,2585
9898,0,0,0,1,67,1,2103,0,0,1906308,9417273,52.79204485526205,2745,3513,3471,2787,53410,736622,827855,3337,6166,3421,4063,6892,26.153393661244042,6.488991180673202,2829,1,682815,4074,684,0,592,2695
9899,0,0,0,1,64,1,1974,0,0,387720,6991884,46.411205543489174,2154,2334,2334,2154,50481,691398,769302,3246,5400,3246,3426,5580,13.416407864998739,0.0,2154,1,510498,0,180,0,1092,3066
9900,0,0,0,1,64,1,1137,0,0,907798,5430008,40.963398296528084,1436,2461,2219,1678,43834,653672,702212,2994,4914,3478,3777,5697,23.259406699226016,15.61977778251397,1920,1,364126,27830,541,0,1558,2695
9901,0,0,0,1,64,1,971,0,0,999722,5135952,39.96248240537617,1427,2393,2223,1597,45202,623904,749328,3046,4813,3386,3842,5609,25.019992006393608,13.052030900365901,1767,1,372101,14280,626,0,1619,2590
9902,0,0,1,0,62,1,912,0,0,1314820,2415690,27.892651361962706,428,2818,2468,778,38160,658260,558900,2755,3883,3455,4795,5923,41.10960958218893,18.997192846382845,1128,0,140040,59500,1690,1,2327,1415
9903,0,0,1,0,62,1,395,0,0,1836524,3634372,34.23448553724738,932,2979,2739,1172,14145,356615,381423,2861,4273,3341,4668,6080,39.585350825778974,15.533788019677399,1412,1,144156,23520,1567,0,1929,1534
9904,0,0,0,1,68,1,2102,0,0,3398283,10880217,56.32938842203065,3131,4286,4244,3173,56144,795528,829818,3387,6602,3471,4500,7715,32.72613634390714,6.495386533491135,3215,1,767866,4914,1071,0,256,2358
9905,0,0,0,1,68,1,2103,0,0,2460780,10037160,54.22176684690383,2832,3885,3777,2940,53336,805704,771564,3306,6354,3522,4251,7299,28.930952282978865,10.410300245868545,3048,1,664440,15660,837,0,474,2577
9906,0,0,0,1,65,1,1517,0,0,689178,6127282,43.393547907494266,1721,2411,2249,1883,41447,706118,621514,3092,5137,3416,3620,5665,19.131126469708992,12.828687024400846,2045,1,359653,26568,366,0,1371,2888
9907,0,0,0,1,65,1,1411,0,0,762276,5953796,42.7551166528639,1638,2435,2245,1828,39494,706769,592774,3067,5085,3447,3674,5692,20.42057785666214,13.874881522629007,2018,1,332696,32870,417,0,1429,2840
9908,0,0,1,0,57,1,672,0,0,881113,1891121,25.709920264364882,491,2164,1994,661,43228,612254,577922,2691,3522,3031,4194,5025,36.51027252705737,13.03851759791075,831,1,133522,25160,1333,0,2200,1528
9909,0,0,1,0,60,1,734,0,0,6393336,8888724,54.055527006958314,2654,5378,5110,2922,45526,672282,626652,2774,5964,3310,5230,8420,46.776062254106,17.208772701712835,3190,1,601932,41004,2188,0,120,854
9910,0,0,0,1,68,1,2102,0,0,2273643,9834156,53.749418601506754,2769,3796,3676,2889,51959,759092,793132,3284,6293,3524,4191,7200,28.053520278211074,10.954451150103322,3009,1,673137,14520,787,0,515,2617
9911,0,0,0,1,67,1,2098,0,0,1772624,9230816,52.38320341483518,2702,3432,3390,2744,51304,713168,814088,3322,6108,3406,4010,6796,25.41653005427767,6.538739683827756,2786,1,664048,3990,646,0,620,2718
9912,0,0,0,1,65,1,1983,0,0,550810,7318860,47.22287581247038,2230,2477,2477,2230,46494,620298,807372,3282,5512,3282,3529,5759,15.716233645501712,0.0,2230,1,548580,0,247,0,1052,3035
9913,0,0,0,1,65,1,1354,0,0,829896,5923428,42.567593307585526,1584,2498,2270,1812,41256,706104,624379,3041,5081,3497,3727,5767,21.400934559032695,15.232182894810565,2040,1,346092,37164,458,0,1457,2811
9914,0,0,0,1,64,1,813,0,0,1128664,4950064,39.293765408777,1477,2342,2275,1544,44522,631582,724556,3139,4750,3273,3937,5548,27.03701166919155,8.286047041568583,1611,1,348944,6633,731,0,1662,2475
9915,0,0,1,0,62,1,865,0,0,1411904,2593344,28.844410203711913,430,2931,2529,832,44232,710676,604698,2715,3949,3519,4814,6048,41.19465984809196,20.318557924378677,1234,0,161408,69948,1697,1,2285,1420
9916,0,0,1,0,61,1,360,0,0,2320756,4151364,36.796738985948195,1354,3068,3068,1354,47088,668388,662256,3066,4420,3066,4780,6134,41.400483088968905,0.0,1354,0,292464,0,1714,0,1712,1352
9917,0,0,1,0,60,1,490,0,0,2136299,3753058,35.17101079013795,1003,3198,2964,1237,46655,658378,652310,2800,4271,3268,4761,6232,41.557189510360296,15.300479647433411,1471,1,265955,32058,1727,0,1797,1307
9918,0,0,1,0,57,1,1423,0,0,968778,1452161,22.427661492005804,473,2459,2429,503,47403,597609,661123,2857,3390,2917,4813,5346,43.88621651498338,5.572104574801163,533,1,115187,3240,1926,0,2384,961
9919,0,0,1,0,55,1,229,0,0,1699062,3978708,37.72267222772003,1333,2707,2617,1423,47025,584364,629100,2706,4219,2886,3990,5503,34.55430508634199,10.03110457464633,1513,0,320175,10350,1194,1,1373,1602
9920,0,0,1,0,63,0,870,0,0,1287000,2465580,27.92848008753788,162,3048,2430,780,44472,644844,689098,2543,3941,3779,4811,6209,40.620192023179804,24.859866147029937,1398,0,170040,72306,1650,1,2381,1511
9921,0,0,1,0,63,0,1016,0,0,1177140,2177640,26.267851073127396,111,2975,2396,690,42180,719568,583860,2577,3846,3735,4862,6131,41.30375285612676,24.0638721730703,1269,0,127650,105957,1706,1,2466,1450
9922,0,0,0,1,65,1,1914,0,0,589680,7124208,46.73328578219169,2142,2496,2454,2184,44505,675234,701330,3220,5446,3304,3532,5758,16.431676725154983,6.48074069840786,2226,1,469560,5250,270,0,1078,2992
9923,0,0,0,1,64,1,980,0,0,1077804,5320224,40.47221268969612,1514,2420,2296,1638,34362,539168,672336,3124,4886,3372,3906,5668,25.65151067676132,11.456179445350307,1762,1,339066,9548,658,0,1610,2590
9924,0,0,1,0,63,1,549,0,0,1262142,4564890,37.82856063875548,1401,2343,2313,1431,32697,602910,551870,3160,4621,3220,4072,5533,29.698484809834994,5.684275577662207,1461,0,247563,4410,882,1,1759,2308
9925,0,0,1,0,58,1,1360,0,0,963236,1493684,22.67156809750927,472,2430,2388,514,30736,656756,395216,2864,3420,2948,4780,5336,43.289721643826724,6.919919043981043,556,1,69904,9450,1874,0,2392,1032
9926,0,0,1,0,56,1,169,0,0,1676366,3887566,37.17526059088221,1232,2745,2595,1382,43197,526031,649803,2663,4195,2963,4026,5558,34.828149534535996,12.740029376818088,1532,1,319242,11550,1213,0,1431,1600
9927,0,0,1,0,56,1,212,0,0,1757664,4022236,37.89459064299283,1346,2750,2660,1436,48720,588210,649832,2711,4237,2891,4025,5551,34.9857113690718,10.146738461686594,1526,1,333152,9630,1224,0,1365,1577
9928,0,0,1,0,62,1,622,0,0,1755600,3285450,32.4037034920393,749,3023,2722,1050,42147,697767,591381,2828,4179,3430,4801,6152,40.890096600521744,17.48229092140404,1351,1,198450,52374,1672,0,2079,1457
9929,0,0,1,0,61,1,355,0,0,4890236,7322176,48.948953002081666,2012,4821,4437,2396,37785,504240,699824,2672,5452,3440,5097,7877,45.17742799230607,20.286293814375917,2780,1,548684,18048,2041,0,660,1015
9930,0,0,0,1,68,1,2101,0,0,3125642,10582442,55.74047003748713,3065,4155,4113,3107,53984,820846,762944,3364,6513,3448,4412,7561,31.71750305430741,6.48074069840786,3149,1,695968,6384,1006,0,299,2400
9931,0,0,0,1,67,1,2086,0,0,1671072,9058400,52.0,2674,3352,3322,2704,51980,770500,757100,3320,6054,3380,3968,6702,24.859605789312106,5.477225575051661,2734,1,611104,4170,618,0,646,2732
9932,0,0,1,0,61,1,750,0,0,1520896,2791356,30.23243291566195,854,2638,2578,914,51513,705474,681042,2994,3968,3114,4718,5692,40.792156108742276,7.745966692414834,974,0,203822,8580,1664,1,2140,1390
9933,0,0,1,0,62,1,65,0,0,1537784,3987036,35.679125549822544,373,3381,2481,1273,44038,710964,607608,2232,4405,4032,4340,6513,34.75629439396553,31.15201172901937,2173,1,246962,154800,1208,0,1859,1924
9934,0,0,1,0,63,1,1228,0,0,1096800,1914600,24.49489742783178,112,2916,2428,600,42432,650964,663728,2703,3791,3679,5019,6107,42.7551166528639,22.3912288843859,1088,1,124800,62952,1828,0,2591,1363
9935,0,0,1,0,61,1,342,0,0,4997323,7391019,49.122296363260546,2005,4892,4484,2413,38512,508458,710616,2655,5476,3471,5134,7955,45.50824101193101,20.891396683285333,2821,1,559816,17952,2071,0,650,992
9936,0,0,0,1,67,1,2090,0,0,2087064,9569952,53.178943201233324,2708,3686,3566,2828,56608,785088,825696,3264,6212,3504,4122,7070,27.16615541441225,11.111005581829925,2948,1,690032,12840,738,0,556,2646
9937,0,0,0,1,66,1,2055,0,0,1240984,8501249,50.428166732491874,2483,3091,3031,2543,43750,585025,835750,3283,5886,3403,3831,6434,22.090722034374522,7.772191019407321,2603,1,635750,1680,488,0,800,2855
9938,0,0,0,1,65,1,1781,0,0,726066,6935841,46.07602413403309,1973,2615,2465,2123,41607,656667,676269,3117,5390,3417,3609,5882,18.49324200890693,12.256148736246766,2273,1,439461,19050,342,0,1144,2925
9939,0,0,0,1,65,1,1438,0,0,889635,6267450,43.64630568559039,1628,2649,2372,1905,33252,671160,536270,3013,5195,3567,3757,5939,21.61018278497431,16.861120351761624,2182,1,310515,49029,467,0,1385,2823
9940,0,0,0,1,64,1,720,0,0,1260441,4929417,39.230090491866065,1509,2388,2358,1539,43014,643803,685442,3173,4742,3233,4022,5591,28.61817604250837,5.478746393072713,1569,1,329346,3540,819,0,1664,2384
9941,0,0,1,0,63,1,57,0,0,1479060,3749328,34.46737587922817,838,2783,2433,1188,43800,631200,691164,2806,4344,3506,4401,5939,35.2845575287547,18.81462497251214,1538,0,260172,38850,1245,1,1968,1911
9942,0,0,1,0,61,1,28,0,0,1406400,3700800,34.64101615137755,712,2860,2372,1200,37290,696984,508860,2596,4284,3572,4256,5944,34.23448553724738,23.626214117947306,1688,1,198000,97600,1172,0,1884,1912
9943,0,0,1,0,58,1,1234,0,0,1529235,2252925,27.65863337187866,456,3073,2764,765,47532,600780,686185,2636,3710,3254,4944,6018,44.710177812216315,17.578395831246947,1074,1,178245,30282,1999,0,2180,946
9944,0,0,1,0,57,1,771,0,0,1053702,2054790,26.664583251946766,510,2394,2193,711,45998,609790,630020,2689,3601,3091,4372,5284,38.49675310984031,14.178850343212243,912,1,154998,25527,1482,0,2179,1408
9945,0,0,1,0,57,1,740,0,0,1064316,2095236,26.94438717061496,510,2408,2192,726,44940,617604,606060,2670,3612,3102,4352,5294,38.28837943815329,14.697647169827432,942,1,152460,30024,1466,0,2160,1420
9946,0,0,1,0,56,1,160,0,0,1835049,4040844,37.907782842049734,1317,2834,2714,1437,47502,570836,658008,2692,4249,2932,4089,5646,35.73513677041127,11.58292185288269,1557,1,336258,11400,1277,0,1375,1535
9947,0,0,1,0,55,1,200,0,0,1919321,4155799,38.58756276314948,1429,2838,2778,1489,44213,499589,689377,2731,4280,2851,4080,5629,35.90264614203248,8.427403136094702,1549,1,367783,2460,1289,0,1302,1502
9948,0,0,1,0,57,1,561,0,0,3537022,6233974,46.71188285650665,1992,3993,3803,2182,39000,571400,557115,2667,5039,3047,4478,6850,40.26164427839479,13.874881522629007,2372,1,425490,26220,1621,0,675,1236
9949,0,0,1,0,65,0,207,0,0,623700,2255715,26.324893162176366,55,2231,1593,693,50301,790965,673785,2617,3948,3893,4155,5486,30.0,25.336504703130462,1331,0,143451,111650,900,1,2562,2355
9950,0,0,0,1,68,1,2097,0,0,2970954,10424400,55.37147279962851,2999,4102,4035,3066,54970,812600,782000,3333,6466,3467,4369,7502,31.12876483254676,8.189452396126915,3133,1,705180,9514,969,0,334,2431
9951,0,0,0,1,65,1,1982,0,0,958368,7860048,48.82622246293481,2384,2786,2786,2384,47736,771498,672588,3297,5681,3297,3699,6083,20.049937655763422,0.0,2384,1,486336,0,402,0,913,2895
9952,0,0,0,1,65,1,1476,0,0,912205,6408775,44.10215414239989,1662,2697,2414,1945,34155,682065,543675,3012,5240,3578,3764,5992,21.656407827707714,17.02725982545862,2228,1,320925,50657,469,0,1350,2826
9953,0,0,1,0,59,1,569,0,0,1786382,3223278,32.89376840679705,1015,2800,2733,1082,50508,616653,726876,2912,4061,3046,4630,5779,40.63249930782009,8.2732738280919,1149,1,264008,5695,1651,0,1897,1328
9954,0,0,1,0,64,1,172,0,0,1888733,4687452,38.24918299781056,711,3506,2754,1463,42244,756144,573516,2452,4667,3956,4495,6710,35.93048844644336,27.42263052468386,2215,1,261877,148144,1291,0,1741,1913
9955,0,0,1,0,58,1,1246,0,0,1107600,1765800,24.49489742783178,420,2626,2446,600,47800,703377,588600,2763,3543,3123,4789,5569,42.96510211788167,13.846246556523738,780,1,120000,32040,1846,0,2343,1097
9956,0,0,1,0,56,1,144,0,0,1896457,4086016,38.09199390948182,1327,2882,2758,1451,46926,557568,667392,2692,4267,2940,4123,5698,36.15245496505044,11.812794264698733,1575,1,343887,10416,1307,0,1365,1509
9957,0,0,1,0,56,1,165,0,0,1937824,4144462,38.43175770115127,1382,2884,2789,1477,47092,541558,684664,2711,4283,2901,4118,5690,36.22154055254967,10.429965964842806,1572,1,360388,6365,1312,0,1329,1494
9958,0,0,1,0,63,0,1537,0,0,862638,1383542,20.904544960366874,17,2831,2411,437,43260,652196,664860,2746,3603,3586,5140,5997,44.429719783046124,20.493901531919196,857,1,91770,54180,1974,0,2729,1192
9959,0,0,0,1,66,1,1965,0,0,1029850,7903500,48.938737212968626,2395,2825,2825,2395,43616,765600,620400,3300,5695,3300,3730,6125,20.73644135332772,0.0,2395,1,450260,0,430,0,905,2870
9960,0,0,0,1,65,1,1780,0,0,859125,7155750,46.636895265444075,2005,2740,2570,2175,39996,651420,664580,3120,5465,3460,3685,6030,19.87460691435179,13.043927959432365,2345,1,439350,21760,395,0,1115,2895
9961,0,0,1,0,63,1,1117,0,0,1734408,2783424,29.5296461204668,213,3520,2861,872,45747,705432,660744,2533,4064,3851,5181,6712,44.598206241955516,26.142010475845158,1531,1,180504,99509,1989,0,2320,1203
9962,0,0,1,0,56,1,150,0,0,2002264,4189536,38.62641583165593,1384,2942,2834,1492,44103,513864,676728,2700,4300,2916,4150,5750,36.6333181680284,10.948360265819424,1600,1,359572,6264,1342,0,1316,1466
9963,0,0,1,0,64,0,1097,0,0,372368,877472,16.492422502470642,119,1794,1641,272,36750,677460,564550,3073,3498,3379,4595,5020,37.0,12.464513167977666,425,0,47600,26316,1369,1,2954,1857
9964,0,0,1,0,65,0,460,0,0,1791264,3679536,33.58571124749333,644,3200,2716,1128,31416,665448,502348,2778,4390,3746,4850,6462,39.84971769034255,22.095544081096477,1612,1,173712,89540,1588,0,2134,1674
9965,0,0,1,0,61,1,242,0,0,5247795,7370580,49.14264950122246,2049,4954,4588,2415,28779,485268,552412,2686,5467,3418,5225,8006,46.61544808322666,19.742312423681366,2781,1,437115,36234,2173,0,637,879
9966,0,0,1,0,58,1,355,0,0,5861250,7663910,51.03920062069938,2545,4915,4855,2605,43498,535444,703138,2882,5547,3002,5192,7857,47.43416490252569,8.06225774829855,2665,1,622595,3540,2250,0,337,692
9967,0,0,0,1,67,1,2036,0,0,1562220,8810500,51.28352561983234,2600,3254,3224,2630,53846,827450,730300,3320,5980,3380,3944,6604,24.372115213907882,5.478746393072713,2660,1,573340,4920,594,0,720,2756
9968,0,0,0,1,66,1,1915,0,0,1027824,7813344,48.49742261192856,2285,2856,2789,2352,38270,714230,591316,3255,5674,3389,3759,6178,20.904544960366874,8.456490803821907,2419,1,418656,11725,437,0,970,2885
9969,0,0,0,1,66,1,1894,0,0,999320,7724976,48.2078831727758,2239,2839,2754,2324,41591,694716,661476,3239,5648,3409,3754,6163,20.73644135332772,9.39804606644414,2409,1,462476,12325,430,0,1000,2894
9970,0,0,0,1,66,1,1764,0,0,927712,7220400,46.776062254106,1996,2804,2612,2188,38606,640200,656700,3108,5488,3492,3724,6104,20.591260281974,13.867762834025882,2380,1,435412,24384,424,0,1112,2876
9971,0,0,0,1,64,1,630,0,0,1406304,4962156,39.26830783214372,1447,2549,2454,1542,47286,685434,714396,3123,4760,3313,4130,5767,30.199337741083,9.759997214798725,1637,1,342324,11875,912,0,1676,2306
9972,0,0,1,0,59,1,118,0,0,1534119,3852834,36.0416425818802,993,2786,2480,1299,23004,631758,320328,2660,4265,3272,4147,5752,34.36568055487916,18.344088203539748,1605,1,140292,71604,1181,0,1667,1785
9973,0,0,1,0,63,1,158,0,0,2502815,4772355,38.79432948254165,1304,3369,3168,1505,47163,631029,751527,2970,4676,3372,4834,6540,40.779897008207364,14.199852474992882,1706,1,356685,17487,1663,0,1666,1508
9974,0,0,0,1,66,1,1898,0,0,1101624,7872120,48.620983124572874,2279,2915,2830,2364,39376,712620,612720,3245,5694,3415,3796,6245,21.587033144922902,9.494144610579708,2449,1,434976,14365,466,0,966,2864
9975,0,0,0,1,66,1,1805,0,0,1014750,7482090,47.486840282335066,2085,2875,2705,2255,35800,593922,663600,3148,5573,3488,3768,6193,21.213203435596427,13.09265514316057,2425,1,451000,17850,450,0,1063,2868
9976,0,0,0,1,64,1,833,0,0,1365368,5367023,40.70626487409524,1657,2481,2481,1657,43617,651039,702863,3239,4896,3239,4063,5720,28.705400188814647,0.0,1657,1,359569,0,824,0,1582,2415
9977,0,0,1,0,55,1,181,0,0,2270400,4448000,40.0,1558,3061,3019,1600,42136,511520,636620,2738,4380,2822,4199,5841,37.66961640367472,6.678188844436455,1642,1,366400,3192,1419,0,1180,1361
9978,0,0,0,1,67,0,360,0,0,503424,1861344,23.49468024894146,377,1639,1464,552,48805,724980,765444,3197,3924,3547,4284,5011,30.199337741083,13.306788019122699,727,1,125304,21000,912,0,2820,2460
9979,0,0,1,0,64,0,1060,0,0,1432581,2505264,27.910571473905726,353,3044,2618,779,37824,633552,617472,2790,3995,3642,5055,6260,42.883563284783136,20.71048612983299,1205,1,149568,58788,1839,0,2437,1377
9980,0,0,1,0,60,1,186,0,0,5523255,7432800,49.44694126030446,2177,4972,4704,2445,52624,632320,769120,2772,5485,3308,5299,8012,47.52893855326458,17.147866211041823,2713,1,618585,18224,2259,0,595,781
9981,0,0,1,0,59,1,212,0,0,5672220,7460040,49.8998997994986,2310,4948,4768,2490,47368,572236,743008,2816,5486,3176,5274,7944,47.7283982551269,14.064063304453542,2670,1,617520,10080,2278,0,506,718
9982,0,0,0,1,66,1,1975,0,0,1438206,8466612,50.40833264451424,2511,3137,3107,2541,38415,656404,649740,3302,5873,3362,3898,6469,23.790754506740637,5.514871952411144,2571,1,495495,4050,566,0,791,2766
9983,0,0,0,1,66,1,1934,0,0,1287992,8194972,49.57822102496216,2373,3067,2982,2458,32220,600120,596786,3249,5792,3419,3858,6401,22.891046284519195,9.494144610579708,2543,1,439982,11050,524,0,876,2810
9984,0,0,0,1,64,1,833,0,0,1407834,5435478,40.91454509095757,1674,2515,2515,1674,44000,649400,714340,3247,4921,3247,4088,5762,29.0,0.0,1674,1,368280,0,841,0,1573,2406
9985,0,0,0,1,64,1,686,0,0,1467432,5179266,40.024992192379,1512,2608,2518,1602,47040,678930,724192,3143,4835,3323,4149,5841,30.265491900843113,9.494144610579708,1692,1,358848,10620,916,0,1631,2317
9986,0,0,0,1,64,1,589,0,0,1504652,5018100,39.44616584663204,1406,2673,2523,1556,46010,693375,690150,3075,4781,3375,4192,5898,31.096623610932426,12.256148736246766,1706,1,332984,20400,967,0,1669,2258
9987,0,0,1,0,56,1,11,0,0,1916810,3947600,37.282703764614496,1390,2769,2769,1390,50160,681600,593560,2840,4230,2840,4219,5609,37.134889255254286,0.0,1390,0,290510,0,1379,1,1450,1461
9988,0,0,1,0,63,1,113,0,0,2613114,4935882,39.50949253027682,1437,3359,3235,1561,45305,648210,698802,3038,4723,3286,4836,6521,40.91454509095757,11.144389776194219,1685,1,344981,14384,1674,0,1601,1488
9989,0,0,1,0,57,1,3,0,0,2000808,4049760,37.62977544445356,1139,3106,2829,1416,48375,614900,643500,2583,4276,3137,4273,5966,37.589892258425,17.242668092248007,1693,1,318600,34071,1413,0,1444,1447
9990,0,0,1,0,55,1,168,0,0,2339968,4503792,40.19950248448356,1556,3124,3064,1616,40991,498873,638223,2727,4403,2847,4235,5911,38.05259518088089,7.994134176674909,1676,1,370064,4080,1448,0,1171,1339
9991,0,0,0,1,66,1,1821,0,0,1200190,7805905,48.321837713398274,2165,3019,2849,2335,43000,718745,668600,3173,5678,3513,3857,6362,22.67156809750927,13.242127012477162,2505,1,467000,25840,514,0,1008,2829
9992,0,0,0,1,63,1,17,0,0,1722584,4212669,36.345563690772494,875,3071,2625,1321,45576,672879,688824,2743,4510,3635,4493,6260,36.11094017053558,21.158967596669914,1767,1,285336,57534,1304,0,1868,1885
9993,0,0,1,0,63,1,430,0,0,1827936,3681260,33.97057550292606,572,3320,2738,1154,24596,548680,456170,2608,4344,3772,4774,6510,39.7994974842648,24.280490012905464,1736,1,165022,91374,1584,0,2036,1606
9994,0,0,1,0,63,1,1157,0,0,1886928,2882832,30.199337741083,684,3209,2981,912,44520,663810,670132,2933,4073,3389,5230,6370,45.48626166217664,15.314698014350183,1140,0,193344,30324,2069,1,2249,1092
9995,0,0,1,0,56,1,56,0,0,2186657,4287415,38.82009788756334,1306,3159,2958,1507,50456,603140,677110,2644,4352,3046,4296,6004,38.09199390948182,14.78598154140589,1708,1,358666,20301,1451,0,1338,1394
9996,0,0,1,0,56,1,96,0,0,2271760,4400368,39.44616584663204,1406,3166,3016,1556,48517,574084,675892,2678,4384,2978,4288,5994,38.2099463490856,12.833302576044929,1706,1,371884,13350,1460,0,1272,1368
9997,0,0,1,0,64,0,1407,0,0,233550,486750,12.24744871391589,0,1857,1707,150,39271,736615,561385,3095,3395,3395,4802,5102,39.45883931389772,12.667476048676626,300,0,25950,29100,1557,1,3095,1688
9998,0,0,1,0,64,0,868,0,0,558140,1395350,20.73644135332772,95,2063,1728,430,46652,694430,707410,2910,3675,3580,4543,5308,36.02776706930364,18.388677513052528,765,0,93740,43885,1298,1,2815,1947
9999,0,0,1,0,61,1,4,0,0,5253260,7106812,47.89572005931219,1827,5051,4584,2294,40018,579326,662972,2631,5392,3565,5388,8149,47.853944456021594,22.324030057264732,2761,1,490916,46233,2290,0,804,808
10000,0,0,0,1,66,1,1971,0,0,1700380,8766520,51.18593556827891,2590,3299,3269,2620,43357,759542,639086,3316,5966,3376,3995,6645,25.475478405713993,5.514871952411144,2650,1,500420,5280,649,0,726,2697
10001,0,0,0,1,67,1,1959,0,0,1640736,8685792,50.91168824543142,2532,3285,3225,2592,44642,740571,676902,3291,5943,3411,3984,6636,25.15949125081825,7.7992067098508295,2652,1,523584,9420,633,0,759,2718
10002,0,0,0,1,67,1,1805,0,0,1274964,7865800,48.45616575834287,2156,3083,2891,2348,44220,737000,673350,3158,5698,3542,3893,6433,23.302360395462088,14.113143603394192,2540,1,471948,30144,543,0,1002,2807
10003,0,0,0,1,66,1,1067,0,0,1398884,6128357,42.790185790669334,1771,2655,2595,1831,46228,609154,850138,3287,5178,3407,4111,6002,27.640549922170507,8.62579277231682,1891,1,465074,1620,764,0,1516,2583
10004,0,0,0,1,66,1,1021,0,0,1417710,6004950,42.49705872175156,1776,2621,2591,1806,42840,565250,837900,3295,5131,3355,4110,5946,28.0178514522438,6.099356562415133,1836,1,455112,450,785,0,1519,2540
10005,0,0,0,1,65,1,787,0,0,1518300,5489498,41.0731055558257,1620,2654,2587,1687,47475,686594,732150,3187,4941,3321,4154,5908,30.0,8.18535277187245,1754,1,379575,7906,900,0,1567,2354
10006,0,0,1,0,64,0,1936,0,0,319617,490212,12.36931687685298,231,2626,2242,153,52212,733716,730512,2820,3357,3588,5293,5830,45.70557952810576,19.596748472736827,537,1,34884,52224,2089,0,3051,1115
10007,0,0,1,0,57,1,225,0,0,1906954,4287276,38.704004960727254,1413,2856,2771,1498,38454,632502,497988,2777,4360,2947,4135,5718,35.679125549822544,9.357120099656203,1583,0,260652,15810,1273,1,1364,1589
10008,0,0,1,0,58,1,263,0,0,1896780,3647076,35.38361202590826,663,3356,2767,1252,48805,626295,661251,2324,4165,3502,4428,6269,38.92300091205713,24.759693311678443,1841,1,284204,71269,1515,0,1661,1398
10009,0,0,1,0,56,1,128,0,0,2555904,4659200,40.792156108742276,1574,3290,3200,1664,47385,546000,680400,2710,4464,2890,4336,6090,39.191835884530846,9.808573176892017,1754,1,404352,6390,1536,0,1136,1264
10010,0,0,1,0,62,0,2209,0,0,455810,595840,13.784048752090222,65,2844,2589,190,40504,765184,520576,2881,3326,3391,5535,5980,48.979587585033826,16.075934767576697,445,0,31540,54825,2399,1,2946,737
10011,0,0,1,0,64,1,668,0,0,2503133,4133826,35.81898937714463,683,3834,3234,1283,48090,676620,737838,2622,4505,3822,5173,7056,44.170125650715555,24.643836901460062,1883,1,293807,66600,1951,0,1939,1271
10012,0,0,1,0,62,1,143,0,0,5154600,6910200,46.9041575982343,1627,5116,4543,2200,33490,533970,618777,2568,5341,3714,5484,8257,48.40454524112379,24.79645564696428,2773,1,433400,55008,2343,0,941,798
10013,0,0,0,1,67,1,1147,0,0,1470720,6419080,43.76071297408213,1830,2768,2683,1915,51106,677104,848056,3267,5267,3437,4120,6120,27.712812921102035,9.930529422773999,2000,1,484495,4335,768,0,1437,2584
10014,0,0,0,1,65,1,879,0,0,1579732,5800025,42.08325082500163,1711,2723,2663,1771,46410,638625,779450,3215,5046,3335,4167,5998,29.866369046136157,8.111420134500735,1831,1,421498,4740,892,0,1504,2383
10015,0,0,0,1,64,1,695,0,0,1652136,5455071,40.97560249709576,1529,2813,2663,1679,48816,701784,734274,3099,4928,3399,4233,6062,31.368774282716245,12.250849366392371,1829,1,379454,18450,984,0,1570,2265
10016,0,0,0,1,64,1,256,0,0,1954832,4125308,35.7211421989835,615,3469,2808,1276,26180,549610,497882,2572,4509,3894,4765,6702,39.14077158156185,25.922647063002877,1937,1,196504,93862,1532,0,1957,1701
10017,0,0,0,1,61,1,1152,0,0,2312100,3211950,32.4037034920393,849,3453,3252,1050,44800,611800,685216,2858,4109,3260,5261,6512,46.92547282660026,14.199852474992882,1251,1,235200,20904,2202,0,2009,857
10018,0,0,1,0,56,1,19,0,0,2403960,4435080,39.496835316262995,1320,3341,3101,1560,51695,599873,696535,2603,4403,3083,4384,6184,39.25557285278104,15.885744871983722,1800,1,382200,21360,1541,0,1283,1302
10019,0,0,0,1,63,0,2030,0,0,639039,881137,16.64331697709324,20,2881,2584,277,40672,788888,521684,2884,3458,3478,5488,6062,48.03123983409131,17.52346007145855,574,1,45428,64746,2307,0,2904,874
10020,0,0,0,1,67,1,1224,0,0,1499617,6670027,44.50842616853577,1857,2862,2738,1981,52324,693602,855218,3243,5348,3491,4124,6229,27.51363298439521,11.718395466430005,2105,1,503174,7688,757,0,1386,2610
10021,0,0,0,1,67,1,1182,0,0,1513944,6564336,44.22668877499196,1861,2825,2730,1956,52877,701404,849068,3261,5312,3451,4130,6181,27.820855486487112,10.453462715764566,2051,1,494868,6270,774,0,1400,2582
10022,0,0,0,1,64,1,242,0,0,2010288,4228896,36.08323710533743,618,3530,2846,1302,29160,584640,526176,2564,4550,3932,4792,6778,39.293765408777,26.393567647015807,1986,1,210924,101232,1544,0,1946,1704
10023,0,0,1,0,64,1,679,0,0,1555296,5263200,40.39801975344831,757,3460,2585,1632,42372,690150,638550,2350,4857,4100,4178,6685,30.870698080866262,29.585072718058466,2507,1,323136,133875,953,0,1593,2272
10024,0,0,1,0,64,1,258,0,0,2524195,5525661,41.50903516103452,1573,3338,3188,1723,49725,721575,708747,3057,4930,3357,4672,6545,38.27531841800928,12.24962545775264,1873,1,380783,20850,1465,0,1484,1742
10025,0,0,1,0,62,1,435,0,0,3277846,5038022,40.07492981902776,1287,3966,3647,1606,34320,611715,552112,2818,4743,3456,5178,7103,45.17742799230607,17.96927154016812,1925,1,282656,48807,2041,0,1531,1096
10026,0,0,1,0,56,1,67,0,0,2611950,4649700,40.620192023179804,1500,3383,3233,1650,51546,600234,681956,2668,4468,2968,4401,6201,39.786932528155525,12.5999078163187,1800,1,399300,14550,1583,0,1168,1235
10027,0,0,0,1,66,1,1007,0,0,1638488,6200700,43.347433603386484,1879,2751,2751,1879,53580,775500,752400,3300,5179,3300,4172,6051,29.5296461204668,0.0,1879,1,428412,0,872,0,1421,2428
10028,0,0,1,0,59,1,1351,0,0,2153540,2793680,30.659419433511783,880,3291,3231,940,42640,609260,618176,2912,3912,3032,5263,6263,47.86439177509728,7.789174875971784,1000,1,195520,7800,2291,0,2032,681
10029,0,0,1,0,56,1,37,0,0,2645160,4652060,40.55859958134649,1463,3435,3253,1645,51574,605192,681548,2646,4473,3010,4436,6263,40.099875311526844,13.866168994530286,1827,1,396445,18018,1608,0,1183,1220
10030,0,0,1,0,56,1,92,0,0,2786784,4813380,41.42463035441596,1621,3435,3340,1716,49852,577830,678810,2710,4521,2900,4429,6240,40.29888335921977,10.152715924344653,1811,1,415272,8360,1624,0,1089,1181
10031,0,0,1,0,55,1,110,0,0,2836200,4859820,41.71330722922842,1673,3437,3370,1740,47628,547428,678699,2726,4533,2860,4423,6230,40.3732584763727,8.47749576439433,1807,1,422820,4757,1630,0,1053,1163
10032,0,0,1,0,64,0,1666,0,0,444600,756522,15.297058540778355,116,2484,2134,234,43316,769454,588406,2883,3467,3583,5133,5717,43.58898943540674,18.79929136212856,584,0,42588,68250,1900,1,2999,1333
10033,0,0,0,0,64,0,1282,1,0,1614048,2525860,27.964262908219126,566,3062,2846,782,56386,752590,781660,3014,4012,3446,5294,6292,45.43126676640219,15.009398570404464,998,1,189244,23544,2064,0,2448,1166
10034,0,0,1,0,60,1,180,0,0,5689669,6920861,47.92702786528704,2057,5014,4774,2297,44820,542340,750237,2773,5310,3253,5490,8027,49.76946855251722,15.977552903810324,2537,1,571953,9360,2477,0,716,536
10035,0,0,1,0,60,1,31,0,0,6689742,7728426,50.70502933634887,2370,5374,5173,2571,28272,685368,372744,2805,5577,3207,5608,8380,51.0098029794274,14.70834415446928,2772,1,318804,47235,2602,0,435,404
10036,0,0,0,1,67,1,1208,0,0,1628928,6761664,44.8998886412873,1921,2919,2824,2016,52070,687570,851916,3259,5370,3449,4162,6273,28.42534080710379,10.273798497703284,2111,1,512064,5510,808,0,1338,2546
10037,0,0,0,1,66,1,960,0,0,1712836,6186074,43.289721643826724,1832,2830,2788,1874,50616,752628,732822,3259,5175,3343,4215,6131,30.23243291566195,6.481658975540136,1916,1,416028,5964,914,0,1427,2387
10038,0,0,1,0,60,1,590,0,0,1548816,4755054,39.67366884975475,1183,2949,2558,1574,18012,477318,344394,2630,4595,3412,4005,5970,31.368774282716245,20.72704244501361,1965,1,179436,64906,984,0,1447,2037
10039,0,0,1,0,60,1,1293,0,0,2449980,3175551,32.357379374726875,1017,3417,3387,1047,42660,545940,718821,3003,4080,3063,5373,6450,48.373546489791295,5.7180036243905645,1077,1,248139,1740,2340,0,1986,693
10040,0,0,1,0,56,1,13,0,0,2635710,4595514,40.2119385257662,1370,3494,3247,1617,51728,602504,693448,2595,4459,3089,4472,6336,40.3732584763727,16.07569406482885,1864,1,394548,22724,1630,0,1225,1212
10041,0,0,1,0,56,1,45,0,0,2770054,4757340,41.0731055558257,1525,3491,3329,1687,51120,600660,676800,2658,4507,2982,4462,6311,40.52159917870962,13.104780096451085,1849,1,404880,16200,1642,0,1133,1178
10042,0,0,1,0,56,1,62,0,0,2818080,4810230,41.352146256270665,1576,3492,3358,1710,51408,607608,669494,2679,4523,2947,4461,6305,40.59556626036888,11.9305333824295,1844,1,406980,14338,1648,0,1103,1165
10043,0,0,1,0,58,1,290,0,0,4700904,6796376,48.14561246884289,2143,4521,4346,2318,39975,601060,571740,2757,5250,3107,4960,7453,45.033320996790806,13.442213731224724,2493,1,452010,25375,2028,0,614,904
10044,0,0,1,0,64,1,320,0,0,4185104,6061968,43.497126341863094,1664,4332,4104,1892,41829,701676,611964,2976,5096,3432,5416,7536,47.031904065219386,15.214538466206742,2120,1,361372,38076,2212,0,1312,992
10045,0,0,0,1,67,1,1277,0,0,1676010,7014258,45.628938186199335,1932,3037,2887,2082,52118,694014,852357,3219,5451,3519,4174,6406,28.372521918222215,12.587015179069688,2232,1,526746,8850,805,0,1287,2564
10046,0,0,0,1,65,1,36,0,0,2128357,4736567,37.960505792204614,795,3564,2918,1441,32200,604808,575225,2641,4728,3933,4764,6851,38.43175770115127,25.595532511611303,2087,1,252175,89794,1477,0,1846,1810
10047,0,0,0,1,65,1,546,0,0,2343496,4221626,35.805027579936315,446,3946,3110,1282,44793,622377,780441,2457,4575,4129,5121,7239,42.7551166528639,29.306953939079524,2118,1,303834,60192,1828,0,2011,1465
10048,0,0,1,0,64,1,781,0,0,1834200,5839200,42.42640687119285,1170,3449,2819,1800,48548,742876,687728,2614,5044,3874,4263,6693,31.921779399024736,25.126335135724513,2430,1,381600,97020,1019,0,1444,2225
10049,0,0,1,0,64,1,637,0,0,2259390,5999070,43.069710934716056,1495,3433,3073,1855,50621,734118,721182,2874,5089,3594,4452,6667,34.899856733230294,19.008741596196415,2215,1,413665,50040,1218,0,1379,2016
10050,0,0,1,0,64,1,455,0,0,2484300,5862220,42.661458015403085,1640,3365,3185,1820,50850,727946,724725,3041,5041,3401,4586,6586,36.945906403822335,13.449823834540586,2000,1,409500,24480,1365,0,1401,1856
10051,0,0,1,0,59,1,1349,0,0,2369130,3010958,31.71750305430741,921,3446,3361,1006,41925,583635,643495,2908,3999,3078,5348,6439,48.52834223420371,9.222414255489701,1091,1,216290,9180,2355,0,1987,638
10052,0,0,1,0,63,0,1946,0,0,835496,1145368,19.026297590440446,170,2862,2670,362,42175,762524,553700,2972,3526,3356,5472,6026,48.041648597857254,14.132314290900673,554,0,63350,39360,2308,1,2802,856
10053,0,0,1,0,67,0,295,0,0,393624,1668926,22.293496809607955,79,1707,1289,497,55842,762266,826068,2940,3855,3776,4150,5065,28.142494558940577,20.445516337765905,915,1,122262,40128,792,0,2861,2566
10054,0,0,0,1,66,1,345,0,0,2315736,4498290,36.864617182333525,535,3887,3063,1359,41495,711650,638830,2486,4669,4134,5014,7197,41.27953488110059,29.095178040283795,2183,1,262287,132664,1704,0,1951,1606
10055,0,0,1,0,60,1,1320,0,0,2616409,3300132,32.96968304366907,1087,3494,3494,1087,42174,601128,646668,3036,4123,3036,5443,6530,49.06118628814432,0.0,1087,1,231531,0,2407,0,1949,629
10056,0,0,1,0,58,1,310,0,0,2341419,4059105,37.1887079635741,742,3717,3076,1383,49163,619285,683855,2294,4318,3576,4628,6652,41.14608122288197,25.818807698945292,2024,1,322239,69228,1693,0,1552,1242
10057,0,0,1,0,56,1,5,0,0,2888294,4816660,41.255302689472536,1492,3609,3399,1702,51863,614110,676370,2620,4532,3040,4527,6439,41.19465984809196,14.826647610630195,1912,1,406778,22470,1697,0,1128,1133
10058,0,0,1,0,56,1,23,0,0,2935950,4867950,41.53311931459037,1545,3607,3427,1725,51840,609552,677280,2642,4547,3002,4524,6429,41.255302689472536,13.719158219336459,1905,1,414000,18540,1702,0,1097,1120
10059,0,0,1,0,56,1,41,0,0,2983836,4920620,41.80908992073375,1598,3605,3455,1748,51863,610855,672785,2665,4563,2965,4522,6420,41.31585652022719,12.525768210359056,1898,1,417772,16050,1707,0,1067,1108
10060,0,0,0,0,63,0,1385,1,0,1709364,2507382,28.053520278211074,663,3083,2959,787,55912,767826,739152,3062,3973,3310,5358,6269,46.604720790924176,11.207254246462899,911,1,182584,15748,2172,0,2399,1014
10061,0,0,1,0,64,1,434,0,0,4159512,5881638,42.82522621072771,1622,4314,4102,1834,45384,782508,596502,2995,5041,3419,5475,7521,47.62352359916263,14.707715565889083,2046,1,341124,41764,2268,0,1373,939
10062,0,0,0,1,67,1,1330,0,0,1810776,7329744,46.54030511288038,1991,3177,3002,2166,46552,622656,856152,3209,5550,3559,4220,6561,28.91366458960192,13.66314557581616,2341,1,547998,4375,836,0,1218,2548
10063,0,0,0,1,66,1,1222,0,0,1825968,7002336,45.760244754590204,1999,3061,2966,2094,55029,739024,832656,3249,5438,3439,4216,6405,29.5296461204668,9.924396939761625,2189,1,521406,8550,872,0,1250,2472
10064,0,0,0,1,66,1,1069,0,0,1864932,6631314,44.73253849269008,2001,2933,2933,2001,48840,735708,729080,3314,5315,3314,4246,6247,30.528675044947494,0.0,2001,1,440220,0,932,0,1313,2382
10065,0,0,1,0,63,1,863,0,0,3245564,4527306,37.69615364994153,1004,4122,3705,1421,37185,640386,589410,2769,4607,3603,5470,7308,47.791212581394085,20.44039542973387,1838,1,262885,62550,2284,0,1765,902
10066,0,0,1,0,56,1,5,0,0,2973894,4873260,41.49698784249286,1512,3659,3449,1722,52102,616940,676370,2620,4552,3040,4557,6489,41.557189510360296,14.806972569945605,1932,1,411558,22470,1727,0,1108,1103
10067,0,0,1,0,59,1,466,0,0,4521032,7002144,48.703182647543684,2210,4440,4278,2372,41109,569736,628776,2790,5324,3114,4858,7392,43.657759905886145,12.890756302658941,2534,1,505236,17658,1906,0,580,1046
10068,0,0,1,0,58,1,518,0,0,4284315,6901335,48.425200051213004,2260,4257,4172,2345,40964,615087,576828,2858,5288,3028,4770,7200,42.74342054632502,9.290499583346438,2430,1,459620,12665,1827,0,598,1116
10069,0,0,1,0,58,1,554,0,0,4133975,6854247,48.25971404805462,2299,4134,4104,2329,41944,629802,576828,2913,5272,2973,4718,7077,42.13074886588179,5.514871952411144,2359,1,456484,4650,1775,0,614,1168
10070,0,0,1,0,64,0,1557,0,0,690120,1161000,18.973665961010276,97,2734,2277,360,49086,783675,651450,2768,3585,3682,5142,5959,43.78355855797927,21.498363164741058,817,0,72720,82260,1917,1,2865,1308
10071,0,0,0,1,68,0,196,0,0,452796,2659204,27.892651361962706,281,1857,1360,778,54692,772468,827156,2921,4196,3915,4000,5275,24.124676163629637,22.361439999339904,1275,1,188276,55167,582,0,2640,2836
10072,0,0,0,1,68,1,1419,0,0,1888272,7695216,47.49736834815167,2009,3340,3093,2256,54432,764064,828873,3164,5667,3658,4248,6751,28.930952282978865,16.2350643095743,2503,1,548208,21983,837,0,1155,2574
10073,0,0,0,1,66,1,945,0,0,1968624,6470289,44.19275958796871,1863,3051,2961,1953,48178,732173,722234,3223,5266,3403,4321,6364,31.74901573277509,9.494144610579708,2043,1,425754,12420,1008,0,1360,2305
10074,0,0,0,1,66,1,865,0,0,1995950,6316370,43.70354676682432,1760,3105,2955,1910,47053,697777,737461,3157,5217,3457,4352,6412,32.32645975048923,12.250849366392371,2060,1,425930,18000,1045,0,1397,2262
10075,0,0,0,1,65,1,658,0,0,2067384,5891864,42.473521163190604,1521,3233,2950,1804,51513,728318,754446,2983,5070,3549,4412,6499,33.85262175962151,16.872842585342138,2087,1,416724,35375,1146,0,1462,2120
10076,0,0,0,1,65,1,617,0,0,2081928,5821192,42.23742416388575,1475,3260,2951,1784,49504,730912,721123,2954,5047,3572,4430,6523,34.161381705077446,17.637744162060443,2093,1,394264,42951,1167,0,1479,2096
10077,0,0,0,1,66,1,353,0,0,2469990,4663195,37.48332962798263,517,4051,3163,1405,49680,716904,763370,2431,4724,4207,5077,7370,41.92851058647326,30.1487054903961,2293,1,323150,103896,1758,0,1914,1561
10078,0,0,1,0,65,1,1031,0,0,1340816,5844674,42.22558466143482,823,3495,2535,1783,43183,711326,652322,2318,5061,4238,4030,6773,27.422618401604176,31.031036572152114,2743,1,354817,148800,752,0,1495,2526
10079,0,0,1,0,56,1,20,0,0,3154076,5029376,42.261093218230876,1636,3702,3552,1786,51408,608256,670208,2666,4602,2966,4582,6518,42.02380277890139,12.54961581009077,1936,1,425068,15900,1766,0,1030,1050
10080,0,0,1,0,56,1,38,0,0,3203739,5081481,42.532340636273474,1689,3700,3580,1809,51408,606744,668542,2689,4618,2929,4580,6509,42.08325082500163,11.232917923179112,1929,1,430542,12720,1771,0,1000,1038
10081,0,0,1,0,56,1,55,0,0,3255464,5133264,42.80186911806539,1742,3699,3609,1832,50740,602430,661272,2712,4634,2892,4579,6501,42.15447781671598,9.740037464252968,1922,1,432352,9630,1777,0,970,1025
10082,0,0,1,0,63,0,1806,0,0,1464691,1935723,24.63736998950984,487,3140,3020,607,41040,765360,545319,3069,3796,3309,5602,6329,49.122296363260546,11.100602434372421,727,0,103797,24960,2413,1,2582,776
10083,0,0,1,0,66,1,806,0,0,3030960,4568584,37.20215047547655,843,4115,3574,1384,42218,689909,666802,2760,4685,3842,5491,7416,46.79743582719036,23.832492020823974,1925,1,279568,76822,2190,0,1917,1111
10084,0,0,0,1,66,1,1277,0,0,1965458,7286576,46.67976006793523,2055,3205,3081,2179,53172,705584,842688,3220,5523,3468,4246,6549,30.033314835362415,11.247002231352543,2303,1,549108,9176,902,0,1165,2442
10085,0,0,1,0,65,1,1086,0,0,1315512,5950608,42.567593307585526,852,3498,2538,1812,43979,725764,653516,2324,5096,4244,4010,6782,26.94438717061496,31.038864785835358,2772,1,360588,152640,726,0,1472,2558
10086,0,0,1,0,65,1,977,0,0,1784874,6233682,43.71498598878879,1281,3475,2845,1911,44505,701330,675234,2632,5173,3892,4196,6737,30.56141357987225,25.15465498252841,2541,1,395577,90090,934,0,1351,2328
10087,0,0,0,1,64,1,244,0,0,3239532,6205572,43.88621651498338,1714,3820,3608,1926,32922,599292,570294,3010,5148,3434,4904,7042,41.012193308819754,14.658435386318777,2138,1,340902,29680,1682,0,1296,1540
10088,0,0,1,0,62,0,1791,0,0,648900,958209,17.578395831246947,279,2439,2409,309,46945,710129,635705,3071,3410,3131,5201,5540,45.8257569495584,5.501408174353464,339,0,63345,4890,2100,1,2792,1001
10089,0,0,1,0,66,1,982,0,0,2772615,4120950,35.2845575287547,523,4194,3472,1245,39248,738130,582560,2588,4555,4032,5537,7504,47.19110085598767,27.287099349200986,1967,1,219120,134292,2227,0,2065,1083
10090,0,0,0,1,69,1,1514,0,0,2090375,8277885,48.877397639399746,2029,3624,3264,2389,52920,727650,873180,3105,5854,3825,4340,7089,29.58039891549808,19.709872796802618,2749,1,602028,23400,875,0,1076,2590
10091,0,0,0,1,66,1,937,0,0,2107658,6618086,44.654227123532216,1886,3159,3051,1994,51051,733499,766689,3211,5313,3427,4376,6478,32.51153641401772,10.397868954212262,2102,1,460614,13176,1057,0,1325,2262
10092,0,0,1,0,55,1,69,0,0,3542616,5363766,43.78355855797927,1857,3825,3765,1917,50616,621156,637944,2738,4715,2858,4646,6623,42.988370520409354,7.864259938752337,1977,1,437076,7620,1848,0,881,950
10093,0,0,1,0,55,1,85,0,0,3598700,5420360,44.04543109109048,1910,3825,3795,1940,49704,609092,637032,2764,4734,2824,4649,6619,43.069710934716056,5.652706486041966,1970,0,442320,3660,1855,1,854,939
10094,0,0,1,0,61,0,1701,0,0,414072,666792,14.696938456699069,24,2325,2133,216,47299,719271,626661,2895,3303,3279,5004,5412,43.78355855797927,13.858755107602944,408,0,43848,32448,1917,1,2871,1170
10095,0,0,1,0,66,0,195,0,0,794206,2651082,28.26658805020514,56,2536,1793,799,30723,693462,487746,2575,4117,4061,4312,5854,31.52776554086889,27.43117329746331,1542,0,117453,147114,994,1,2519,2324
10096,0,0,1,0,59,1,498,0,0,6014224,6599248,47.07440918375928,2096,5050,4930,2216,39872,530084,667072,2858,5194,3098,5692,8028,52.09606511052442,11.418751370995183,2336,1,496384,8880,2714,0,762,264
10097,0,0,0,1,69,1,1580,0,0,2232000,8667600,49.79959839195493,2101,3759,3380,2480,52644,747930,859770,3116,5975,3874,4395,7254,30.0,19.552082392881232,2859,1,610080,34110,900,0,1015,2595
10098,0,0,0,1,67,1,1291,0,0,2125760,7510720,47.32863826479693,2090,3339,3189,2240,52208,697424,841603,3203,5593,3503,4302,6692,30.805843601498726,12.401817263524045,2390,1,562240,10950,949,0,1113,2404
10099,0,0,0,1,66,1,1257,0,0,2125144,7403656,47.07440918375928,2096,3295,3175,2216,53192,728338,815204,3221,5557,3461,4300,6636,30.967725134404045,11.045361017187261,2336,1,540704,11880,959,0,1125,2382
10100,0,0,0,1,66,1,1047,0,0,2151754,6927649,45.617978911828175,2039,3157,3115,2081,48024,772328,689103,3287,5410,3371,4363,6486,32.155870381627054,6.5135556243263055,2123,1,430767,6846,1034,0,1248,2295
10101,0,0,1,0,64,1,431,0,0,3067020,6423120,44.49719092257398,1890,3619,3529,1980,39292,677996,609872,3154,5224,3334,4793,6863,39.35733730830886,9.491514370027666,2070,1,372240,14220,1549,0,1264,1695
10102,0,0,0,1,64,1,585,0,0,3462016,5126202,39.88734135035826,1134,4224,3767,1591,38805,641178,628290,2765,4813,3679,5398,7446,46.647615158762406,21.39483602663112,2048,1,310245,62609,2176,0,1631,1046
10103,0,0,1,0,55,1,58,0,0,3635808,5414992,44.0,1869,3881,3814,1936,53361,646107,646107,2730,4733,2864,4675,6678,43.3358973600409,8.2732738280919,2003,1,447216,8844,1878,0,861,919
10104,0,0,0,0,56,1,165,1,0,4063500,5880000,45.8257569495584,2070,4065,4035,2100,48608,694400,548800,2770,4900,2830,4735,6865,43.98863489584554,5.572104574801163,2130,1,411600,5700,1935,0,700,865
10105,0,0,1,0,63,0,1616,0,0,1142736,1691760,23.065125189341593,370,2842,2680,532,51840,686880,763200,3018,3712,3342,5328,6022,46.34652090502587,12.97706729119361,694,0,127680,16686,2148,1,2648,1032
10106,0,0,1,0,64,0,2084,0,0,1455072,1782960,23.49468024894146,191,3549,3188,552,56628,781660,755820,2869,3782,3591,5866,6779,51.34199061197374,19.17120320542915,913,1,129168,46569,2636,0,2678,594
10107,0,0,1,0,63,1,2410,0,0,550200,666960,14.491376746189438,9,3031,2830,210,45738,768592,600264,2975,3386,3377,5796,6207,51.18593556827891,14.322673538179135,411,1,39690,38793,2620,0,2966,556
10108,0,0,0,0,65,1,1892,1,0,1403340,1861620,23.874672772626646,23,3579,3032,570,48945,819766,636870,2719,3836,3813,5728,6845,49.61854492022111,23.716403117986015,1117,1,111150,105024,2462,0,2696,804
10109,0,0,0,1,70,1,1614,0,0,2372872,8928822,50.457903246171455,2211,3813,3478,2546,50932,750498,834666,3172,6053,3842,4439,7320,30.528675044947494,18.457762804509517,2881,1,605948,34840,932,0,961,2575
10110,0,0,0,1,68,1,1490,0,0,2264016,8343408,49.23413450036468,2064,3718,3358,2424,50094,681516,870826,3082,5866,3802,4376,7160,30.56141357987225,19.232749017330665,2784,1,613272,16560,934,0,1018,2508
10111,0,0,0,1,68,1,1462,0,0,2251200,8224800,48.98979485566356,2070,3668,3338,2400,51408,699108,863604,3097,5827,3757,4365,7095,30.62678566222711,18.63392795707676,2730,1,604800,17820,938,0,1027,2489
10112,0,0,0,1,66,1,1040,0,0,2229161,6998431,45.83666654546336,2041,3222,3162,2101,48256,772792,692848,3271,5432,3391,4392,6553,32.57299494980466,7.822290851349969,2161,1,437008,9720,1061,0,1230,2270
10113,0,0,0,1,66,1,892,0,0,2262845,6679725,44.88875137492688,1853,3300,3138,2015,50128,689520,798915,3153,5330,3477,4438,6615,33.51119216023208,12.72901313522338,2177,1,485615,14904,1123,0,1300,2192
10114,0,0,0,1,66,1,543,0,0,2377078,6073122,42.86023798347368,1429,3539,3131,1837,29202,614916,519042,2898,5143,3714,4600,6845,35.9722114972099,20.199009876724155,2245,1,288409,65688,1294,0,1469,2012
10115,0,0,1,0,62,1,1320,0,0,3227796,3889908,35.41186241925155,1187,3895,3828,1254,37054,592482,601788,3035,4356,3169,5676,6997,50.73460357586329,8.456490803821907,1321,1,243276,8509,2574,0,1848,528
10116,0,0,1,0,58,1,306,0,0,2910960,4587960,39.496835316262995,948,4038,3426,1560,48336,623492,670548,2329,4501,3553,4807,6979,43.197222132910355,25.234986082758308,2172,1,355680,70380,1866,0,1381,1075
10117,0,0,1,0,56,1,16,0,0,3621345,5360355,43.71498598878879,1777,3940,3806,1911,53336,633930,661980,2671,4716,2939,4700,6745,43.53159771935783,11.65306661673843,2045,1,450996,16214,1895,0,894,910
10118,0,0,1,0,60,1,1402,0,0,1858688,6804764,47.265209192385896,1925,3375,3066,2234,45504,721902,584832,2737,5280,3355,3878,6421,28.844410203711913,17.580650666457768,2543,0,428928,57165,832,1,812,2214
10119,0,0,1,0,63,0,1602,0,0,1235299,1816817,23.853720883753127,445,2864,2740,569,39840,766320,530038,3069,3762,3317,5364,6057,46.593991028886975,11.718395466430005,693,0,94454,26288,2171,1,2624,1022
10120,0,0,1,0,64,1,806,0,0,4801575,5878325,42.720018726587654,1170,5111,4456,1825,50290,689294,756935,2566,5046,3876,5852,8332,51.29327441292864,25.595890319272677,2480,1,428875,71395,2631,0,1396,590
10121,0,0,0,1,66,1,1207,0,0,2287800,7448184,47.24404724407086,2142,3347,3257,2232,51493,737477,777521,3247,5569,3427,4362,6684,32.01562118716424,9.580310602724222,2322,1,520056,10800,1025,0,1105,2312
10122,0,0,1,0,66,1,1282,0,0,1284323,6427444,44.07947368106838,1041,3506,2604,1943,42612,701296,664908,2406,5251,4210,3969,6814,25.709920264364882,30.134545864926963,2845,1,390543,133496,661,0,1365,2647
10123,0,0,1,0,65,1,1138,0,0,1854815,6723960,45.221676218380054,1472,3525,2952,2045,42411,693768,660888,2715,5333,3861,4195,6813,30.116440692751194,24.068033375179375,2618,1,411045,83085,907,0,1243,2381
10124,0,0,0,1,65,1,458,0,0,3234528,6681424,45.18849411078001,1918,3750,3626,2042,31785,638040,533336,3148,5314,3396,4856,7022,39.7994974842648,11.147098121756736,2166,1,332846,20460,1584,0,1230,1688
10125,0,0,1,0,60,1,1137,0,0,3160630,7402400,49.345719165901315,2167,4001,3733,2435,40803,617120,611040,2772,5475,3308,4338,7041,36.02776706930364,16.723801532624496,2703,1,489435,36448,1298,0,605,1742
10126,0,0,1,0,66,0,349,0,0,811356,2456358,27.258026340878022,27,2551,1835,743,41701,737238,618222,2590,4049,4022,4398,5857,33.04542328371661,26.950315191669265,1459,0,138941,125300,1092,1,2563,2214
10127,0,0,0,1,70,1,1633,0,0,2622110,9233930,51.28352561983234,2360,3897,3627,2630,52030,754865,849662,3241,6141,3781,4508,7408,31.575306807693888,16.671821607899098,2900,1,636460,19710,997,0,881,2514
10128,0,0,1,0,55,1,31,0,0,3922140,5576824,44.67661580737735,1906,4051,3961,1996,51072,637032,625856,2704,4790,2884,4759,6845,44.328320518603,9.52871847115494,2086,1,447104,12510,1965,0,798,829
10129,0,0,1,0,64,1,914,0,0,4813232,5739128,42.23742416388575,1120,5146,4482,1784,48548,682004,736693,2553,5001,3881,5915,8363,51.94227565288221,25.769658455934582,2448,1,408536,75696,2698,0,1433,519
10130,0,0,0,1,68,1,1506,0,0,2576520,8689440,50.25932749251625,2243,3829,3546,2526,51750,712080,860000,3157,5966,3723,4460,7269,31.937438845342623,16.82685571859981,2809,1,631500,16697,1020,0,914,2420
10131,0,0,1,0,62,1,858,0,0,2812320,4040106,36.08323710533743,791,3973,3462,1302,33300,574055,558540,2592,4405,3614,5263,7076,46.475800154489,22.645220383230445,1813,1,234360,68985,2160,0,1801,943
10132,0,0,1,0,61,1,708,0,0,2850309,4202115,37.027017163147235,650,4171,3450,1371,44004,591545,698820,2344,4436,3786,5144,7236,45.59605246071199,26.851765990777285,2092,1,312588,64890,2079,0,1694,986
10133,0,0,0,1,68,1,1542,0,0,2721600,8934624,50.91168824543142,2364,3870,3642,2592,54692,779022,834174,3219,6039,3675,4497,7317,32.4037034920393,15.110114860095715,2820,1,627264,20976,1050,0,855,2397
10134,0,0,0,1,66,1,1421,0,0,1254792,6789321,45.13313638558703,1154,3536,2653,2037,39140,686598,633270,2450,5370,4216,3949,6869,24.819347291981714,29.875045558967003,2920,1,387030,133333,616,0,1296,2717
10135,0,0,0,1,65,1,838,0,0,2779400,7021192,46.238512086787566,1988,3588,3438,2138,42824,663368,696208,3134,5422,3434,4584,6872,36.05551275463989,12.429640165330436,2288,1,453256,18150,1300,0,1146,1984
10136,0,0,1,0,62,1,1215,0,0,3753874,4473912,37.72267222772003,1393,4091,4061,1423,39195,631944,613080,3114,4567,3174,5782,7235,51.36146415358503,5.531194905403055,1453,1,277485,4200,2638,0,1721,506
10137,0,0,1,0,60,1,1179,0,0,3433570,7723632,50.33885179461288,2352,4071,3889,2534,38940,670560,539496,2866,5582,3230,4403,7119,36.810324638611924,13.494401588860493,2716,1,448518,33124,1355,0,514,1693
10138,0,0,1,0,62,0,1450,0,0,778539,1306878,20.42057785666214,149,2552,2284,417,41769,692614,592326,2866,3551,3402,5001,5686,43.2087954009366,16.421750123487765,685,0,78813,45560,1867,1,2717,1267
10139,0,0,1,0,66,0,206,0,0,856152,2741508,28.77498913987632,20,2670,1862,828,51408,788018,715176,2503,4139,4119,4345,5981,32.155870381627054,28.599299339858412,1636,0,178848,129280,1034,1,2483,2277
10140,0,0,0,1,68,1,1530,0,0,2818800,8960130,51.088159097779204,2409,3891,3690,2610,56120,789590,837652,3232,6043,3634,4513,7324,32.863353450309965,14.177797783946604,2811,1,636840,20703,1080,0,823,2353
10141,0,0,0,1,66,1,1439,0,0,1336002,6954702,45.617978911828175,1251,3553,2723,2081,39390,651690,675084,2512,5423,4172,3984,6895,25.337718918639855,29.00963069292132,2911,1,420362,102920,642,0,1261,2700
10142,0,0,0,1,66,1,1279,0,0,1958022,7239672,46.66904755831214,1637,3618,3077,2178,37492,684744,604968,2783,5502,3865,4223,6942,29.9833287011299,23.544984707838566,2719,1,396396,87101,899,0,1146,2425
10143,0,0,0,1,66,1,1170,0,0,2285416,7359216,46.968074263269514,1804,3644,3242,2206,35126,643848,607152,2934,5542,3738,4372,6980,32.18695387886216,20.577415810718957,2608,1,401492,57888,1036,0,1130,2300
10144,0,0,1,0,56,1,59,0,0,4009136,5591482,44.41846462902562,1763,4215,4005,1973,45652,572468,640484,2624,4807,3044,4866,7049,45.077710678338576,14.662164531492765,2183,1,445898,21840,2032,0,861,802
10145,0,0,1,0,62,1,1469,0,0,1273572,6459424,45.617978911828175,1593,3181,2693,2081,40248,726336,533888,2616,5185,3592,3716,6285,24.73863375370596,22.11748160043092,2569,0,357932,98088,612,1,1023,2492
10146,0,0,1,0,67,0,276,0,0,803605,3532100,32.32645975048923,48,2811,1814,1045,38304,757120,577980,2383,4425,4377,4149,6191,27.730849247724095,31.85232098945456,2042,0,178695,191424,769,1,2335,2611
10147,0,0,0,1,67,0,294,0,0,200232,2082042,24.859605789312106,132,1692,942,618,51429,731073,798453,2619,3987,4119,3693,5061,18.0,27.74336127940047,1368,1,146466,81750,324,0,2751,3045
10148,0,0,0,1,66,1,1043,0,0,2579070,7363720,47.01063709417264,1940,3647,3377,2210,39035,616420,703052,3062,5542,3602,4499,6979,34.161381705077446,16.918198356421826,2480,1,466310,27270,1167,0,1122,2165
10149,0,0,1,0,61,1,1220,0,0,3532476,4204548,36.959437225152655,1232,4086,3952,1366,42840,627912,646380,2944,4444,3212,5664,7164,50.85272854036448,11.737458020983768,1500,1,286860,16884,2586,0,1712,492
10150,0,0,1,0,57,1,224,0,0,5528772,7030566,49.658836071740545,2346,4828,4708,2466,40992,638624,521733,2731,5317,2971,5093,7679,47.34976240700686,11.080810612286749,2586,1,451278,21720,2242,0,385,609
10151,0,0,1,0,58,1,671,0,0,5907102,8121568,52.81098370604357,2759,4937,4907,2789,41360,684320,512512,2882,5701,2942,5030,7849,46.021733996015406,5.5965095842615735,2819,0,490864,5940,2118,1,123,794
10152,0,0,1,0,62,1,1492,0,0,1193813,6447004,45.48626166217664,1556,3159,2646,2069,41064,735376,542184,2603,5185,3629,3693,6275,24.020824298928627,22.659909933568922,2582,0,360006,103626,577,1,1047,2539
10153,0,0,1,0,63,0,1383,0,0,1545334,2324580,27.03701166919155,646,2930,2845,731,40356,750480,543780,3095,3911,3265,5294,6110,45.9782557302906,9.357120099656203,816,0,125001,17340,2114,1,2449,1066
10154,0,0,0,1,69,0,630,0,0,279000,3215940,30.495901363953813,2,2162,1230,930,54692,836836,781508,2526,4388,4390,3758,5620,17.320508075688775,30.607666142657184,1862,1,210180,138868,300,0,2528,3158
10155,0,0,0,1,68,1,1507,0,0,3017580,9055387,51.44900387762624,2497,3937,3787,2647,56169,810777,810777,3271,6068,3571,4561,7358,33.76388603226827,12.247993008684867,2797,1,627339,19200,1140,0,774,2281
10156,0,0,0,1,66,1,1343,0,0,2024990,7514015,47.38143096192854,1708,3684,3147,2245,36462,689482,592419,2810,5592,3884,4249,7031,30.033314835362415,23.57906108400487,2782,1,397365,88605,902,0,1102,2445
10157,0,0,1,0,60,1,496,0,0,3390660,4855760,40.124805295477756,710,4616,3716,1610,40205,563992,648440,2116,4626,3916,5122,7632,45.89117562233506,30.589226974250263,2510,1,346150,88200,2106,0,1406,910
10158,0,0,1,0,56,1,77,0,0,4215380,5732675,44.88875137492688,1805,4317,4107,2015,45652,574690,642970,2635,4860,3055,4937,7162,45.73838650411709,14.79733705011341,2225,1,455390,22050,2092,0,830,753
10159,0,0,1,0,63,0,1351,0,0,1601490,2418174,27.54995462791182,692,2936,2869,759,36252,726408,506574,3119,3945,3253,5296,6122,45.93473631142341,8.499160266369426,826,0,120681,13869,2110,1,2427,1076
10160,0,0,1,0,64,0,1261,0,0,1453430,2368120,27.018512172212592,568,2883,2721,730,43584,622848,736388,3082,3974,3406,5235,6127,44.62062303464621,12.89950058566656,892,0,165710,14418,1991,1,2514,1253
10161,0,0,0,1,68,0,590,0,0,176144,2760936,28.42534080710379,91,1925,1026,808,53965,734655,857667,2518,4225,4316,3635,5342,14.7648230602334,30.01033724842987,1707,1,202808,71920,218,0,2609,3199
10162,0,0,0,1,67,1,1239,0,0,2930440,8200840,49.39635614091387,2373,3708,3641,2440,52668,766308,776391,3294,5801,3428,4562,7069,34.655446902326915,8.19263674150144,2507,1,563640,8643,1201,0,921,2160
10163,0,0,0,1,67,1,1450,0,0,1739400,7470500,47.22287581247038,1572,3668,3010,2230,36381,673350,606350,2692,5580,4008,4130,7018,27.92848008753788,25.96575225965148,2888,1,403630,101332,780,0,1120,2570
10164,0,0,1,0,56,1,36,0,0,4485600,5940900,45.8257569495584,1980,4356,4236,2100,47328,577116,656328,2709,4929,2949,4965,7185,46.216880033165374,11.246826503806982,2220,1,487200,11880,2136,0,729,693
10165,0,0,1,0,56,1,10,0,0,4661256,6067856,46.51881339845203,2134,4348,4318,2164,47586,577624,647724,2774,4968,2834,4958,7152,46.411205543489174,5.623413251903491,2194,0,499884,3090,2154,1,640,650
10166,0,0,1,0,61,1,1711,0,0,1457040,7189465,48.321837713398274,2095,3199,2959,2335,41230,668143,585010,2839,5414,3319,3703,6278,24.979991993593593,15.496234907772216,2575,0,443650,39600,624,1,744,2455
10167,0,0,0,1,67,0,415,0,0,136296,2138459,25.11971337416094,158,1636,847,631,54050,779470,796415,2600,4020,4178,3605,5025,14.696938456699069,28.45952287968153,1420,1,148285,99414,216,0,2758,3173
10168,0,0,0,1,67,0,370,0,0,141336,2041520,24.576411454889016,156,1598,838,604,53325,760500,801060,2620,3984,4140,3614,4978,15.297058540778355,27.959288573360745,1364,1,143148,89680,234,0,2776,3146
10169,0,0,0,1,67,1,1365,0,0,3100626,8715690,50.70502933634887,2447,3901,3777,2571,55144,766140,827160,3266,5961,3514,4596,7291,34.72751070837067,11.207254246462899,2695,1,627324,13268,1206,0,819,2184
10170,0,0,0,1,67,1,1330,0,0,3182991,8680651,50.68530358989675,2484,3893,3808,2569,54948,770412,814339,3294,5948,3464,4618,7272,35.199431813596085,9.245276771705237,2654,1,619129,9775,1239,0,810,2140
10171,0,0,0,1,67,1,1277,0,0,3151200,8499150,50.24937810560445,2465,3833,3773,2525,54720,767448,807840,3306,5891,3426,4614,7199,35.32704346531139,7.750803389552748,2585,1,606000,7020,1248,0,841,2118
10172,0,0,0,1,66,1,1001,0,0,3034656,7720794,48.093658625644196,2189,3749,3625,2313,38025,650910,650910,3214,5651,3462,4650,7087,36.22154055254967,11.375520776142816,2437,1,451035,16368,1312,0,1025,2026
10173,0,0,0,1,68,0,667,0,0,142290,2864214,28.930952282978865,129,1973,1007,837,53965,735730,858922,2456,4259,4388,3592,5395,13.038404810405298,31.448201588618442,1803,1,210087,77280,170,0,2585,3252
10174,0,0,0,1,67,0,387,0,0,111168,1951809,24.06241883103193,173,1523,771,579,56168,802298,795556,2619,3950,4123,3563,4894,13.856406460551018,27.746872851396056,1331,1,136644,99264,192,0,2792,3179
10175,0,0,1,0,63,0,1916,0,0,1531461,1919941,24.63736998950984,406,3331,3130,607,53000,790750,670556,2962,3770,3364,5686,6494,50.22947341949744,14.240973470021874,808,0,128684,34572,2523,1,2556,640
10176,0,0,1,0,66,1,1628,0,0,2570208,3257040,31.368774282716245,447,4133,3596,984,54707,797710,751370,2773,4294,3847,5922,7443,51.10772935672255,23.35623085044243,1521,1,223368,79476,2612,0,2326,698
10177,0,0,1,0,66,1,1569,0,0,2717010,3440505,32.264531609803356,583,4109,3651,1041,42074,637865,720490,2847,4346,3763,5915,7414,51.088159097779204,21.609092725423515,1499,1,226938,46258,2610,0,2264,695
10178,0,0,0,1,67,1,1163,0,0,2796528,7933296,48.49742261192856,2105,3788,3541,2352,34600,583529,674600,3126,5725,3620,4562,7161,34.48187929913333,16.2350643095743,2599,1,470400,23959,1189,0,1021,2184
10179,0,0,1,0,64,1,704,0,0,4107345,5486690,41.291645644125154,1675,4144,4114,1705,45570,675780,698306,3188,4923,3248,5627,7362,49.08156476723211,5.501408174353464,1735,0,369985,3750,2409,1,1513,809
10180,0,0,1,0,64,1,1088,0,0,4194225,5099850,39.68626966596886,1333,4480,4238,1575,40232,608744,692932,2996,4813,3480,5901,7718,51.60426338976267,15.984841753686606,1817,1,337050,24200,2663,0,1663,575
10181,0,0,1,0,57,1,76,0,0,4755317,6109693,46.292547996410825,1990,4515,4362,2143,45571,567349,652879,2698,4994,3004,5070,7366,47.10626285325551,12.819678275901781,2296,1,490747,14841,2219,0,708,632
10182,0,0,1,0,63,1,1568,0,0,859140,6349644,44.69899327725402,1362,3064,2428,1998,38579,708694,549794,2542,5176,3814,3608,6242,20.73644135332772,25.242714448841607,2634,1,345654,120840,430,0,1180,2748
10183,0,0,0,1,68,0,684,0,0,150325,2942934,29.30870177950569,114,2007,1034,859,53965,736590,859926,2453,4285,4399,3601,5433,13.228756555322953,31.570350204827307,1832,1,215609,76867,175,0,2567,3251
10184,0,0,0,1,68,0,673,0,0,101600,2726400,28.284271247461902,124,1851,927,800,55596,770208,838368,2484,4208,4332,3535,5259,11.269427669584644,30.740465028626996,1724,1,196800,94248,127,0,2608,3281
10185,0,0,0,1,68,0,663,0,0,83268,2621400,27.76688675382964,129,1779,879,771,55660,782000,822800,2500,4171,4300,3508,5179,10.392304845413264,30.328813726748365,1671,1,186582,101700,108,0,2629,3292
10186,0,0,1,0,63,1,2409,0,0,1263436,1414942,21.047565179849187,3,3741,3295,443,44640,792112,574920,2748,3637,3640,6046,6935,53.40411969127476,21.210505439499578,889,1,79740,91430,2852,0,2751,342
10187,0,0,1,0,64,1,2185,0,0,1684556,1946692,24.576411454889016,14,4011,3393,604,49644,812196,634931,2605,3827,3841,6012,7234,52.81098370604357,24.984673912421375,1222,1,118988,118038,2789,0,2619,434
10188,0,0,0,1,67,1,1361,0,0,3431622,8983790,51.51698748956503,2594,4007,3947,2654,54988,788705,798860,3325,6039,3445,4678,7392,35.958309192730404,7.759379671981613,2714,1,626344,7680,1293,0,731,2092
10189,0,0,0,1,67,1,1231,0,0,2752290,8089920,48.83646178829912,2100,3824,3539,2385,35979,607168,681792,3107,5777,3677,4546,7216,33.97057550292606,17.48865077192607,2670,1,479385,29640,1154,0,1007,2238
10190,0,0,0,1,67,1,1166,0,0,2885727,8041020,48.774993593028796,2151,3820,3592,2379,34773,584740,679380,3152,5759,3608,4593,7200,34.828149534535996,15.533788019677399,2607,1,478179,21888,1213,0,1001,2167
10191,0,0,1,0,62,1,861,0,0,3658230,4761360,39.11521443121589,1440,4011,3921,1530,42525,700200,588168,3022,4642,3202,5503,7123,48.8978527135906,9.65116822864259,1620,1,289170,15750,2391,0,1582,721
10192,0,0,1,0,57,1,163,0,0,4609410,5988099,45.46427168667722,1761,4603,4297,2067,45310,570709,666310,2591,4964,3203,5127,7500,47.22287581247038,18.032490798265005,2373,1,475410,28764,2230,0,830,667
10193,0,0,1,0,57,1,68,0,0,4927244,6230100,46.75467891024384,2052,4574,4440,2186,44719,561450,646950,2716,5036,2984,5104,7424,47.47630988187688,12.004193403260864,2320,1,496222,12998,2254,0,664,596
10194,0,0,1,0,65,0,424,0,0,139956,2094846,25.337718918639855,150,1352,860,642,44270,760279,619970,2771,3905,3755,3481,4615,14.7648230602334,22.329870222592874,1134,1,121980,90528,218,0,2621,3045
10195,0,0,1,0,64,1,1428,0,0,3438373,4087603,35.679125549822544,1273,3974,3974,1273,53590,738530,748163,3211,4484,3211,5912,7185,51.97114584074513,0.0,1273,1,296609,0,2701,0,1938,510
10196,0,0,0,1,67,1,1398,0,0,3587760,9216738,52.1344415909483,2676,4080,4038,2718,55176,773148,820622,3349,6109,3433,4711,7471,36.3318042491699,6.488991180673202,2760,1,657756,4788,1320,0,673,2071
10197,0,0,1,0,57,1,91,0,0,4986452,6264244,46.776062254106,2013,4642,4467,2188,45652,578326,647038,2688,5051,3038,5142,7505,47.738873049120045,13.675967344555211,2363,1,494488,18200,2279,0,675,584
10198,0,0,1,0,56,1,61,0,0,5099892,6343116,47.20169488482379,2104,4641,4517,2228,43968,546624,651963,2723,5075,2971,5136,7488,47.843494855622744,11.456179445350307,2352,1,510212,10788,2289,0,619,558
10199,0,0,1,0,56,1,46,0,0,5161455,6380413,47.4236228055175,2154,4639,4544,2249,44850,553215,652510,2742,5086,2932,5132,7476,47.90615826801394,10.028378966423087,2344,1,517270,8455,2295,0,588,542
10200,0,0,0,1,67,0,694,0,0,74955,2681022,28.089143810376278,101,1774,884,789,53100,764550,801928,2508,4187,4288,3493,5172,9.746794344808963,30.16023025489831,1679,1,186204,106800,95,0,2609,3303
10201,0,0,0,1,67,0,670,0,0,21000,2371600,26.457513110645905,116,1546,730,700,54056,786016,789404,2572,4088,4204,3418,4934,5.477225575051661,28.89962978058344,1516,1,163100,106896,30,0,2688,3358
10202,0,0,1,0,64,1,2305,0,0,1573656,1770914,23.473389188611005,56,4014,3407,551,51333,774574,684582,2607,3765,3821,6070,7228,53.44155686354955,24.741044226625924,1158,1,117363,100762,2856,0,2663,358
10203,0,0,1,0,58,1,963,0,0,6070768,5963231,45.044422518220834,1944,5106,5021,2029,55221,696543,684787,2854,4968,3024,5931,8045,54.699177324709375,9.224644470006377,2114,0,472757,11560,2992,1,910,53
10204,0,0,0,1,68,1,1233,0,0,2941434,8304795,49.38623289946298,2197,3887,3645,2439,36432,599280,704835,3163,5844,3647,4611,7292,34.72751070837067,16.068407690798903,2681,1,504873,22506,1206,0,966,2199
10205,0,0,1,0,57,1,38,0,0,5057640,6382260,47.22287581247038,2068,4660,4498,2230,46284,580986,652536,2700,5092,3024,5130,7522,47.62352359916263,13.117536098593346,2392,1,508440,16524,2268,0,632,594
10206,0,0,0,1,67,1,1061,0,0,3380052,8270496,49.4368283772331,2359,3912,3827,2444,37800,639576,676800,3299,5828,3469,4767,7296,37.1887079635741,9.39804606644414,2529,1,488800,10115,1383,0,940,2001
10207,0,0,1,0,65,1,884,0,0,4513536,5674752,41.569219381653056,1548,4520,4340,1728,32361,660084,528724,3104,5012,3464,5896,7804,51.10772935672255,14.034855041500148,1908,1,278208,31500,2612,0,1556,672
10208,0,0,0,0,58,1,504,1,0,6296980,8052922,52.66877632905477,2647,5171,5044,2774,39840,722847,464480,2776,5677,3030,5173,8074,47.644516998286385,11.593364526831646,2901,1,443840,27940,2270,0,129,633
10209,0,0,1,0,62,0,1075,0,0,256476,627321,14.177446878757825,67,1745,1477,201,44160,717830,599232,2853,3322,3389,4397,4866,35.7211421989835,16.46112489689083,469,0,38592,47436,1276,1,2920,1845
10210,0,0,0,1,67,0,566,0,0,42411,2131311,25.15949125081825,99,1432,700,633,55081,750841,831649,2635,4000,4099,3434,4799,8.18535277187245,27.361422606784217,1365,1,156351,71004,67,0,2734,3300
10211,0,0,1,0,62,1,2007,0,0,1250494,7881370,50.05996404313531,2398,3113,3005,2506,41888,704480,588115,3037,5651,3253,3644,6258,22.338307903688676,10.400314334861214,2614,1,468622,19008,499,0,639,2646
10212,0,0,1,0,63,1,1998,0,0,909160,7542220,48.78524367060187,2133,3009,2762,2380,38232,684504,560913,2922,5549,3416,3551,6178,19.544820285692065,15.773876900185215,2627,1,421260,43966,382,0,789,2787
10213,0,0,0,1,68,1,1156,0,0,3383100,8532930,50.05996404313531,2386,3976,3856,2506,46209,718455,745695,3285,5911,3525,4755,7381,36.742346141747674,11.320779839735554,2626,1,548814,15120,1350,0,899,2055
10214,0,0,1,0,62,0,2491,0,0,837300,943500,17.320508075688775,138,3253,3091,300,49560,742220,660450,2983,3445,3307,5936,6398,52.82991576748916,12.748363342157862,462,0,63000,26568,2791,1,2845,354
10215,0,0,0,1,67,0,615,0,0,114750,2594115,27.65863337187866,54,1734,915,765,47380,698546,779930,2572,4156,4210,3541,5125,12.24744871391589,28.961391251457712,1584,1,175950,85176,150,0,2626,3241
10216,0,0,0,1,67,0,582,0,0,87544,2386280,26.570660511172846,59,1595,830,706,49704,736840,770640,2615,4086,4145,3504,4975,11.135528725660043,27.99395075493803,1471,1,160968,93330,124,0,2674,3256
10217,0,0,0,1,67,0,484,0,0,82812,2078334,24.859605789312106,67,1437,752,618,47066,679326,783579,2678,3981,4048,3497,4800,11.575836902790225,26.492997318816293,1303,1,143994,65760,134,0,2745,3229
10218,0,0,1,0,62,1,2083,0,0,1603238,8415659,51.778373863998475,2639,3321,3279,2681,41856,684302,602688,3097,5820,3181,3737,6460,24.454038521274967,6.503581472166948,2723,0,514752,6888,598,1,458,2541
10219,0,0,1,0,64,1,1980,0,0,412300,7028630,46.58325879540846,1600,2930,2360,2170,37788,651039,608932,2669,5409,3809,3429,6169,13.784048752090222,24.05629755072903,2740,1,407960,84360,190,0,1069,3049
10220,0,0,1,0,67,0,135,0,0,2292184,5317297,39.786932528155525,877,3737,3031,1583,50820,738980,775929,2653,4942,4065,4807,7096,38.05259518088089,27.161016446382824,2289,1,365673,85426,1448,0,1776,1911
10221,0,0,1,0,63,1,2483,0,0,1252590,1372990,20.73644135332772,260,4033,3343,430,55527,795057,712039,2503,3623,3883,6106,7226,53.97221507405454,26.364639921971666,1120,1,95890,106260,2913,0,2763,280
10222,0,0,1,0,68,0,313,0,0,1630590,4906200,37.986839826445156,651,3365,2573,1443,55176,822800,775200,2608,4843,4192,4530,6765,33.61547262794322,28.74245856852247,2235,1,329004,115632,1130,0,1957,2270
10223,0,0,1,0,61,1,253,0,0,4188548,6650735,46.65833258915282,1667,4611,4101,2177,43152,568230,708760,2545,5232,3565,4979,7666,43.86342439892262,22.602689905800858,2687,1,505064,38250,1924,0,878,1131
10224,0,0,1,0,56,1,421,0,0,5518212,7283115,50.68530358989675,2569,4717,4717,2569,48399,620865,626535,2835,5404,2835,4983,7552,46.34652090502587,0.0,2569,0,567749,0,2148,0,266,687
10225,0,0,1,0,65,0,437,0,0,1722488,3666264,33.34666400106613,978,2795,2661,1112,37820,804468,511035,3163,4409,3431,4846,6092,39.35733730830886,11.959283984848298,1246,0,172360,29882,1549,1,2185,1748
10226,0,0,1,0,65,0,355,0,0,97734,593866,13.490737563232042,95,996,719,182,54480,740701,783120,2986,3445,3540,3800,4259,23.173260452512935,16.816771953247702,459,1,43680,31855,537,0,3081,2726
10227,0,0,1,0,65,0,324,0,0,135360,1836384,23.748684174075834,169,1199,804,564,41860,748880,592592,2861,3820,3651,3496,4455,15.491933384829668,20.003780178133944,959,1,102648,74260,240,0,2692,3016
10228,0,0,1,0,62,1,2984,0,0,395097,398907,11.269427669584644,145,3510,3238,127,48306,782109,609354,2869,3268,3413,6252,6651,55.776339069537364,16.54919588070608,399,0,24638,52224,3111,1,3014,30
10229,0,0,1,0,64,1,75,0,0,3671566,6303604,44.204072210600685,1444,4343,3833,1954,41808,671008,648426,2716,5180,3736,5105,7569,43.347433603386484,22.616122629980858,2464,1,392754,72930,1879,0,1272,1347
10230,0,0,1,0,63,1,211,0,0,3855992,6551664,45.51922670696417,1558,4447,3933,2072,43844,613428,714612,2648,5234,3676,5023,7609,43.139309220245984,23.063923039717324,2586,1,468272,47802,1861,0,1090,1301
10231,0,0,1,0,58,1,419,0,0,4913412,7115556,49.35585071701227,2196,4693,4453,2436,42370,554990,651383,2681,5357,3161,4938,7614,44.91102314577124,16.210236398163584,2676,1,543228,21840,2017,0,485,904
10232,0,0,0,1,65,0,777,0,0,1732824,3237360,31.368774282716245,602,3127,2745,984,41418,582330,769860,2908,4274,3672,5051,6417,41.96427051671457,19.865046449669148,1366,1,230256,22156,1761,0,2306,1529
10233,0,0,0,1,68,0,504,0,0,318420,2977140,29.49576240750525,103,2003,1236,870,53520,763106,821280,2655,4292,4189,3788,5425,19.131126469708992,27.752254673718905,1637,1,208800,85137,366,0,2552,3056
10234,0,0,0,1,68,0,457,0,0,251940,2666820,27.92848008753788,7,1890,1103,780,51520,786370,765856,2632,4199,4206,3742,5309,17.97220075561143,28.453653546264114,1567,1,174720,111754,323,0,2639,3096
10235,0,0,1,0,64,0,498,0,0,74160,389400,10.954451150103322,72,930,738,120,54026,736615,772310,3053,3365,3437,3863,4175,24.859605789312106,13.99717480090423,312,1,28560,22656,618,0,3125,2627
10236,0,0,1,0,64,1,2242,0,0,1062888,1288008,20.049937655763422,430,3878,3046,402,51054,813816,644004,2372,3606,4036,5848,7082,51.419840528729765,28.97191379421272,1234,0,80802,148096,2644,1,2802,560
10237,0,0,1,0,59,1,1446,0,0,5995080,9795240,57.23635208501674,3042,5340,5106,3276,40338,726570,496340,2756,6266,3224,4820,8330,42.77849927241488,15.504089381993905,3510,1,543816,50076,1830,0,286,1160
10238,0,0,1,0,63,1,2199,0,0,1782270,8984904,53.1883445878888,2637,3651,3459,2829,41447,689192,606616,2984,6005,3368,3806,6827,25.099800796022265,13.914767815144769,3021,0,540339,31488,630,1,347,2546
10239,0,0,0,1,68,0,492,0,0,367200,3078900,30.0,174,2034,1308,900,55660,786830,827882,2695,4321,4147,3829,5455,20.199009876724155,27.00858199694779,1626,1,217800,82038,408,0,2521,3013
10240,0,0,0,1,68,0,429,0,0,273780,2663700,27.92848008753788,1,1910,1131,780,54720,819600,778620,2636,4195,4194,3766,5325,18.734993995195193,28.300134653785022,1559,1,177840,112955,351,0,2635,3064
10241,0,0,1,0,63,1,2241,0,0,983992,1200944,19.390719429665317,429,3798,2993,376,50800,811276,638800,2389,3570,3999,5811,6992,51.15662224971465,28.50168390468836,1181,0,75200,148120,2617,1,2818,577
10242,0,0,1,0,64,1,1390,0,0,2125200,2977120,30.331501776206203,596,3554,3230,920,49153,799292,643964,2912,4156,3560,5546,6790,48.062459362791664,18.012375776781223,1244,1,183080,60264,2310,0,2316,926
10243,0,0,1,0,62,1,1078,0,0,3315680,4279920,36.87817782917155,807,4351,3798,1360,49288,635694,767868,2594,4507,3700,5585,7498,49.37610758251404,24.328724041841333,1913,1,331840,43687,2438,0,1787,709
10244,0,0,0,1,68,0,480,0,0,418500,3187110,30.495901363953813,245,2065,1380,930,54000,771075,822480,2742,4357,4112,3877,5492,21.213203435596427,26.23122243761111,1615,1,223200,77405,450,0,2497,2977
10245,0,0,1,0,67,0,472,0,0,920448,4143240,34.9857113690718,287,2913,1976,1224,55176,819170,771780,2448,4609,4322,4137,6298,27.422618401604176,30.96691696885771,2161,1,279072,137739,752,0,2161,2633
10246,0,0,1,0,63,1,2533,0,0,686660,780273,15.716233645501712,330,3604,3027,247,50058,767637,650754,2582,3406,3736,5939,6763,52.72570530585627,24.118994184306505,824,0,50882,101552,2780,1,2912,379
10247,0,0,1,0,61,1,539,0,0,4140126,7112286,48.187135212627034,1962,4465,4105,2322,44982,578907,728994,2703,5385,3423,4846,7528,42.22558466143482,19.026297590440446,2682,1,552636,25200,1783,0,741,1280
10248,0,0,1,0,64,1,2186,0,0,2785376,9884688,55.569775957799216,2645,4433,3990,3088,44200,640200,707421,2758,6289,3644,4103,7634,30.033314835362415,21.266168693515176,3531,1,682448,47844,902,0,113,2299
10249,0,0,0,1,68,0,427,0,0,385410,2973660,29.49576240750525,179,2004,1313,870,53824,792976,792976,2727,4288,4109,3861,5422,21.047565179849187,26.36192476688313,1561,1,201840,91903,443,0,2548,2975
10250,0,0,0,1,68,0,239,0,0,246330,2144520,25.099800796022265,12,1639,1021,630,55404,776112,827172,2786,4034,4022,3795,5043,19.77371993328519,25.343633801188687,1248,1,153090,68598,391,0,2774,3013
10251,0,0,1,0,64,1,2182,0,0,3282944,10326526,56.621550667568265,2642,4794,4230,3206,44556,763377,605548,2657,6427,3785,4245,8015,32.0,24.039615347699886,3770,1,602728,106032,1024,0,15,2197
10252,0,0,1,0,66,0,369,0,0,2253616,5637434,41.19465984809196,1163,3559,3025,1697,55125,747450,813890,2788,5019,3856,4650,6881,36.4417343165772,23.59239906339728,2231,1,415765,48594,1328,0,1625,1994
10253,0,0,1,0,64,0,589,0,0,2237370,3972900,35.07135583350036,865,3414,3049,1230,56133,746130,784890,2865,4460,3595,5049,6644,42.649736224272246,19.358889276734608,1595,1,298890,37960,1819,0,2000,1411
10254,0,0,1,0,63,0,1004,0,0,2064480,3253800,31.937438845342623,707,3357,3044,1020,54752,740080,752840,2877,4210,3503,5214,6547,44.98888751680797,17.83171680974042,1333,1,240720,39751,2024,0,2170,1166
10255,0,0,1,0,63,0,1479,0,0,1762020,2465580,27.92848008753788,540,3279,3039,780,49862,676454,736513,2921,3941,3401,5420,6440,47.52893855326458,15.540719891657039,1020,0,181740,26640,2259,1,2381,902
10256,0,0,1,0,63,1,2566,0,0,500136,574574,13.490737563232042,328,3440,2930,182,53599,779779,685069,2647,3339,3667,5905,6597,52.421369688324624,22.69181438633058,692,0,39494,84150,2748,1,2975,409
10257,0,0,1,0,63,1,2386,0,0,595992,718200,15.0996688705415,430,3500,2842,228,53212,790650,667800,2492,3378,3808,5764,6650,51.12729212465687,25.699498646357917,886,0,48336,113834,2614,1,2922,536
10258,0,0,0,0,62,1,1839,1,0,4888150,10293284,57.56735185849702,2864,5239,4789,3314,39852,764076,503172,2656,6420,3556,4581,8345,38.40572873934304,21.37886328318364,3764,1,536868,98550,1475,0,208,1631
10259,0,0,0,1,68,1,440,0,0,4804809,8243046,49.22397789695587,2183,4646,4406,2423,50676,700812,836892,3162,5825,3642,5385,8048,44.53088815642464,16.010000385993933,2663,1,596058,19200,1983,0,979,1419
10260,0,0,0,0,61,1,1768,1,0,5373905,10300265,58.008620049092706,3030,5297,4962,3365,45567,762189,560163,2726,6426,3396,4658,8358,39.96248240537617,18.416477016971058,3700,1,615795,68005,1597,0,304,1464
10261,0,0,1,0,64,0,600,0,0,411264,1318248,20.199009876724155,58,1882,1416,408,28944,697896,432954,2765,3639,3697,4239,5113,31.74901573277509,22.03908150076563,874,0,54672,101122,1008,1,2823,2223
10262,0,0,0,1,70,0,499,0,0,1022472,4530119,35.93048844644336,811,2563,2083,1291,55125,789525,859705,3029,4800,3989,4301,6072,28.142494558940577,21.914985572290853,1771,1,316295,49920,792,0,2218,2717
10263,0,0,0,1,68,0,396,0,0,544492,3296774,31.016124838541646,396,2094,1528,962,53312,815626,767648,2861,4389,3993,3993,5521,23.790754506740637,23.86881033313307,1528,1,215488,84900,566,0,2465,2861
10264,0,0,1,0,63,0,586,0,0,302280,1055340,18.16590212458495,60,1636,1246,330,29920,703560,434928,2808,3528,3588,4114,4834,30.265491900843113,20.096949035490134,720,0,44880,85410,916,1,2868,2282
10265,0,0,0,1,68,0,323,0,0,483000,2985500,29.58039891549808,280,2022,1427,875,50850,771112,767700,2817,4287,4007,3964,5434,23.49468024894146,24.45856763739386,1470,1,196875,80325,552,0,2537,2860
10266,0,0,0,1,67,0,237,0,0,391090,2565490,27.477263328068172,96,1932,1273,755,52650,795132,764550,2739,4153,4057,3916,5330,22.759613353482084,25.715582071767123,1414,1,169875,95555,518,0,2643,2880
10267,0,0,1,0,66,0,63,0,0,296578,1916217,24.020824298928627,175,1493,1091,577,34992,717336,538002,2919,3898,3723,3835,4814,22.67156809750927,20.525197985817506,979,1,93474,77184,514,0,2744,2807
10268,0,0,1,0,67,0,463,0,0,1482768,4938147,38.353617821530214,780,3170,2479,1471,55454,782181,798966,2666,4828,4048,4365,6527,31.74901573277509,26.731372991902578,2162,0,350098,86375,1008,0,1886,2349
10269,0,0,1,0,64,1,1365,0,0,1629450,2467125,27.65863337187866,298,3362,2895,765,54808,799800,712725,2758,3990,3692,5355,6587,46.151923036857305,21.61733839773163,1232,1,169065,74253,2130,0,2460,1095
10270,0,0,1,0,57,1,913,0,0,5448870,8164800,53.24471804789655,2740,4852,4757,2835,44655,659520,561600,2785,5715,2975,4802,7732,43.840620433565945,9.833118885374187,2930,0,552825,16435,1922,1,45,958
10271,0,0,1,0,57,1,922,0,0,5893320,8485208,54.147945482723536,2704,5170,4942,2932,44655,662726,564330,2666,5826,3122,4904,8064,44.83302354291979,15.285101559010016,3160,0,571740,39444,2010,1,38,884
10272,0,0,1,0,66,0,354,0,0,2490415,4660533,37.5632799419859,1291,3296,3176,1411,46398,690327,733266,3183,4714,3423,5068,6599,42.01190307520001,11.12174306341096,1531,0,313242,14400,1765,1,1892,1538
10273,0,0,0,1,70,0,466,0,0,1075680,4538592,36.0,876,2546,2126,1296,53799,794954,829974,3082,4798,3922,4332,6048,28.809720581775867,20.496253743168847,1716,1,307152,50400,830,0,2206,2672
10274,0,0,0,1,68,0,187,0,0,396390,2482000,27.018512172212592,81,1922,1273,730,52851,805800,758200,2751,4130,4049,3943,5322,23.302360395462088,25.496153512318614,1379,1,162790,97350,543,0,2670,2857
10275,0,0,1,0,66,0,71,0,0,331092,2042856,24.73863375370596,169,1596,1153,612,41810,754388,617530,2895,3950,3781,3879,4934,23.259406699226016,21.575641921109895,1055,1,113220,79740,541,0,2726,2797
10276,0,0,1,0,63,1,2257,0,0,470208,605568,13.856406460551018,415,3248,2641,192,53320,782192,678110,2547,3346,3761,5603,6402,49.48737212663449,24.721211180365824,799,0,41280,101976,2449,1,2962,705
10277,0,0,1,0,63,1,590,0,0,3564896,7045964,46.968074263269514,1996,4032,3822,2206,55304,792112,712262,2984,5400,3404,4810,7226,40.19950248448356,14.495400452462528,2416,1,491938,31080,1616,0,988,1578
10278,0,0,0,1,65,0,556,0,0,2387616,4257140,35.94440151122286,888,3544,3140,1292,48384,711720,738080,2891,4587,3699,5143,6839,42.988370520409354,20.23253793133618,1696,1,289408,50500,1848,0,2003,1447
10279,0,0,1,0,64,1,1372,0,0,1444860,2242674,26.419689627245813,206,3260,2768,698,54500,803250,700434,2721,3911,3705,5283,6473,45.4972526643093,22.1818976646657,1190,1,152164,79704,2070,0,2515,1143
10280,0,0,1,0,60,1,886,0,0,3281976,4327146,37.70941526992961,953,4199,3730,1422,46899,587299,739449,2574,4465,3512,5351,7242,48.041648597857254,21.917859106650187,1891,1,345546,31892,2308,0,1621,735
10281,0,0,0,1,68,1,697,0,0,4898388,8900982,50.882216932834204,2312,4758,4481,2589,49500,680724,859500,3161,6027,3715,5330,8196,43.497126341863094,16.788049508445038,2866,1,647250,17728,1892,0,849,1546
10282,0,0,0,1,68,1,563,0,0,5030618,8658052,50.41825066382212,2326,4737,4521,2542,53320,732290,844688,3190,5948,3622,5385,8143,44.48595283907045,14.847084957501849,2758,1,630416,19008,1979,0,864,1427
10283,0,0,1,0,64,1,2265,0,0,3012700,10393815,56.61271941887264,2632,4718,4145,3205,45770,745890,645357,2670,6448,3816,4183,7961,30.659419433511783,24.090219887171386,3778,1,637795,97983,940,0,38,2303
10284,0,0,1,0,64,1,2300,0,0,2148269,9789237,54.89080068645383,2567,4172,3726,3013,36863,627057,620559,2803,6262,3695,3962,7421,26.70205984563738,21.36913432715679,3459,1,575483,59764,713,0,236,2536
10285,0,0,0,1,68,0,252,0,0,564768,3026304,29.79932885150268,364,2048,1524,888,52614,807696,756576,2884,4296,3932,4044,5456,25.219040425836983,22.947196593057914,1412,1,197136,79124,636,0,2520,2772
10286,0,0,0,1,68,0,233,0,0,537734,2928331,29.30870177950569,322,2022,1485,859,51282,787479,756798,2872,4268,3946,4035,5431,25.019992006393608,23.212057032608545,1396,1,190698,77865,626,0,2550,2783
10287,0,0,1,0,66,0,5,0,0,360594,1993732,24.454038521274967,148,1651,1201,598,35550,750150,526772,2884,3932,3784,3937,4985,24.55605831561735,21.695266944172975,1048,1,94484,92700,603,0,2736,2731
10288,0,0,1,0,67,0,204,0,0,519580,2792120,28.809720581775867,172,2114,1456,830,40144,699712,649252,2706,4194,4022,3990,5478,25.019992006393608,26.078895966337225,1488,1,160190,99358,626,0,2534,2738
10289,0,0,1,0,63,1,1291,0,0,1550336,2413316,27.51363298439521,121,3441,2805,757,56643,755556,761932,2552,3945,3824,5236,6629,45.254833995939045,25.227281752496047,1393,1,180923,75048,2048,0,2431,1140
10290,0,0,0,1,68,1,714,0,0,4966600,8984318,51.12729212465687,2359,4769,4514,2614,50298,694274,855813,3182,6051,3692,5337,8206,43.58898943540674,16.126065707209307,2869,1,650886,17850,1900,0,823,1537
10291,0,0,0,1,67,1,537,0,0,5146848,8662329,50.52722038663912,2378,4744,4569,2553,53072,726102,841464,3218,5946,3568,5409,8137,44.8998886412873,13.331335488514162,2728,1,633144,15050,2016,0,840,1377
10292,0,0,1,0,64,1,561,0,0,3702400,7162275,47.16990566028302,2050,4064,3889,2225,56350,788655,740370,3044,5444,3394,4883,7283,40.792156108742276,13.337978041188823,2400,1,511750,24850,1664,0,994,1555
10293,0,0,1,0,61,1,947,0,0,3729930,7558340,49.61854492022111,2312,4127,3977,2462,56120,749080,706100,2920,5532,3220,4585,7197,38.92300091205713,12.514175867137965,2612,1,566260,20250,1515,0,608,1555
10294,0,0,0,1,70,0,447,0,0,1396054,5025224,37.76241517699841,1091,2740,2405,1426,47306,768232,764708,3189,4950,3859,4503,6264,31.28897569432403,18.342062884023168,1761,1,309442,45560,979,0,2098,2545
10295,0,0,0,1,68,0,268,0,0,652805,3253542,30.870698080866262,486,2105,1638,953,54520,792048,802290,2947,4367,3881,4099,5519,26.1725046566048,21.662411126940235,1420,1,223955,59776,685,0,2461,2729
10296,0,0,0,1,68,0,189,0,0,542376,2853333,28.930952282978865,312,2010,1485,837,51528,770434,777252,2884,4246,3934,4057,5419,25.45584412271571,22.92915472618891,1362,1,190836,69300,648,0,2572,2761
10297,0,0,0,1,67,0,90,0,0,454951,2446353,26.851443164195103,126,1947,1352,721,53562,804141,766818,2798,4114,3988,4024,5340,25.11971337416094,24.406115200624097,1316,1,162946,86870,631,0,2672,2762
10298,0,0,0,1,70,0,444,0,0,1556005,5251703,38.58756276314948,1166,2857,2534,1489,47300,775940,758305,3204,5016,3850,4572,6384,32.32645975048923,18.021779711427715,1812,1,320135,45543,1045,0,2038,2482
10299,0,0,0,1,70,0,424,0,0,1368777,4938525,37.429934544425805,1100,2679,2378,1401,49268,796650,768450,3224,4926,3826,4502,6204,31.25699921617557,17.398167068783604,1702,1,305418,43043,977,0,2124,2548
10300,0,0,0,1,68,0,209,0,0,625086,3077624,30.033314835362415,432,2065,1595,902,50429,815468,719932,2942,4314,3882,4105,5477,26.324893162176366,21.72061022665624,1372,1,190322,78490,693,0,2510,2719
10301,0,0,0,1,67,0,70,0,0,483191,2480283,27.03701166919155,158,1965,1392,731,52899,776997,783783,2820,4124,3966,4054,5358,25.709920264364882,23.944705759233695,1304,1,168861,75063,661,0,2662,2732
10302,0,0,1,0,59,1,668,0,0,4750469,5581193,43.255057507764334,1709,4572,4410,1871,53105,641345,736801,2821,4854,3145,5522,7555,50.38849074937649,12.917631945094628,2033,1,462137,14580,2539,0,1112,444
10303,0,0,1,0,63,1,780,0,0,3526624,7325592,48.041648597857254,2218,3926,3836,2308,55932,752238,749064,3084,5482,3264,4702,7100,39.08964057138413,9.505517133991825,2398,1,544688,11790,1528,0,866,1646
10304,0,0,1,0,59,1,1352,0,0,6930548,10090362,58.25804665451803,3286,5544,5436,3394,42624,660006,570816,2865,6367,3081,5015,8517,45.18849411078001,10.406531168715494,3502,0,651648,18144,2042,1,421,931
10305,0,0,0,1,66,0,496,0,0,2914121,4891824,38.43175770115127,1117,3810,3450,1477,42586,708768,659088,2952,4789,3672,5285,7122,44.41846462902562,18.9868649392261,1837,1,293923,54720,1973,0,1835,1339
10306,0,0,0,1,67,0,101,0,0,554712,2708206,28.231188426986208,286,2004,1493,797,52440,774744,781540,2887,4195,3909,4094,5402,26.38181191654584,22.616749338363483,1308,1,183310,66941,696,0,2601,2702
10307,0,0,1,0,66,1,354,0,0,4681912,7823536,48.45616575834287,2092,4598,4342,2348,52800,733040,799680,3076,5680,3588,5326,7930,44.654227123532216,16.138808182068317,2604,1,563520,27392,1994,0,984,1338
10308,0,0,0,1,70,0,424,0,0,1692180,5419260,39.11521443121589,1247,2919,2636,1530,51750,814660,796950,3259,5072,3825,4648,6461,33.25657829663178,16.94729252812277,1813,1,344250,39620,1106,0,2012,2436
10309,0,0,0,1,68,0,58,0,0,563160,2652000,27.92848008753788,271,2011,1502,780,48825,765000,737800,2891,4180,3909,4122,5411,26.870057685088806,22.56279152857298,1289,1,169260,73296,722,0,2620,2678
10310,0,0,1,0,63,0,466,0,0,116280,570600,13.416407864998739,38,1044,826,180,36192,735440,494520,2952,3350,3388,3816,4214,25.41653005427767,15.073166625245115,398,0,28080,46652,646,1,2990,2524
10311,0,0,1,0,65,0,452,0,0,405900,1481400,21.213203435596427,34,1836,1352,450,38801,793372,530012,2808,3742,3776,4194,5128,30.033314835362415,22.770801523799292,934,0,72450,105028,902,1,2842,2390
10312,0,0,0,1,68,0,256,0,0,930345,3773127,33.18132004607411,804,2243,1946,1101,53586,801918,784783,3130,4528,3724,4272,5670,29.068883707497267,17.28663384116569,1398,1,252129,40986,845,0,2326,2582
10313,0,0,0,1,68,0,87,0,0,643720,2884035,29.103264421710495,401,2053,1607,847,50400,766125,762720,2959,4252,3851,4165,5458,27.568097504180443,21.120410580967924,1293,1,189728,61102,760,0,2558,2645
10314,0,0,0,1,68,0,40,0,0,595584,2695968,28.142494558940577,308,2028,1544,792,45732,755688,701224,2920,4196,3888,4156,5432,27.422618401604176,22.000586941199153,1276,1,163152,74536,752,0,2612,2652
10315,0,0,1,0,62,1,1192,0,0,1381908,2272134,26.870057685088806,9,3367,2636,722,55328,777309,704928,2416,3869,3878,5061,6514,43.749285708454714,27.178031234126028,1453,1,161728,112574,1914,0,2425,1233
10316,0,0,1,0,62,1,1106,0,0,3361416,7712500,49.678969393496885,2468,3830,3830,2468,54740,718750,743750,3125,5593,3125,4487,6955,36.90528417449187,0.0,2468,0,587384,0,1362,1,657,1763
10317,0,0,1,0,59,1,1279,0,0,6306912,9586377,56.84188596448925,2823,5591,5183,3231,36676,629004,513291,2559,6198,3375,4919,8558,44.181444068749045,20.244992766201662,3639,1,558963,72216,1952,0,264,1015
10318,0,0,0,1,68,0,189,0,0,856900,3509600,32.01562118716424,702,2184,1861,1025,51736,763552,794368,3101,4449,3747,4260,5608,28.91366458960192,17.979474520935437,1348,1,237800,40052,836,0,2399,2588
10319,0,0,0,1,68,0,172,0,0,822525,3406749,31.575306807693888,662,2157,1822,997,51513,761991,789327,3082,4414,3752,4242,5574,28.722813232690143,18.319292668959594,1332,1,230307,41875,825,0,2420,2592
10320,0,0,0,1,68,0,23,0,0,629510,2745050,28.372521918222215,348,2044,1587,805,47652,777480,712690,2953,4215,3867,4192,5454,27.964262908219126,21.37755832643195,1262,1,168245,71749,782,0,2605,2628
10321,0,0,1,0,66,0,170,0,0,495456,2076672,24.979991993593593,216,1826,1418,624,46127,642304,795392,2920,3952,3736,4122,5154,28.178005607210743,20.489979379042996,1032,1,149136,29784,794,0,2704,2534
10322,0,0,1,0,63,1,1041,0,0,3398220,7712376,49.35585071701227,2406,3861,3831,2436,51984,721848,721848,3136,5602,3196,4561,7027,37.3496987939662,5.478746393072713,2466,0,555408,4050,1395,1,730,1771
10323,0,0,1,0,58,1,1348,0,0,4416573,8383710,53.67494760127857,2851,4444,4414,2881,50140,669300,634380,2880,5791,2940,4443,7354,39.153543900903784,5.477225575051661,2911,0,628058,4470,1533,0,29,1377
10324,0,0,0,1,70,0,341,0,0,1494920,4962460,37.48332962798263,1255,2619,2469,1405,49235,759380,808828,3382,4937,3682,4596,6151,32.61901286060018,12.449381359612769,1555,1,321745,17700,1064,0,2127,2468
10325,0,0,0,1,68,0,53,0,0,714168,2975264,29.5296461204668,470,2093,1691,872,49248,777936,736992,3010,4284,3814,4231,5505,28.61817604250837,20.05006172293723,1274,1,188352,59898,819,0,2540,2593
10326,0,0,0,1,68,0,43,0,0,621270,2613936,27.694764848252458,309,2035,1577,767,48530,719088,783840,2950,4175,3866,4218,5443,28.460498941515414,21.46696931432114,1225,1,176410,50838,810,0,2641,2598
10327,0,0,1,0,65,0,441,0,0,411742,1492164,21.400934559032695,173,1642,1357,458,34350,746082,488700,2973,3716,3543,4157,4900,29.9833287011299,17.000407068627272,743,1,68700,61560,899,0,2800,2359
10328,0,0,0,1,70,0,354,0,0,1719000,5313000,38.72983346207417,1350,2796,2646,1500,52437,804034,818202,3392,5042,3692,4688,6338,33.85262175962151,12.561867176898298,1650,1,346500,19350,1146,0,2042,2396
10329,0,0,0,1,68,0,260,0,0,1221869,4287107,35.25620512760839,1093,2376,2226,1243,49848,693249,855352,3299,4692,3599,4432,5825,31.352830813181765,12.282138241571156,1393,1,308264,10650,983,0,2206,2466
10330,0,0,0,1,68,0,138,0,0,899640,3488400,31.937438845342623,737,2185,1902,1020,51744,790020,766080,3137,4440,3703,4302,5605,29.698484809834994,16.82265635323201,1303,1,228480,40469,882,0,2400,2538
10331,0,0,1,0,64,0,510,0,0,441919,1479309,21.37755832643195,372,1509,1424,457,49434,692718,747747,3152,3694,3322,4204,4746,31.096623610932426,9.239893968762086,542,1,105567,9605,967,0,2780,2270
10332,0,0,1,0,64,0,629,0,0,442050,1356883,20.518284528683193,391,1501,1471,421,50095,750959,692945,3193,3644,3253,4273,4724,32.4037034920393,5.514871952411144,451,1,90515,4650,1050,0,2802,2173
10333,0,0,1,0,61,1,2187,0,0,5729050,11540050,61.032778078668514,3430,5558,5263,3725,41347,740422,535954,2803,6823,3393,4636,8656,39.21734310225516,17.176008088112784,4020,0,644425,60475,1538,1,627,1560
10334,0,0,0,1,66,1,2335,0,0,2449200,10374000,55.85696017507576,2427,4598,3905,3120,40136,771400,575225,2632,6445,4018,4110,7923,28.0178514522438,26.73032588332722,3813,1,539760,137214,785,0,205,2540
10335,0,0,0,1,68,0,246,0,0,1264032,4325046,35.41186241925155,1127,2389,2262,1254,50470,710494,845005,3322,4703,3576,4457,5838,31.74901573277509,11.290504321766129,1381,1,307230,10414,1008,0,2195,2441
10336,0,0,0,1,68,0,189,0,0,1088326,3918202,33.793490497431605,941,2296,2095,1142,51212,809716,744527,3230,4573,3632,4384,5727,30.870698080866262,14.18060408792329,1343,1,247814,31356,953,0,2289,2478
10337,0,0,0,1,68,0,121,0,0,653250,2559750,27.386127875258307,102,2269,1621,750,47740,750860,740621,2765,4163,4061,4284,5682,29.512709126747414,26.11722092393526,1398,1,162750,90072,871,0,2663,2542
10338,0,0,0,1,67,0,515,0,0,1962894,3957297,34.161381705077446,825,3191,2849,1167,34354,603598,654463,3049,4558,3733,5073,6582,41.012193308819754,18.53613812444298,1509,1,225231,37962,1682,0,2224,1709
10339,0,0,0,1,71,0,344,0,0,1938825,5599125,39.68626966596886,1413,2968,2806,1575,49056,796320,778545,3393,5130,3717,4786,6523,35.08560958569767,13.170380740752039,1737,1,344925,23004,1231,0,1980,2324
10340,0,0,1,0,65,1,832,0,0,4291713,8290062,50.28916384272063,2529,4226,4226,2529,46872,708048,711326,3278,5807,3278,4975,7504,41.19465984809196,0.0,2529,1,548793,0,1697,0,749,1581
10341,0,0,1,0,63,1,1303,0,0,3237030,8115660,50.6458290484024,2415,3977,3827,2565,49946,699244,715064,3014,5729,3314,4426,7141,35.52463933666322,12.261034368426225,2715,0,579690,19350,1262,1,599,1902
10342,0,0,1,0,61,1,1459,0,0,7277060,10751724,59.36328831862332,3241,5872,5589,3524,33120,631557,488160,2768,6575,3334,5116,8923,45.44227107000705,16.94729252812277,3807,1,563840,51789,2065,0,473,986
10343,0,0,0,1,68,0,96,0,0,775620,2842272,28.879058156387302,473,2125,1764,834,53118,773616,797472,3047,4242,3769,4338,5533,30.495901363953813,19.143040513129645,1195,1,195156,45125,930,0,2574,2478
10344,0,0,1,0,68,0,191,0,0,693962,2538088,27.258026340878022,136,2284,1677,743,36000,819840,512400,2809,4159,4023,4350,5700,30.56141357987225,25.39605655732377,1350,1,111450,136575,934,0,2673,2482
10345,0,0,1,0,59,1,652,0,0,3541824,4720320,39.7994974842648,1434,3970,3820,1584,54934,721160,676460,2830,4564,3130,5216,6950,47.286361670147556,12.291303419254204,1734,0,359568,22200,2236,1,1396,744
10346,0,0,1,0,63,1,1391,0,0,3170112,8235513,51.05878964487897,2427,4003,3823,2607,48396,688662,701298,2979,5766,3339,4375,7162,34.87119154832539,13.428916482288244,2787,0,578754,23400,1216,1,552,1943
10347,0,0,0,1,71,0,326,0,0,2102112,5785674,40.27406113120453,1442,3098,2918,1622,45126,777606,738369,3387,5189,3747,4863,6665,36.0,13.950540266179848,1802,1,335754,26640,1296,0,1945,2271
10348,0,0,0,1,68,0,188,0,0,1353053,4340362,35.510561809129406,1176,2419,2334,1261,54731,822638,788218,3357,4703,3527,4515,5861,32.7566787083184,9.224644470006377,1346,1,288769,12155,1073,0,2181,2369
10349,0,0,0,1,68,0,159,0,0,1264936,4142424,34.741905532080416,1099,2363,2255,1207,51528,782496,775632,3324,4639,3540,4480,5795,32.37282811247729,10.410300245868545,1315,1,272782,14688,1048,0,2225,2384
10350,0,0,0,1,68,0,22,0,0,976023,3415581,31.606961258558215,757,2218,1976,999,52377,810303,755599,3177,4418,3661,4396,5637,31.25699921617557,15.701012843427549,1241,1,220779,36784,977,0,2420,2442
10351,0,0,1,0,66,0,255,0,0,705394,2411480,26.870057685088806,409,2012,1699,722,42320,614560,768200,3027,4062,3653,4317,5352,31.25699921617557,18.02404300576254,1035,1,166060,23475,977,0,2618,2363
10352,0,0,1,0,67,0,274,0,0,686831,2368407,26.514147167125703,179,2204,1680,703,31088,781608,451446,2845,4072,3893,4346,5573,31.25699921617557,23.425772117206183,1227,1,94202,121044,977,0,2666,2392
10353,0,0,1,0,61,1,777,0,0,2067678,3360252,33.18132004607411,621,3459,2979,1101,55176,695856,738584,2572,4153,3532,4930,6511,43.3358973600409,22.005632697413855,1581,0,266442,54240,1878,1,1951,1174
10354,0,0,1,0,65,1,1070,0,0,3895800,8400480,50.79370039680118,2446,4224,4090,2580,40492,621896,690272,3122,5836,3390,4766,7480,38.8587184554509,11.577287155571419,2714,1,546960,14338,1510,0,676,1746
10355,0,0,1,0,64,1,1327,0,0,3379838,8401162,51.16639522186413,2408,4119,3909,2618,46004,696353,680308,2999,5827,3419,4500,7328,35.93048844644336,14.492116045569249,2828,0,555016,29400,1291,1,591,1918
10356,0,0,0,1,71,0,311,0,0,2272560,5973825,40.87786687193939,1453,3249,3031,1671,49296,847275,743600,3357,5246,3793,4935,6824,36.87817782917155,15.261454732415379,1889,1,347568,36624,1360,0,1904,2215
10357,0,0,0,1,71,0,295,0,0,2134736,5765888,40.19950248448356,1454,3099,2937,1616,53846,777824,881296,3406,5184,3730,4889,6667,36.345563690772494,13.36109675744256,1778,1,399152,15066,1321,0,1952,2247
10358,0,0,0,1,68,0,101,0,0,1280006,4063605,34.39476704383968,1098,2350,2265,1183,53105,848445,738525,3350,4618,3520,4517,5785,32.89376840679705,9.412769291411893,1268,1,254345,14280,1082,0,2252,2353
10359,0,0,0,1,68,0,86,0,0,1241376,3978888,34.02939905434711,1050,2338,2230,1158,54755,807460,800588,3328,4594,3544,4508,5774,32.7414110874898,10.539713118296461,1266,1,269814,14472,1072,0,2278,2364
10360,0,0,0,1,68,0,34,0,0,1133936,3705850,32.89376840679705,920,2292,2130,1082,50112,794600,739800,3263,4507,3587,4473,5717,32.37282811247729,13.05562736842334,1244,1,233712,24786,1048,0,2343,2377
10361,0,0,0,1,68,0,23,0,0,1039248,3446352,31.74901573277509,807,2240,2039,1008,49220,786370,731666,3218,4427,3620,4450,5659,32.109188716004645,14.600386728658112,1209,1,215712,30753,1031,0,2411,2388
10362,0,0,1,0,65,0,267,0,0,2097748,5165764,39.84971769034255,1288,3209,2909,1588,56643,770961,777467,2953,4841,3553,4574,6462,36.345563690772494,17.50838755398781,1888,1,379532,37200,1321,0,1665,1932
10363,0,0,1,0,64,0,291,0,0,2305980,5409027,40.87786687193939,1437,3285,3051,1671,56635,760695,780117,3003,4908,3471,4617,6522,37.14835124201342,15.449058775108385,1905,1,402711,27846,1380,0,1566,1857
10364,0,0,1,0,60,1,722,0,0,2140728,3483840,33.85262175962151,756,3404,3014,1146,48600,684000,656640,2650,4186,3430,4908,6444,43.22036556994862,19.835609259888148,1536,0,247536,56940,1868,1,1894,1172
10365,0,0,1,0,64,1,1272,0,0,3611520,8550960,51.38093031466052,2412,4236,4008,2640,42074,625127,706102,3011,5879,3467,4607,7475,36.98648401781386,15.099959329782587,2868,1,575520,23484,1368,0,599,1871
10366,0,0,1,0,62,1,1746,0,0,3110895,8869602,53.301031884945715,2594,4183,3936,2841,40352,605668,649376,2875,5963,3369,4217,7305,33.090784215548595,15.747311567024632,3088,1,590928,28652,1095,0,281,2027
10367,0,0,1,0,63,1,2316,0,0,5197285,11828560,60.95079983068311,3249,5580,5114,3715,40832,738688,560384,2718,6899,3650,4583,8764,37.403208418530085,21.675949426424932,4181,0,653840,91336,1399,1,531,1785
10368,0,0,0,1,68,0,3,0,0,1150254,3678450,32.77193921634788,924,2295,2145,1074,54587,845975,756925,3275,4499,3575,4496,5720,32.72613634390714,12.9849534146292,1224,1,237354,23850,1071,0,2351,2354
10369,0,0,1,0,63,0,1058,0,0,2651103,3758391,34.39476704383968,927,3680,3424,1183,53724,705294,768834,2921,4360,3433,5418,6857,47.3392015141785,16.029459553337965,1439,0,286286,27648,2241,1,1994,936
10370,0,0,1,0,60,1,718,0,0,2070408,3416960,33.52610922848042,762,3328,2966,1124,50838,674880,696160,2678,4164,3402,4882,6368,42.91852746774987,19.123695683739186,1486,0,257396,45612,1842,1,1916,1198
10371,0,0,1,0,64,1,1383,0,0,3448170,8633790,51.70106381884226,2403,4233,3963,2673,43452,658920,687990,2960,5903,3500,4520,7463,35.91656999213594,16.43730883454241,2943,0,569349,33210,1290,1,557,1940
10372,0,0,1,0,60,1,1828,0,0,3391740,8936730,54.49770637375485,2788,4294,4112,2970,40504,499494,734196,2827,5979,3191,4151,7303,33.793490497431605,13.719448665121039,3152,1,724680,4914,1142,0,39,1867
10373,0,0,1,0,67,0,212,0,0,945248,2936896,29.5296461204668,654,2174,1956,872,56376,781376,818424,3150,4240,3586,4452,5542,32.92415526630866,15.162381191036106,1090,1,211896,23544,1084,0,2496,2284
10374,0,0,1,0,67,0,256,0,0,909060,2797236,28.879058156387302,624,2134,1924,834,55000,737880,838500,3144,4188,3564,4444,5488,33.015148038438355,14.910611547535398,1044,1,208500,18270,1090,0,2520,2264
10375,0,0,1,0,59,1,666,0,0,2562336,3900792,36.08323710533743,1047,3525,3270,1302,53312,671104,713048,2741,4298,3251,4964,6521,44.36214602563767,16.0273953799475,1557,0,309876,29325,1968,1,1694,1028
10376,0,0,0,1,71,0,293,0,0,2585148,6279726,41.96427051671457,1452,3538,3229,1761,50344,827312,773822,3257,5327,3875,5034,7104,38.31448812133603,17.818695391551277,2070,1,382137,46968,1468,0,1805,2098
10377,0,0,1,0,67,0,176,0,0,1036740,3148514,30.56141357987225,744,2234,2044,934,54466,761846,812411,3181,4305,3561,4481,5605,33.31666249791537,14.03521675058493,1124,1,225094,17670,1110,0,2437,2261
10378,0,0,1,0,67,0,198,0,0,1016368,3077438,30.23243291566195,713,2227,2026,914,56404,794612,804713,3166,4281,3568,4479,5594,33.34666400106613,14.37539151437394,1115,1,218446,22914,1112,0,2453,2255
10379,0,0,1,0,66,0,328,0,0,917888,2685792,28.42534080710379,655,2097,1944,808,55552,744576,824352,3171,4132,3477,4460,5421,33.704599092705436,12.60665128010484,961,1,200384,14229,1136,0,2516,2188
10380,0,0,1,0,67,0,364,0,0,888476,2617192,27.892651361962706,297,2401,1920,778,29430,733352,454140,2883,4142,3845,4506,5765,33.793490497431605,22.446518810142177,1259,1,105030,104858,1142,0,2586,2222
10381,0,0,1,0,64,1,2333,0,0,4619748,11710104,60.09991680526688,2951,5552,4891,3612,38872,732692,557624,2581,6854,3903,4521,8794,35.76310948449533,25.71838952919529,4273,0,621264,127573,1279,1,370,1963
10382,0,0,0,1,71,0,266,0,0,2494536,6136696,41.44876355212541,1441,3447,3170,1718,48124,810844,757264,3295,5290,3849,5024,7019,38.1051177665153,16.97189250944288,1995,1,364216,42381,1452,0,1854,2120
10383,0,0,0,1,71,0,257,0,0,2424894,6031797,41.12177038990418,1436,3380,3125,1691,48180,784740,781173,3312,5258,3822,5001,6947,37.86819245752297,16.294791930224218,1946,1,370329,34680,1434,0,1876,2133
10384,0,0,0,1,71,0,239,0,0,2288526,5837542,40.45985664828782,1421,3251,3035,1637,45980,784520,745294,3350,5203,3782,4964,6817,37.389838191679836,15.099741486923206,1853,1,342133,31752,1398,0,1929,2168
10385,0,0,1,0,61,1,1403,0,0,163188,334692,10.392304845413264,335,2062,1619,108,55632,756156,706572,2656,3207,3542,4610,5161,38.87158345115362,21.05359536021371,551,0,24624,65564,1511,1,2991,1588
10386,0,0,1,0,66,0,273,0,0,1070260,3018496,30.116440692751194,787,2207,2087,907,55029,735488,828672,3208,4235,3448,4508,5535,34.351128074635334,11.15593165433301,1027,1,225843,10080,1180,0,2421,2148
10387,0,0,0,1,69,0,133,0,0,1219920,3611920,32.2490309931942,347,2906,2213,1040,53436,847412,760587,2780,4513,4166,4646,6379,34.249087579087416,26.831185115132605,1733,1,227760,110880,1173,0,2433,2300
10388,0,0,1,0,63,0,1301,0,0,2743470,3598123,33.60059523282288,705,3983,3559,1129,43848,688392,646961,2763,4316,3611,5617,7170,49.29503017546495,20.626248397933796,1553,0,229187,64024,2430,1,2058,757
10389,0,0,1,0,64,1,1752,0,0,2984593,9071925,53.03772242470448,2405,4282,3874,2813,47488,683700,722400,2817,6038,3633,4286,7507,32.57299494980466,20.207771106230066,3221,0,630112,48960,1061,1,412,2164
10390,0,0,1,0,64,1,2330,0,0,5522904,12189784,61.54673021371647,3314,5720,5246,3788,37620,707960,550278,2744,7006,3692,4676,8938,38.18376618407357,21.77154105707724,4262,0,647748,89586,1458,1,570,1760
10391,0,0,0,1,66,0,16,0,0,1493220,4060830,34.84250278036869,1214,2444,2444,1214,53900,819525,735900,3345,4559,3345,4575,5789,35.07135583350036,0.0,1214,1,267080,0,1230,0,2131,2115
10392,0,0,1,0,66,0,159,0,0,1249200,3476940,32.264531609803356,951,2331,2241,1041,53535,831660,718100,3250,4381,3430,4540,5671,34.64101615137755,9.613403705477898,1131,1,223815,13860,1200,0,2299,2140
10393,0,0,1,0,66,0,297,0,0,1111108,3034708,30.265491900843113,826,2219,2129,916,56619,771929,805059,3223,4229,3403,4526,5532,34.828149534535996,9.580310602724222,1006,1,222588,9900,1213,0,2397,2100
10394,0,0,1,0,60,1,666,0,0,2041200,3408804,33.67491648096547,972,3096,2934,1134,55209,694386,718434,2844,4140,3168,4806,6102,42.42640687119285,12.767025201137244,1296,0,271026,19602,1800,1,1872,1206
10395,0,0,0,1,71,0,234,0,0,2679192,6290124,41.92851058647326,1416,3624,3282,1758,48070,822940,747802,3236,5336,3920,5102,7202,39.03844259188627,18.77244248942647,2100,1,367422,54378,1524,0,1820,2054
10396,0,0,1,0,66,0,223,0,0,1240848,3357648,31.74901573277509,913,2334,2239,1008,56862,809433,779454,3236,4339,3426,4562,5665,35.08560958569767,9.85304212894363,1103,1,235872,12730,1231,0,2323,2100
10397,0,0,1,0,66,0,282,0,0,1185723,3165756,30.93541659651604,897,2256,2196,957,56069,750916,817076,3248,4265,3368,4547,5564,35.199431813596085,7.83531632499182,1017,1,236379,5940,1239,0,2351,2069
10398,0,0,1,0,65,0,321,0,0,1156896,3058173,30.44667469527666,867,2235,2175,927,56608,765368,804956,3239,4226,3359,4547,5534,35.32704346531139,7.754559014766193,987,1,226188,6540,1248,0,2372,2051
10399,0,0,0,1,61,1,1996,0,0,5279021,10841785,59.18614702783076,3057,5456,5010,3503,30380,606620,479725,2649,6598,3541,4602,8551,38.82009788756334,21.172256159623927,3949,1,542965,78050,1507,0,408,1588
10400,0,0,0,1,71,0,165,0,0,2344816,5775584,40.19950248448356,1339,3344,3067,1616,47736,729096,836316,3297,5190,3851,5025,6918,38.09199390948182,17.643027078777994,1893,1,378144,26592,1451,0,1958,2123
10401,0,0,1,0,64,0,1381,0,0,2895942,3669492,33.85262175962151,622,4197,3673,1146,48990,736460,682026,2678,4348,3726,5729,7399,50.269274910227224,22.936948401312673,1670,0,244098,81220,2527,1,2056,675
10402,0,0,0,1,63,1,1957,0,0,6459990,11679810,60.844062980705026,3150,5999,5447,3702,36784,659395,555280,2603,6857,3707,4900,9154,41.773197148410844,23.741289494079258,4254,1,651552,93840,1745,0,547,1410
10403,0,0,1,0,64,1,2328,0,0,6462720,12759120,62.928530890209096,3654,5898,5592,3960,40112,702396,592848,2916,7182,3528,4854,9120,40.39801975344831,17.507968316931443,4266,0,728640,52938,1632,1,738,1590
10404,0,0,0,1,71,0,195,0,0,2668626,6209454,41.641325627314025,1372,3635,3273,1734,49932,816468,784239,3219,5315,3943,5120,7216,39.230090491866065,19.647014564874116,2096,1,379746,52852,1539,0,1847,2042
10405,0,0,1,0,66,0,253,0,0,1344720,3441360,32.2490309931942,998,2375,2333,1040,56882,787542,790851,3267,4349,3351,4602,5684,35.958309192730404,6.678188844436455,1082,1,248560,5166,1293,0,2269,2016
10406,0,0,1,0,65,0,291,0,0,1309392,3321360,31.74901573277509,1008,2307,2307,1008,56334,754555,810570,3295,4303,3295,4594,5602,36.0416425818802,0.0,1008,1,247968,0,1299,0,2287,1996
10407,0,0,1,0,63,0,848,0,0,3205824,4529784,37.62977544445356,942,4154,3680,1416,47508,710178,684586,2725,4615,3673,5463,7353,47.58150901348127,21.78917998855659,1890,0,303024,68256,2264,1,1783,935
10408,0,0,0,1,71,0,184,0,0,2737185,6270165,41.82104733265297,1359,3704,3314,1749,50621,813795,799455,3195,5334,3975,5150,7289,39.56008088970496,20.33950688248161,2139,1,390027,54600,1565,0,1836,2020
10409,0,0,0,1,66,0,85,0,0,1673924,4176672,35.38361202590826,1222,2619,2589,1252,47460,700560,753936,3306,4588,3366,4673,5955,36.565010597564445,5.490867587491313,1282,1,282952,3420,1337,0,2084,1999
10410,0,0,1,0,66,0,239,0,0,1429322,3574928,32.89376840679705,1052,2433,2403,1082,56133,802872,763224,3274,4386,3334,4625,5737,36.345563690772494,5.478746393072713,1112,1,249942,4230,1321,0,2222,1983
10411,0,0,0,1,68,0,461,0,0,1279740,3143448,30.397368307141328,522,2711,2309,924,35442,673596,608958,3000,4326,3804,4787,6113,37.21558813185679,20.891807942855518,1326,1,165396,61908,1385,0,2478,2017
10412,0,0,1,0,64,0,234,0,0,3379275,6268800,44.26059195266146,1892,3751,3684,1959,40182,710400,579200,3133,5159,3267,4925,6951,41.53311931459037,8.187175587434018,2026,0,354579,12060,1725,1,1241,1475
10413,0,0,1,0,59,1,2305,0,0,3088046,9713190,57.043842787806646,3224,4233,4203,3254,49280,656700,668640,2955,6239,3015,3934,7218,30.805843601498726,5.531194905403055,3284,0,728896,3900,949,0,269,2036
10414,0,0,0,1,66,0,109,0,0,1706586,4176249,35.397740040855716,1211,2657,2615,1253,43581,663267,729927,3291,4586,3375,4695,5990,36.90528417449187,6.553889165207866,1295,1,274407,4536,1362,0,2080,1971
10415,0,0,1,0,68,0,491,0,0,1349886,3211278,30.692018506445613,576,2741,2375,942,29704,640892,538622,3043,4351,3775,4842,6150,37.8549864614954,20.026571997750292,1308,1,148836,59292,1433,0,2467,1976
10416,0,0,0,1,68,0,429,0,0,1352296,3302816,31.11269837220809,498,2835,2365,968,39879,719932,644868,2942,4380,3882,4809,6247,37.376463182061514,22.45818122510278,1438,1,182952,74730,1397,0,2444,2015
10417,0,0,1,0,64,0,78,0,0,3578143,5992602,43.04648650006177,1598,4039,3784,1853,36816,672672,572418,2979,5087,3489,5165,7273,43.94314508543966,16.1852938789691,2108,1,327981,42840,1931,0,1381,1303
10418,0,0,1,0,59,1,2345,0,0,3172800,9875340,57.48912940721924,3275,4295,4265,3305,45675,672300,606564,2958,6293,3018,3948,7283,30.983866769659336,5.514871952411144,3335,0,670915,4830,960,0,317,2028
10419,0,0,1,0,60,1,2282,0,0,3837408,10234224,58.378078077305695,3341,4601,4534,3408,39776,678678,528528,2936,6411,3070,4129,7604,33.555923471125034,8.18535277187245,3475,0,599808,12663,1126,1,405,1877
10420,0,0,0,1,66,0,132,0,0,1743328,4191272,35.4400902933387,1196,2704,2644,1256,45540,690759,734140,3277,4593,3397,4725,6041,37.255872020394314,7.83531632499182,1316,1,276320,7080,1388,0,2081,1949
10421,0,0,0,1,66,0,181,0,0,1657200,3986400,34.64101615137755,1133,2648,2581,1200,52140,730840,787314,3255,4522,3389,4703,5970,37.16180835212409,8.18535277187245,1267,1,284400,7504,1381,0,2122,1941
10422,0,0,0,1,68,0,459,0,0,1417486,3363826,31.352830813181765,550,2858,2425,983,40572,708354,670712,2989,4405,3855,4864,6280,37.97367509209505,21.68139689687292,1416,1,192668,63218,1442,0,2439,1980
10423,0,0,0,1,63,1,2145,0,0,5901424,11881136,61.05735008989499,3240,5799,5311,3728,33495,646961,525855,2699,6915,3675,4770,8986,39.786932528155525,22.237668554433014,4216,1,615120,84912,1583,0,541,1604
10424,0,0,0,1,71,0,175,0,0,3091704,6649104,42.988370520409354,1506,3863,3521,1848,43056,744786,748384,3256,5446,3940,5271,7461,40.90232267243512,18.63860152714558,2190,1,384384,45486,1673,0,1750,1925
10425,0,0,0,1,66,0,187,0,0,1727064,4061232,34.9857113690718,1129,2730,2635,1224,53058,736596,793002,3223,4542,3413,4729,6048,37.5632799419859,9.753537202071987,1319,1,292536,10545,1411,0,2094,1907
10426,0,0,0,1,68,0,398,0,0,1505448,3584052,32.31098884280702,493,3037,2486,1044,41013,744961,648837,2882,4477,3984,4875,6470,37.97367509209505,24.239465750153663,1595,1,197316,91466,1442,0,2389,1991
10427,0,0,1,0,64,0,149,0,0,3048206,5863196,42.68489194082609,1822,3495,3495,1822,44325,633946,724050,3218,5040,3218,4891,6713,40.90232267243512,0.0,1822,0,409950,0,1673,1,1396,1545
10428,0,0,1,0,65,0,372,0,0,3640293,5634405,41.60528812542944,1329,4236,3834,1731,34905,582645,634725,2853,4986,3657,5358,7491,45.858477951192405,20.23603846453246,2133,1,337545,44622,2103,0,1524,1152
10429,0,0,1,0,59,1,579,0,0,2081502,3518814,34.38022687534217,1182,2943,2943,1182,48124,675779,631124,2977,4159,2977,4738,5920,41.96427051671457,0.0,1182,0,250584,0,1761,1,1795,1216
10430,0,0,0,1,64,1,2154,0,0,6282055,12191220,61.68468205316454,3289,5972,5456,3805,39104,666432,602352,2688,7009,3720,4855,9176,40.63249930782009,22.847591819681195,4321,1,715340,80496,1651,0,601,1553
10431,0,0,0,1,72,0,166,0,0,3165072,6725312,43.174066289845804,1551,3875,3562,1864,44290,775720,743248,3295,5472,3921,5306,7483,41.20679555607303,17.915125167392006,2177,1,383984,45385,1698,0,1744,1910
10432,0,0,0,1,72,0,157,0,0,3093198,6631434,42.883563284783136,1533,3827,3521,1839,43260,757260,742836,3300,5445,3912,5288,7433,41.012193308819754,17.71109711354345,2145,1,378834,42534,1682,0,1767,1924
10433,0,0,0,1,66,0,437,0,0,1574060,3518425,32.48076353782343,875,2727,2547,1055,25230,580290,483575,3155,4390,3515,4827,6062,38.62641583165593,13.740794290386374,1235,1,152975,28260,1492,0,2280,1843
10434,0,0,0,1,68,0,414,0,0,1570051,3655657,32.60368077380221,522,3081,2540,1063,43600,749702,687800,2898,4502,3980,4916,6520,38.43175770115127,24.06760300607744,1604,1,212600,83855,1477,0,2376,1962
10435,0,0,0,1,69,0,289,0,0,1665222,4006688,33.97057550292606,630,3121,2597,1154,41170,798560,621488,2948,4626,3996,4915,6593,37.986839826445156,23.400683780661282,1678,1,206566,100084,1443,0,2318,2029
10436,0,0,0,1,69,0,323,0,0,1707090,4000920,33.98529093593286,630,3158,2633,1155,42550,796720,640840,2939,4619,3989,4942,6622,38.44476557348217,23.28796332436253,1680,1,213675,97125,1478,0,2309,1986
10437,0,0,1,0,65,0,657,0,0,3692638,5274734,40.26164427839479,1068,4452,3899,1621,34587,615006,595482,2701,4875,3807,5532,7706,47.7283982551269,23.61773601086439,2174,1,296643,75761,2278,0,1633,976
10438,0,0,1,0,64,0,1024,0,0,3555972,4657660,37.97367509209505,776,4574,3908,1442,53130,746130,742900,2564,4672,3896,5696,7804,49.658836071740545,25.86093016921873,2108,0,331660,89910,2466,1,1788,764
10439,0,0,1,0,59,1,599,0,0,1580856,2969070,31.51190251317746,951,2627,2585,993,48590,675740,642850,2948,3983,3032,4582,5617,39.89987468652001,6.48074069840786,1035,0,213495,6216,1592,1,1997,1398
10440,0,0,0,1,72,0,20,0,0,3207581,6523222,42.43819034784589,1518,3865,3582,1801,46189,800462,756998,3339,5423,3905,5403,7487,42.20189569201838,17.189805831208552,2084,1,376409,42167,1781,0,1821,1841
10441,0,0,0,1,72,0,129,0,0,3176712,6667584,42.988370520409354,1606,3809,3567,1848,55216,837056,858704,3366,5456,3850,5327,7417,41.46082488325576,15.88081601204312,2090,1,439824,29766,1719,0,1760,1889
10442,0,0,0,1,72,0,119,0,0,3109920,6571872,42.708313008125245,1584,3769,3529,1824,55842,817881,886338,3363,5427,3843,5308,7372,41.291645644125154,15.776869846465061,2064,1,448704,24960,1705,0,1779,1898
10443,0,0,0,1,68,0,44,0,0,2334300,5171604,38.80721582386451,1264,3298,3056,1506,51750,710838,858500,3192,4940,3676,4984,6732,39.370039370059054,16.015419589854947,1748,1,376500,17908,1550,0,1928,1884
10444,0,0,0,1,67,0,480,0,0,1724625,3719715,33.090784215548595,839,2926,2670,1095,17442,519741,387258,3141,4492,3653,4972,6323,39.68626966596886,16.814563709866416,1351,1,124830,40960,1575,0,2302,1822
10445,0,0,0,1,69,0,371,0,0,1743812,3964044,33.88214869219483,595,3220,2667,1148,42624,766566,662976,2900,4601,4006,4972,6673,38.97435053981015,23.779179523545242,1701,1,220416,92904,1519,0,2305,1934
10446,0,0,0,1,69,0,443,0,0,1793744,3924880,33.704599092705436,584,3267,2715,1136,44642,763555,697910,2903,4591,4007,5034,6722,39.736632972611055,24.273151402093745,1688,1,229472,86664,1579,0,2319,1876
10447,0,0,0,1,69,0,401,0,0,1805322,4005522,34.02939905434711,585,3290,2717,1158,40723,729849,667587,2886,4617,4032,5018,6749,39.48417404479927,24.212880716530954,1731,1,223494,88815,1559,0,2301,1900
10448,0,0,0,1,69,0,328,0,0,1858233,4200066,34.77067730142742,735,3220,2746,1209,41440,778176,642690,3000,4683,3948,5011,6694,39.20459156782532,22.270514270252853,1683,1,223665,84372,1537,0,2265,1937
10449,0,0,1,0,62,1,2720,0,0,1921764,10381488,57.463031594234565,2967,4219,3884,3302,51294,647664,782856,2809,6446,3479,3726,7363,24.124676163629637,18.597383942831776,3637,1,822198,25125,582,0,158,2562
10450,0,0,1,0,64,1,2334,0,0,8007832,13639528,65.02307282803544,4138,6212,6122,4228,43010,741980,603262,3136,7454,3316,5120,9438,43.520110293977886,9.505517133991825,4318,0,790636,16470,1894,1,1002,1332
10451,0,0,0,1,69,0,4,0,0,2732405,5754435,40.681691213615984,1427,3534,3306,1655,54225,782325,837957,3249,5132,3705,5128,7011,40.63249930782009,15.18292293020051,1883,1,398855,25308,1651,0,1822,1826
10452,0,0,0,1,69,0,491,0,0,1887150,3974400,33.91164991562634,827,3114,2791,1150,17248,532224,387072,3133,4606,3779,5097,6570,40.50925820105819,19.204150683387002,1473,1,128800,52649,1641,0,2306,1815
10453,0,0,0,1,69,0,517,0,0,1900184,3967392,33.823069050575526,794,3155,2805,1144,29640,658920,541008,3118,4612,3818,5129,6623,40.755367744629666,19.920432686284766,1494,1,178464,58100,1661,0,2324,1807
10454,0,0,0,1,68,0,380,0,0,1988829,4219326,35.11409973215888,999,3080,2846,1233,26784,636492,492768,3188,4655,3656,5035,6502,40.162171256046406,16.25908091500631,1467,1,177552,40482,1613,0,2189,1809
10455,0,0,1,0,64,0,71,0,0,3309320,6021330,43.069710934716056,1813,3681,3639,1855,40280,688152,616740,3204,5101,3288,5030,6927,42.23742416388575,6.488991180673202,1897,0,352450,6636,1784,1,1391,1462
10456,0,0,1,0,64,0,1224,0,0,3811572,4654764,37.86819245752297,618,4908,4092,1434,48160,727104,697890,2430,4680,4062,5904,8154,51.55579501860097,28.619626550234184,2250,0,308310,119136,2658,1,1812,588
10457,0,0,0,1,69,0,22,0,0,2845848,5814044,40.93897898091744,1514,3536,3374,1676,53436,759711,846436,3307,5145,3631,5167,7005,41.20679555607303,12.89950058566656,1838,1,408944,16200,1698,0,1793,1771
10458,0,0,0,1,69,0,430,0,0,2041800,4273020,35.07135583350036,678,3442,2890,1230,43026,739962,701748,2922,4704,4026,5134,6916,40.74309757492672,23.809094935555226,1782,1,248460,80592,1660,0,2244,1814
10459,0,0,1,0,66,1,2431,0,0,2649552,10815757,56.9824534396335,2441,4869,4063,3247,43044,702841,679524,2525,6578,4137,4147,8200,28.5657137141714,28.796758125846164,4053,1,662388,114452,816,0,84,2515
10460,0,0,1,0,66,1,2609,0,0,2149686,10843173,57.15767664977295,2609,4583,3925,3267,43470,696990,687033,2661,6586,3977,3977,7902,25.65151067676132,26.230045014422668,3925,1,676269,90804,658,0,52,2661
10461,0,0,0,1,65,1,2257,0,0,8203650,13714820,64.8613906727261,3898,6466,6157,4207,47443,681340,740020,2951,7467,3569,5210,9726,44.15880433163923,17.851964650931695,4516,1,954989,34608,1950,0,947,1310
10462,0,0,0,1,69,0,7,0,0,3036294,6051720,41.701318923986086,1605,3619,3485,1739,53846,758640,859560,3346,5219,3614,5226,7099,41.78516483155236,11.65306661673843,1873,1,429533,12596,1746,0,1741,1734
10463,0,0,0,1,66,0,184,0,0,2440761,4919820,38.379682124790975,1473,3130,3130,1473,52440,768200,761520,3340,4813,3340,4997,6470,40.70626487409524,0.0,1473,1,335844,0,1657,0,1867,1683
10464,0,0,0,1,69,0,436,0,0,2134005,4381320,35.482389998420345,898,3315,2954,1259,30429,720360,511560,3119,4739,3841,5175,6795,41.1703777004778,20.15191656996704,1620,1,185073,70395,1695,0,2221,1785
10465,0,0,0,1,69,0,475,0,0,2135474,4349257,35.25620512760839,843,3361,2961,1243,35119,710297,605327,3099,4742,3899,5217,6860,41.44876355212541,21.244065395510024,1643,1,215039,66000,1718,0,2256,1781
10466,0,0,0,1,69,0,525,0,0,2161636,4296190,35.08560958569767,788,3430,2987,1231,46221,757330,743370,3047,4721,3933,5246,6920,41.90465367951393,22.161092926787695,1674,1,262203,62020,1756,0,2259,1734
10467,0,0,0,1,69,0,467,0,0,2125530,4326883,35.25620512760839,649,3547,2953,1243,43442,744934,706643,2887,4724,4075,5191,7028,41.352146256270665,25.1749862017779,1837,1,252329,87318,1710,0,2238,1771
10468,0,0,1,0,60,1,614,0,0,813960,1958672,25.41653005427767,436,2116,1906,646,50850,685232,682200,2822,3678,3242,4292,5148,35.4964786985977,14.596690407581317,856,0,145350,28350,1260,1,2386,1772
10469,0,0,0,1,69,0,2,0,0,3179088,6213834,42.21374183841087,1687,3661,3566,1782,52611,742731,861289,3392,5269,3582,5271,7148,42.23742416388575,9.80698324197389,1877,1,440154,8455,1784,0,1705,1703
10470,0,0,0,1,66,0,162,0,0,2591983,5127319,39.1279950930277,1531,3224,3224,1531,49533,699941,793713,3349,4880,3349,5042,6573,41.14608122288197,0.0,1531,1,362847,0,1693,0,1818,1656
10471,0,0,0,1,69,0,436,0,0,2223525,4497321,35.90264614203248,907,3396,3014,1289,33824,781536,526839,3107,4778,3871,5214,6885,41.53311931459037,20.676971076302063,1671,1,194639,80220,1725,0,2200,1764
10472,0,0,0,1,69,0,534,0,0,2260440,4399920,35.4964786985977,776,3538,3054,1260,47080,768240,747288,3008,4752,3976,5286,7030,42.35563716909474,23.004334272335193,1744,1,269640,68244,1794,0,2232,1698
10473,0,0,0,1,69,0,524,0,0,2247840,4398660,35.4964786985977,744,3560,3044,1260,46368,781984,722637,2975,4751,4007,5275,7051,42.23742416388575,23.60288206955182,1776,1,260820,79980,1784,0,2231,1707
10474,0,0,0,1,62,1,3005,0,0,1453896,10732770,58.557663887829406,3174,4108,3853,3429,50800,626000,795020,2875,6559,3385,3554,7238,20.591260281974,16.12004122835068,3684,1,870966,14280,424,0,299,2706
10475,0,0,0,1,65,1,2421,0,0,6855030,13370175,63.99218702310463,3671,6193,5769,4095,41475,773805,571375,2841,7360,3689,4939,9458,40.91454509095757,20.734113859503474,4519,1,716625,85224,1674,0,830,1591
10476,0,0,0,1,67,0,128,0,0,2791488,5425392,40.099875311526844,1578,3374,3344,1608,53535,725410,840126,3344,4982,3404,5110,6748,41.66533331199932,5.5965095842615735,1638,1,400392,2580,1736,0,1766,1638
10477,0,0,0,1,67,0,234,0,0,2527147,4949427,38.43175770115127,1477,3188,3188,1477,41701,747273,626637,3351,4828,3351,5062,6539,41.36423575989287,0.0,1477,1,276199,0,1711,0,1874,1640
10478,0,0,0,1,67,0,302,0,0,2413920,4781310,37.54996671103717,1276,3256,3122,1410,30576,705328,498477,3257,4801,3525,5103,6647,41.376321731154405,11.675279088410905,1544,1,207270,26398,1712,0,1981,1679
10479,0,0,0,1,70,0,474,0,0,2312352,4576530,36.08323710533743,844,3536,3078,1302,46920,808450,717060,3057,4817,3973,5291,7051,42.14261501141095,21.517911559998208,1760,1,265608,75570,1776,0,2213,1739
10480,0,0,1,0,61,1,2776,0,0,3685617,11564046,61.29437168288782,3672,4823,4738,3757,41584,695628,566352,2993,6835,3163,4059,7901,31.32091952673165,9.219863456115478,3842,0,691288,15470,981,1,679,2097
10481,0,0,0,1,64,1,2528,0,0,5997840,12900180,63.40346993658943,3762,5770,5512,4020,41452,773369,551948,2951,7229,3467,4701,8979,38.62641583165593,16.235473249581162,4278,1,691440,53406,1492,0,811,1717
10482,0,0,0,1,67,0,172,0,0,2771493,5301093,39.761790704142086,1581,3334,3334,1581,50820,737660,774543,3353,4934,3353,5106,6687,41.86884283091664,0.0,1581,1,365211,0,1753,0,1772,1600
10483,0,0,0,1,69,0,385,0,0,2423136,4754080,37.094473981982816,1108,3405,3137,1376,37674,808470,556255,3187,4831,3723,5216,6860,41.96427051671457,16.409090174556454,1644,1,221536,56548,1761,0,2079,1694
10484,0,0,0,1,70,0,531,0,0,2443320,4622640,36.3318042491699,769,3722,3171,1320,45154,749428,738922,2951,4822,4053,5353,7224,43.02324952859791,24.350085002816723,1871,1,278520,76038,1851,0,2182,1651
10485,0,0,0,1,70,0,488,0,0,2402225,4640150,36.40054944640259,752,3711,3138,1325,43848,756432,710906,2929,4827,4075,5315,7213,42.579337712087536,24.262901157337957,1898,1,268975,85950,1813,0,2177,1689
10486,0,0,0,1,68,0,90,0,0,3145051,5911451,41.58124577258358,1729,3548,3548,1729,47959,680381,823979,3419,5148,3419,5238,6967,42.649736224272246,0.0,1729,1,416689,0,1819,0,1690,1600
10487,0,0,0,1,67,0,280,0,0,2637300,5037690,38.600518131237564,1430,3320,3260,1490,38744,784392,564627,3321,4871,3441,5151,6701,42.07136793592526,7.864259938752337,1550,1,248830,12300,1770,0,1891,1611
10488,0,0,0,1,70,0,448,0,0,2493849,4806726,37.027017163147235,995,3566,3190,1371,46563,872994,655622,3130,4877,3882,5325,7072,42.649736224272246,19.508993843271128,1747,1,256377,74824,1819,0,2135,1687
10489,0,0,0,1,70,0,453,0,0,2484754,4790562,36.959437225152655,878,3673,3185,1366,43632,757512,708414,3019,4873,3995,5326,7180,42.649736224272246,22.569274746185005,1854,1,275932,73688,1819,0,2141,1688
10490,0,0,0,1,65,0,89,0,0,4355676,6986564,46.17358552246078,2102,4205,4175,2132,45792,707832,694724,3247,5409,3307,5320,7482,45.19955751995809,5.477225575051661,2162,1,451984,4200,2043,0,1145,1234
10491,0,0,0,1,68,0,322,0,0,2673528,5061030,38.49675310984031,1374,3394,3286,1482,36093,775205,542985,3307,4897,3523,5219,6809,42.473521163190604,10.435690064413366,1590,1,235638,22248,1804,0,1933,1611
10492,0,0,0,1,69,0,436,0,0,2589852,4911158,37.49666651850535,1071,3583,3248,1406,43648,866264,614768,3158,4899,3828,5335,7076,42.91852746774987,18.388677513052528,1741,1,247456,69680,1842,0,2087,1651
10493,0,0,0,1,70,0,471,0,0,2593296,4884528,37.30951621235526,974,3673,3255,1392,49692,863214,708818,3091,4901,3927,5372,7182,43.162483709814474,20.556582172247484,1810,1,281184,76076,1863,0,2117,1646
10494,0,0,0,1,70,0,486,0,0,2591335,4862735,37.21558813185679,854,3787,3256,1385,45353,761887,733799,2980,4896,4042,5382,7298,43.255057507764334,23.439315103801263,1916,1,289465,76995,1871,0,2126,1640
10495,0,0,0,1,69,0,104,0,0,3442032,6249056,42.473521163190604,1774,3742,3712,1804,38880,623520,748224,3434,5268,3494,5372,7206,43.68065933568311,5.477225575051661,1834,1,389664,2640,1908,0,1660,1556
10496,0,0,0,1,67,0,185,0,0,3052194,5577462,40.70626487409524,1657,3499,3499,1657,42586,720324,669834,3366,5023,3366,5208,6865,42.91852746774987,0.0,1657,1,329743,0,1842,0,1709,1524
10497,0,0,0,1,68,0,350,0,0,2738271,5119182,38.58756276314948,1339,3478,3328,1489,33371,759798,519138,3288,4927,3588,5277,6916,42.883563284783136,12.25845656828046,1639,1,224839,31050,1839,0,1949,1599
10498,0,0,0,1,69,0,387,0,0,2706550,5073684,38.24918299781056,1247,3529,3313,1463,40762,794172,617304,3252,4931,3684,5318,6997,43.01162633521314,14.731545485687572,1679,1,260414,41256,1850,0,2005,1618
10499,0,0,0,1,69,0,448,0,0,2685540,4999280,37.815340802378074,1079,3659,3308,1430,46550,856520,664240,3145,4926,3847,5374,7155,43.3358973600409,18.825613524806947,1781,1,271700,68094,1878,0,2066,1618
10500,0,0,0,1,70,0,516,0,0,2715660,4967430,37.54996671103717,841,3905,3336,1410,42400,746876,704600,2954,4933,4092,5449,7428,43.88621651498338,24.226817124943175,1979,1,282000,84212,1926,0,2113,1597
10501,0,0,1,0,67,0,246,0,0,4851307,6982216,45.639894828976104,1653,4842,4412,2083,49235,767608,720680,2922,5435,3782,5681,8194,48.25971404805462,21.201697044618026,2513,1,447845,64930,2329,0,1269,1023
10502,0,0,1,0,62,1,2959,0,0,3387762,11910941,61.97580172938467,3629,4935,4723,3841,36462,638806,548877,2889,6942,3313,3983,8036,29.698484809834994,14.568312119522872,4053,1,679857,34980,882,0,740,2219
10503,0,0,0,1,68,0,338,0,0,2851248,5250208,39.08964057138413,1420,3502,3394,1528,32832,742176,522272,3328,4964,3544,5302,6938,43.197222132910355,10.403202108104866,1636,1,232256,21816,1866,0,1908,1570
10504,0,0,1,0,63,1,3292,0,0,954080,11249600,59.665735560705194,3305,4083,3828,3560,54180,679400,796320,2905,6720,3415,3428,7243,16.3707055437449,16.108330850650685,3815,1,897120,19635,268,0,400,2892
10505,0,0,0,1,69,0,172,0,0,3496988,6200992,42.261093218230876,1696,3834,3744,1786,49266,718704,826336,3382,5258,3562,5430,7306,44.24929377967517,9.48712577043745,1876,1,425068,8460,1958,0,1686,1514
10506,0,0,0,1,70,0,480,0,0,2893924,5195170,38.44476557348217,1054,3860,3436,1478,49350,826025,738150,3091,4993,3939,5473,7375,44.24929377967517,20.72240842835788,1902,1,310380,69112,1958,0,2037,1557
10507,0,0,0,1,66,0,29,0,0,4441346,7008966,46.06517122512408,2092,4245,4215,2122,47515,710145,729963,3273,5425,3333,5396,7548,45.749316934791494,5.5503012171862105,2152,1,468962,3810,2093,0,1181,1210
10508,0,0,0,1,66,1,2976,0,0,1947456,11656512,59.39696961966999,3019,4589,4080,3528,54000,713664,826000,2795,6832,3813,3856,7893,23.49468024894146,23.09881075028368,4037,1,882000,38684,552,0,224,2752
10509,0,0,1,0,61,1,3362,0,0,1174239,11348523,60.67124524847005,3681,4000,4000,3681,48832,690592,672094,3083,6764,3083,3402,7083,17.86057109949175,0.0,3681,0,802458,0,319,1,598,2764
10510,0,0,1,0,65,1,2428,0,0,9775520,15028720,67.58698099486321,4226,7050,6708,4568,44178,730380,654710,2948,7858,3632,5430,10340,46.26013402488151,18.668183522734903,4910,0,909032,55062,2140,1,1278,1150
10511,0,0,0,1,69,0,159,0,0,3575236,6254850,42.579337712087536,1693,3905,3785,1813,51660,724500,848700,3330,5263,3570,5422,7355,44.40720662234904,10.986451322313634,1933,1,445998,10320,1972,0,1637,1478
10512,0,0,0,1,68,0,128,0,0,3609705,6322954,42.86023798347368,1713,3926,3802,1837,51129,712494,850174,3318,5279,3566,5407,7368,44.328320518603,11.222142929558922,1961,1,453739,10044,1965,0,1605,1477
10513,0,0,0,1,67,0,209,0,0,3314232,5842881,41.46082488325576,1652,3714,3647,1719,39856,720588,639012,3332,5118,3466,5327,7113,43.9089968002003,8.436161057888377,1786,1,323172,10854,1928,0,1680,1471
10514,0,0,1,0,65,0,813,0,0,4971780,6128700,43.12771730569565,1060,5333,4533,1860,39270,616165,691950,2495,5155,4095,5968,8628,51.70106381884226,28.28444802249994,2660,1,390600,83200,2673,0,1435,622
10515,0,0,0,1,68,0,237,0,0,3355018,5853253,41.43669871020132,1583,3805,3671,1717,40257,726117,644301,3275,5126,3543,5363,7214,44.204072210600685,11.825513470936757,1851,1,324513,21574,1954,0,1692,1455
10516,0,0,0,1,68,0,319,0,0,3187616,5628951,40.4103947023535,1633,3585,3585,1633,30096,720423,496368,3447,5080,3447,5399,7032,44.181444068749045,0.0,1633,1,235152,0,1952,0,1814,1495
10517,0,0,0,1,70,0,499,0,0,3115056,5406891,39.153543900903784,1053,4045,3565,1533,47586,814737,726562,3047,5060,4007,5559,7572,45.077710678338576,21.934744989055304,2013,1,315798,78720,2032,0,1994,1495
10518,0,0,0,1,70,0,519,0,0,3134970,5403960,39.11521443121589,1046,4063,3579,1530,51863,844148,766444,3048,5062,4016,5581,7595,45.2658811910251,22.163825885740945,2014,1,332010,76956,2049,0,2002,1483
10519,0,0,1,0,61,1,3501,0,0,787156,11499161,60.93439094632849,3713,3925,3925,3713,50398,699922,690631,3097,6810,3097,3309,7022,14.560219778561036,0.0,3713,0,827999,0,212,1,616,2885
10520,0,0,0,1,70,0,423,0,0,3197068,5561500,39.8622628559895,1319,3871,3601,1589,43010,805000,654500,3230,5089,3770,5512,7371,44.85532298401161,16.58772693547993,1859,1,297143,49410,2012,0,1911,1488
10521,0,0,1,0,66,0,654,0,0,5224552,6631772,44.51965857910413,1223,5377,4618,1982,47736,739466,722736,2587,5328,4105,5982,8723,51.34199061197374,27.734892907455976,2741,1,428112,107019,2636,0,1364,710
10522,0,0,0,1,69,0,300,0,0,3437100,5911470,41.352146256270665,1650,3780,3720,1710,30535,681029,535835,3397,5167,3517,5467,7237,44.83302354291979,7.914659756013729,1770,1,265050,10560,2010,0,1747,1447
10523,0,0,1,0,63,1,3462,0,0,841320,11638260,60.74537019394976,3478,4130,3918,3690,54340,693880,779038,2942,6844,3366,3382,7284,15.0996688705415,14.599262058563324,3902,1,911430,20352,228,0,536,2926
10524,0,0,0,1,70,0,435,0,0,3410434,5773272,40.52159917870962,1357,4004,3719,1642,38976,787584,611784,3231,5158,3801,5593,7520,45.574115460423364,16.907035861815707,1927,1,285708,53865,2077,0,1874,1439
10525,0,0,0,1,70,0,455,0,0,3413426,5766386,40.422765862815474,1292,4065,3723,1634,40363,786967,638749,3187,5163,3871,5618,7594,45.70557952810576,18.541474343042776,1976,1,295754,61902,2089,0,1895,1440
10526,0,0,1,0,62,1,3398,0,0,2010768,12264120,62.545983084447556,3670,4668,4426,3912,28548,573705,489060,2893,7047,3377,3649,7803,22.67156809750927,15.790094819097714,4154,1,610272,37994,514,0,777,2621
10527,0,0,0,1,70,0,413,0,0,3527568,5914062,41.02438299353203,1465,3997,3779,1683,39458,766052,636034,3296,5197,3732,5610,7511,45.78209256903839,14.79579361898563,1901,1,304623,38368,2096,0,1831,1418
10528,0,0,0,1,70,0,434,0,0,3521232,5888784,40.890096600521744,1395,4055,3778,1672,37668,771318,605784,3245,5194,3799,5628,7577,45.89117562233506,16.68566947568206,1949,1,287584,51522,2106,0,1850,1416
10529,0,0,0,1,70,0,403,0,0,3643878,6038770,41.44876355212541,1536,4021,3839,1718,38325,769785,615125,3333,5233,3697,5636,7536,46.05431575867782,13.535417710445202,1900,1,300650,33306,2121,0,1797,1394
10530,0,0,0,1,70,0,414,0,0,3639712,6026240,41.376321731154405,1500,4050,3838,1712,37410,756800,612480,3308,5232,3732,5646,7570,46.10856753359401,14.614663499292087,1924,1,297888,38160,2126,0,1808,1394
10531,0,0,0,1,70,0,474,0,0,3645607,5983789,41.0731055558257,1296,4239,3848,1687,45652,801622,716494,3156,5234,3938,5708,7786,46.486557196677836,19.86393016257081,2078,1,340774,63733,2161,0,1860,1386
10532,0,0,1,0,64,1,2929,0,0,6117990,14001953,65.87108622149782,4339,5749,5749,4339,44583,745437,622811,3227,7566,3227,4637,8976,37.54996671103717,0.0,4339,0,837427,0,1410,1,1112,1817
10533,0,0,0,1,70,0,404,0,0,3757797,6158175,41.79712908801273,1567,4078,3898,1747,34485,736725,581625,3345,5272,3705,5676,7603,46.37887450122092,13.514804416149667,1927,1,288255,32580,2151,0,1778,1374
10534,0,0,1,0,65,1,2574,0,0,4055731,12060560,60.63827174318213,3166,5291,4780,3677,51246,767520,718320,2769,6957,3791,4383,8571,33.21144381083123,22.607473056312717,4188,1,805263,77672,1103,0,397,2177
10535,0,0,0,1,71,0,434,0,0,3865395,6255072,41.96427051671457,1491,4226,3956,1761,34320,738816,586080,3282,5313,3822,5747,7778,46.850827100489916,16.61804363561106,2031,1,290565,48600,2195,0,1791,1357
10536,0,0,1,0,65,1,2633,0,0,3670128,11946121,60.340699366182356,3101,5189,4649,3641,48777,751349,698853,2741,6922,3821,4289,8470,31.74901573277509,23.240310355435227,4181,0,775533,82620,1008,1,360,2273
10537,0,0,0,1,71,0,415,0,0,3987000,6390000,42.42640687119285,1590,4225,4015,1800,34680,724200,603500,3340,5350,3760,5765,7775,47.06378650300037,14.742402984169178,2010,1,306000,35700,2215,0,1750,1335
10538,0,0,1,0,63,1,3440,0,0,1536000,12176640,61.96773353931867,3612,4468,4240,3840,54635,707133,776895,2943,7011,3399,3571,7639,20.0,15.12061154588234,4068,1,940800,23484,400,0,669,2771
10539,0,0,1,0,65,1,2667,0,0,3653008,12032576,60.530983801686226,3094,5231,4661,3664,47424,748752,683072,2714,6948,3854,4281,8515,31.575306807693888,23.878272632304746,4234,1,762112,90060,997,0,380,2287
10540,0,0,0,1,71,0,434,0,0,4102280,6499220,42.661458015403085,1550,4344,4074,1820,35700,749910,607070,3301,5391,3841,5825,7915,47.47630988187688,16.756044470937617,2090,1,309400,47790,2254,0,1751,1317
10541,0,0,0,1,71,0,462,0,0,4108239,6459939,42.532340636273474,1449,4440,4080,1809,48438,739197,835614,3211,5380,3931,5842,8011,47.65501022977542,19.18704342521298,2169,1,423306,36360,2271,0,1762,1300
10542,0,0,0,1,67,0,539,0,0,5898062,7339424,46.62617290749907,1541,5520,4887,2174,53357,773104,786608,2743,5550,4009,6089,8896,52.08646657242167,25.330800164979326,2807,1,506542,81657,2713,0,1202,663
10543,0,0,1,0,65,1,2991,0,0,3260160,12518400,61.96773353931867,3356,5173,4689,3840,55615,798700,740020,2776,7100,3744,4109,8433,29.13760456866693,22.17162877421657,4324,1,871680,72116,849,0,580,2411
10544,0,0,1,0,64,1,3192,0,0,4807728,13936380,65.63535632568775,4011,5721,5424,4308,38456,676115,595240,2938,7543,3532,4351,8956,33.406586176980134,17.307503054825638,4605,1,792672,48114,1116,0,1073,2119
10545,0,0,1,0,65,1,2701,0,0,3640056,12126144,60.728905802755904,3088,5275,4675,3688,45426,743088,660888,2688,6976,3888,4275,8563,31.416556144810016,24.50040692064771,4288,1,741288,98400,987,0,400,2301
10546,0,0,1,0,65,0,1530,0,0,5155591,5374145,40.38564101261734,1165,5258,4792,1631,51296,738080,754555,2829,4926,3761,6456,8553,56.22277118748239,21.587430765743377,2097,1,373499,59648,3161,0,1664,134
10547,0,0,0,1,71,0,424,0,0,4348272,6754140,43.40506882842141,1637,4439,4192,1884,42267,785115,691905,3338,5469,3832,5893,8024,48.041648597857254,16.22436246843356,2131,1,363612,40755,2308,0,1701,1277
10548,0,0,1,0,62,1,3819,0,0,761710,12600287,63.31666447310692,3979,4229,4199,4009,47488,704032,666316,3113,7152,3173,3333,7372,13.784048752090222,5.5503012171862105,4039,0,849908,4470,190,1,866,2953
10549,0,0,1,0,65,1,3343,0,0,4062630,13946790,65.49809157525127,3823,5704,5237,4290,45854,737977,656702,2784,7541,3718,4198,8955,30.773365106858236,21.744576489239012,4757,1,866580,76121,947,0,1039,2304
10550,0,0,0,1,71,0,406,0,0,4607127,7013223,44.19275958796871,1737,4528,4312,1953,39130,772065,653562,3375,5544,3807,5950,8119,48.569537778323564,15.259836841981645,2169,1,355446,36936,2359,0,1638,1232
10551,0,0,0,1,71,0,425,0,0,4601024,6990914,44.07947368106838,1675,4579,4311,1943,42900,791560,701610,3330,5541,3866,5966,8177,48.662100242385755,16.95499152878866,2211,1,378885,43684,2368,0,1655,1230
10552,0,0,1,0,66,1,2770,0,0,4733016,13239760,62.960304954788775,3331,5791,5158,3964,55615,758180,818300,2707,7304,3973,4534,9131,34.55430508634199,25.547285032868256,4597,1,971180,67098,1194,0,624,2146
10553,0,0,1,0,63,1,3754,0,0,1679832,13284810,64.48255578061404,3996,4724,4562,4158,37791,706095,546345,3033,7353,3357,3599,7919,20.09975124224178,12.728043305644134,4320,1,711018,30618,404,0,963,2791
10554,0,0,1,0,64,1,3721,0,0,2072796,13582712,64.90762667052309,3985,4933,4705,4213,38304,735072,541632,2996,7437,3452,3716,8157,22.181073012818835,15.108447856955953,4441,1,707784,45372,492,0,989,2732
10555,0,0,1,0,65,1,3091,0,0,3883950,13186800,63.63961030678928,3689,5370,5009,4050,51792,677248,810744,2895,7306,3617,4215,8626,30.967725134404045,19.201785255365955,4411,1,1008450,28158,959,0,794,2297
10556,0,0,0,1,68,0,788,0,0,5803245,6996646,45.24378410345447,1563,5366,4882,2047,54366,755378,840828,2934,5465,3902,6253,8784,53.24471804789655,22.0495132880664,2531,1,503562,47432,2835,0,1371,583
10557,0,0,0,1,72,0,407,0,0,5408478,7763233,46.16275555033516,1913,4887,4669,2131,53325,863391,819675,3425,5774,3861,6181,8530,50.37856687124,15.40787498688845,2349,1,479475,32046,2538,0,1512,1105
10558,0,0,0,1,72,0,416,0,0,5540505,7833425,46.42197755374064,1973,4908,4726,2155,55081,897845,810605,3453,5790,3817,6206,8543,50.70502933634887,14.187875184162642,2337,1,480565,28392,2571,0,1480,1064
10559,0,0,0,1,67,0,1069,0,0,5665470,6435090,43.64630568559039,1410,5374,4879,1905,54720,770184,810720,2883,5283,3873,6352,8752,54.53439281774392,22.3752000672253,2400,1,457200,57915,2974,0,1473,404
10560,0,0,1,0,64,1,3817,0,0,2226134,13945820,65.81033353509159,4197,4979,4845,4331,46575,724500,666540,3086,7551,3354,3734,8199,22.67156809750927,11.709062801829726,4465,1,896517,20904,514,0,1111,2706
10561,0,0,0,1,66,1,3504,0,0,5144452,15313288,67.95586803212802,3960,6390,5732,4618,43240,762680,623408,2658,7934,3974,4430,9706,33.37663853655727,25.750528878388607,5276,1,868184,119098,1114,0,1302,2202
10562,0,0,1,0,62,1,2834,0,0,6860595,13729980,66.29479617586888,3525,6826,5956,4395,53676,787248,665412,2254,7519,3994,4685,9950,39.50949253027682,30.211421201608548,5265,1,936135,145290,1561,0,1271,1563
10563,0,0,0,1,66,0,1431,0,0,5439220,5765056,41.52107898405339,1405,5198,4879,1724,52580,735680,799216,3025,5068,3663,6499,8542,56.16938667993447,17.93387866802097,2043,1,412036,35090,3155,0,1620,189
10564,0,0,0,1,67,0,1487,0,0,5408130,5713770,41.20679555607303,1421,5160,4883,1698,55209,777315,804235,3088,5063,3642,6550,8525,56.43580423808985,16.76183378250879,1975,1,405822,33517,3185,0,1667,180
10565,0,0,1,0,65,0,1820,0,0,4056000,4232800,36.05551275463989,1210,4510,4420,1300,56394,761904,784696,3166,4556,3346,6376,7766,55.85696017507576,9.501147918471748,1390,0,313300,10710,3120,1,1956,136
10566,0,0,1,0,65,0,1915,0,0,4711950,4653935,37.61648574760805,1373,4787,4745,1415,50694,782782,700557,3247,4704,3331,6619,8076,57.706152185014034,6.553889165207866,1457,0,301395,6846,3330,1,1874,41
10567,0,0,1,0,64,0,1820,0,0,3292800,3616480,33.46640106136302,1090,4090,4060,1120,56069,732983,797563,3199,4349,3259,6169,7319,54.22176684690383,5.572104574801163,1150,0,276640,3000,2940,1,2109,289
10568,0,0,0,1,67,0,1422,0,0,5521504,5891232,41.7612260356422,1502,5152,4910,1744,53352,770184,790452,3136,5122,3620,6544,8530,56.2672195865408,15.656385866328812,1986,1,408096,30492,3166,0,1634,212
10569,0,0,1,0,61,1,2979,0,0,7044282,13943508,67.32755750805164,3776,6844,6087,4533,56870,744392,722860,2319,7609,3833,4630,9920,39.42080668885405,28.223896796941382,5290,1,1065255,99924,1554,0,1457,1522
10570,0,0,1,0,64,1,3654,0,0,3946672,14492252,67.27555276621665,4334,5590,5398,4526,38804,698036,569956,3010,7728,3394,4074,8792,29.5296461204668,13.905851183659104,4718,1,805628,34368,872,0,1324,2330
10571,0,0,1,0,65,1,3803,0,0,3574740,14926831,67.69785816405124,4288,5658,5363,4583,38500,716540,569975,2962,7840,3552,4037,8915,27.92848008753788,17.214117292961248,4878,1,802025,53985,780,0,1326,2477
10572,0,0,0,1,66,0,2130,0,0,4814496,4545192,37.067505985701274,1374,4878,4878,1374,49494,724452,747608,3308,4682,3308,6812,8186,59.19459434779497,0.0,1374,1,310524,0,3504,0,1934,196
10573,0,0,0,1,66,0,2085,0,0,4869234,4644156,37.389838191679836,1398,4881,4881,1398,50127,767382,720874,3322,4720,3322,6805,8203,59.016946718718,0.0,1398,1,303366,0,3483,0,1924,161
10574,0,0,1,0,63,0,1876,0,0,1845957,2253793,26.70205984563738,605,3410,3302,713,50976,682776,745996,3053,3874,3269,5750,6571,50.882216932834204,10.429745618880121,821,0,168268,11664,2589,1,2448,572
10575,0,0,1,0,61,1,2945,0,0,4963314,12714867,64.36614016701638,3335,6149,5341,4143,40500,767250,497178,2261,7212,3877,4267,9218,34.61213659975356,28.43013981623815,4951,1,671166,176144,1198,0,1074,1871
10576,0,0,1,0,63,1,3039,0,0,2432626,11771248,60.802960454241045,3439,4613,4355,3697,54000,796000,687744,2926,6881,3442,3842,7797,25.65151067676132,16.560491721348367,3955,1,798552,43086,658,0,513,2526
10577,0,0,1,0,63,1,3043,0,0,2164610,11579754,60.315835400000886,3420,4451,4233,3638,56120,776652,732090,2965,6821,3401,3778,7634,24.392621835300936,15.382387179430689,3856,1,836740,31174,595,0,455,2588
10578,0,0,0,1,67,0,1745,0,0,5411484,5403424,40.149719799769464,1582,4999,4969,1612,53550,754200,797776,3322,4964,3382,6709,8351,57.9396237474839,5.483301264452448,1642,1,383656,3510,3357,0,1740,5
10579,0,0,1,0,65,0,2045,0,0,3404484,3553403,32.96968304366907,912,4394,4219,1087,49280,732256,719180,3094,4356,3444,6401,7663,55.96427431853289,13.228864543850085,1262,0,239140,24500,3132,1,2182,137
10580,0,0,1,0,59,1,2835,0,0,6496666,12854644,65.83312236253116,3575,6592,5833,4334,51920,699976,652520,2207,7300,3725,4465,9558,38.71692136521188,27.77487087706129,5093,1,953480,92598,1499,0,1368,1467
10581,0,0,1,0,65,0,2193,0,0,2783700,2927700,30.0,538,4355,3993,900,52210,748190,738431,2891,4153,3615,6346,7608,55.614746245937326,19.04080001540113,1262,0,204300,49594,3093,1,2353,160
10582,0,0,0,0,56,1,2531,1,0,6461270,11654095,64.07027391856539,3447,6337,5679,4105,49530,721106,553605,2181,6944,3497,4413,9176,39.67366884975475,25.738881093095852,4763,1,800475,125020,1574,0,1266,1265
10583,0,0,0,0,57,1,2537,1,0,5635080,11480040,62.928530890209096,3195,6148,5383,3960,40508,716053,475436,2134,6859,3664,4322,9047,37.72267222772003,27.927665241684245,4725,1,649440,151470,1423,0,1061,1476
10584,0,0,1,0,67,0,953,0,0,8278920,8261840,49.39635614091387,2145,6128,5833,2440,52624,856658,704288,3091,5826,3681,6779,9514,58.249463516842795,17.257911955985243,2735,1,507520,51920,3393,0,946,7
10585,0,0,0,0,56,1,2465,1,0,6256676,11407577,63.41135544995076,3379,6219,5577,4021,48888,714924,550378,2195,6858,3479,4393,9056,39.44616584663204,25.448035317865536,4663,1,780074,123906,1556,0,1184,1281
10586,0,0,0,1,67,0,2704,0,0,4204032,3722688,33.2264954516723,709,5307,4912,1104,50576,735096,782304,2977,4476,3767,7180,8679,61.70899448216605,19.88380379960343,1499,1,256128,46215,3808,0,2268,436
10587,0,0,0,0,59,1,2315,1,0,3581936,10111120,58.1033561853358,3242,4571,4437,3376,54014,676870,715805,2861,6371,3129,4056,7566,32.57299494980466,12.08361278705801,3510,1,806864,12462,1061,0,381,1934
10588,0,0,1,0,62,0,2155,0,0,345750,470850,12.24744871391589,62,2667,2455,150,54516,740804,725109,2927,3289,3351,5444,5806,48.010415536631214,14.852658030956366,362,1,34650,29044,2305,0,2989,834
10589,0,0,0,0,57,1,2354,1,0,5610696,10961496,61.82232606429493,3148,5964,5290,3822,42084,722736,478956,2194,6690,3542,4336,8832,38.31448812133603,26.256823329805275,4496,1,638274,144236,1468,0,954,1400
10590,0,0,0,1,67,0,2819,0,0,4305882,3723412,33.15116890850155,775,5341,5017,1099,55418,775852,819896,3064,4487,3712,7306,8729,62.5939294181153,18.128294347542088,1423,1,265958,36936,3918,0,2289,530
10591,0,0,0,0,59,1,2208,1,0,4084993,10146046,58.36951259004995,3167,4846,4606,3407,55216,690896,708764,2738,6385,3218,4177,7824,34.62657938636157,15.603746290173804,3647,1,810866,25440,1199,0,429,1779
10592,0,0,0,0,59,1,2056,1,0,3223977,9222866,55.65069631190611,2944,4291,4138,3097,35136,726632,428832,2825,6075,3131,4019,7269,32.264531609803356,12.369845243052126,3250,1,445968,32436,1041,0,119,1937
10593,0,0,1,0,66,0,2782,0,0,3082719,2823774,29.13760456866693,602,4727,4480,849,54880,745024,814870,3079,4175,3573,6957,8053,60.25777958073132,15.718551579159874,1096,1,208005,25935,3631,0,2477,305
10594,0,0,0,0,57,1,2155,1,0,5518634,10550222,60.51446108162907,3062,5769,5169,3662,45108,726012,515699,2281,6543,3481,4388,8650,38.82009788756334,24.983327328736156,4262,1,655498,115800,1507,0,781,1374
10595,0,0,1,0,62,0,2486,0,0,331851,399415,11.269427669584644,43,2910,2740,127,55596,710770,773670,2975,3272,3315,5758,6055,51.11751167652823,13.517639279314812,297,1,31242,17510,2613,0,3018,532
10596,0,0,1,0,60,1,1329,0,0,3235246,7810550,50.813384063650005,2285,4132,3835,2582,50960,741125,629200,2728,5607,3322,4278,7157,35.397740040855716,17.649942346005595,2879,1,537056,51975,1253,0,443,1772
10597,0,0,1,0,66,0,1416,0,0,9077761,7893809,48.85693400122443,2177,6400,6190,2387,52002,707698,803601,3097,5694,3517,7110,9707,61.66846844214635,14.498026371449333,2597,1,580041,19950,3803,0,920,496
10598,0,0,0,0,58,1,1738,1,0,3773223,8697294,54.74486277268398,2907,4346,4256,2997,46046,734206,528164,2812,5899,2992,4161,7248,35.482389998420345,9.664766342822109,3087,1,545454,17460,1259,0,95,1643
10599,0,0,0,1,68,0,3071,0,0,4162602,3463236,31.906112267087632,741,5384,5107,1018,55822,768852,840294,3125,4420,3679,7491,8786,63.94528911499267,16.925060583549502,1295,1,251446,26869,4089,0,2384,687
10600,0,0,1,0,64,0,1677,0,0,8774080,7168000,47.32863826479693,2210,6187,6157,2240,54808,793600,707200,3170,5440,3230,7117,9387,62.5859409132754,5.501408174353464,2270,0,495040,4770,3917,1,960,717
10601,0,0,0,1,67,0,2848,0,0,4894385,4102593,34.741905532080416,547,5922,5262,1207,56144,788568,822558,2739,4606,4059,7454,9321,63.67888189973188,25.76240944170022,1867,1,292094,75900,4055,0,2192,656
10602,0,0,0,0,55,1,1872,1,0,6533188,10191188,60.481402100149765,3339,5763,5444,3658,48260,707644,529340,2467,6444,3105,4572,8549,42.261093218230876,18.183807997192172,3977,1,695020,61886,1786,0,872,1000
10603,0,0,1,0,65,0,2087,0,0,7260318,6064110,42.96510211788167,1634,5991,5779,1846,52459,824535,686565,3073,5131,3497,7218,9276,62.71363488110062,14.560219778561036,2058,1,385814,37312,3933,0,1439,648
10604,0,0,1,0,65,0,1494,0,0,9952555,8176115,49.949974974968704,2465,6514,6484,2495,52364,694724,809419,3247,5772,3307,7266,9791,63.15853069855251,5.531194905403055,2525,1,616265,2640,3989,0,782,712
10605,0,0,1,0,65,0,3095,0,0,2359824,2084469,25.15949125081825,525,4469,4361,633,52624,684944,833129,3185,3926,3401,7021,7762,61.05735008989499,10.684669642126707,741,1,160149,6804,3728,0,2660,435
10606,0,0,0,1,66,0,1641,0,0,9461452,7856975,48.61069841094653,2303,6427,6367,2363,53568,718200,824600,3265,5688,3385,7329,9752,63.2771680782255,7.810249675906654,2423,1,586024,5340,4004,0,962,679
10607,0,0,1,0,65,0,1514,0,0,10067595,8208885,50.049975024968795,2505,6524,6524,2505,50996,684893,799588,3277,5782,3277,7296,9801,63.39558344238185,0.0,2505,1,611220,0,4019,0,772,742
10608,0,0,0,0,56,1,1513,1,0,4601058,8589854,55.054518434003214,2861,4719,4549,3031,55632,691496,646152,2664,5865,3004,4352,7553,38.961519477556315,13.04561731755299,3201,1,691068,23290,1518,0,197,1316
10609,0,0,0,1,66,0,1711,0,0,9339222,7732848,48.14561246884289,2288,6377,6347,2318,53703,737256,810648,3306,5654,3366,7365,9713,63.474404290233394,5.531194905403055,2348,1,563274,3090,4029,0,1018,693
10610,0,0,0,1,66,0,1634,0,0,9694472,7955424,49.01020301937138,2372,6468,6438,2402,50880,702144,794880,3282,5714,3342,7348,9780,63.52952069707436,5.514871952411144,2432,1,576480,2940,4036,0,910,724
10611,0,0,1,0,63,0,1806,0,0,9056755,7120020,47.31807265728392,2209,6314,6284,2239,55448,760020,737760,3150,5419,3210,7225,9494,63.60031446463138,5.477225575051661,2269,0,519448,4200,4045,0,941,865
10612,0,0,1,0,67,0,2601,0,0,5951160,4911720,38.262252939417984,857,6136,5529,1464,40424,832040,546865,2748,4819,3962,7420,9491,63.75735251718032,24.637386706440076,2071,1,238632,132933,4065,0,1891,710
10613,0,0,1,0,65,0,2457,0,0,6684694,5370958,40.422765862815474,1217,6142,5725,1634,52668,828324,686983,2870,4921,3704,7378,9429,63.96092557178953,20.92847680914748,2051,1,341506,73809,4091,0,1653,804
10614,0,0,0,0,58,1,896,1,0,3767360,7122360,49.39635614091387,2306,4118,3984,2440,41750,729750,487473,2785,5359,3053,4463,7037,39.293765408777,11.59897583714774,2574,1,407480,27068,1544,0,479,1375
10615,0,0,0,0,54,1,1580,1,0,6595869,9426147,58.966091951222275,3261,5590,5374,3477,55632,661484,618108,2495,6188,2927,4608,8301,43.55456348076513,14.792473605492738,3693,1,792756,29376,1897,0,766,814
10616,0,0,1,0,65,0,3356,0,0,2641212,2170084,25.65151067676132,457,4873,4672,658,55278,732156,821202,3097,3956,3499,7312,8171,63.35613624582863,14.223629663068442,859,1,163842,17889,4014,0,2640,716
10617,0,0,1,0,65,0,2541,0,0,6821950,5318670,40.422765862815474,1339,6104,5809,1634,52920,820260,683550,2960,4889,3550,7430,9359,64.61423991660043,17.66737638206614,1929,1,343140,49265,4175,0,1621,920
10618,0,0,0,0,54,1,1459,1,0,6292986,9026742,57.810033731178535,3130,5437,5225,3342,52371,683353,559107,2489,6043,2913,4584,8138,43.393547907494266,14.721525937382115,3554,1,691794,36676,1883,0,641,818
10619,0,0,0,0,57,1,719,1,0,3860766,6781089,48.54894437575342,2129,4223,3995,2357,44526,707742,520737,2649,5234,3105,4515,7100,40.47221268969612,15.10554740609148,2585,1,426617,40128,1638,0,520,1239
10620,0,0,1,0,67,0,3254,0,0,4578215,3581936,32.57299494980466,254,6183,5376,1061,54531,840624,739344,2569,4437,4183,7691,9559,65.68865959965997,29.00627128538635,1868,1,232359,130734,4315,0,2315,939
10621,0,0,1,0,62,0,3285,0,0,422716,386880,11.135528725660043,110,3767,3533,124,54900,761280,702000,2886,3244,3354,6529,6887,58.38664230798,15.418798691010508,358,0,27900,35568,3409,1,2996,289
10622,0,0,1,0,63,0,2124,0,0,9343852,6930712,46.62617290749907,2012,6634,6472,2174,48682,643976,768308,3026,5362,3350,7486,9822,65.55913361233506,12.751620014469642,2336,0,523934,13608,4298,1,1014,1110
10623,0,0,1,0,62,0,3354,0,0,373896,335988,10.392304845413264,104,3782,3570,108,55632,759084,709308,2899,3219,3323,6573,6893,58.8387627334226,14.64762860497819,320,0,24624,31376,3462,1,3003,351
10624,0,0,1,0,67,0,3598,0,0,3887160,2914500,29.49576240750525,144,6064,5338,870,55822,827450,757100,2624,4220,4076,7818,9414,66.84309986827361,26.950021437933053,1596,1,196620,108174,4468,0,2480,1118
10625,0,0,1,0,62,0,3406,0,0,533400,466200,12.24744871391589,78,3934,3706,150,55104,764568,696192,2880,3258,3336,6664,7042,59.632206063502295,15.164604009364755,378,0,33600,35340,3556,1,2958,448
10626,0,0,1,0,63,0,3522,0,0,1225279,1012825,17.86057109949175,99,4578,4160,319,55056,704850,787400,2757,3494,3593,7016,7753,61.97580172938467,21.041959165298426,737,0,79112,39292,3841,1,2856,666
10627,0,0,1,0,66,0,3755,0,0,3452516,2548704,27.640549922170507,80,5967,5283,764,55692,793968,780624,2652,4100,4020,7855,9303,67.22350779303324,26.154078415720335,1448,1,178776,92340,4519,0,2572,1183
10628,0,0,0,0,52,1,1025,1,0,6019886,7909780,54.945427471264615,2829,5203,5013,3019,53172,660240,552820,2430,5639,2810,4614,7823,44.654227123532216,13.822074075384924,3209,1,637009,32680,1994,0,399,626
10629,0,0,1,0,63,0,2661,0,0,7929880,5632088,42.23742416388575,1694,6319,6229,1784,48840,700854,694540,3067,4941,3247,7602,9476,66.67083320313314,9.489467114586667,1874,0,392480,12330,4445,1,1373,1288
10630,0,0,0,1,65,0,2312,0,0,10020564,7290702,47.05316142407437,2022,6932,6740,2214,46926,652014,780441,3101,5507,3485,7819,10225,67.27555276621665,13.865793893587346,2406,1,524718,16320,4526,0,1079,1233
10631,0,0,0,0,52,1,901,0,1,6195420,7753960,54.589376255824725,2872,5167,5059,2980,55370,637490,588052,2494,5582,2710,4681,7769,45.59605246071199,10.406531168715494,3088,1,673480,16308,2079,0,378,523
10632,0,0,0,0,51,1,820,0,1,6308925,7662315,54.35991169970753,2888,5157,5090,2955,55632,632692,591204,2526,5548,2660,4728,7750,46.20606020859169,8.185808589931957,3022,1,673740,9916,2135,0,362,458
10633,0,0,0,0,52,1,566,1,0,5302311,6786021,51.01960407529639,2483,4760,4640,2603,55930,612645,620466,2487,5210,2727,4644,7367,45.13313638558703,10.966602528904897,2723,1,619514,15000,2037,0,4,570
10634,0,0,0,0,56,1,679,1,0,1076112,4061178,37.82856063875548,957,2657,2183,1431,53424,715176,601656,2364,4269,3312,3590,5495,27.422618401604176,21.772728008815307,1905,1,303372,81054,752,0,1407,2086
10635,0,0,0,0,54,1,1129,1,0,9158502,9836100,60.35726965329032,3403,6397,6157,3643,56608,658800,626400,2460,6343,2940,5214,9097,50.1398045468867,15.644581702699938,3883,1,845176,33600,2514,0,943,186
10636,0,0,1,0,64,0,3721,0,0,4465580,3075100,30.903074280724887,646,5940,5631,955,48006,817880,608580,2911,4175,3529,7896,9160,68.38128398911503,17.88002145714202,1264,0,180495,59019,4676,1,2265,1456
10637,0,0,0,0,53,1,403,1,0,2871540,5143968,43.68065933568311,1674,3647,3413,1908,52080,668608,566160,2462,4604,2930,4201,6343,38.79432948254165,15.637590964712755,2142,1,400680,36738,1505,0,788,1191
10638,0,0,0,0,52,1,314,0,1,3397851,5264361,44.799553569204235,1684,4023,3700,2007,51156,660996,532469,2300,4630,2946,4316,6646,41.14608122288197,18.525609125436034,2330,1,407421,54910,1693,0,616,930
10639,0,0,0,0,52,1,290,0,1,3483359,5256302,44.91102314577124,1708,4053,3744,2017,53463,654106,555078,2297,4623,2915,4333,6659,41.557189510360296,18.013102969688195,2326,1,429621,50058,1727,0,589,879
10640,0,0,0,0,52,1,298,0,1,3275655,5134545,44.328320518603,1680,3917,3632,1965,51250,653250,535665,2328,4578,2898,4280,6530,40.82891132518721,17.437717859579717,2250,1,402825,47025,1667,0,648,946
10641,0,0,0,0,52,1,315,0,1,2887336,4909776,43.174066289845804,1663,3614,3413,1864,49447,661134,518898,2433,4498,2835,4183,6248,39.35733730830886,14.255752335575957,2065,1,367208,34572,1549,0,770,1085
10642,0,0,0,0,55,1,458,1,0,1226720,3761760,36.87817782917155,999,2623,2262,1360,55000,691500,608520,2405,4126,3127,3668,5389,30.033314835362415,19.02851135378198,1721,1,299200,55955,902,0,1406,1864
10643,0,0,0,0,52,1,286,0,1,3063087,4950693,43.57751713900185,1657,3754,3512,1899,49896,656964,516186,2365,4506,2849,4220,6361,40.162171256046406,16.181695947463304,2141,1,376002,42108,1613,0,708,994
10644,0,0,1,0,66,0,3042,0,0,8882275,6031625,42.720018726587654,1655,6862,6692,1825,46652,720490,707270,3135,5130,3475,8172,10167,69.76388750635962,13.049669101523763,1995,0,390550,23630,4867,1,1480,1562
10645,0,0,1,0,51,1,406,0,0,6553415,7077134,52.640288753007425,2771,5136,5136,2771,56168,607852,602744,2554,5325,2554,4919,7690,48.63126566315131,0.0,2771,0,653956,0,2365,0,217,189
10646,0,0,0,0,51,1,217,0,1,3978234,5416632,45.89117562233506,1850,4251,3995,2106,55822,635284,581272,2316,4678,2828,4461,6823,43.46262762420146,16.03801130245182,2362,1,475956,38144,1889,0,466,683
10647,0,0,0,0,51,1,190,0,1,4430424,5637120,46.92547282660026,2068,4348,4214,2202,54500,640000,558080,2426,4762,2694,4572,6908,44.85532298401161,11.602978935530418,2336,1,480036,21708,2012,0,358,548
10648,0,0,0,0,51,1,192,0,1,4313025,5572350,46.636895265444075,2013,4320,4158,2175,54750,640500,561078,2400,4737,2724,4545,6882,44.53088815642464,12.75511514473605,2337,1,476325,26082,1983,0,387,579
10649,0,0,0,0,51,1,195,0,1,4195044,5505324,46.34652090502587,1958,4291,4101,2148,55000,640750,563860,2373,4711,2753,4516,6854,44.19275958796871,13.808421129276201,2338,1,472560,30020,1953,0,415,610
10650,0,0,1,0,62,0,3795,0,0,5408496,3470976,33.2264954516723,1037,6070,6003,1104,48180,688536,691680,3077,4248,3211,8043,9214,69.99285677838846,8.20759886765899,1171,0,242880,8911,4899,1,2040,1755
10651,0,0,0,0,51,1,184,0,1,3731892,5174404,45.0111097397076,1808,4086,3868,2026,56105,625730,584866,2336,4580,2772,4396,6640,42.91852746774987,14.805740272943908,2244,1,463954,31610,1842,0,528,712
10652,0,0,0,0,51,1,191,0,1,3411530,4961695,44.10215414239989,1770,3874,3699,1945,56105,624995,584179,2376,4496,2726,4305,6425,41.88078318274385,13.415268981669886,2120,1,445405,24500,1754,0,606,797
10653,0,0,0,0,51,1,202,0,1,3010443,4706001,42.883563284783136,1715,3600,3476,1839,52164,644868,529713,2435,4398,2683,4196,6159,40.45985664828782,11.595770371638656,1963,1,380673,20708,1637,0,720,922
10654,0,0,0,0,50,1,171,0,1,3402252,4911144,43.95452195167182,1782,3843,3693,1932,56364,620248,587202,2392,4474,2692,4303,6385,41.96427051671457,12.393026621210916,2082,1,446292,20850,1761,0,610,781
10655,0,0,0,0,54,1,270,0,1,1135251,3276390,34.77067730142742,766,2591,2148,1209,52290,674790,569100,2267,3919,3153,3649,5301,30.643106892089126,21.10165129528022,1652,1,253890,69994,939,0,1501,1771
10656,0,0,1,0,65,0,3389,0,0,7785630,5165300,39.6232255123179,1144,6955,6529,1570,45492,671160,733670,2864,4860,3716,8249,10245,70.42016756583301,20.65351536312378,1996,0,350110,47286,4959,1,1720,1669
10657,0,0,0,0,50,1,134,0,1,4643847,5650866,47.148700936505136,2163,4372,4312,2223,54560,630416,559240,2482,4765,2602,4631,6914,45.70557952810576,7.754559014766193,2283,1,489060,9660,2089,0,319,453
10658,0,0,0,0,54,1,287,0,1,695970,2687850,31.464265445104548,780,1903,1693,990,45108,684180,485985,2505,3705,2925,3418,4618,26.514147167125703,14.524125829022891,1200,1,177210,40530,703,0,1725,2012
10659,0,0,0,0,54,1,334,0,1,473375,2394875,29.58039891549808,845,1446,1416,875,53130,692461,574770,2707,3612,2767,3278,4183,23.259406699226016,5.478746393072713,905,1,183750,5220,541,0,1862,2196
10660,0,0,1,0,50,1,106,0,0,6103032,6388244,50.23942674832188,2494,4972,4942,2524,53130,584661,582130,2501,5055,2561,4949,7503,49.17316341257699,5.477225575051661,2554,0,580520,4050,2418,0,7,113
10661,0,0,0,0,50,1,114,0,1,4885272,5756184,47.62352359916263,2238,4452,4422,2268,54900,619272,571050,2508,4806,2568,4692,6990,46.411205543489174,5.490867587491313,2298,1,510300,4590,2154,0,270,384
10662,0,0,0,0,50,1,97,0,0,5008530,5795258,47.82258880487337,2287,4477,4477,2287,47310,630966,481460,2534,4821,2534,4724,7011,46.79743582719036,0.0,2287,0,434530,0,2190,0,247,344
10663,0,0,0,0,50,1,75,0,0,6092086,6347698,50.05996404313531,2416,5027,4937,2506,50848,574991,567392,2443,5039,2623,4964,7560,49.3051721424842,9.488003977624334,2596,0,561344,12420,2431,0,27,102
10664,0,0,0,0,50,1,77,0,0,5670060,6105660,49.193495504995376,2360,4823,4763,2420,52206,582813,570198,2463,4943,2583,4866,7346,48.40454524112379,7.745966692414834,2480,0,546920,8340,2343,0,103,180
10665,0,0,0,0,50,1,94,0,0,2880995,4371225,41.773197148410844,1745,3396,3396,1745,54000,601200,563625,2505,4250,2505,4156,5901,40.63249930782009,0.0,1745,0,392625,0,1651,0,760,854
10666,0,0,0,0,53,1,160,0,1,636804,2376108,29.698484809834994,732,1754,1604,882,43077,670806,466062,2544,3576,2844,3416,4448,26.870057685088806,12.470060607585795,1032,1,152586,28950,722,0,1812,1972
10667,0,0,0,0,54,1,165,0,1,580716,2302488,29.13760456866693,759,1623,1533,849,49530,688848,528840,2622,3561,2802,3396,4335,26.153393661244042,9.638070910968185,939,1,165555,16470,684,0,1863,2028
10668,0,0,0,0,50,1,47,0,0,4025490,5117630,45.05552130427524,2030,4013,4013,2030,55575,622687,567225,2521,4551,2521,4504,6534,44.53088815642464,0.0,2030,0,456750,0,1983,0,491,538
10669,0,0,0,0,50,1,48,0,0,3911908,5047042,44.74371464239419,2002,3956,3956,2002,55842,620166,572267,2521,4523,2521,4475,6477,44.204072210600685,0.0,2002,0,454454,0,1954,0,519,567
10670,0,0,0,0,50,1,51,0,0,2513160,4037166,40.13726448077895,1611,3171,3171,1611,54750,626500,548814,2506,4117,2506,4066,5677,39.496835316262995,0.0,1611,0,352809,0,1560,0,895,946
10671,0,0,0,0,50,1,29,0,0,3800340,4937496,44.31703961232068,1964,3899,3899,1964,51959,585762,560622,2514,4478,2514,4449,6413,43.98863489584554,0.0,1964,0,437972,0,1935,0,550,579
10672,0,0,0,0,50,1,28,0,0,3478029,4708774,43.347433603386484,1879,3730,3730,1879,51980,576380,566356,2506,4385,2506,4357,6236,43.02324952859791,0.0,1879,0,424654,0,1851,0,627,655
10673,0,0,0,0,50,1,9,0,0,3914442,4999143,44.53088815642464,1953,3987,3957,1983,43430,542015,509242,2491,4504,2551,4495,6508,44.429719783046124,5.531194905403055,2013,0,400566,4470,1974,0,538,547
10674,0,0,0,0,50,1,8,0,0,3478209,4693059,43.23193264243457,1839,3760,3730,1869,45368,537354,532332,2481,4380,2541,4372,6271,43.139309220245984,5.483301264452448,1899,0,396228,4110,1861,0,642,650
10675,0,0,0,0,50,1,1,0,0,2180052,3702839,38.43175770115127,1477,2953,2953,1477,47560,581624,513935,2507,3984,2507,3983,5460,38.41874542459709,0.0,1477,0,302785,0,1476,0,1030,1031
10676,0,0,0,0,51,1,8,0,1,1290480,2902448,33.645207682521445,942,2462,2272,1132,44954,633308,466648,2374,3696,2754,3704,5026,33.76388603226827,14.292200046114488,1322,1,206024,33820,1140,0,1432,1424
10677,0,0,1,0,54,1,127,0,0,401100,1553976,23.93741840717165,123,1723,1273,573,55660,656304,623760,2262,3285,3162,3412,4435,26.457513110645905,21.227043939481455,1023,1,131790,64800,700,0,2139,2012
10678,0,0,0,0,52,1,131,0,1,586302,1851702,26.514147167125703,613,1627,1537,703,49447,661134,518898,2544,3337,2724,3468,4261,28.879058156387302,10.219890331034485,793,1,138491,15660,834,0,1931,1800
10679,0,0,0,0,49,1,148,0,0,1684524,3053966,35.014282800023196,1226,2600,2600,1226,50808,577912,545529,2491,3717,2491,3865,5091,37.067505985701274,0.0,1226,0,268494,0,1374,0,1265,1117
10680,0,0,1,0,66,0,4190,0,0,6141000,3800750,33.91164991562634,543,7097,6490,1150,41200,680830,661000,2698,4455,3912,8645,10402,73.07530362578044,25.096211178239933,1757,1,230000,84980,5340,0,2155,2035
10681,0,0,1,0,65,0,4395,0,0,5071456,3099434,30.805843601498726,461,6781,6293,949,49234,672796,780574,2778,4215,3754,8610,10047,73.10266752998827,22.472623601413748,1437,0,226811,44408,5344,1,2317,2078
10682,0,0,0,0,52,1,108,1,0,8476828,7794648,54.46099521676041,2434,6356,5824,2966,47264,554508,588672,2096,5594,3160,5486,8984,53.46026561849464,23.133359348926245,3498,1,664384,62776,2858,0,338,230
10683,0,0,0,0,49,1,256,0,1,1152177,2372970,30.870698080866262,911,2204,2162,953,45933,624990,455670,2448,3443,2532,3699,4694,34.77067730142742,6.538739683827756,995,1,174399,8526,1209,0,1537,1281
10684,0,0,0,0,51,1,163,1,0,4717460,5424556,45.73838650411709,1965,4474,4347,2092,37422,513414,490077,2466,4685,2720,4848,7067,47.486840282335066,11.433666374303913,2219,1,395388,18161,2255,0,501,338
10685,0,0,0,0,51,1,206,1,0,3157791,4331691,40.95119045888654,1437,3800,3560,1677,48138,583758,550179,2343,4260,2823,4466,6383,43.393547907494266,15.785330030454086,1917,1,357201,36240,1883,0,906,700
10686,0,0,0,0,52,1,169,1,0,7880532,7608590,53.786615435440815,2396,6114,5617,2893,51624,568080,628570,2133,5523,3127,5354,8744,52.191953402799555,22.30648200488191,3390,1,691427,51688,2724,0,263,94
10687,0,0,0,0,50,1,262,1,0,2438328,3627336,37.89459064299283,1436,3134,3134,1436,48108,532986,575928,2526,3962,2526,4224,5660,41.20679555607303,0.0,1436,1,327408,0,1698,0,1090,828
10688,0,0,1,0,53,1,206,0,0,335135,1295920,22.02271554554524,332,1329,1176,485,55081,659984,595856,2519,3157,2825,3363,4001,26.28687885618983,12.41189691052956,638,1,108155,23868,691,0,2187,1981
10689,0,0,0,0,52,1,50,1,0,6385104,6525216,50.0199960015992,2378,5178,5054,2502,45570,547680,565936,2484,5110,2732,5160,7786,50.51732376126036,11.388237031910945,2626,1,542934,15500,2552,0,106,56
10690,0,0,0,0,49,1,462,1,0,982963,1949399,28.053520278211074,787,2036,2036,787,42532,537509,485492,2477,3264,2477,3726,4513,35.34119409414458,0.0,787,1,154252,0,1249,0,1690,1228
10691,0,0,0,0,52,1,429,0,1,215622,772794,17.233687939614086,22,1342,1023,297,50292,660908,515196,2283,2899,2921,3328,3944,26.94438717061496,18.975495718103826,616,1,58806,59334,726,0,2305,1876
10692,0,0,0,0,52,1,243,1,0,7627698,7598838,53.72150407425317,2420,5995,5529,2886,44775,523967,592425,2167,5519,3099,5276,8628,51.41011573610781,21.732895534294883,3352,1,649350,47066,2643,0,253,10
10693,0,0,0,0,52,1,234,1,0,4673536,5386240,45.254833995939045,1806,4572,4330,2048,40352,510220,547040,2388,4678,2872,4912,7202,47.77028364998475,15.95519545368323,2290,1,425984,28072,2282,0,582,348
10694,0,0,0,0,49,1,733,0,0,342468,794124,18.0,294,1411,1381,324,52250,612750,512259,2421,2775,2481,3508,3862,32.51153641401772,5.483301264452448,354,0,67716,4860,1057,0,2127,1394
10695,0,0,0,0,48,1,729,0,0,394942,882556,19.026297590440446,332,1483,1453,362,53360,560740,565616,2408,2800,2468,3529,3921,33.03028912982749,5.753771868478424,392,0,83984,3900,1091,0,2076,1347
10696,0,0,0,0,48,1,731,0,0,187332,490440,14.177446878757825,171,1163,1133,201,53816,605120,529480,2410,2641,2470,3372,3603,30.528675044947494,5.490867587491313,231,0,43617,4950,932,0,2239,1508
10697,0,0,0,0,53,1,345,1,0,7306216,7703794,53.67494760127857,2457,5841,5417,2881,36248,492016,526778,2250,5555,3098,5210,8515,50.35871324805669,20.659670300883477,3305,1,567557,48760,2536,0,207,138
10698,0,0,1,0,62,0,5204,0,0,1785221,1014220,17.97220075561143,53,6120,5850,323,54264,715920,747320,2870,3463,3410,8667,9260,74.34379597518544,16.478863475110064,593,0,76874,32400,5527,1,2817,2387
10699,0,0,1,0,53,1,12,0,0,5225760,6067080,47.74934554525329,2156,4696,4572,2280,28416,510912,393828,2537,4941,2785,4953,7357,47.8748368143433,11.793485665503141,2404,1,337440,21948,2292,0,381,369
10700,0,0,0,0,50,1,668,1,0,876480,1680360,25.69046515733026,593,2055,1988,660,38925,572850,440458,2479,3206,2613,3874,4601,36.4417343165772,8.521468497772455,727,1,114180,12797,1328,0,1886,1218
10701,0,0,1,0,63,0,5287,0,0,2421464,1337296,20.591260281974,22,6581,6135,424,53336,712804,744344,2708,3578,3600,8865,9735,75.57115851963631,21.139490519643243,870,0,100064,53520,5711,1,2730,2557
10702,0,0,0,0,54,1,423,1,0,7076160,7810560,53.665631459994955,2514,5703,5337,2880,34944,493584,520704,2346,5592,3078,5169,8415,49.56813492557492,19.16108320217453,3246,1,552960,43188,2457,0,168,255
10703,0,0,1,0,63,0,5329,0,0,2439272,1339840,20.591260281974,46,6647,6177,424,51736,704680,733120,2690,3584,3630,8913,9807,75.8485332752058,21.738154294342262,894,0,98368,57340,5753,1,2736,2593
10704,0,0,1,0,62,0,5320,0,0,2178164,1202154,19.544820285692065,42,6508,6084,382,54285,726957,739545,2723,3529,3571,8849,9655,75.51158851461145,20.612103242357982,806,0,89770,54272,5702,1,2765,2555
10705,0,0,0,0,56,1,667,1,0,9054534,9437688,57.97413216254298,2743,6673,6055,3361,45344,612144,584064,2190,6169,3426,5502,9481,51.90375708944392,24.95306800861016,3979,1,699088,90228,2694,0,553,114
10706,0,0,0,0,51,1,639,1,0,701632,1478851,24.020824298928627,385,1985,1793,577,47250,576675,538230,2371,3140,2755,3779,4548,34.87119154832539,14.042896465990824,769,1,121170,29184,1216,0,1986,1347
10707,0,0,1,0,55,1,28,0,0,4355373,5715261,45.53020975132884,1738,4509,4174,2073,33698,457662,559671,2422,4830,3092,4858,7266,45.83666654546336,18.303005217723125,2408,1,420819,28140,2101,0,684,656
10708,0,0,0,0,51,1,603,1,0,1941148,2911160,33.52610922848042,1124,2851,2851,1124,47080,554260,569800,2590,3714,2590,4317,5441,41.557189510360296,0.0,1124,1,247280,0,1727,0,1466,863
10709,0,0,0,0,56,1,779,1,0,8536046,9460395,57.766772456144714,2812,6420,5895,3337,45780,618030,595350,2310,6172,3360,5393,9255,50.57667446560717,22.922930663405353,3862,1,700770,75600,2558,0,502,277
10710,0,0,0,0,56,1,110,1,0,4008984,5787096,45.36518488885502,1866,4198,4006,2058,45510,576460,624264,2620,4870,3004,4760,7010,44.13615298142782,13.897662509711425,2250,1,456876,21696,1948,0,754,864
10711,0,0,0,0,51,1,559,1,0,1021232,1987865,27.730849247724095,674,2192,2097,769,52538,622985,563530,2490,3354,2680,3913,4777,36.4417343165772,9.759997214798725,864,1,167642,15200,1328,0,1816,1257
10712,0,0,0,0,51,1,544,1,0,974592,1941664,27.422618401604176,667,2133,2048,752,54366,635172,570622,2497,3334,2667,3878,4715,36.0,9.227509513928014,837,1,166192,13515,1296,0,1830,1286
10713,0,0,0,0,54,1,118,1,0,3240120,4715594,41.737273509418415,1742,3602,3602,1742,48111,549521,641559,2707,4449,2707,4567,6309,43.12771730569565,0.0,1742,1,412854,0,1860,0,965,847
10714,0,0,0,0,51,1,546,1,0,1513071,2556330,31.416556144810016,834,2673,2520,987,50388,572390,590520,2437,3577,2743,4123,5263,39.153543900903784,12.388295554641243,1140,1,225036,19278,1533,0,1603,1057
10715,0,0,0,0,51,1,541,1,0,1301586,2325356,30.033314835362415,835,2412,2345,902,52899,595518,590362,2511,3480,2645,4021,4990,37.986839826445156,8.18535277187245,969,1,206558,9112,1443,0,1676,1135
10716,0,0,0,0,51,1,525,1,0,932094,1903302,27.16615541441225,671,2068,2001,738,53924,629276,569959,2512,3317,2646,3842,4647,35.53871128783372,8.187175587434018,805,1,163098,10586,1263,0,1841,1316
10717,0,0,0,0,51,1,400,1,0,298724,982504,19.544820285692065,85,1461,1164,382,45570,540120,558124,2275,2954,2869,3354,4033,27.964262908219126,17.303788837718695,679,1,82894,37125,782,0,2190,1790
10718,0,0,0,0,52,1,530,1,0,1848000,2932160,33.46640106136302,930,2960,2770,1120,46620,549780,581196,2428,3738,2808,4268,5578,40.620192023179804,13.790153968403581,1310,1,248640,22800,1650,0,1498,968
10719,0,0,0,0,51,1,501,1,0,1081080,2110563,28.61817604250837,819,2139,2139,819,50127,595287,559209,2577,3396,2577,3897,4716,36.3318042491699,0.0,819,1,177723,0,1320,0,1758,1257
10720,0,0,1,0,56,1,776,0,0,6064505,8095610,53.67494760127857,2851,5016,4986,2881,54808,621010,696880,2780,5691,2840,4915,7826,45.880278987817846,5.514871952411144,2911,1,714488,2820,2105,0,71,705
10721,0,0,0,0,51,1,473,1,0,931110,1948518,27.51363298439521,757,1987,1987,757,53128,589446,597168,2574,3331,2574,3804,4561,35.07135583350036,0.0,757,1,175624,0,1230,0,1817,1344
10722,0,0,0,0,51,1,450,1,0,900000,1925250,27.386127875258307,720,1980,1950,750,54014,580142,613513,2537,3317,2597,3767,4547,34.64101615137755,5.531194905403055,780,1,179250,3480,1200,0,1817,1367
10723,0,0,0,0,51,1,444,0,1,849420,1860012,26.94438717061496,726,1896,1896,726,55221,596946,607194,2562,3288,2562,3732,4458,34.20526275297414,0.0,726,1,172062,0,1170,0,1836,1392
10724,0,0,0,0,51,1,420,1,0,824524,1844710,26.870057685088806,722,1864,1864,722,54984,592760,605535,2555,3277,2555,3697,4419,33.793490497431605,0.0,722,1,171114,0,1142,0,1833,1413
10725,0,0,0,0,51,1,401,1,0,849992,1896879,27.258026340878022,713,1917,1887,743,53100,574425,602508,2523,3296,2583,3697,4470,33.823069050575526,5.478746393072713,773,1,175348,3600,1144,0,1810,1409
10726,0,0,0,0,50,1,306,1,0,704200,1771000,26.457513110645905,700,1706,1706,700,55454,602140,589490,2530,3230,2530,3536,4236,31.71750305430741,0.0,700,1,163100,0,1006,0,1830,1524
10727,0,0,0,0,47,1,5,0,0,132126,863151,19.0,361,727,727,361,52488,581013,516456,2391,2752,2391,2757,3118,19.131126469708992,0.0,361,0,77976,0,366,0,2030,2025
10728,0,0,0,0,47,1,18,0,0,159120,934050,19.748417658131498,360,828,798,390,54282,522110,596355,2365,2785,2425,2803,3223,20.199009876724155,5.501408174353464,420,0,97110,2640,408,0,2005,1987
10729,0,0,0,0,48,1,20,1,0,108141,829533,18.411952639521967,249,748,658,339,20181,530999,227571,2357,2786,2537,2766,3195,17.86057109949175,10.195209251481318,429,1,31527,22230,319,0,2108,2128
10730,0,0,0,0,48,1,324,0,1,23040,145440,7.745966692414834,0,504,444,60,53110,547824,569640,2364,2484,2484,2808,2928,19.595917942265423,7.7992067098508295,120,1,14100,7260,384,0,2364,2040
10731,0,0,1,0,57,1,977,0,0,4911998,7907186,52.51666402200353,2490,4807,4539,2758,36417,524661,570533,2599,5625,3135,4648,7674,42.20189569201838,16.53439366152476,3026,1,548842,30016,1781,0,109,1086
10732,0,0,0,0,47,1,6,0,0,178920,1003800,20.493901531919196,420,846,846,420,55418,547310,578380,2390,2810,2390,2816,3236,20.639767440550294,0.0,420,0,101640,0,426,0,1970,1964
10733,0,0,1,0,57,1,1080,0,0,5468400,8426040,54.22176684690383,2700,5040,4800,2940,38130,587530,533076,2626,5806,3106,4726,7906,43.12771730569565,15.67744954089078,3180,1,546840,37200,1860,0,74,1006
10734,0,0,0,0,55,1,385,1,0,2726850,5108670,43.069710934716056,1855,3325,3325,1855,49104,545292,682992,2754,4609,2754,4224,6079,38.34057902536163,0.0,1855,1,460040,0,1470,0,899,1284
10735,0,0,0,0,49,1,192,0,1,497728,1529528,24.819347291981714,616,1424,1424,616,56069,563641,613301,2483,3099,2483,3291,3907,28.42534080710379,0.0,616,1,152152,0,808,0,1867,1675
10736,0,0,0,0,51,1,238,1,0,894048,2147550,28.879058156387302,707,2033,1906,834,44492,504700,584525,2448,3409,2702,3647,4608,32.7414110874898,11.593364526831646,961,1,189318,11938,1072,0,1741,1503
10737,0,0,0,0,49,1,174,1,0,489456,1523988,24.859605789312106,588,1440,1410,618,52819,544986,589374,2436,3084,2496,3258,3906,28.142494558940577,5.830951894845301,648,1,147702,3300,792,0,1848,1674
10738,0,0,0,0,48,1,260,0,1,31500,218430,9.486832980505138,92,622,440,90,54312,531513,601896,2245,2517,2609,2777,3049,18.708286933869708,13.497249324540688,272,1,22320,16926,350,0,2337,2077
10739,0,0,0,0,47,1,95,0,1,0,0,0.0,108,203,95,0,52360,570248,527120,2288,2396,2504,2491,2599,9.746794344808963,10.406531168715494,108,1,0,16740,95,0,2396,2301
10740,0,0,0,0,47,1,18,0,0,349200,1430400,24.49489742783178,600,1182,1182,600,48175,560240,488720,2384,2984,2384,2966,3566,24.124676163629637,0.0,600,0,123000,0,582,0,1784,1802
10741,0,0,0,0,47,1,74,0,1,8040,142380,7.745966692414834,7,261,194,60,53383,600369,500703,2306,2433,2440,2507,2634,11.575836902790225,8.361900766312248,127,1,12660,11323,134,0,2313,2239
10742,0,0,0,0,47,1,48,0,1,6480,142620,7.745966692414834,25,253,168,60,52070,603758,487285,2292,2437,2462,2485,2630,10.392304845413264,9.412769291411893,145,1,12300,15130,108,0,2317,2269
10743,0,0,0,0,47,1,15,0,0,341584,1413104,24.331050121192877,592,1169,1169,592,53928,601524,510818,2387,2979,2387,2964,3556,24.020824298928627,0.0,592,0,126688,0,577,0,1795,1810
10744,0,0,0,0,57,1,982,1,0,2870615,6492145,47.486840282335066,2080,3703,3528,2255,45815,538373,705355,2704,5134,3054,4152,6582,35.679125549822544,13.601470508735444,2430,1,552475,9800,1273,0,624,1606
10745,0,0,0,0,56,1,854,1,0,2593227,5933655,45.749316934791494,1998,3427,3332,2093,53590,660555,652050,2740,4928,2930,4074,6262,35.199431813596085,9.815189597405173,2188,1,481390,12920,1239,0,742,1596
10746,0,0,0,0,53,1,205,1,0,2047284,4123771,39.20459156782532,1357,3049,2869,1537,46330,606358,550015,2503,4220,2863,4015,5732,36.49657518178932,13.421477552349653,1717,1,315085,28800,1332,0,1146,1351
10747,0,0,0,0,52,1,27,0,1,1986508,3743913,37.72267222772003,1363,2879,2819,1423,43575,460425,655119,2571,4054,2691,4027,5510,37.36308338453881,7.994134176674909,1483,1,354327,1860,1396,0,1208,1235
10748,0,0,0,0,58,1,1237,1,0,3752580,7722624,51.49757275833493,2291,4428,4067,2652,53502,646464,701792,2551,5564,3273,4327,7340,37.61648574760805,19.4042153059401,3013,1,639132,39710,1415,0,260,1497
10749,0,0,0,0,52,1,150,1,0,1926475,3466340,36.26292872893749,1195,2900,2780,1315,41990,651092,448120,2516,3951,2756,4101,5536,38.27531841800928,11.40175425099138,1435,1,223550,25680,1465,0,1321,1171
10750,0,0,0,0,47,1,177,0,0,25840,225245,9.746794344808963,95,367,367,95,52416,531104,554814,2371,2466,2371,2643,2738,16.492422502470642,0.0,95,0,22230,0,272,0,2276,2099
10751,0,0,0,0,47,1,37,0,1,2010,159192,8.18535277187245,23,187,97,67,42579,591624,406296,2286,2443,2466,2406,2563,5.477225575051661,9.638070910968185,157,1,11457,19170,30,0,2309,2346
10752,0,0,0,0,47,1,13,1,0,408918,1507173,25.15949125081825,603,1309,1279,633,42612,504772,478581,2351,3014,2411,3027,3690,25.41653005427767,5.572104574801163,663,1,127233,4440,646,0,1748,1735
10753,0,0,0,0,47,1,98,0,0,314568,1231030,22.67156809750927,514,1126,1126,514,49938,589170,486185,2395,2909,2395,3007,3521,24.73863375370596,0.0,514,0,104342,0,612,0,1881,1783
10754,0,0,0,0,47,1,169,1,0,29916,256716,10.392304845413264,108,385,385,108,44304,494416,506301,2377,2485,2377,2654,2762,16.64331697709324,0.0,108,1,23004,0,277,0,2269,2100
10755,0,0,0,0,58,1,1332,1,0,3816540,7998900,52.24940191045253,2354,4504,4128,2730,49368,597720,709060,2554,5660,3306,4328,7434,37.389838191679836,19.905615212982802,3106,1,660660,31960,1398,0,200,1532
10756,0,0,0,0,53,1,275,1,0,1976250,4140050,39.370039370059054,1400,2975,2825,1550,54033,579607,665079,2521,4221,2821,3946,5646,35.70714214271425,12.740029376818088,1700,1,385950,13350,1275,0,1121,1396
10757,0,0,0,0,47,1,158,1,0,36195,302768,11.269427669584644,97,442,412,127,45154,510176,503024,2354,2511,2414,2669,2826,16.881943016134134,5.531194905403055,157,1,26797,4140,285,0,2257,2099
10758,0,0,0,0,47,1,148,1,0,27648,257040,10.392304845413264,66,406,364,108,43581,473620,521220,2338,2488,2422,2636,2786,16.0,6.488991180673202,150,1,23652,4620,256,0,2272,2124
10759,0,0,1,0,56,1,1529,0,0,6595260,9743076,58.68560300448484,3402,5401,5359,3444,51865,715737,579945,2787,6273,2871,4744,8230,43.76071297408213,6.63067838716079,3486,1,706020,7602,1915,0,615,914
10760,0,0,0,0,49,1,17,1,0,651984,2001648,28.5657137141714,604,1827,1615,816,48755,488147,600985,2241,3269,2665,3252,4280,28.26658805020514,14.900873568745732,1028,1,199920,15688,799,0,1637,1654
10761,0,0,0,0,48,1,17,1,0,624818,1952756,28.26658805020514,607,1773,1581,799,49629,520572,569452,2252,3243,2636,3226,4217,27.964262908219126,14.152112943504028,991,1,186167,21120,782,0,1645,1662
10762,0,0,0,0,48,1,25,1,0,507500,1689800,26.457513110645905,592,1533,1425,700,37932,420036,526252,2306,3114,2522,3139,3947,26.92582403567252,10.748049169056976,808,1,152600,8208,725,0,1714,1689
10763,0,0,0,0,48,1,175,1,0,298706,1119332,21.587033144922902,436,1137,1107,466,47718,578882,475596,2372,2868,2432,3043,3539,25.317977802344327,5.478746393072713,496,1,92268,5460,641,0,1936,1761
10764,0,0,0,0,48,1,174,1,0,237456,982464,20.199009876724155,378,1020,990,408,48048,556248,500864,2378,2816,2438,2990,3428,24.124676163629637,5.490867587491313,438,1,84864,4830,582,0,2000,1826
10765,0,0,0,0,47,1,169,1,0,117116,641860,16.3707055437449,208,765,705,268,47073,510135,529295,2335,2663,2455,2832,3160,20.904544960366874,7.7992067098508295,328,1,59228,7500,437,0,2127,1958
10766,0,0,0,0,47,1,159,1,0,67392,458496,13.856406460551018,132,603,543,192,47234,539688,499092,2328,2580,2448,2739,2991,18.734993995195193,7.765259411425052,252,1,40128,9300,351,0,2196,2037
10767,0,0,0,0,47,1,145,1,0,44250,358350,12.24744871391589,90,505,445,150,46200,525580,501690,2329,2539,2449,2684,2894,17.175564037317667,7.789174875971784,210,1,31500,8760,295,0,2239,2094
10768,0,0,0,0,48,1,36,0,1,22780,408170,13.038404810405298,20,454,304,170,36873,578641,367353,2251,2571,2551,2535,2855,11.575836902790225,12.54961581009077,320,1,26010,33450,134,0,2231,2267
10769,0,0,0,0,53,1,475,1,0,1958574,4440760,40.70626487409524,1429,3067,2839,1657,54492,611040,640520,2452,4337,2908,3862,5747,34.38022687534217,15.152330459825967,1885,1,396023,26904,1182,0,1023,1498
10770,0,0,0,0,53,1,406,1,0,1946891,4301871,40.162171256046406,1431,3002,2820,1613,55216,618744,634746,2485,4280,2849,3874,5669,34.741905532080416,13.854620689726602,1795,1,383894,22568,1207,0,1054,1460
10771,0,0,0,0,49,1,17,1,0,692984,2063814,29.0,607,1899,1665,841,40363,444174,547242,2220,3295,2688,3278,4353,28.705400188814647,15.601376800644807,1075,1,187543,18486,824,0,1613,1630
10772,0,0,0,0,47,1,124,1,0,419957,1410655,24.269322199023193,499,1392,1302,589,37818,457445,474210,2305,2984,2485,3108,3787,26.70205984563738,9.52871847115494,679,1,116622,11070,713,0,1806,1682
10773,0,0,0,0,48,1,171,1,0,246202,1007798,20.445048300260872,358,1067,1007,418,37492,496666,438802,2351,2829,2471,3000,3478,24.269322199023193,7.7992067098508295,478,1,76076,9600,589,0,1993,1822
10774,0,0,0,0,48,1,165,1,0,146466,742836,17.578395831246947,214,878,783,309,38773,459164,488012,2309,2713,2499,2878,3282,21.77154105707724,9.747874142570481,404,1,62727,11115,474,0,2095,1930
10775,0,0,0,0,47,1,121,1,0,45846,387504,12.727922061357855,67,540,445,162,54502,547768,569296,2297,2554,2487,2675,2932,16.822603841260722,9.785443037298442,257,1,38556,11400,283,0,2230,2109
10776,0,0,0,0,48,1,157,1,0,137100,723900,17.320508075688775,180,877,757,300,35292,417449,492252,2293,2713,2533,2870,3290,21.37755832643195,11.100602434372421,420,1,61200,10920,457,0,2113,1956
10777,0,0,0,0,46,1,10,0,0,34200,422100,13.416407864998739,138,412,370,180,39935,574525,382235,2303,2525,2387,2535,2757,13.784048752090222,6.538739683827756,222,0,29340,9156,190,0,2165,2155
10778,0,0,0,0,51,1,278,0,1,1907223,3950349,39.07684736515984,1497,2806,2776,1527,46656,496704,628641,2557,4114,2617,3836,5393,35.34119409414458,5.5503012171862105,1557,1,371061,2010,1249,0,1060,1338
10779,0,0,0,0,49,1,87,1,0,582568,1770776,26.851443164195103,546,1704,1529,721,30970,400328,466640,2281,3177,2631,3264,4160,28.42534080710379,13.770090784684108,896,1,136990,16450,808,0,1735,1648
10780,0,0,0,0,48,1,143,1,0,495444,1551204,25.219040425836983,486,1565,1415,636,25950,365850,421947,2289,3075,2589,3218,4004,27.910571473905726,12.653555250482114,786,1,110028,14400,779,0,1803,1660
10781,0,0,0,0,48,1,171,1,0,434250,1405812,24.06241883103193,429,1479,1329,579,27370,390908,412760,2278,3007,2578,3178,3907,27.386127875258307,12.345470001201512,729,1,98430,17100,750,0,1849,1678
10782,0,0,0,0,52,1,127,0,1,1904510,3765670,38.01315561749642,1355,2853,2763,1445,38097,648894,398718,2516,4051,2696,3924,5459,36.30426972134269,9.724035232351886,1535,1,221085,19890,1318,0,1161,1288
10783,0,0,0,0,51,1,137,1,0,1591740,3096245,34.56877203488721,979,2743,2527,1195,48160,557065,580384,2375,3786,2807,3923,5334,36.49657518178932,14.815282538179423,1411,1,267680,26784,1332,0,1396,1259
10784,0,0,0,0,49,1,72,1,0,676033,1957269,28.053520278211074,553,1880,1646,787,32472,407868,492426,2253,3274,2721,3346,4367,29.30870177950569,16.00219681314721,1021,1,155826,20124,859,0,1700,1628
10785,0,0,0,0,49,1,105,1,0,611116,1806301,27.03701166919155,530,1768,1567,731,31248,415128,459606,2270,3202,2672,3307,4239,28.91366458960192,14.812821783183203,932,1,135966,21306,836,0,1740,1635
10786,0,0,0,0,48,1,164,1,0,343740,1248990,22.58317958127243,360,1334,1184,510,27302,457963,357554,2299,2959,2599,3123,3783,25.96150997149434,12.54961581009077,660,1,74460,25800,674,0,1939,1775
10787,0,0,0,0,49,1,156,0,1,230112,1006944,20.199009876724155,246,1134,972,408,27058,402284,409688,2306,2876,2630,3032,3602,23.748684174075834,13.240404067118192,570,1,67728,19602,564,0,2060,1904
10788,0,0,0,0,46,1,43,0,1,67920,559680,15.491933384829668,240,523,523,240,56635,548020,562012,2332,2572,2332,2615,2855,16.822603841260722,0.0,240,1,57840,0,283,0,2092,2049
10789,0,0,0,0,52,1,84,0,1,1899877,3735809,37.69615364994153,1271,2908,2758,1421,42500,657250,446930,2479,4050,2779,3966,5537,36.565010597564445,13.1493192969221,1571,1,241570,32100,1337,0,1208,1292
10790,0,0,0,0,46,1,15,0,0,75844,624976,16.3707055437449,226,593,551,268,39324,527032,405768,2290,2600,2374,2615,2925,16.822603841260722,6.484411467763075,310,0,46632,8064,283,0,2064,2049
10791,0,0,0,0,50,1,34,1,0,932867,2398123,30.805843601498726,587,2294,1932,949,48608,548359,566048,2165,3476,2889,3510,4821,31.352830813181765,19.045469988444534,1311,1,212576,45974,983,0,1578,1544
10792,0,0,0,0,47,1,94,0,1,134691,768094,17.97220075561143,233,830,740,323,47941,454198,596878,2288,2701,2468,2795,3208,20.42057785666214,9.924141172814958,413,1,81073,4500,417,0,2055,1961
10793,0,0,0,0,49,1,124,0,1,374381,1358721,23.515952032609693,468,1315,1230,553,46872,619164,457002,2372,3010,2542,3134,3772,26.019223662515376,9.300149152818726,638,1,102858,17085,677,0,1904,1780
10794,0,0,0,0,46,1,26,0,1,103515,723369,17.578395831246947,279,674,644,309,49335,456495,592273,2311,2650,2371,2676,3015,18.303005217723125,5.5965095842615735,339,1,78177,1530,335,0,2032,2006
10795,0,0,0,0,46,1,25,0,0,73014,601398,16.06237840420901,228,571,541,258,39360,559440,382284,2301,2589,2361,2614,2902,16.822603841260722,5.477225575051661,288,0,42312,6420,283,0,2073,2048
10796,0,0,0,0,52,1,708,1,0,1795680,4577940,41.71330722922842,1558,2954,2772,1740,52824,560403,652488,2449,4371,2813,3663,5585,32.12475680841802,13.74811193271127,1922,1,431520,15652,1032,0,891,1599
10797,0,0,0,0,49,1,141,1,0,696436,1892956,27.694764848252458,647,1795,1675,767,50838,547896,565172,2348,3235,2588,3376,4263,30.133038346638727,11.07142749248319,887,1,175643,15000,908,0,1701,1560
10798,0,0,0,0,52,1,904,1,0,1738932,4878978,42.96510211788167,1786,2848,2788,1846,55278,658107,586746,2583,4489,2703,3585,5491,30.692018506445613,7.780166052320878,1906,1,409812,9300,942,0,797,1701
10799,0,0,0,0,51,1,593,0,1,1817868,4318275,40.95119045888654,1592,2846,2761,1677,37355,399125,620575,2490,4252,2660,3659,5421,32.92415526630866,9.548881526149486,1762,1,404157,1105,1084,0,898,1491
10800,0,0,0,0,51,1,338,0,1,1875839,3971636,39.35733730830886,1482,2827,2760,1549,34263,623052,361524,2497,4113,2631,3775,5391,34.79942528261063,8.667941798665202,1616,1,218409,14338,1211,0,1015,1353
10801,0,0,0,0,52,1,91,1,0,1964936,3543127,36.837480912787726,1015,3147,2805,1357,50388,644917,532644,2269,3968,2953,4059,5758,38.05259518088089,19.127840843987745,1699,1,276828,61902,1448,0,1254,1163
10802,0,0,0,0,49,1,126,1,0,754672,2003840,28.42534080710379,655,1895,1742,808,43758,491040,548080,2327,3288,2633,3414,4375,30.56141357987225,12.546325833189906,961,1,178568,16218,934,0,1672,1546
10803,0,0,0,0,50,1,423,0,1,1858288,4033185,39.88734135035826,1561,2789,2759,1591,45864,638820,461370,2505,4126,2565,3703,5324,34.17601498127012,5.514871952411144,1621,1,289562,5730,1168,0,944,1367
10804,0,0,0,0,52,1,805,0,1,1746536,4683000,42.23742416388575,1614,2933,2763,1784,49729,585375,585375,2455,4409,2795,3604,5558,31.28897569432403,13.159533562430733,1954,1,397832,22780,979,0,841,1646
10805,0,0,0,0,52,1,764,0,1,1755717,4599732,41.96427051671457,1627,2892,2758,1761,41968,449264,637328,2478,4373,2746,3609,5504,31.575306807693888,12.391975741304819,1895,1,429684,4824,997,0,851,1615
10806,0,0,0,0,50,1,598,0,1,1779288,4178328,40.8166632639171,1636,2764,2734,1666,48000,481536,627000,2478,4174,2538,3576,5272,32.68026927673638,5.477225575051661,1696,1,416500,1620,1068,0,842,1440
10807,0,0,0,0,55,1,1674,0,1,4223392,8425392,55.281099844341014,3056,4438,4438,3056,52070,700278,565185,2757,5813,2757,4139,7195,37.17526059088221,0.0,3056,1,626480,0,1382,0,299,1375
10808,0,0,0,0,54,1,1613,1,0,1494318,6138513,47.65501022977542,2271,2929,2929,2271,53502,600066,651423,2703,4974,2703,3361,5632,25.65151067676132,0.0,2271,1,547311,0,658,0,432,2045
10809,0,0,0,0,56,1,1653,1,0,5175718,9211739,56.9824534396335,3013,5075,4841,3247,48039,570237,678043,2603,6084,3071,4431,7912,39.92492955535426,15.550568514571738,3481,1,776033,19890,1594,0,410,1243
10810,0,0,0,0,53,1,1483,1,0,1018934,5333950,44.654227123532216,1994,2505,2505,1994,53463,671425,569775,2675,4669,2675,3186,5180,22.60530911091463,0.0,1994,1,424722,0,511,0,681,2164
10811,0,0,0,0,51,1,43,0,1,1807218,3438477,36.373066958946424,1196,2816,2689,1323,48576,657547,499008,2472,3922,2726,3965,5415,36.959437225152655,11.579381003458169,1450,1,254016,23495,1366,0,1276,1233
10812,0,0,0,0,56,1,1679,0,1,2558682,7474950,51.43928459844674,2412,3847,3613,2646,44678,709075,502850,2591,5471,3059,3792,6672,31.096623610932426,16.273428347107732,2880,1,470988,44460,967,0,179,1858
10813,0,0,0,0,52,1,1152,1,0,1051200,4597248,41.8568990729127,1562,2542,2352,1752,54502,600896,624512,2434,4376,2814,3224,5166,24.49489742783178,13.830019647711413,1942,1,416976,22990,600,0,872,2024
10814,0,0,0,0,49,1,457,0,1,1506540,3655575,38.43175770115127,1417,2557,2497,1477,41895,423225,606375,2415,3952,2535,3495,5032,31.937438845342623,7.759379671981613,1537,1,361865,0,1020,0,998,1455
10815,0,0,0,0,49,1,232,0,1,1671348,3533586,37.603191353926334,1324,2686,2596,1414,41164,627249,409836,2409,3913,2589,3681,5185,34.38022687534217,9.845454104733873,1504,1,231896,19260,1182,0,1085,1317
10816,0,0,0,0,51,1,35,0,1,1753994,3394279,36.15245496505044,1173,2783,2649,1307,49022,659638,501221,2463,3904,2731,3939,5380,36.6333181680284,11.837739672445862,1441,1,252251,24790,1342,0,1290,1255
10817,0,0,0,0,47,1,42,0,1,77400,616620,16.06237840420901,150,666,558,258,49104,592720,473220,2282,2648,2498,2690,3056,17.320508075688775,10.669676460233537,366,1,51084,20412,300,0,2132,2090
10818,0,0,0,0,47,1,42,0,1,102600,712200,17.320508075688775,233,709,642,300,45287,600622,424946,2307,2674,2441,2716,3083,18.49324200890693,8.361900766312248,367,1,53700,13802,342,0,2074,2032
10819,0,0,0,0,52,1,1191,1,0,921150,4522950,41.53311931459037,1485,2499,2259,1725,54635,584706,642390,2382,4347,2862,3156,5121,23.108440016582687,15.588127267775322,1965,1,422625,24960,534,0,897,2088
10820,0,0,0,0,51,1,106,0,1,1766091,3271674,35.73513677041127,1192,2745,2660,1277,48070,648186,486780,2477,3839,2647,3945,5307,37.1887079635741,9.443791641391353,1362,1,242630,15810,1383,0,1285,1179
10821,0,0,0,0,49,1,142,0,1,1552463,3285629,36.318039594669756,1234,2581,2496,1319,38595,620259,386105,2406,3810,2576,3668,5072,34.307433596816885,9.607770959340817,1404,1,204445,18955,1177,0,1172,1314
10822,0,0,0,0,51,1,168,1,0,1815444,3263748,35.58089374931439,1181,2785,2700,1266,52890,554270,634188,2493,3844,2663,4012,5363,37.86819245752297,9.265143265380413,1351,1,311436,7735,1434,0,1312,1144
10823,0,0,0,0,47,1,79,0,1,95472,645456,16.492422502470642,145,750,623,272,55932,560028,562401,2246,2645,2500,2724,3123,18.734993995195193,11.377048979465448,399,1,64464,16256,351,0,2101,2022
10824,0,0,0,0,54,1,1672,1,0,1054080,5918400,46.475800154489,1932,2876,2648,2160,53568,591840,679520,2512,4900,2968,3228,5616,22.090722034374522,15.220284956002983,2388,1,535680,20292,488,0,580,2252
10825,0,0,0,0,50,1,202,0,1,1745424,3101616,34.9857113690718,1194,2680,2650,1224,54467,636034,549878,2504,3758,2564,3960,5214,37.76241517699841,5.477225575051661,1254,1,265608,4770,1426,0,1310,1108
10826,0,0,0,0,49,1,41,1,0,497310,1707705,26.1725046566048,457,1639,1411,685,39008,458712,528516,2265,3178,2721,3219,4132,26.94438717061496,15.67997926561349,913,1,145220,22344,726,0,1808,1767
10827,0,0,0,0,52,1,39,0,1,1149876,2760966,32.449961479175904,747,2451,2145,1053,49082,663366,508668,2316,3675,2928,3714,5073,33.04542328371661,18.658146044588314,1359,1,204282,55386,1092,0,1569,1530
10828,0,0,0,0,56,1,1614,0,1,4810320,8900664,56.07138307550475,2760,5058,4674,3144,53130,716243,594510,2447,5975,3215,4361,7889,39.11521443121589,19.826248876169714,3528,1,660240,66432,1530,0,313,1301
10829,0,0,0,0,50,1,794,1,0,983015,3726960,38.27531841800928,1435,2166,2136,1465,51600,546960,610560,2514,4009,2574,3215,4710,25.903667693977237,5.483301264452448,1495,1,351600,3060,671,0,1079,1873
10830,0,0,0,0,52,1,40,0,1,1056384,2628864,31.74901573277509,647,2417,2056,1008,54520,612880,605056,2247,3616,2969,3656,5025,32.37282811247729,19.791286831170876,1369,1,233856,41515,1048,0,1600,1560
10831,0,0,0,0,50,1,605,0,1,1056606,3466602,37.067505985701274,1344,2173,2143,1374,55902,582813,610566,2493,3897,2553,3292,4696,27.730849247724095,5.531194905403055,1404,1,332508,3150,769,0,1149,1754
10832,0,0,0,0,49,1,63,0,0,1376110,2952250,34.713109915419565,1175,2377,2347,1205,48636,617400,472850,2420,3655,2480,3592,4827,33.793490497431605,5.5503012171862105,1235,0,232565,5400,1142,0,1245,1308
10833,0,0,0,0,50,1,679,1,0,969462,3495311,37.16180835212409,1351,2113,2083,1381,51788,541634,612502,2501,3912,2561,3233,4644,26.49528259898354,5.483301264452448,1411,1,334202,2940,702,0,1150,1829
10834,0,0,0,0,51,1,40,0,1,896409,2381463,30.44667469527666,481,2340,1894,927,55822,634543,580594,2123,3496,3015,3536,4909,31.096623610932426,21.82293485004397,1373,1,209502,67346,967,0,1642,1602
10835,0,0,0,0,54,1,1677,0,1,1009090,5882780,46.33573135281238,1900,2864,2617,2147,56880,657600,649380,2493,4887,2987,3210,5604,21.6794833886788,16.558124265379583,2394,1,508839,31863,470,0,593,2270
10836,0,0,0,0,51,1,944,1,0,769232,3805056,38.31448812133603,1293,2167,1992,1468,49088,539136,611712,2417,4060,2767,3116,4759,22.891046284519195,13.43304388518588,1643,1,346448,17325,524,0,1124,2068
10837,0,0,0,0,54,1,1581,0,1,5089600,8709578,56.4003546088143,2868,5094,4781,3181,36803,676286,407962,2425,5919,3051,4338,7832,40.0,18.06997837734952,3494,1,473969,68234,1600,0,443,1138
10838,0,0,0,0,50,1,466,1,0,1012800,3167532,35.58089374931439,1236,2096,2066,1266,42848,515412,520416,2472,3768,2532,3302,4598,28.284271247461902,5.478746393072713,1296,1,263328,3960,800,0,1236,1702
10839,0,0,0,0,49,1,119,1,0,1196580,2833215,33.98529093593286,1155,2191,2191,1155,45254,458711,593626,2453,3608,2453,3489,4644,32.18695387886216,0.0,1155,1,279510,0,1036,0,1298,1417
10840,0,0,0,0,48,1,77,1,0,1216230,2783054,33.793490497431605,1142,2207,2207,1142,46656,467904,592191,2437,3579,2437,3502,4644,32.63433774416144,0.0,1142,1,277506,0,1065,0,1295,1372
10841,0,0,0,0,48,1,44,0,0,1280940,2690640,33.31666249791537,1110,2264,2264,1110,54500,606000,528432,2424,3534,2424,3578,4688,33.97057550292606,0.0,1110,0,241980,0,1154,0,1314,1270
10842,0,0,0,0,49,1,231,0,1,1394442,2651796,32.72613634390714,947,2497,2373,1071,43010,626428,420920,2352,3547,2600,3778,4973,36.08323710533743,11.64690025978279,1195,1,182070,26040,1302,0,1405,1174
10843,0,0,0,0,49,1,267,0,1,1418580,2650785,32.63433774416144,912,2550,2397,1065,43092,627228,425619,2336,3554,2642,3821,5039,36.49657518178932,12.939497000677182,1218,1,182115,31671,1332,0,1424,1157
10844,0,0,0,0,54,1,1677,0,1,738118,5537924,45.155287619502545,1889,2551,2401,2039,56400,651840,638260,2566,4755,2866,3078,5267,19.026297590440446,12.296281753706847,2189,1,479165,19950,362,0,677,2354
10845,0,0,0,0,50,1,312,1,0,1055185,2987500,34.56877203488721,1165,2108,2078,1195,39270,467500,525000,2470,3695,2530,3383,4608,29.715315916207253,5.623413251903491,1225,1,250950,3120,883,0,1305,1617
10846,0,0,0,0,50,1,185,0,1,1038996,2343327,30.512292604784715,601,2377,2047,931,50882,621699,518502,2187,3448,2847,3633,4894,33.406586176980134,18.319130009366607,1261,1,191786,51480,1116,0,1586,1401
10847,0,0,0,0,56,1,1573,0,1,4495800,8534400,55.20869496736904,2669,4902,4523,3048,55822,691600,632800,2421,5848,3179,4275,7702,38.40572873934304,20.401055743101512,3427,1,688848,54955,1475,0,248,1325
10848,0,0,0,0,53,1,1680,1,0,465124,5181712,43.840620433565945,1892,2194,2164,1922,55460,636256,633560,2666,4618,2726,2938,4890,15.556349186104045,5.477225575051661,1952,1,451670,3960,242,0,774,2454
10849,0,0,0,0,53,1,1674,1,0,273600,4879200,42.708313008125245,1824,1974,1974,1824,53760,599200,642000,2675,4499,2675,2825,4649,12.24744871391589,0.0,1824,1,437760,0,150,0,851,2525
10850,0,0,0,0,52,1,1204,0,1,493221,4000740,39.07684736515984,1485,1892,1850,1527,52750,655000,552820,2578,4147,2662,2943,4512,17.97220075561143,6.609134537568676,1569,1,322197,7308,323,0,1093,2297
10851,0,0,0,0,49,1,117,1,0,1110658,2754922,33.37663853655727,1054,2171,2111,1114,46116,467397,603412,2413,3587,2533,3470,4644,31.575306807693888,7.7992067098508295,1174,1,271816,3660,997,0,1359,1476
10852,0,0,0,0,48,1,52,0,1,1187424,2578072,32.61901286060018,1022,2222,2180,1064,51728,513676,591212,2381,3487,2465,3539,4645,33.406586176980134,6.488991180673202,1106,1,259616,3864,1116,0,1359,1307
10853,0,0,0,0,55,1,1570,0,1,4083999,8194575,54.3415126767741,2563,4726,4336,2953,56870,671550,652125,2385,5728,3165,4158,7501,37.1887079635741,20.755732167936053,3343,1,693955,51870,1383,0,178,1392
10854,0,0,0,0,54,1,1578,0,1,3588183,7807068,53.301031884945715,2558,4387,4104,2841,50880,582576,659520,2465,5589,3031,4011,7135,35.53871128783372,16.996538735441106,3124,1,681840,27734,1263,0,93,1485
10855,0,0,0,0,50,1,313,1,0,978510,2923950,34.02939905434711,1063,2098,2003,1158,42488,474700,570650,2430,3683,2620,3370,4623,29.068883707497267,10.06192246325636,1253,1,261708,8075,845,0,1367,1680
10856,0,0,0,0,48,1,158,0,0,1190595,2446150,31.85906464414798,1015,2188,2188,1015,51706,604910,496460,2410,3425,2410,3583,4598,34.249087579087416,0.0,1015,0,209090,0,1173,0,1395,1237
10857,0,0,0,0,52,1,1621,0,1,1426782,5928020,47.47630988187688,2224,2917,2887,2254,44392,652240,470770,2600,4884,2660,3263,5547,25.15949125081825,5.572104574801163,2284,1,403466,5460,633,0,376,1997
10858,0,0,0,0,53,1,1637,0,1,1026564,5665191,46.05431575867782,2013,2713,2605,2121,51414,657066,558239,2563,4792,2779,3155,5384,22.0,11.07198010139901,2229,1,443289,16200,484,0,550,2187
10859,0,0,0,0,53,1,1641,0,1,951130,5620885,45.77116996538323,1968,2676,2549,2095,44322,668067,477574,2556,4778,2810,3137,5359,21.307275752662516,12.103119191447773,2222,1,372910,23622,454,0,588,2229
10860,0,0,0,0,50,1,210,0,1,640224,1773252,26.49528259898354,311,2005,1614,702,53172,636552,532986,2135,3228,2917,3438,4531,30.199337741083,20.481837355656964,1093,1,148122,64124,912,0,1824,1614
10861,0,0,0,0,53,1,1581,0,1,4853050,8384818,55.95533933415113,2876,4936,4681,3131,41415,672178,441870,2423,5809,2933,4228,7614,39.370039370059054,16.12004122835068,3386,1,516615,53805,1550,0,453,1128
10862,0,0,0,0,48,1,366,0,1,1191960,2257332,30.397368307141328,829,2309,2214,924,47752,620522,459284,2348,3367,2538,3733,4752,35.91656999213594,10.133790967822552,1019,1,173712,18810,1290,0,1519,1153
10863,0,0,0,0,49,1,364,0,1,1163712,2238048,30.199337741083,759,2341,2188,912,55552,608592,549696,2301,3366,2607,3730,4795,35.7211421989835,12.687108756730307,1065,1,204288,23562,1276,0,1542,1178
10864,0,0,0,0,46,1,557,1,0,92594,310478,11.575836902790225,104,855,825,134,46492,456449,546812,2287,2451,2347,3008,3172,26.28687885618983,5.531194905403055,164,1,31624,2550,691,0,2183,1626
10865,0,0,0,0,53,1,1643,0,1,451920,5059621,43.393547907494266,1749,2257,2123,1883,55660,650254,618010,2553,4570,2821,2927,4944,15.491933384829668,11.579864037853417,2017,1,433090,19162,240,0,804,2447
10866,0,0,0,0,51,1,384,1,0,850500,2910978,33.67491648096547,924,2094,1884,1134,48336,544204,585276,2357,3701,2777,3317,4661,27.386127875258307,14.955655596508846,1344,1,258552,24150,750,0,1433,1817
10867,0,0,0,0,48,1,404,0,1,293280,902776,19.390719429665317,108,1424,1156,376,54560,528220,595448,2133,2777,2669,3181,3825,27.92848008753788,16.666261985261205,644,1,93248,25192,780,0,2025,1621
10868,0,0,0,0,46,1,597,0,1,89404,287928,11.135528725660043,82,887,845,124,45632,427248,575856,2280,2446,2364,3043,3209,26.851443164195103,6.678188844436455,166,1,30752,1890,721,0,2198,1601
10869,0,0,0,0,54,1,1529,0,1,4275360,8078649,54.48853090330111,2711,4667,4409,2969,42336,685692,457128,2463,5690,2979,4161,7388,37.94733192202055,16.983897347118912,3227,1,498792,55212,1440,0,248,1281
10870,0,0,0,0,54,1,1532,0,1,4018560,7987616,53.96295025292817,2615,4589,4292,2912,46990,696722,507455,2446,5655,3040,4123,7332,37.14835124201342,18.15580153567937,3209,1,538720,59697,1380,0,169,1363
10871,0,0,0,0,54,1,1548,0,1,2950380,7274946,51.55579501860097,2403,4023,3768,2658,53088,613088,648669,2482,5395,2992,3847,6760,33.31666249791537,16.45450722263354,2913,1,629946,30090,1110,0,79,1627
10872,0,0,0,0,53,1,1630,0,1,390504,4934718,42.91852746774987,1689,2207,2054,1842,55370,656355,605454,2526,4521,2832,2891,4886,14.560219778561036,12.391581592403785,1995,1,416292,23256,212,0,837,2467
10873,0,0,0,0,52,1,1495,0,1,151050,4175340,39.87480407475377,1590,1685,1685,1590,54560,651248,577720,2626,4216,2626,2721,4311,9.746794344808963,0.0,1590,1,349800,0,95,0,1036,2531
10874,0,0,0,0,54,1,1553,0,1,4292204,8076278,54.67174773134658,2773,4641,4425,2989,42588,680904,456638,2486,5691,2918,4138,7343,37.89459064299283,15.569083775539836,3205,1,505141,46008,1436,0,287,1266
10875,0,0,0,0,52,1,1563,1,0,1649770,5972990,47.80167361086848,2177,3115,3007,2285,40480,460064,601220,2506,4899,2722,3336,5729,26.870057685088806,10.406531168715494,2393,1,525550,6912,722,0,329,1892
10876,0,0,0,0,52,1,1564,1,0,1564101,5879485,47.50789408087881,2162,3045,2950,2257,44128,513185,583520,2510,4862,2700,3298,5650,26.324893162176366,9.746794344808963,2352,1,505568,9595,693,0,348,1912
10877,0,0,0,0,51,1,738,0,1,643528,3237672,35.38361202590826,1167,1851,1766,1252,46736,656844,475824,2501,3838,2671,3100,4437,22.67156809750927,9.855393472241717,1337,1,230368,17085,514,0,1334,2072
10878,0,0,0,0,49,1,5,0,1,930254,2391391,31.096623610932426,766,2130,1929,967,46228,450086,628142,2272,3440,2674,3435,4603,31.016124838541646,14.695835810225852,1168,1,245618,5829,962,0,1506,1511
10879,0,0,0,0,53,1,1640,0,1,4372116,8143296,55.37147279962851,2913,4645,4492,3066,45034,671968,472768,2503,5722,2809,4082,7301,37.76241517699841,12.878133187687109,3219,1,545748,31518,1426,0,410,1230
10880,0,0,0,0,52,1,1546,1,0,1737255,6070038,47.968739820845826,2151,3206,3056,2301,35805,408890,609378,2488,4939,2788,3393,5844,27.477263328068172,12.384480471957746,2451,1,531531,4500,755,0,337,1883
10881,0,0,0,0,51,1,1554,1,0,1392840,5672100,46.79743582719036,2105,2911,2826,2190,48306,502460,644910,2505,4780,2675,3226,5501,25.219040425836983,9.222414255489701,2275,1,545310,5015,636,0,400,1954
10882,0,0,0,0,51,1,1558,1,0,1231895,5474140,46.20606020859169,2105,2742,2712,2135,56144,620488,594848,2534,4699,2594,3141,5306,24.020824298928627,6.099356562415133,2165,1,495320,3870,577,0,429,1987
10883,0,0,0,0,52,1,1230,0,1,332424,3838914,38.18376618407357,1338,1806,1686,1458,56635,618755,634553,2513,4091,2753,2861,4439,15.0996688705415,11.261033825263985,1578,1,351378,14160,228,0,1175,2405
10884,0,0,0,0,47,1,367,0,0,1005708,2001384,28.91366458960192,806,2069,2039,836,49647,591318,481194,2364,3230,2424,3597,4463,34.68429039204925,5.477225575051661,866,0,168036,5520,1203,0,1558,1191
10885,0,0,0,0,48,1,399,0,0,1009800,1980000,28.722813232690143,783,2091,2049,825,48443,602400,463200,2358,3225,2442,3624,4491,34.9857113690718,6.503581472166948,867,0,159225,8190,1224,0,1575,1176
10886,0,0,0,0,53,1,1594,0,1,4091067,7980106,54.506880299646575,2801,4518,4348,2971,40913,674186,437818,2516,5657,2856,4063,7204,37.107950630558946,13.802720429891991,3141,1,484273,36210,1377,0,285,1309
10887,0,0,0,0,51,1,1539,1,0,1316412,5528070,46.37887450122092,2084,2830,2763,2151,44322,457460,639930,2503,4721,2637,3182,5400,24.73863375370596,8.299636160530056,2218,1,535599,2412,612,0,419,1958
10888,0,0,0,0,51,1,1544,0,1,1083632,5287876,45.47526800360829,2068,2592,2592,2068,51865,646921,524185,2557,4625,2557,3081,5149,22.891046284519195,0.0,2068,1,423940,0,524,0,489,2033
10889,0,0,0,0,52,1,1555,0,1,606594,4939140,43.3358973600409,1744,2335,2201,1878,38376,646980,410280,2496,4508,2764,2953,4965,17.97220075561143,12.31452873038128,2012,1,292968,27336,323,0,752,2307
10890,0,0,0,0,51,1,685,0,1,633516,3101085,34.77067730142742,1149,1793,1733,1209,40913,643815,418095,2505,3774,2625,3089,4358,22.891046284519195,8.086478275311649,1269,1,197067,12780,524,0,1356,2041
10891,0,0,0,0,50,1,184,0,1,821457,2554641,31.670175244226233,697,2128,1822,1003,49196,499212,639297,2241,3550,2853,3366,4675,28.61817604250837,17.642662892028316,1309,1,251753,17748,819,0,1544,1728
10892,0,0,0,0,46,1,711,0,1,113230,310076,11.575836902790225,16,1129,979,134,54502,529906,550732,2164,2448,2464,3159,3443,29.068883707497267,12.459604606992961,284,1,31892,15000,845,0,2180,1469
10893,0,0,0,0,54,1,1498,0,1,2932160,7141904,51.16639522186413,2268,4088,3738,2618,55596,671088,616528,2378,5346,3078,3848,6816,33.46640106136302,19.003643797848515,2968,1,591668,52850,1120,0,110,1608
10894,0,0,0,0,52,1,1261,0,1,312276,3859260,38.379682124790975,1431,1727,1685,1473,53424,660240,555440,2578,4093,2662,2832,4347,14.560219778561036,6.63067838716079,1515,1,312276,7224,212,0,1147,2408
10895,0,0,0,0,47,1,589,0,1,304520,786456,18.193405398660254,4,1586,1251,331,47500,451440,594000,2041,2707,2711,3296,3962,30.331501776206203,18.71321023298192,666,1,82750,17085,920,0,2045,1456
10896,0,0,0,0,51,1,1503,1,0,1178968,5304320,45.51922670696417,2005,2708,2641,2072,47561,509440,611840,2493,4632,2627,3129,5268,23.853720883753127,8.189452396126915,2139,1,495208,5494,569,0,488,1991
10897,0,0,0,0,48,1,202,1,0,864024,2023284,28.879058156387302,714,1990,1870,834,45120,456088,582240,2306,3260,2546,3462,4416,32.18695387886216,11.144209149602325,954,1,200160,7800,1036,0,1592,1390
10898,0,0,0,0,47,1,388,0,1,785013,1702644,26.70205984563738,713,1814,1814,713,56153,575508,556404,2388,3101,2388,3489,4202,33.18132004607411,0.0,713,1,166129,0,1101,0,1675,1287
10899,0,0,0,0,47,1,599,0,1,345240,860760,18.973665961010276,1,1680,1319,360,44286,437553,578622,2030,2751,2752,3350,4071,30.967725134404045,19.480413115444396,721,1,87120,19855,959,0,2031,1432
10900,0,0,0,0,52,1,1744,0,1,4040097,7994430,55.344376408086845,3033,4412,4382,3063,50800,662940,522000,2580,5673,2640,3929,7022,36.318039594669756,5.7180036243905645,3093,1,612600,5490,1319,0,453,1291
10901,0,0,0,0,51,1,1482,1,0,1051144,5133354,44.78839135311738,1976,2560,2530,2006,41140,562980,478533,2529,4565,2589,3083,5119,22.891046284519195,5.684275577662207,2036,1,375122,5130,524,0,553,2035
10902,0,0,0,0,52,1,1361,1,0,329910,4150582,39.63584236521283,1476,1876,1781,1571,52538,575956,636722,2547,4213,2737,2852,4518,14.491376746189438,9.981197033715764,1666,1,378611,9785,210,0,1071,2432
10903,0,0,0,0,51,1,799,0,1,550206,3172068,35.24202037341219,1182,1745,1685,1242,41168,423964,633392,2494,3796,2614,2997,4299,21.047565179849187,8.06225774829855,1302,1,308016,1140,443,0,1312,2111
10904,0,0,0,0,51,1,446,0,1,688152,2781822,32.89376840679705,962,1838,1718,1082,42921,645321,439641,2451,3653,2691,3207,4409,25.219040425836983,11.418751370995183,1202,1,185022,24120,636,0,1489,1935
10905,0,0,0,0,51,1,147,0,1,771640,2446710,30.903074280724887,655,2063,1763,955,44954,466284,632814,2262,3517,2862,3370,4625,28.42534080710379,17.545163059830713,1255,1,235885,14100,808,0,1607,1754
10906,0,0,0,0,50,1,97,0,1,781758,2377964,30.56141357987225,610,2095,1771,934,43788,453188,626316,2222,3480,2870,3383,4641,28.930952282978865,18.119223478368507,1258,1,229764,13284,837,0,1612,1709
10907,0,0,0,0,47,1,376,0,1,702537,1597651,25.903667693977237,641,1748,1718,671,54216,597631,514296,2351,3052,2411,3428,4129,32.357379374726875,5.483301264452448,701,1,144936,4860,1047,0,1710,1334
10908,0,0,0,0,48,1,306,0,1,599112,1530852,25.219040425836983,466,1748,1578,636,52200,558424,541575,2237,3043,2577,3349,4155,30.692018506445613,13.039419792601862,806,1,143100,24310,942,0,1771,1465
10909,0,0,0,0,54,1,1460,0,1,2323200,6548520,49.193495504995376,2058,3742,3380,2420,54990,635910,633204,2344,5126,3068,3666,6448,30.983866769659336,19.379325353089175,2782,1,566280,48146,960,0,286,1746
10910,0,0,0,0,51,1,316,0,1,714636,2618296,31.906112267087632,838,1900,1720,1018,52668,648144,537548,2392,3590,2752,3274,4472,26.49528259898354,13.687973365625968,1198,1,212762,30420,702,0,1554,1870
10911,0,0,0,0,50,1,67,0,1,770640,2322864,30.199337741083,603,2066,1757,912,44888,461007,631656,2238,3459,2856,3392,4613,29.068883707497267,17.71109711354345,1221,1,226176,12669,845,0,1635,1702
10912,0,0,0,0,47,1,401,0,0,707160,1589616,25.768197453450252,634,1759,1729,664,51092,507528,576954,2364,3058,2424,3459,4153,32.63433774416144,5.483301264452448,694,0,160024,2910,1065,0,1730,1329
10913,0,0,0,0,47,1,339,0,1,610470,1505070,25.099800796022265,563,1666,1599,630,45264,587694,439576,2322,3019,2456,3358,4055,31.12876483254676,8.189452396126915,697,1,115920,13467,969,0,1759,1420
10914,0,0,0,0,48,1,305,0,1,553584,1461656,24.63736998950984,415,1711,1519,607,52206,556248,544208,2216,3015,2600,3320,4119,30.199337741083,13.856500429365498,799,1,137182,26688,912,0,1801,1496
10915,0,0,0,0,46,1,844,0,1,115680,278040,10.954451150103322,0,1204,1084,120,42560,440230,519008,2197,2437,2437,3281,3521,31.04834939252005,11.290330617691032,240,1,26880,10800,964,0,2197,1353
10916,0,0,0,0,46,1,900,0,1,57600,138060,7.745966692414834,0,1080,1020,60,46648,450996,547638,2241,2361,2361,3261,3381,30.983866769659336,8.111420134500735,120,1,14280,4800,960,0,2241,1341
10917,0,0,0,0,51,1,1807,1,0,3912138,7996644,55.47972602672079,3048,4379,4349,3078,51012,607932,566364,2568,5676,2628,3869,6977,35.651086939951774,5.531194905403055,3108,1,671004,4590,1271,0,480,1327
10918,0,0,0,0,53,1,1581,0,1,3361122,7446864,52.79204485526205,2653,4127,3993,2787,42419,670672,451568,2538,5459,2806,3878,6799,34.72751070837067,12.683189504223728,2921,1,471003,27202,1206,0,115,1466
10919,0,0,0,0,54,1,1441,0,1,3062436,7091682,51.11751167652823,2355,4043,3785,2613,49776,662216,553656,2456,5327,2972,3886,6757,34.23448553724738,16.724015322265164,2871,1,533052,45924,1172,0,101,1542
10920,0,0,0,0,50,1,1412,0,1,733664,4616272,42.61455150532503,1786,2250,2220,1816,40755,627874,419430,2512,4358,2572,2946,4792,20.09975124224178,6.300703649796459,1846,1,299640,5850,404,0,726,2138
10921,0,0,0,0,48,1,411,1,0,682822,1551692,25.41653005427767,586,1763,1703,646,50525,516430,564470,2342,3048,2462,3459,4165,32.51153641401772,7.759379671981613,706,1,151810,6600,1057,0,1756,1345
10922,0,0,0,0,47,1,372,0,1,594253,1435555,24.63736998950984,607,1586,1586,607,52877,598345,494285,2365,2972,2365,3344,3951,31.28897569432403,0.0,607,1,126863,0,979,0,1758,1386
10923,0,0,0,0,47,1,330,0,1,558000,1437600,24.49489742783178,492,1638,1530,600,45872,584624,450448,2288,2996,2504,3326,4034,30.495901363953813,10.414507905016443,708,1,112800,21060,930,0,1796,1466
10924,0,0,0,0,47,1,301,0,1,496470,1366860,23.874672772626646,360,1651,1441,570,52875,539550,563530,2188,2968,2608,3269,4049,29.512709126747414,14.538465512071845,780,1,133950,25410,871,0,1828,1527
10925,0,0,0,0,47,1,704,1,0,341220,791340,18.16590212458495,1,1695,1364,330,48144,489192,565928,2067,2728,2729,3432,4093,32.155870381627054,18.80064583757662,661,1,77880,31114,1034,0,2068,1364
10926,0,0,0,0,52,1,1629,0,1,3314620,7424187,53.0,2714,4084,3989,2809,41085,658107,436095,2548,5452,2738,3823,6727,34.351128074635334,10.60004836173973,2904,1,463485,19190,1180,0,166,1463
10927,0,0,0,0,51,1,1408,1,0,1117284,5106738,44.429719783046124,1889,2625,2540,1974,48930,602771,543270,2502,4561,2672,3153,5212,23.790754506740637,9.494144610579708,2059,1,414540,13770,566,0,613,2021
10928,0,0,0,0,50,1,1392,1,0,872809,4685998,43.139309220245984,1861,2330,2330,1861,55527,561514,626982,2518,4379,2518,2987,4848,21.656407827707714,0.0,1861,1,463389,0,469,0,657,2049
10929,0,0,0,0,51,1,746,0,1,569835,3118905,34.85685011586675,1120,1779,1684,1215,51054,515967,652018,2472,3782,2662,3036,4346,21.656407827707714,10.453462715764566,1310,1,308610,5320,469,0,1352,2098
10930,0,0,0,0,49,1,284,1,0,775500,1854750,27.386127875258307,558,1976,1784,750,44620,479762,568790,2281,3223,2665,3507,4449,32.155870381627054,14.40893599983394,942,1,172500,16896,1034,0,1723,1439
10931,0,0,0,0,48,1,421,1,0,784700,1713600,26.457513110645905,566,1955,1821,700,45400,489600,555696,2314,3148,2582,3569,4403,33.481338085566414,12.019627717482168,834,1,158900,13400,1121,0,1748,1327
10932,0,0,0,0,47,1,394,0,0,578987,1390629,24.269322199023193,559,1602,1572,589,51250,484005,590250,2331,2950,2391,3344,3963,31.352830813181765,5.478746393072713,619,0,147250,2160,983,0,1772,1378
10933,0,0,0,0,51,1,1747,0,1,3421068,7583562,54.0277706369604,2889,4121,4091,2919,48768,659892,498816,2568,5517,2628,3770,6719,34.23448553724738,5.5503012171862105,2949,1,560448,5670,1172,0,321,1426
10934,0,0,0,0,53,1,1408,0,1,2559888,6610592,49.51767361255979,2129,3819,3496,2452,55632,657824,614688,2373,5148,3019,3740,6515,32.31098884280702,18.860290466803878,2775,1,559056,47804,1044,0,244,1652
10935,0,0,0,0,53,1,1404,0,1,1994125,6103162,47.738873049120045,1918,3515,3154,2279,54984,621296,634686,2317,4957,3039,3553,6193,29.58039891549808,19.294892988731046,2640,1,540123,45125,875,0,399,1803
10936,0,0,0,0,51,1,1276,0,1,571077,4196033,40.33608806019741,1493,2112,1978,1627,42408,639592,441009,2445,4206,2713,2930,4691,18.734993995195193,12.35290383596832,1761,1,278217,25594,351,0,952,2228
10937,0,0,0,0,50,1,174,1,0,752815,1964070,28.0178514522438,502,2027,1744,785,49245,502902,612990,2219,3287,2785,3461,4529,30.967725134404045,17.404240192069448,1068,1,192325,21791,959,0,1717,1543
10938,0,0,0,0,49,1,318,0,1,757944,1798302,26.94438717061496,514,1982,1770,726,46566,492923,579618,2265,3203,2689,3521,4459,32.31098884280702,15.088691753432045,938,1,169884,19080,1044,0,1751,1433
10939,0,0,0,0,48,1,417,0,1,595728,1420173,24.310491562286437,471,1719,1599,591,52731,521451,583929,2283,2994,2523,3411,4122,31.74901573277509,11.13281192559312,711,1,143613,11880,1008,0,1812,1395
10940,0,0,0,0,48,1,302,0,1,414120,1225020,22.58317958127243,263,1569,1322,510,52670,550058,552460,2155,2912,2649,3214,3971,28.495613697550013,15.766482753919849,757,1,117300,32604,812,0,1892,1590
10941,0,0,0,0,47,1,302,0,1,414120,1212780,22.58317958127243,376,1456,1322,510,54253,539806,568342,2244,2888,2512,3190,3834,28.495613697550013,11.5784147532791,644,1,121890,15678,812,0,1868,1566
10942,0,0,0,0,51,1,1792,0,1,3383300,7599186,54.24020648928247,2942,4092,4092,2942,51204,648333,526932,2583,5525,2583,3733,6675,33.91164991562634,0.0,2942,1,600168,0,1150,0,359,1433
10943,0,0,0,0,53,1,1389,0,1,2284902,6328872,48.55924216871593,2023,3662,3327,2358,56133,652212,620004,2349,5042,3019,3653,6346,31.12876483254676,19.201608695830398,2693,1,544698,47905,969,0,326,1715
10944,0,0,0,0,53,1,1387,0,1,2193918,6246378,48.25971404805462,1987,3613,3271,2329,55926,640998,627588,2340,5011,3024,3624,6295,30.692018506445613,19.345712612055728,2671,1,544986,46512,942,0,353,1740
10945,0,0,0,0,52,1,1369,0,1,1448300,5408366,45.48626166217664,1857,2981,2769,2069,46376,488818,648272,2402,4683,2826,3314,5595,26.457513110645905,14.862034112126459,2281,1,513112,11236,700,0,545,1914
10946,0,0,0,0,50,1,531,0,1,637632,2774142,33.27160951922825,1077,1713,1683,1107,49698,496188,629006,2476,3613,2536,3082,4219,24.0,5.684275577662207,1137,1,277857,1800,576,0,1399,1930
10947,0,0,0,0,50,1,334,0,1,679392,2528064,31.74901573277509,966,1724,1682,1008,44781,634524,443916,2466,3516,2550,3182,4232,25.96150997149434,6.678188844436455,1050,1,178416,8736,674,0,1500,1834
10948,0,0,0,0,48,1,437,0,1,628764,1464700,24.576411454889016,429,1820,1645,604,51408,523800,577150,2250,3029,2600,3466,4245,32.264531609803356,13.312619750312495,779,1,143752,18725,1041,0,1821,1384
10949,0,0,0,0,51,1,1771,0,1,3181962,7431291,53.637673327615545,2877,3983,3983,2877,56088,635418,588924,2583,5460,2583,3689,6566,33.25657829663178,0.0,2877,1,655956,0,1106,0,294,1477
10950,0,0,0,0,53,1,1470,0,1,2768536,6865152,50.53711507397311,2326,3866,3638,2554,54412,655872,599424,2460,5242,2916,3772,6554,32.92415526630866,16.246736158365664,2782,1,569542,31236,1084,0,134,1604
10951,0,0,0,0,53,1,1369,0,1,2305350,6293300,48.47679857416329,2044,3637,3331,2350,55842,658788,607906,2372,5028,2984,3659,6315,31.32091952673165,18.436695833410436,2656,1,533450,45900,981,0,328,1697
10952,0,0,0,0,53,1,1360,0,1,1863225,5874120,46.95742752749558,1874,3381,3050,2205,53743,594072,642024,2333,4869,2995,3509,6045,29.068883707497267,18.93714320760639,2536,1,531405,36410,845,0,459,1819
10953,0,0,0,0,52,1,1351,0,1,1624506,5585166,46.021733996015406,1841,3162,2885,2118,51414,551133,648702,2360,4755,2914,3404,5799,27.694764848252458,17.066170763217382,2395,1,521028,23545,767,0,519,1870
10954,0,0,0,0,50,1,858,0,1,576343,3270714,36.069377593742864,1271,1774,1744,1301,51706,631014,517884,2484,3815,2544,2957,4288,21.047565179849187,5.7180036243905645,1331,1,268006,4950,443,0,1213,2071
10955,0,0,0,0,49,1,349,0,1,675990,2530395,31.85906464414798,1015,1681,1681,1015,48132,628236,476163,2493,3508,2493,3159,4174,25.80697580112788,0.0,1015,1,193865,0,666,0,1478,1827
10956,0,0,0,0,49,1,336,1,0,725200,1745100,26.457513110645905,423,2013,1736,700,47008,518544,563418,2216,3193,2770,3529,4506,32.18695387886216,17.15108802688017,977,1,158200,31024,1036,0,1793,1457
10957,0,0,0,0,48,1,423,0,1,515520,1289874,23.173260452512935,417,1617,1497,537,51972,511626,586088,2282,2939,2522,3362,4019,30.983866769659336,11.232917923179112,657,1,131028,11160,960,0,1865,1442
10958,0,0,0,0,48,1,307,0,1,377760,1160640,21.908902300206645,270,1477,1267,480,50244,573066,512616,2208,2898,2628,3205,3895,28.053520278211074,14.846855792793013,690,1,101760,34230,787,0,1938,1631
10959,0,0,0,0,47,1,300,0,1,338701,1074733,21.236760581595302,259,1394,1202,451,50787,498047,579069,2191,2834,2575,3134,3777,27.40437921208944,13.864011748252963,643,1,109593,17088,751,0,1932,1632
10960,0,0,0,0,52,1,1899,1,0,3381280,7852419,54.945427471264615,2911,4247,4139,3019,46492,512397,613836,2493,5620,2709,3721,6848,33.46640106136302,10.46373382427936,3127,1,712484,9072,1120,0,418,1481
10961,0,0,0,0,50,1,1194,0,1,754507,4148963,40.63249930782009,1609,2150,2108,1651,46736,638302,462392,2471,4164,2555,2970,4663,21.37755832643195,6.589126398255297,1693,1,303784,8274,457,0,862,2056
10962,0,0,0,0,50,1,217,0,1,694668,2374398,30.805843601498726,907,1723,1681,949,51816,635508,510408,2460,3451,2544,3234,4225,27.055498516937366,6.553889165207866,991,1,193596,7602,732,0,1553,1770
10963,0,0,0,0,50,1,223,0,1,717738,1867159,27.258026340878022,475,1977,1709,743,50820,552860,580503,2245,3256,2781,3479,4490,31.080540535840107,16.48489384028688,1011,1,171633,32428,966,0,1770,1547
10964,0,0,0,0,50,1,272,0,1,715953,1808268,26.851443164195103,426,2009,1714,721,47488,531696,561792,2213,3229,2803,3501,4517,31.51190251317746,17.297609256991084,1016,1,161504,35400,993,0,1787,1515
10965,0,0,0,0,49,1,466,1,0,669912,1523370,24.859605789312106,362,1958,1702,618,43197,460955,569415,2209,3083,2721,3549,4423,32.92415526630866,16.299181598019334,874,1,142758,19712,1084,0,1847,1381
10966,0,0,0,0,48,1,342,0,1,356400,1080900,21.213203435596427,330,1362,1242,450,41160,588490,403536,2282,2852,2522,3194,3764,28.142494558940577,11.418751370995183,570,1,75600,25680,792,0,1952,1610
10967,0,0,0,0,48,1,309,0,1,341550,1088550,21.213203435596427,240,1419,1209,450,53217,587817,529761,2209,2869,2629,3178,3838,27.54995462791182,14.857157716059705,660,1,98550,33600,759,0,1969,1660
10968,0,0,0,0,51,1,1840,0,1,3054225,7454625,53.80520420925842,2835,4010,3950,2895,54492,587100,615425,2515,5470,2635,3630,6585,32.48076353782343,7.765259411425052,2955,1,691905,7140,1055,0,320,1520
10969,0,0,0,0,53,1,1485,0,1,2579824,6664336,50.11985634456667,2330,3721,3539,2512,51408,631414,573048,2471,5165,2835,3680,6374,32.046840717924134,14.461132905563277,2694,1,542592,23478,1027,0,141,1626
10970,0,0,0,0,53,1,1347,0,1,2509960,6368305,48.938737212968626,2167,3671,3443,2395,53482,643478,587639,2431,5054,2887,3707,6330,32.37282811247729,16.1852938789691,2623,1,529295,30780,1048,0,264,1611
10971,0,0,0,0,50,1,1255,0,1,1152536,4767308,43.255057507764334,1737,2621,2487,1871,42090,466284,586040,2414,4419,2682,3164,5169,24.819347291981714,11.727705886231366,2005,1,430330,9648,616,0,677,1932
10972,0,0,0,0,50,1,1021,0,1,661950,3728985,38.353617821530214,1347,2045,1921,1471,50715,621075,524745,2411,4006,2659,2985,4580,21.213203435596427,11.83231048371444,1595,1,304497,18724,450,0,1064,2085
10973,0,0,0,0,50,1,858,0,1,631368,3337992,36.49657518178932,1290,1848,1806,1332,54180,538790,631512,2464,3838,2548,2980,4354,21.77154105707724,6.484411467763075,1374,1,335664,3192,474,0,1174,2032
10974,0,0,0,0,49,1,739,0,1,636990,3120002,35.34119409414458,1219,1789,1759,1249,48260,634492,474620,2468,3747,2528,3008,4287,22.58317958127243,5.478746393072713,1279,1,237310,5700,510,0,1249,1988
10975,0,0,0,0,49,1,231,0,1,694782,2385801,30.93541659651604,957,1683,1683,957,53874,613278,545967,2493,3450,2493,3219,4176,26.94438717061496,0.0,957,1,209583,0,726,0,1536,1767
10976,0,0,0,0,50,1,306,0,1,704200,1760500,26.457513110645905,423,1983,1706,700,44308,525635,533180,2238,3215,2792,3521,4498,31.71750305430741,16.76183378250879,977,1,148400,36564,1006,0,1815,1509
10977,0,0,0,0,49,1,465,1,0,599616,1419264,24.0,299,1894,1617,576,41400,453376,554400,2187,3040,2741,3505,4358,32.264531609803356,16.881579281383758,853,1,129600,22437,1041,0,1888,1423
10978,0,0,0,0,47,1,425,0,1,420650,1124240,21.6794833886788,375,1460,1365,470,49490,483184,586040,2297,2862,2487,3287,3852,29.916550603303182,10.273798497703284,565,1,115150,7315,895,0,1922,1497
10979,0,0,0,0,48,1,301,0,1,269490,937170,19.748417658131498,113,1358,1081,390,48600,519048,540675,2126,2793,2680,3094,3761,26.28687885618983,16.688736125797796,667,1,87750,34348,691,0,2013,1712
10980,0,0,0,0,47,1,363,0,1,249550,825650,18.708286933869708,230,1183,1063,350,51903,516621,559083,2239,2709,2479,3072,3542,26.70205984563738,10.966602528904897,470,1,82950,13320,713,0,2009,1646
10981,0,0,0,0,46,1,942,0,1,275184,544050,15.297058540778355,21,1665,1410,234,50394,516150,527775,2070,2559,2580,3501,3990,34.292856398964496,16.1852938789691,489,1,53118,32640,1176,0,2091,1149
10982,0,0,0,0,51,1,1886,1,0,3019280,7533600,54.037024344425184,2825,4049,3954,2920,50907,549540,616620,2485,5500,2675,3614,6629,32.155870381627054,9.74706432789427,3015,1,697880,9595,1034,0,340,1546
10983,0,0,0,0,52,1,1333,0,1,2420334,6232478,48.569537778323564,2147,3597,3385,2359,51192,626154,570672,2430,5001,2854,3668,6239,32.03123475609393,15.410129902918593,2571,1,509544,27136,1026,0,283,1616
10984,0,0,0,0,50,1,1216,0,1,1133412,4663862,42.82522621072771,1707,2579,2452,1834,40406,452654,577261,2416,4377,2670,3161,5122,24.859605789312106,11.526200699097002,1961,1,416318,8890,618,0,709,1925
10985,0,0,0,0,50,1,888,0,1,671488,3460640,37.094473981982816,1268,1972,1864,1376,55696,593540,593540,2407,3891,2623,3003,4487,22.090722034374522,10.392304845413264,1484,1,324736,12420,488,0,1139,2027
10986,0,0,0,0,50,1,294,0,1,695800,1765400,26.457513110645905,466,1928,1694,700,47174,577538,519532,2288,3222,2756,3516,4450,31.52776554086889,15.496772346339544,934,1,144200,37674,994,0,1822,1528
10987,0,0,0,0,46,1,408,0,0,332928,957168,20.199009876724155,408,1224,1224,408,52675,504390,574770,2346,2754,2346,3162,3570,28.5657137141714,0.0,408,0,99960,0,816,0,1938,1530
10988,0,0,0,0,51,1,1819,0,1,2731692,7135392,52.87721626560914,2796,3773,3773,2796,40411,640552,410872,2552,5348,2552,3529,6325,31.25699921617557,0.0,2796,1,450156,0,977,0,244,1575
10989,0,0,0,0,51,1,1205,0,1,1281800,4846335,43.41658669218482,1693,2757,2565,1885,43739,491061,588759,2379,4456,2763,3251,5328,26.076809620810597,14.193561620765193,2077,1,431665,16512,680,0,686,1891
10990,0,0,0,0,49,1,1042,0,1,820584,3889944,39.57271787481876,1536,2120,2090,1566,53320,616032,534060,2454,4050,2514,3008,4604,22.891046284519195,5.477225575051661,1596,1,336690,4560,524,0,918,1960
10991,0,0,0,0,49,1,702,0,1,692208,3098634,35.41186241925155,1254,1806,1806,1254,56640,593040,583156,2471,3725,2471,3023,4277,23.49468024894146,0.0,1254,1,295944,0,552,0,1217,1919
10992,0,0,0,0,50,1,1845,1,0,2644024,7102848,52.839379254491625,2792,3739,3739,2792,46563,633456,475728,2544,5336,2544,3491,6283,30.773365106858236,0.0,2792,1,522104,0,947,0,248,1597
10993,0,0,0,0,51,1,1741,0,1,2491236,6877629,51.70106381884226,2631,3647,3605,2673,46189,635531,481151,2531,5246,2615,3505,6220,30.528675044947494,6.7597809605921,2715,1,499851,7224,932,0,100,1641
10994,0,0,0,0,51,1,1489,0,1,2306892,6316548,49.35585071701227,2312,3507,3383,2436,48200,624913,518600,2469,5029,2717,3540,6100,30.773365106858236,11.700176052913939,2560,1,487200,18476,947,0,157,1646
10995,0,0,0,0,50,1,1114,0,1,1070376,4373300,41.617304093369626,1624,2458,2350,1732,48995,517625,603475,2417,4257,2633,3143,4983,24.859605789312106,10.539713118296461,1840,1,413948,9720,618,0,793,1907
10996,0,0,0,0,49,1,1027,1,0,888720,3924651,39.83716857408418,1587,2147,2147,1587,55615,561371,605885,2473,4060,2473,3033,4620,23.664319132398465,0.0,1587,1,388815,0,560,0,886,1913
10997,0,0,0,0,50,1,265,0,1,688884,1779204,26.60826939130014,558,1831,1681,708,47250,628250,474957,2363,3221,2663,3486,4344,31.192947920964443,12.514175867137965,858,1,133812,29700,973,0,1805,1540
10998,0,0,0,0,50,1,363,0,1,676864,1671669,25.709920264364882,469,1877,1685,661,46170,614547,480510,2337,3190,2721,3553,4406,32.0,14.132314290900673,853,1,125590,36864,1024,0,1868,1505
10999,0,0,0,0,51,1,1916,1,0,2650557,7316790,53.3572862878164,2780,3845,3778,2847,38844,426620,601380,2503,5417,2637,3501,6415,30.512292604784715,8.329212945039274,2914,1,666198,2814,931,0,277,1639
11000,0,0,0,0,51,1,1846,1,0,2515296,7049448,52.51666402200353,2728,3700,3670,2758,49848,633888,513756,2526,5314,2586,3468,6256,30.199337741083,5.684275577662207,2788,1,554358,5520,912,0,202,1644
11001,0,0,0,0,50,1,1064,0,1,1069545,4262925,41.1703777004778,1587,2434,2326,1695,54707,570905,606115,2407,4210,2623,3146,4949,25.11971337416094,10.429745618880121,1803,1,408495,12204,631,0,820,1884
11002,0,0,0,0,49,1,141,0,1,726910,2304814,30.430248109405877,859,1778,1711,926,56334,612294,569981,2422,3415,2556,3274,4267,28.0178514522438,8.2732738280919,993,1,212054,9715,785,0,1563,1704
11003,0,0,0,0,51,1,1918,1,0,2517635,7198467,53.03772242470448,2746,3775,3708,2813,37962,437589,568098,2492,5372,2626,3454,6334,29.916550603303182,8.286047041568583,2880,1,624486,4489,895,0,254,1664
11004,0,0,0,0,51,1,1172,0,1,1776540,5235688,45.18849411078001,1862,3092,2912,2042,54780,638436,564080,2384,4606,2744,3434,5656,29.49576240750525,13.719158219336459,2222,1,449240,27360,870,0,522,1694
11005,0,0,0,0,51,1,1127,0,1,1455360,4870150,43.53159771935783,1705,2853,2663,1895,55029,639930,567970,2380,4465,2760,3338,5423,27.712812921102035,14.529345172540314,2085,1,418795,30020,768,0,675,1802
11006,0,0,0,0,49,1,509,0,1,767886,2864985,34.161381705077446,1137,1855,1825,1167,52624,621115,510640,2425,3622,2485,3113,4310,25.65151067676132,5.478746393072713,1197,1,242736,5250,658,0,1288,1797
11007,0,0,0,0,50,1,497,0,1,580650,1393007,23.515952032609693,325,1831,1603,553,54560,554180,624712,2291,3072,2747,3569,4350,32.4037034920393,15.307105875285492,781,1,137144,21204,1050,0,1966,1469
11008,0,0,0,0,51,1,1871,1,0,2309280,6936000,52.15361924162119,2678,3611,3569,2720,50400,535500,612000,2508,5270,2592,3399,6161,29.13760456866693,6.503581472166948,2762,1,652800,3990,849,0,170,1701
11009,0,0,0,0,50,1,1372,0,1,2051148,5785056,47.686476070265456,2184,3266,3176,2274,52644,625824,544416,2454,4818,2634,3446,5810,30.033314835362415,9.638070910968185,2364,1,486636,13230,902,0,270,1642
11010,0,0,0,0,49,1,960,0,1,1078336,4050256,40.29888335921977,1516,2396,2288,1624,53136,538704,613524,2386,4118,2602,3158,4890,25.768197453450252,10.489171794062365,1732,1,399504,10044,664,0,870,1830
11011,0,0,0,0,49,1,817,0,1,913688,3570768,38.05259518088089,1418,2109,2079,1448,55902,596772,569646,2436,3914,2496,3097,4575,25.11971337416094,5.501408174353464,1478,1,334488,4290,631,0,1018,1835
11012,0,0,0,0,49,1,728,0,1,861513,3343977,36.89173349139343,1361,1994,1994,1361,56643,587223,582309,2457,3818,2457,3090,4451,25.15949125081825,0.0,1361,1,322557,0,633,0,1096,1824
11013,0,0,0,0,48,1,303,0,1,773604,2551536,32.31098884280702,1002,1827,1785,1044,53286,523016,608556,2402,3488,2486,3185,4271,27.2213151776324,6.82047017429532,1086,1,259956,2898,741,0,1400,1703
11014,0,0,0,0,49,1,23,0,1,736890,2090396,29.103264421710495,817,1747,1717,847,52152,523216,607128,2438,3315,2498,3338,4215,29.49576240750525,5.531194905403055,877,1,208362,2670,870,0,1621,1598
11015,0,0,0,0,48,1,469,0,1,277362,820800,18.49324200890693,192,1303,1153,342,49588,470400,607200,2250,2742,2550,3211,3703,28.478061731796284,12.75511514473605,492,1,86526,7650,811,0,2058,1589
11016,0,0,0,0,50,1,1816,1,0,2130497,6641056,51.254268114957995,2585,3480,3438,2627,54280,581440,596608,2486,5155,2570,3339,6008,28.478061731796284,6.5252844928085345,2669,1,619972,5208,811,0,99,1717
11017,0,0,0,0,50,1,1787,1,0,2103570,6552231,50.96076922496363,2567,3437,3407,2597,54948,575244,608043,2493,5120,2553,3333,5960,28.460498941515414,5.684275577662207,2627,1,625877,3420,810,0,74,1713
11018,0,0,0,0,50,1,1726,1,0,2060856,6380532,50.37856687124,2508,3380,3350,2538,53000,628500,532968,2484,5052,2544,3326,5894,28.495613697550013,5.791460926441345,2568,1,538056,5190,812,0,24,1702
11019,0,0,0,0,50,1,1814,1,0,2023320,6562820,50.93132631298737,2534,3434,3374,2594,43979,503470,559130,2470,5124,2590,3310,5964,27.92848008753788,7.759379671981613,2654,1,573274,6420,780,0,64,1750
11020,0,0,0,0,50,1,1577,1,0,1927080,6019740,48.83646178829912,2385,3193,3193,2385,55460,593140,595664,2524,4909,2524,3332,5717,28.42534080710379,0.0,2385,1,562860,0,808,0,139,1716
11021,0,0,0,0,50,1,1419,0,1,1919302,5710320,47.60252094164762,2236,3143,3113,2266,55552,624960,564480,2490,4786,2550,3367,5663,29.103264421710495,5.514871952411144,2296,1,507584,4560,847,0,254,1673
11022,0,0,0,0,49,1,6,0,1,772632,2168838,29.698484809834994,822,1818,1758,882,38688,609832,383604,2399,3341,2519,3335,4277,29.597297173897484,8.16338338718601,942,1,137592,13380,876,0,1577,1583
11023,0,0,0,0,52,1,1892,0,1,2312765,7173677,52.316345438113316,2460,3859,3582,2737,53352,597588,613314,2344,5358,2898,3466,6480,29.068883707497267,16.89569571515248,3014,1,640458,34902,845,0,116,1776
11024,0,0,0,0,50,1,1565,1,0,1851024,5922336,48.49742261192856,2352,3139,3139,2352,53808,594248,574104,2518,4870,2518,3305,5657,28.053520278211074,0.0,2352,1,536256,0,787,0,166,1731
11025,0,0,0,0,50,1,1525,1,0,1850634,5844474,48.187135212627034,2322,3119,3119,2322,54720,604080,573876,2517,4839,2517,3314,5636,28.231188426986208,0.0,2322,1,529416,0,797,0,195,1720
11026,0,0,0,0,49,1,620,1,0,968924,3299978,36.6333181680284,1300,2106,2064,1342,44075,528685,504095,2417,3801,2501,3181,4565,26.870057685088806,6.484411467763075,1384,1,275110,6132,722,0,1117,1737
11027,0,0,0,0,48,1,366,0,1,700960,1650626,25.96150997149434,674,1714,1714,674,52152,602454,519188,2449,3123,2449,3489,4163,32.2490309931942,0.0,674,1,142888,0,1040,0,1775,1409
11028,0,0,0,0,50,1,511,0,1,562776,1346259,23.173260452512935,387,1735,1585,537,51816,636778,511428,2357,3044,2657,3555,4242,32.37282811247729,12.480747566911448,687,1,109548,26700,1048,0,1970,1459
11029,0,0,0,0,49,1,509,0,1,480612,1208548,22.0,274,1687,1477,484,56069,566819,616759,2287,2981,2707,3490,4184,31.51190251317746,14.574776296522492,694,1,119548,21210,993,0,2013,1504
11030,0,0,0,0,50,1,937,0,1,1505790,4465692,42.21374183841087,1722,2687,2627,1782,55304,621488,558838,2446,4288,2566,3351,5193,29.068883707497267,7.754559014766193,1842,1,397386,8820,845,0,724,1661
11031,0,0,0,0,49,1,552,1,0,986785,3226983,36.15245496505044,1222,2147,2062,1307,37467,511083,446889,2384,3776,2554,3224,4616,27.477263328068172,9.265143265380413,1392,1,236567,13855,755,0,1162,1714
11032,0,0,0,0,48,1,292,1,0,888800,2692800,33.166247903554,1100,1908,1908,1100,49020,526320,558144,2448,3548,2448,3256,4356,28.42534080710379,0.0,1100,1,250800,0,808,0,1348,1640
11033,0,0,0,0,48,1,152,0,1,775680,1977984,28.42534080710379,741,1835,1768,808,56069,555696,604656,2381,3256,2515,3408,4283,30.983866769659336,8.299636160530056,875,1,199576,6700,960,0,1640,1488
11034,0,0,0,0,48,1,347,0,1,720720,1689534,26.324893162176366,663,1763,1733,693,55125,597310,548550,2408,3131,2468,3478,4201,32.2490309931942,5.623413251903491,723,1,155925,4200,1040,0,1745,1398
11035,0,0,0,0,47,1,474,0,1,127872,452160,13.856406460551018,107,943,858,192,50932,503970,560490,2270,2547,2440,3021,3298,25.80697580112788,9.370214040084857,277,1,45696,8755,666,0,2163,1689
11036,0,0,0,0,51,1,1936,1,0,1888737,6882102,51.468436929831086,2448,3563,3362,2649,49980,545580,618324,2397,5247,2799,3311,6161,26.70205984563738,14.417702721914399,2850,1,630462,19899,713,0,51,1885
11037,0,0,0,0,50,1,1656,1,0,1713817,5997171,48.75448697299562,2310,3165,3098,2377,44880,514692,555060,2456,4900,2590,3244,5688,26.851443164195103,8.19672545160342,2444,1,522940,7705,721,0,146,1802
11038,0,0,0,0,50,1,1535,1,0,1719824,5738083,47.82258880487337,2227,3099,3039,2287,48697,524381,584597,2449,4796,2569,3261,5608,27.422618401604176,7.780166052320878,2347,1,532871,6240,752,0,222,1757
11039,0,0,0,0,49,1,1404,1,0,1742221,5459545,46.87216658103186,2155,3032,2990,2197,52640,556640,583975,2443,4682,2527,3278,5517,28.160255680657446,6.538739683827756,2239,1,516295,4998,793,0,288,1692
11040,0,0,0,0,49,1,770,0,1,1256000,3893600,39.6232255123179,1540,2400,2370,1570,51076,560480,560480,2450,4050,2510,3280,4880,28.284271247461902,5.501408174353464,1600,1,354820,4020,800,0,910,1680
11041,0,0,0,0,48,1,477,0,1,690478,1511790,25.019992006393608,596,1759,1729,626,50038,613410,475755,2385,3041,2445,3518,4174,33.21144381083123,5.8721273231371045,656,1,123322,5550,1103,0,1789,1312
11042,0,0,0,0,49,1,512,0,1,367428,992136,20.049937655763422,132,1586,1316,402,52070,505940,626872,2198,2870,2738,3382,4054,30.23243291566195,16.432183852193692,672,1,102108,16470,914,0,2066,1554
11043,0,0,0,0,48,1,509,0,1,300650,853300,18.708286933869708,55,1504,1209,350,50292,482724,619252,2143,2788,2733,3297,3942,29.30870177950569,17.804139447115162,645,1,88900,14750,859,0,2088,1579
11044,0,0,0,0,50,1,1602,1,0,1650595,5847690,48.11444689487763,2225,3118,3028,2315,38874,469836,527934,2436,4841,2616,3239,5644,26.70205984563738,9.505517133991825,2405,1,483835,9360,713,0,211,1813
11045,0,0,0,0,49,1,877,0,1,1596624,4434672,42.14261501141095,1776,2675,2675,1776,47792,579304,514382,2497,4273,2497,3396,5172,29.9833287011299,0.0,1776,1,365856,0,899,0,721,1598
11046,0,0,0,0,50,1,860,0,1,1546956,4365000,41.78516483155236,1716,2662,2632,1746,49416,580000,532500,2470,4246,2530,3386,5162,29.765752132274432,5.490867587491313,1776,1,371898,4680,886,0,754,1614
11047,0,0,0,0,49,1,803,0,1,1415078,4119302,40.70626487409524,1657,2511,2511,1657,47520,536976,546920,2486,4143,2486,3340,4997,29.223278392404914,0.0,1657,1,364540,0,854,0,829,1632
11048,0,0,0,0,49,1,379,0,1,1003470,3015246,34.77067730142742,1075,2173,2039,1209,45732,553668,513764,2360,3703,2628,3324,4667,28.809720581775867,12.019627717482168,1343,1,249054,20636,830,0,1285,1664
11049,0,0,0,0,48,1,60,0,1,886464,2373624,31.176914536239792,912,1944,1884,972,48240,490842,586080,2382,3414,2502,3354,4386,30.199337741083,8.038779614196052,1032,1,233280,5040,912,0,1470,1530
11050,0,0,0,0,49,1,512,0,1,388740,1032460,20.445048300260872,178,1588,1348,418,55822,558220,610090,2230,2888,2710,3400,4058,30.495901363953813,15.493614093656653,658,1,103246,23520,930,0,2052,1540
11051,0,0,0,0,52,1,1916,0,1,1781685,6765201,51.0,2301,3586,3286,2601,53320,645048,559215,2301,5202,2901,3286,6187,26.1725046566048,17.46945657321371,2901,1,559215,50400,685,0,0,1916
11052,0,0,0,0,49,1,706,1,0,1344335,3898415,39.56008088970496,1565,2424,2424,1565,44720,535565,518128,2491,4056,2491,3350,4915,29.30870177950569,0.0,1565,1,325520,0,859,0,926,1632
11053,0,0,0,0,49,1,656,1,0,1277745,3738420,38.79432948254165,1475,2384,2354,1505,41818,504252,511704,2454,3989,2514,3333,4868,29.13760456866693,5.490867587491313,1535,1,310030,3900,849,0,979,1635
11054,0,0,0,0,49,1,514,1,0,1139555,3360400,36.810324638611924,1231,2320,2196,1355,44325,558000,488560,2356,3835,2604,3321,4800,29.0,11.166001493285611,1479,1,266935,20708,841,0,1125,1639
11055,0,0,0,0,48,1,15,0,1,893914,2281216,30.62678566222711,896,1933,1891,938,46172,471808,578816,2390,3370,2474,3385,4365,30.870698080866262,6.653712290320142,980,1,223244,3234,953,0,1494,1479
11056,0,0,0,0,51,1,1736,1,0,1508592,6077064,48.703182647543684,2219,3161,3008,2372,34300,448350,502152,2409,4934,2715,3198,5723,25.219040425836983,12.617493041379154,2525,1,464912,15912,636,0,190,1926
11057,0,0,0,0,50,1,1334,1,0,1614336,5276020,45.8475735453906,2012,2960,2870,2102,33831,449290,474390,2420,4612,2600,3278,5470,27.712812921102035,9.82680210338744,2192,1,397278,10530,768,0,408,1742
11058,0,0,0,0,50,1,762,1,0,1547440,4206682,41.012193308819754,1652,2632,2602,1682,46440,540216,537715,2471,4183,2531,3421,5133,30.331501776206203,5.483301264452448,1712,1,361630,4110,920,0,819,1581
11059,0,0,0,0,49,1,625,1,0,1319634,3746979,38.768543949960254,1443,2441,2381,1503,40602,501093,503586,2433,3996,2553,3371,4934,29.631064780058107,7.780166052320878,1563,1,303606,7980,878,0,990,1615
11060,0,0,0,0,49,1,164,0,1,997280,2679648,32.92415526630866,964,2124,2004,1084,43456,479568,553728,2352,3556,2592,3392,4596,30.331501776206203,11.06238981080611,1204,1,242816,11520,920,0,1388,1552
11061,0,0,0,0,48,1,90,1,0,898576,2193104,30.066592756745816,862,1940,1898,904,49494,531294,548276,2384,3330,2468,3420,4366,31.52776554086889,6.481658975540136,946,1,204304,5334,994,0,1522,1432
11062,0,0,0,0,47,1,513,0,1,196864,612608,16.0,66,1215,1025,256,50904,483386,603036,2203,2649,2583,3162,3608,27.730849247724095,14.241925542717267,446,1,64512,12350,769,0,2137,1624
11063,0,0,0,0,46,1,496,0,1,65232,252720,10.392304845413264,0,820,712,108,56400,561600,549900,2232,2448,2448,2944,3160,24.576411454889016,10.45608800483739,216,1,25380,14472,604,0,2232,1736
11064,0,0,0,0,50,1,1592,1,0,1483409,5731046,47.44470465710583,2081,3080,2910,2251,35512,468464,491378,2376,4797,2716,3205,5626,25.67099530598687,13.573165933825017,2421,1,434443,20570,659,0,295,1887
11065,0,0,0,0,50,1,1500,1,0,1513981,5571713,46.8081189538738,2057,3016,2882,2191,34560,457740,488256,2409,4734,2677,3234,5559,26.28687885618983,12.25832084953297,2325,1,420672,15544,691,0,352,1852
11066,0,0,0,0,50,1,667,1,0,1470084,3982273,39.88734135035826,1531,2575,2515,1591,39951,518121,483079,2443,4094,2563,3427,5078,30.397368307141328,7.83531632499182,1651,1,307063,8940,924,0,912,1579
11067,0,0,0,0,49,1,481,1,0,1242900,3440071,37.16180835212409,1231,2431,2281,1381,43890,520619,523110,2341,3872,2641,3391,4922,30.0,12.325090945468352,1531,1,290010,19950,900,0,1110,1591
11068,0,0,0,0,48,1,347,1,0,826448,1829616,27.422618401604176,692,1911,1851,752,46200,486600,562023,2373,3185,2493,3532,4344,33.15116890850155,7.765259411425052,812,1,173712,5700,1099,0,1681,1334
11069,0,0,0,0,48,1,394,0,1,805752,1748684,26.870057685088806,662,1898,1838,722,44693,452914,578858,2362,3144,2482,3538,4320,33.406586176980134,7.880145860644973,782,1,172558,4020,1116,0,1700,1306
11070,0,0,0,0,47,1,490,0,0,764439,1588548,25.748786379167466,663,1816,1816,663,53743,534308,577436,2396,3059,2396,3549,4212,33.95585369269929,0.0,663,0,159783,0,1153,0,1733,1243
11071,0,0,0,0,50,1,1378,1,0,1516200,5325600,45.8257569495584,1950,2972,2822,2100,35490,461552,494520,2386,4636,2686,3258,5508,26.870057685088806,12.72513248597547,2250,1,409500,17100,722,0,436,1814
11072,0,0,0,0,50,1,960,1,0,1674000,4724400,43.12771730569565,1740,2880,2760,1860,20116,477520,271780,2420,4400,2660,3440,5420,30.0,11.246826503806982,1980,1,199020,25080,900,0,680,1640
11073,0,0,0,0,50,1,703,1,0,1641360,4231920,40.98780306383839,1590,2747,2657,1680,34034,471053,458458,2429,4199,2609,3496,5266,31.25699921617557,9.590813010750445,1770,1,305760,12150,977,0,839,1542
11074,0,0,0,0,51,1,1548,1,0,1405980,5612970,46.79743582719036,2000,3022,2832,2190,38784,492096,517726,2373,4753,2753,3205,5585,25.337718918639855,14.470300240284018,2380,1,442380,22800,642,0,373,1921
11075,0,0,0,0,51,1,1891,0,1,1390662,6326775,49.56813492557492,2055,3425,3023,2457,51500,643750,530450,2173,5032,2977,3141,6000,23.790754506740637,20.226739949721797,2859,1,506142,72360,566,0,118,2009
11076,0,0,0,0,51,1,1421,1,0,1425900,5378100,45.8257569495584,1890,2989,2779,2100,36465,478907,499395,2351,4661,2771,3240,5550,26.057628441590765,15.064106383522578,2310,1,409500,25410,679,0,461,1882
11077,0,0,0,0,51,1,1318,1,0,1472880,5214240,45.16635916254486,1830,2972,2762,2040,34408,470304,477972,2346,4596,2766,3278,5528,26.870057685088806,14.846855792793013,2250,1,381480,26460,722,0,516,1834
11078,0,0,0,0,50,1,1104,1,0,1566720,4878720,43.81780460041329,1740,2916,2736,1920,31096,429429,467544,2361,4461,2721,3357,5457,28.5657137141714,13.687973365625968,2100,1,353280,19620,816,0,621,1725
11079,0,0,0,0,50,1,624,1,0,1692900,4200900,40.620192023179804,1497,2829,2676,1650,31506,450642,453188,2393,4196,2699,3572,5375,32.03123475609393,12.639835959643802,1803,1,293700,19431,1026,0,896,1520
11080,0,0,0,0,50,1,529,1,0,1531530,3873960,39.11521443121589,1377,2684,2531,1530,39996,501336,511464,2379,4062,2685,3533,5216,31.63858403911275,12.596031671368893,1683,1,309060,19431,1001,0,1002,1531
11081,0,0,0,0,49,1,287,0,1,948648,2076429,29.0,691,2119,1969,841,31960,464172,419730,2319,3310,2619,3597,4588,33.58571124749333,12.470060607585795,991,1,142970,22350,1128,0,1628,1341
11082,0,0,0,0,47,1,484,0,1,605661,1374627,23.93741840717165,543,1660,1630,573,33154,580558,328663,2369,2972,2429,3456,4059,32.51153641401772,5.514871952411144,603,1,78501,6990,1057,0,1826,1342
11083,0,0,0,0,51,1,1905,0,1,1156276,6149286,48.877397639399746,1972,3290,2873,2389,49938,633204,522522,2157,4963,2991,3058,5864,22.0,20.680533434288655,2806,1,484967,75894,484,0,185,2090
11084,0,0,0,0,50,1,391,1,0,1518036,3662334,37.986839826445156,1201,2737,2495,1443,42640,520290,527904,2296,3981,2780,3590,5275,32.43454948045371,15.70714518281398,1685,1,300144,31460,1052,0,1095,1486
11085,0,0,0,0,46,1,457,0,0,91050,350400,12.24744871391589,150,757,757,150,42824,471872,495232,2336,2486,2336,2943,3093,24.63736998950984,0.0,150,0,31800,0,607,0,2186,1729
11086,0,0,0,0,51,1,1538,1,0,1269135,5541534,46.184412955021955,1833,3028,2728,2133,39400,511806,519600,2298,4731,2898,3193,5626,24.392621835300936,18.00655506037119,2433,1,426600,38700,595,0,465,2003
11087,0,0,0,0,51,1,1101,1,0,1501942,4875156,43.520110293977886,1626,2955,2687,1894,27720,540540,339768,2306,4468,2842,3367,5529,28.160255680657446,16.67419489778013,2162,1,250008,57084,793,0,680,1781
11088,0,0,0,0,51,1,703,1,0,1652004,4349772,41.036569057366385,1444,2905,2665,1684,39800,514017,516600,2343,4267,2823,3564,5488,31.32091952673165,15.935709737308477,1924,1,336800,31680,981,0,899,1602
11089,0,0,0,0,50,1,3,0,1,1242108,2830176,33.406586176980134,785,2560,2229,1116,46842,535096,562992,2205,3652,2867,3649,5096,33.36165463522455,18.659416045821843,1447,1,247752,40051,1113,0,1420,1423
11090,0,0,0,0,49,1,471,0,1,876730,1791420,27.018512172212592,610,2051,1931,730,46368,451536,618408,2334,3184,2574,3655,4505,34.655446902326915,11.58292185288269,850,1,183960,4560,1201,0,1724,1253
11091,0,0,0,0,50,1,1839,0,1,1195132,5985052,48.45616575834287,2042,3163,2857,2348,46872,642348,474114,2243,4897,2855,3058,5712,22.561028345356956,17.68109658663758,2654,1,436728,61506,509,0,201,2040
11092,0,0,0,0,52,1,1889,0,1,888810,5939074,47.738873049120045,1879,3069,2669,2279,49848,646288,523806,2206,4885,3006,2996,5675,19.748417658131498,20.237727727130004,2679,1,458079,73600,390,0,327,2216
11093,0,0,0,0,51,1,890,1,0,1573536,4612272,42.14261501141095,1506,2932,2662,1776,43264,540176,540176,2327,4373,2867,3483,5529,29.765752132274432,16.93798840892058,2046,1,369408,36180,886,0,821,1711
11094,0,0,0,0,51,1,544,1,0,1681641,4123454,39.96248240537617,1327,2920,2650,1597,41382,511236,539638,2312,4179,2852,3635,5502,32.449961479175904,16.889160885292643,1867,1,333773,32130,1053,0,985,1529
11095,0,0,0,0,47,1,451,0,1,327990,930150,19.748417658131498,270,1351,1231,390,52624,496080,603405,2265,2775,2505,3226,3736,29.0,11.305412972083932,510,1,98670,7560,841,0,1995,1544
11096,0,0,0,0,51,1,1925,0,1,757100,5842100,47.53945729601885,1803,3052,2595,2260,51308,656590,522170,2128,4845,3042,2920,5637,18.303005217723125,21.491516166593023,2717,1,456520,83174,335,0,325,2250
11097,0,0,0,0,52,1,962,1,0,1532223,4717872,42.532340636273474,1508,2957,2656,1809,45360,547680,563328,2307,4417,2909,3455,5565,29.103264421710495,17.882645020557682,2110,1,390744,38227,847,0,799,1761
11098,0,0,0,0,52,1,731,1,0,1620710,4395690,41.10960958218893,1390,2949,2649,1690,43264,541008,541008,2301,4291,2901,3560,5550,30.967725134404045,17.320508075688775,1990,1,351520,40200,959,0,911,1642
11099,0,0,0,0,50,1,319,0,1,1135566,2305098,30.298514815086232,617,2456,2155,918,47515,539865,554931,2210,3429,2812,3748,4967,35.17101079013795,17.670141105659948,1219,1,202878,38227,1237,0,1593,1274
11100,0,0,0,0,48,1,447,0,1,492480,1242999,22.64950330581225,423,1563,1473,513,56400,569405,581520,2333,2936,2513,3383,3986,30.983866769659336,9.724035232351886,603,1,123120,10890,960,0,1910,1463
11101,0,0,0,0,47,1,430,0,1,273000,822850,18.708286933869708,290,1190,1130,350,53072,503114,583048,2291,2701,2411,3131,3541,27.92848008753788,7.7992067098508295,410,1,86800,5220,780,0,2001,1571
11102,0,0,0,0,51,1,1870,0,1,918696,5814618,47.686476070265456,1974,2978,2678,2274,51865,646921,524185,2257,4831,2857,2961,5535,20.09975124224178,17.756461590612943,2574,1,466170,54000,404,0,283,2153
11103,0,0,0,0,52,1,1865,0,1,775250,5763430,47.06378650300037,1765,3015,2565,2215,47311,658306,486574,2152,4817,3052,2952,5617,18.708286933869708,21.98166379060546,2665,1,414205,90000,350,0,387,2252
11104,0,0,0,0,52,1,1599,0,1,1157740,5613220,46.26013402488151,1750,3071,2681,2140,44940,561322,550830,2233,4763,3013,3164,5694,23.259406699226016,20.42395326320896,2530,1,449400,54210,541,0,483,2082
11105,0,0,0,0,52,1,976,1,0,1514832,4734756,42.567593307585526,1481,2979,2648,1812,46652,559182,569634,2282,4425,2944,3449,5592,28.91366458960192,18.701792923195054,2143,1,395016,43361,836,0,801,1777
11106,0,0,0,0,51,1,452,1,0,1686048,3998960,39.293765408777,1304,2876,2636,1544,44036,523180,564620,2350,4134,2830,3682,5466,33.04542328371661,15.500062938088007,1784,1,336592,27360,1092,0,1046,1498
11107,0,0,0,0,51,1,256,1,0,1668420,3660542,37.76241517699841,1179,2843,2596,1426,43681,536503,536503,2320,3993,2814,3737,5410,34.20526275297414,15.790158320479412,1673,1,298034,33098,1170,0,1141,1397
11108,0,0,0,0,52,1,1507,0,1,1202468,5466332,45.65084884205331,1666,3079,2661,2084,47306,569191,571814,2205,4707,3041,3200,5702,24.020824298928627,20.951212386814206,2502,1,454312,56012,577,0,539,2046
11109,0,0,0,0,51,1,1897,0,1,580220,5568380,46.52956049652737,1774,2824,2433,2165,46736,653288,473248,2181,4737,2963,2840,5396,16.3707055437449,20.42961431767183,2556,1,398360,76636,268,0,407,2304
11110,0,0,0,0,52,1,771,0,1,1584562,4454134,41.255302689472536,1468,2867,2633,1702,47085,573123,562655,2383,4319,2851,3548,5484,30.512292604784715,15.312748817767162,1936,1,365930,32760,931,0,915,1686
11111,0,0,0,0,51,1,242,0,1,1714584,3706316,37.89459064299283,1246,2820,2630,1436,43888,536848,544591,2391,4017,2771,3775,5401,34.55430508634199,13.822074075384924,1626,1,302996,24700,1194,0,1145,1387
11112,0,0,0,0,51,1,20,0,1,1559901,3240666,35.482389998420345,991,2766,2498,1259,50820,594594,566280,2306,3833,2842,3813,5340,35.199431813596085,16.38186260813823,1527,1,276980,39396,1239,0,1315,1335
11113,0,0,0,0,50,1,264,0,1,1323540,2596806,32.03123475609393,703,2639,2316,1026,47443,528979,574537,2208,3557,2854,3821,5170,35.91656999213594,18.185470972928353,1349,1,232902,36176,1290,0,1505,1241
11114,0,0,0,0,50,1,1912,0,1,559860,5505290,46.58325879540846,1902,2696,2428,2170,56088,624102,578436,2269,4707,2805,2795,5233,16.06237840420901,16.715296746065686,2438,1,494760,38056,258,0,367,2279
11115,0,0,0,0,50,1,1939,0,1,456012,5448483,46.37887450122092,1827,2687,2363,2151,54934,574991,612986,2209,4684,2857,2745,5220,14.560219778561036,18.236427457834708,2475,1,520542,31104,212,0,382,2321
11116,0,0,0,0,51,1,1873,0,1,549798,5474539,46.16275555033516,1771,2749,2389,2131,46228,652526,467558,2209,4700,2929,2827,5318,16.06237840420901,19.68150370737571,2491,1,387842,70920,258,0,438,2311
11117,0,0,0,0,49,1,428,0,1,998688,1988488,28.42534080710379,628,2224,2044,808,47724,477434,605406,2281,3269,2641,3697,4685,35.156791662493895,13.936984710943394,988,1,198768,11520,1236,0,1653,1225
11118,0,0,0,0,50,1,1939,0,1,386022,5342799,46.05431575867782,1821,2603,2303,2121,54412,561737,614636,2219,4640,2819,2701,5122,13.490737563232042,17.496824208506457,2421,1,517524,25800,182,0,398,2337
11119,0,0,0,0,50,1,1937,0,1,381060,5313670,46.010868281309364,1798,2616,2297,2117,54264,597380,572280,2191,4627,2829,2690,5126,13.416407864998739,18.060097869899543,2436,1,482676,39237,180,0,393,2330
11120,0,0,0,0,51,1,26,0,1,1653627,3276702,35.679125549822544,1057,2788,2572,1273,54280,607464,592020,2358,3847,2790,3873,5362,36.0416425818802,14.703313187521976,1489,1,292790,30240,1299,0,1301,1275
11121,0,0,0,0,52,1,1329,0,1,1203246,5116716,44.12482294582042,1510,3002,2565,1947,52416,614952,588672,2191,4575,3065,3246,5630,24.859605789312106,20.920290215528947,2384,1,436128,63802,618,0,681,2010
11122,0,0,0,0,50,1,1876,0,1,347820,5151828,45.232731511594565,1774,2488,2216,2046,43172,632018,433096,2246,4564,2790,2688,5006,13.038404810405298,16.94513492650589,2318,1,351912,53856,170,0,472,2348
11123,0,0,0,0,52,1,1623,0,1,758758,5253248,44.74371464239419,1707,2676,2381,2002,53424,661248,556288,2329,4626,2919,3003,5300,19.467922333931785,18.849063843145075,2297,1,424424,50445,379,0,622,2245
11124,0,0,0,0,52,1,817,0,1,1566300,4526400,41.53311931459037,1575,2783,2633,1725,53824,608768,608768,2474,4349,2774,3532,5407,30.133038346638727,12.30152264982736,1875,1,400200,19800,908,0,899,1716
11125,0,0,0,0,51,1,235,0,1,1587684,2927400,33.88214869219483,938,2741,2531,1148,56386,594150,617100,2340,3698,2760,3933,5291,37.1887079635741,14.491705337660376,1358,1,277816,24360,1383,0,1402,1167
11126,0,0,0,0,47,1,228,1,0,259488,968184,20.199009876724155,348,1104,1044,408,25807,467481,310863,2313,2781,2433,3009,3477,25.219040425836983,8.246211251235321,468,1,53448,11880,636,0,1965,1737
11127,0,0,0,0,49,1,1891,0,1,256286,5032892,44.9221548904324,1771,2392,2145,2018,41666,625994,414004,2247,4512,2741,2621,4886,11.269427669584644,16.005917126935234,2265,1,334988,50635,127,0,476,2367
11128,0,0,0,0,52,1,1603,0,1,732354,5165958,44.429719783046124,1706,2613,2345,1974,53424,659484,554804,2349,4591,2885,2988,5230,19.261360284258224,18.141037733946636,2242,1,418488,45292,371,0,643,2246
11129,0,0,0,0,47,1,358,0,0,673559,1575163,25.709920264364882,631,1710,1680,661,44772,586218,433706,2353,3044,2413,3402,4093,31.921779399024736,5.684275577662207,691,0,120302,6060,1019,0,1722,1364
11130,0,0,0,0,52,1,972,0,1,1448608,4693704,42.23742416388575,1572,2808,2596,1784,52628,620916,586713,2419,4415,2843,3443,5439,28.495613697550013,14.618906374886377,1996,1,397832,31588,812,0,847,1819
11131,0,0,0,0,50,1,340,0,1,1622325,2815375,33.391615714128,965,2720,2570,1115,56404,595900,603475,2375,3640,2675,3980,5245,38.144462245521304,12.256148736246766,1265,1,266485,18600,1455,0,1410,1070
11132,0,0,0,0,50,1,376,0,1,1590281,2741414,32.96968304366907,937,2700,2550,1087,55890,612846,580060,2372,3609,2672,3985,5222,38.24918299781056,12.250849366392371,1237,1,250010,21750,1463,0,1435,1059
11133,0,0,0,0,47,1,259,1,0,392190,1207170,22.58317958127243,480,1309,1279,510,35000,473400,414225,2337,2877,2397,3136,3676,27.730849247724095,5.652706486041966,540,1,89250,4800,769,0,1857,1598
11134,0,0,0,0,49,1,1766,0,1,354536,4852468,44.13615298142782,1768,2310,2130,1948,41416,617768,415997,2311,4439,2671,2673,4801,13.490737563232042,13.833892875472413,2128,1,325316,35280,182,0,543,2309
11135,0,0,0,0,51,1,1516,0,1,745637,4946758,43.669211121796096,1673,2532,2298,1907,52710,651094,544740,2360,4501,2828,2985,5126,19.77371993328519,16.972403872751418,2141,1,400470,37908,391,0,687,2203
11136,0,0,0,0,52,1,1398,0,1,903799,4900432,43.347433603386484,1582,2657,2360,1879,53383,659824,550288,2311,4487,2905,3089,5265,21.93171219946131,18.621783418566388,2176,1,396469,50787,481,0,729,2127
11137,0,0,0,0,47,1,270,1,0,473176,1344250,23.790754506740637,506,1462,1402,566,31132,429875,408500,2315,2941,2435,3211,3837,28.91366458960192,7.9332512824338455,626,1,97352,8340,836,0,1809,1539
11138,0,0,0,0,48,1,176,1,0,332145,1193940,22.24859546128699,387,1274,1166,495,30753,484812,369036,2304,2907,2520,3083,3686,25.903667693977237,11.115195081142032,603,1,75735,19656,671,0,1917,1741
11139,0,0,0,0,48,1,134,1,0,299112,1173216,22.0,334,1252,1102,484,37590,509040,433896,2274,2908,2574,3042,3676,24.859605789312106,12.9849534146292,634,1,86636,25050,618,0,1940,1806
11140,0,0,0,0,50,1,340,0,1,1758669,2942007,34.161381705077446,1077,2764,2674,1167,55350,567225,620166,2431,3688,2611,4028,5285,38.82009788756334,9.497356383238309,1257,1,287082,9180,1507,0,1354,1014
11141,0,0,0,0,48,1,353,0,1,989958,2012442,28.879058156387302,804,2051,2021,834,50652,485013,608076,2383,3247,2443,3600,4464,34.45286635390443,5.5503012171862105,864,1,210168,1920,1187,0,1579,1226
11142,0,0,0,0,47,1,315,0,0,710500,1661800,26.457513110645905,700,1715,1715,700,55692,565012,555516,2374,3074,2374,3389,4089,31.85906464414798,0.0,700,0,163800,0,1015,0,1674,1359
11143,0,0,0,0,49,1,1628,0,0,648429,4817181,44.26059195266146,1959,2290,2290,1959,52152,604914,521308,2459,4418,2459,2790,4749,18.193405398660254,0.0,1959,0,415308,0,331,0,500,2128
11144,0,0,0,0,52,1,572,0,1,1703100,4220444,40.27406113120453,1562,2732,2672,1622,52200,585450,603664,2542,4224,2662,3652,5334,32.4037034920393,7.746504550744806,1682,1,376304,7560,1050,0,980,1552
11145,0,0,0,0,48,1,106,1,0,352407,1326006,23.302360395462088,351,1384,1192,543,42336,527472,478632,2250,2985,2634,3091,3826,25.475478405713993,14.561839326296232,735,1,106428,30144,649,0,1899,1793
11146,0,0,0,0,49,1,1595,1,0,646550,4745870,43.93176527297759,1900,2295,2265,1930,51726,572947,545898,2429,4389,2489,2794,4754,18.303005217723125,5.477225575051661,1960,1,428460,4410,335,0,529,2124
11147,0,0,0,0,48,1,1667,0,0,472758,4673988,43.749285708454714,1914,2161,2161,1914,56870,590964,573870,2442,4356,2442,2689,4603,15.716233645501712,0.0,1914,0,449790,0,247,0,528,2195
11148,0,0,0,0,49,1,1817,0,1,126228,4627104,43.40506882842141,1776,2059,1951,1884,55418,562424,594352,2348,4340,2564,2523,4515,8.18535277187245,10.435690064413366,1992,1,455928,12312,67,0,572,2389
11149,0,0,0,0,48,1,1732,0,1,250044,4558638,43.197222132910355,1771,2095,2000,1866,53424,615636,517916,2348,4309,2538,2577,4538,11.575836902790225,9.82390283601982,1961,1,395592,15960,134,0,577,2309
11150,0,0,0,0,52,1,942,0,1,1273888,4448444,41.15823125451335,1409,2731,2446,1694,53352,648622,567216,2341,4320,2911,3378,5357,27.422618401604176,16.907035861815707,1979,1,365904,47310,752,0,932,1874
11151,0,0,0,0,51,1,62,0,1,1826943,3530799,37.1887079635741,1383,2704,2704,1383,54970,610167,587190,2553,3936,2553,3874,5257,36.345563690772494,0.0,1383,1,318090,0,1321,0,1170,1232
11152,0,0,0,0,48,1,358,0,1,1334520,2415600,31.464265445104548,990,2338,2338,990,52297,529480,588040,2440,3430,2440,3788,4778,36.71511950137164,0.0,990,1,238590,0,1348,0,1450,1092
11153,0,0,0,0,47,1,299,1,0,813960,1822230,27.65863337187866,723,1871,1829,765,41989,474018,502602,2340,3147,2424,3446,4253,32.61901286060018,6.503581472166948,807,1,161415,4998,1064,0,1617,1318
11154,0,0,0,0,48,1,90,1,0,354384,1350744,23.49468024894146,318,1428,1194,552,45878,553022,496741,2213,2999,2681,3089,3875,25.337718918639855,15.891790495269438,786,1,112056,37674,642,0,1895,1805
11155,0,0,0,0,49,1,1719,0,1,280350,4582788,43.23193264243457,1827,2061,2019,1869,53750,613000,527180,2410,4321,2494,2602,4513,12.24744871391589,6.5135556243263055,1911,1,401835,7056,150,0,583,2302
11156,0,0,0,0,48,1,1760,0,1,166500,4523250,43.01162633521314,1755,2035,1940,1850,54340,537900,603915,2350,4295,2540,2535,4480,9.486832980505138,9.753537202071987,1945,1,456950,9120,90,0,595,2355
11157,0,0,0,0,48,1,340,1,0,1248000,2335680,30.983866769659336,930,2290,2260,960,46008,518229,525528,2403,3393,2463,3733,4723,36.05551275463989,5.478746393072713,990,1,207360,3900,1300,0,1473,1133
11158,0,0,0,0,48,1,310,1,0,983991,2040996,29.13760456866693,789,2068,2008,849,39246,447144,507244,2344,3253,2464,3563,4472,34.044089061098404,7.759379671981613,909,1,179139,6000,1159,0,1555,1245
11159,0,0,0,0,48,1,239,1,0,657300,1703800,26.457513110645905,573,1766,1639,700,21432,457592,277476,2307,3134,2561,3373,4200,30.643106892089126,11.906612245133031,827,1,79800,25781,939,0,1734,1495
11160,0,0,0,0,48,1,1650,0,0,353664,4505532,42.91852746774987,1842,2034,2034,1842,51906,601716,516106,2446,4288,2446,2638,4480,13.856406460551018,0.0,1842,0,388662,0,192,0,604,2254
11161,0,0,0,0,51,1,1128,0,1,995220,4416930,41.352146256270665,1415,2587,2292,1710,45793,653499,467523,2288,4293,2878,3165,5170,24.124676163629637,18.4520352732338,2005,1,309510,56935,582,0,873,2001
11162,0,0,0,0,52,1,921,0,1,1205230,4309110,40.63249930782009,1316,2716,2381,1651,51816,662940,532440,2275,4261,2945,3340,5326,27.018512172212592,18.304472869627627,1986,1,336804,59965,730,0,959,1880
11163,0,0,0,0,49,1,166,1,0,505767,1560978,25.15949125081825,415,1650,1432,633,34944,473472,448812,2248,3099,2684,3265,4116,28.26658805020514,15.626268309565164,851,1,115206,31174,799,0,1833,1667
11164,0,0,0,0,49,1,168,1,0,436500,1434048,24.124676163629637,340,1574,1332,582,43466,507584,519904,2222,3046,2706,3214,4038,27.386127875258307,16.278994450423134,824,1,122802,30976,750,0,1882,1714
11165,0,0,0,0,48,1,1582,0,0,424944,4436488,42.61455150532503,1816,2050,2050,1816,48880,574105,508144,2443,4259,2443,2677,4493,15.297058540778355,0.0,1816,0,377728,0,234,0,627,2209
11166,0,0,0,0,48,1,1642,0,1,274635,4379800,42.36744032862972,1765,1978,1948,1795,56619,592920,568520,2410,4235,2470,2593,4418,12.36931687685298,5.5965095842615735,1825,1,418235,4110,153,0,645,2287
11167,0,0,0,0,48,1,1478,0,1,498363,4280991,41.96427051671457,1761,2044,2044,1761,47752,617474,457028,2431,4192,2431,2714,4475,16.822603841260722,0.0,1761,1,331068,0,283,0,670,2148
11168,0,0,0,0,50,1,187,0,1,1908098,3252029,35.93048844644336,1231,2829,2769,1291,55209,581889,602041,2459,3810,2579,3997,5348,38.44476557348217,7.849311256600636,1351,1,308549,7200,1478,0,1228,1041
11169,0,0,0,0,48,1,248,1,0,836553,1940771,28.26658805020514,649,1996,1846,799,27010,449365,354634,2279,3228,2579,3476,4425,32.357379374726875,12.574334296829354,949,1,116654,25500,1047,0,1630,1382
11170,0,0,0,0,49,1,208,0,1,344400,1208844,22.181073012818835,183,1501,1192,492,51574,592137,525798,2148,2949,2766,3157,3958,26.457513110645905,18.03018803230308,801,1,105288,50676,700,0,1965,1757
11171,0,0,0,0,48,1,1584,0,0,321412,4294912,42.02380277890139,1766,1948,1948,1766,56088,598272,554496,2432,4198,2432,2614,4380,13.490737563232042,0.0,1766,0,402648,0,182,0,666,2250
11172,0,0,0,0,49,1,346,0,1,1806096,2934906,34.38022687534217,1092,2800,2710,1182,55161,563641,603369,2393,3665,2573,4011,5283,39.08964057138413,9.678858787534972,1272,1,287226,9990,1528,0,1301,955
11173,0,0,0,0,49,1,318,0,1,1414719,2565024,32.264531609803356,921,2520,2400,1041,49680,532224,566720,2344,3505,2584,3823,4984,36.864617182333525,10.963758173094375,1161,1,239430,14160,1359,0,1423,1105
11174,0,0,0,0,48,1,294,0,1,1192795,2337840,30.903074280724887,805,2354,2204,955,46420,516528,538560,2298,3403,2598,3697,4802,35.34119409414458,12.270382205646603,1105,1,210100,18450,1249,0,1493,1199
11175,0,0,0,0,48,1,288,0,1,1141348,2279894,30.56141357987225,784,2306,2156,934,44660,495523,537020,2291,3375,2591,3663,4747,34.95711658589707,12.25845656828046,1084,1,205480,16950,1222,0,1507,1219
11176,0,0,0,0,49,1,1411,1,0,650382,4367866,42.15447781671598,1717,2203,2143,1777,43020,442440,587462,2398,4235,2518,2824,4661,19.131126469708992,7.896951773353783,1837,1,424703,3300,366,0,681,2092
11177,0,0,0,0,48,1,1383,0,0,542938,4096714,41.255302689472536,1672,2051,2021,1702,52118,608971,495842,2377,4109,2437,2726,4458,17.86057109949175,5.652706486041966,1732,0,350612,5400,319,0,705,2088
11178,0,0,0,0,50,1,1127,0,1,865124,4155567,40.63249930782009,1481,2345,2175,1651,43596,634284,435441,2347,4168,2687,3041,4862,22.891046284519195,14.116966219983684,1821,1,285623,34000,524,0,866,1993
11179,0,0,0,0,51,1,736,0,1,1247552,4002048,39.293765408777,1220,2676,2352,1544,51204,650592,528768,2268,4136,2916,3400,5268,28.42534080710379,19.393496264009,1868,1,314976,53784,808,0,1048,1784
11180,0,0,0,0,48,1,277,0,1,1180938,2342736,30.93541659651604,777,2371,2191,957,49268,533664,553248,2268,3405,2628,3682,4819,35.12833614050059,13.433868909381221,1137,1,216282,22680,1234,0,1491,1214
11181,0,0,0,0,48,1,254,0,1,1038600,2204100,30.0,720,2234,2054,900,44642,541229,494698,2269,3349,2629,3603,4683,33.97057550292606,13.461829731744027,1080,1,181800,28260,1154,0,1549,1295
11182,0,0,0,0,49,1,1397,1,0,588504,4268824,41.66533331199932,1736,2075,2075,1736,33920,521308,393440,2459,4195,2459,2798,4534,18.411952639521967,0.0,1736,1,277760,0,339,0,723,2120
11183,0,0,0,0,49,1,1427,1,0,518100,4253601,41.557189510360296,1667,2087,2027,1727,37555,455655,499989,2403,4190,2523,2763,4550,17.320508075688775,7.994134176674909,1787,1,350581,6540,300,0,736,2163
11184,0,0,0,0,50,1,905,0,1,1064246,4005923,39.736632972611055,1351,2481,2253,1579,41500,634250,421142,2309,4116,2765,3211,5018,25.96150997149434,16.008355269390623,1807,1,262114,46512,674,0,958,1863
11185,0,0,0,0,50,1,789,0,1,1133730,3893850,39.11521443121589,1302,2499,2271,1530,51870,628615,534450,2317,4075,2773,3286,5044,27.2213151776324,16.373041306494688,1758,1,321300,34884,741,0,1015,1804
11186,0,0,0,0,51,1,583,0,1,1292130,3760655,38.27531841800928,1146,2666,2347,1465,48945,644317,500565,2248,4032,2886,3449,5233,29.698484809834994,18.86755284149355,1784,1,285675,55506,882,0,1102,1685
11187,0,0,0,0,51,1,196,0,1,1603296,3489768,36.98648401781386,1126,2782,2540,1368,49588,499996,645403,2309,3919,2793,3723,5333,34.23448553724738,15.556415593152641,1610,1,346104,10406,1172,0,1183,1379
11188,0,0,0,0,50,1,49,0,1,1828656,3337264,36.4417343165772,1148,2885,2705,1328,55056,623224,557886,2333,3841,2693,3890,5398,37.107950630558946,13.548605186119353,1508,1,294816,27000,1377,0,1185,1136
11189,0,0,0,0,50,1,751,0,1,1130256,3801087,38.768543949960254,1302,2456,2255,1503,51660,622134,531090,2328,4032,2730,3281,4985,27.422618401604176,15.436840168162993,1704,1,315630,30351,752,0,1026,1777
11190,0,0,0,0,50,1,52,0,1,1668588,3297636,36.30426972134269,1090,2812,2584,1318,55890,575460,607986,2274,3820,2730,3768,5314,35.58089374931439,15.257585007586592,1546,1,320274,23028,1266,0,1184,1236
11191,0,0,0,0,49,1,1287,1,0,535558,3965718,40.22437072223753,1498,2069,1949,1618,35308,475494,446082,2331,4069,2571,2782,4520,18.193405398660254,11.080810612286749,1738,1,294476,17520,331,0,833,2120
11192,0,0,0,0,49,1,850,0,1,994431,3751374,38.84584919911006,1385,2292,2168,1509,45318,619014,452452,2362,3995,2610,3145,4778,25.67099530598687,11.852030944155647,1633,1,274638,22568,659,0,977,1827
11193,0,0,0,0,50,1,589,0,1,1216292,3623028,37.89459064299283,1202,2517,2283,1436,48945,633273,491985,2289,3959,2757,3370,5040,29.103264421710495,16.133571940578015,1670,1,280020,40716,847,0,1087,1676
11194,0,0,0,0,49,1,55,0,1,1700964,3169514,35.73513677041127,1035,2851,2609,1277,54312,615536,543558,2240,3759,2724,3814,5333,36.49657518178932,15.84624764074158,1519,1,279663,36058,1332,0,1205,1150
11195,0,0,0,0,48,1,288,0,1,1753488,2893968,34.46737587922817,946,2906,2664,1188,56069,601692,552972,2194,3624,2678,3912,5342,38.41874542459709,15.974855339047577,1430,1,269676,35090,1476,0,1248,960
11196,0,0,0,0,49,1,1175,1,0,610350,3845205,39.56008088970496,1412,2108,1955,1565,46926,486486,582309,2304,4022,2610,2847,4565,19.748417658131498,12.519275369364598,1718,1,370905,12852,390,0,892,2067
11197,0,0,0,0,49,1,631,0,1,1155980,3584256,37.89459064299283,1266,2411,2241,1436,53072,619008,534144,2326,3932,2666,3301,4907,28.372521918222215,13.81913831625272,1606,1,307304,25840,805,0,1060,1691
11198,0,0,0,0,50,1,590,0,1,1183104,3559266,37.70941526992961,1230,2446,2254,1422,48636,630756,483079,2311,3925,2695,3335,4949,28.844410203711913,14.621066420214344,1614,1,274446,34176,832,0,1081,1671
11199,0,0,0,0,49,1,57,0,1,1641430,3096163,35.397740040855716,976,2840,2563,1253,54978,588098,570801,2194,3724,2748,3781,5311,36.193922141707716,16.96385803918754,1530,1,289443,33517,1310,0,1218,1161
11200,0,0,0,0,48,1,340,0,1,1931100,2999970,35.07135583350036,960,3070,2800,1230,56088,556092,599994,2169,3669,2709,4009,5509,39.6232255123179,16.999389342224802,1500,1,302580,27000,1570,0,1209,869
11201,0,0,0,0,48,1,361,0,1,789162,1775796,26.94438717061496,366,2173,1813,726,52877,618838,511214,2086,3172,2806,3533,4619,32.96968304366907,19.364916731037084,1086,1,151734,61560,1087,0,1720,1359
11202,0,0,0,0,48,1,976,1,0,800217,3625842,38.82009788756334,1477,2068,2038,1507,54412,587064,536538,2376,3913,2436,2937,4474,23.043437243605826,5.483301264452448,1537,1,336061,4680,531,0,899,1875
11203,0,0,0,0,50,1,470,0,1,1230731,3423869,37.0,1157,2480,2268,1369,48192,627751,480192,2289,3870,2713,3400,4981,29.9833287011299,15.202029772713532,1581,1,262848,37736,899,0,1132,1602
11204,0,0,0,0,48,1,357,0,1,1868400,2905200,34.64101615137755,932,3025,2757,1200,56376,561672,588303,2153,3621,2689,3978,5446,39.45883931389772,16.516944551401593,1468,1,291600,29212,1557,0,1221,864
11205,0,0,0,0,48,1,317,0,1,1513718,2621686,32.89376840679705,751,2812,2481,1082,49302,603327,479754,2092,3505,2754,3822,5235,37.403208418530085,18.43470088701494,1413,1,214236,62228,1399,0,1341,1024
11206,0,0,0,0,48,1,377,0,1,849008,1830368,27.422618401604176,422,2211,1881,752,53928,613368,520876,2104,3186,2764,3563,4645,33.60059523282288,18.516322432273395,1082,1,160928,55110,1129,0,1682,1305
11207,0,0,0,0,48,1,391,0,1,751212,1689534,26.324893162176366,370,2100,1777,693,54216,611938,526608,2115,3131,2761,3522,4538,32.92415526630866,18.364385332158275,1016,1,149688,51680,1084,0,1745,1354
11208,0,0,0,0,50,1,1098,1,0,688624,3906320,39.293765408777,1420,2114,1990,1544,38728,475640,521180,2406,4074,2654,2976,4644,21.118712081942874,11.375520776142816,1668,1,318064,13640,446,0,986,2084
11209,0,0,0,0,49,1,615,0,1,1092454,3431032,37.376463182061514,1312,2264,2179,1397,39520,606632,392960,2371,3853,2541,3238,4720,27.964262908219126,9.855393472241717,1482,1,223520,17170,782,0,1059,1674
11210,0,0,0,0,50,1,159,0,1,1391986,3175192,35.52463933666322,1006,2621,2365,1262,50007,596292,530876,2260,3778,2772,3619,5137,33.21144381083123,16.71609963912538,1518,1,266282,33792,1103,0,1254,1413
11211,0,0,0,0,48,1,134,0,1,1585632,2919330,34.55430508634199,911,2805,2522,1194,56644,581910,581910,2162,3639,2728,3773,5250,36.4417343165772,17.09571816764056,1477,1,284172,33960,1328,0,1251,1117
11212,0,0,0,0,50,1,1041,1,0,718110,3849615,38.92300091205713,1381,2123,1989,1515,36180,457380,510741,2407,4056,2675,3015,4664,21.77154105707724,12.239957291285208,1649,1,304515,14070,474,0,1026,2067
11213,0,0,0,0,48,1,346,0,1,1616160,2678430,33.31666249791537,786,2890,2566,1110,43855,591185,431927,2089,3523,2737,3869,5303,38.157568056677825,18.090028760734143,1434,1,198690,66096,1456,0,1303,957
11214,0,0,0,0,48,1,426,0,1,825120,1741680,26.832815729997478,450,2136,1866,720,55527,602331,539437,2149,3139,2689,3565,4555,33.85262175962151,16.764275179295073,990,1,160560,41040,1146,0,1699,1273
11215,0,0,0,0,50,1,990,1,0,707551,3717217,38.353617821530214,1215,2208,1952,1471,30855,416955,472549,2271,3998,2783,3008,4735,21.93171219946131,16.19471969289564,1727,1,275077,25856,481,0,1056,2046
11216,0,0,0,0,49,1,5,0,1,1403034,2943760,34.45286635390443,975,2581,2369,1187,53743,597680,553040,2268,3667,2692,3662,5061,34.38022687534217,15.007032090461722,1399,1,264701,27984,1182,0,1293,1298
11217,0,0,0,0,48,1,408,0,1,1114009,2106078,29.512709126747414,603,2418,2150,871,56386,563394,585156,2150,3289,2686,3697,4836,35.76310948449533,16.698570277407985,1139,1,210782,31088,1279,0,1547,1139
11218,0,0,0,0,51,1,927,1,0,760324,3716011,38.09199390948182,1269,2157,1975,1451,34125,448175,499395,2379,4012,2743,3085,4718,22.891046284519195,13.990149959375703,1633,1,282945,19110,524,0,1110,2037
11219,0,0,0,0,48,1,764,1,0,866112,3347856,37.255872020394314,1264,2136,2012,1388,45200,482400,545112,2288,3800,2536,3036,4548,24.979991993593593,11.142040945118985,1512,1,313688,12648,624,0,1024,1788
11220,0,0,0,0,48,1,541,0,0,1045136,3188528,36.4417343165772,1328,2115,2115,1328,46046,607453,436982,2401,3729,2401,3188,4516,28.053520278211074,0.0,1328,0,241696,0,787,0,1073,1614
11221,0,0,0,0,48,1,304,0,1,1206777,3081884,35.510561809129406,1153,2326,2218,1261,48888,615888,474136,2336,3705,2552,3401,4770,30.93541659651604,10.700008142562027,1369,1,244634,19332,957,0,1183,1487
11222,0,0,0,0,49,1,111,0,1,1302226,2948278,34.61213659975356,1045,2438,2285,1198,53482,595562,543881,2308,3659,2614,3548,4899,32.96968304366907,12.764261190342262,1351,1,264758,20655,1087,0,1263,1374
11223,0,0,0,0,48,1,287,0,1,1525700,2655400,33.166247903554,908,2679,2487,1100,56640,569704,579360,2222,3514,2606,3801,5093,37.242448899072144,14.01927502583177,1292,1,264000,22848,1387,0,1314,1027
11224,0,0,0,0,51,1,851,1,0,852222,3718918,37.97367509209505,1357,2118,2033,1442,35066,508063,459062,2494,4021,2664,3170,4697,24.310491562286437,9.568061544601736,1527,1,256676,13090,591,0,1137,1988
11225,0,0,0,0,50,1,835,1,0,767564,3483880,37.255872020394314,1091,2238,1941,1388,33325,389050,539650,2213,3898,2807,3063,4748,23.515952032609693,17.720808923323293,1685,1,298420,15444,553,0,1122,1957
11226,0,0,0,0,47,1,525,1,0,1028350,3128280,36.193922141707716,1268,2137,2095,1310,53703,580284,527748,2346,3698,2430,3173,4525,28.0178514522438,6.609134537568676,1352,1,289510,6594,785,0,1078,1603
11227,0,0,0,0,48,1,541,1,0,968250,3124220,35.93048844644336,1141,2191,2041,1291,35890,469480,447700,2270,3711,2570,3170,4611,27.386127875258307,12.312788037888811,1441,1,238835,21150,750,0,1129,1670
11228,0,0,0,0,48,1,20,0,1,1247589,2727340,33.57082066318904,1067,2294,2234,1127,54858,595320,539660,2360,3547,2480,3527,4714,33.27160951922825,7.864259938752337,1187,1,251321,8520,1107,0,1293,1313
11229,0,0,0,0,48,1,127,0,1,1308138,2618440,32.89376840679705,992,2381,2291,1082,52459,607420,505780,2330,3502,2510,3629,4801,34.77067730142742,9.625480693201963,1172,1,226138,14850,1209,0,1338,1211
11230,0,0,0,0,51,1,692,1,0,834813,3423924,36.373066958946424,1014,2263,1954,1323,42833,525364,546068,2279,3911,2897,3219,4851,25.11971337416094,17.887233479950705,1632,1,279153,38316,631,0,1265,1957
11231,0,0,0,0,50,1,627,1,0,857224,3245574,35.93048844644336,991,2255,1955,1291,30514,367044,525426,2214,3805,2814,3178,4769,25.768197453450252,17.84686516926831,1591,1,269819,13800,664,0,1223,1850
11232,0,0,0,0,48,1,543,0,1,921294,3093822,35.62302626111375,1053,2211,1995,1269,39270,414460,563178,2222,3707,2654,3164,4649,26.94438717061496,14.787141465807673,1485,1,293139,11448,726,0,1169,1712
11233,0,0,0,0,48,1,314,1,0,1073655,2906460,34.713109915419565,1138,2163,2096,1205,42570,477576,518580,2345,3617,2479,3303,4575,29.8496231131986,8.239962426314323,1272,1,259075,7571,891,0,1207,1521
11234,0,0,0,0,51,1,622,1,0,848063,3321687,35.81898937714463,907,2320,1944,1283,42372,512622,554046,2213,3872,2965,3250,4909,25.709920264364882,19.724874845353288,1659,1,274562,42864,661,0,1306,1928
11235,0,0,0,0,48,1,487,0,1,931728,3030594,35.199431813596085,997,2233,1991,1239,37620,403590,557688,2204,3685,2688,3198,4679,27.422618401604176,15.70714518281398,1481,1,282492,11858,752,0,1207,1694
11236,0,0,0,0,48,1,265,1,0,1073424,2849517,34.307433596816885,1092,2174,2089,1177,39676,440622,527778,2336,3598,2506,3333,4595,30.199337741083,9.344583777936014,1262,1,256586,7395,912,0,1244,1509
11237,0,0,0,0,48,1,83,1,0,1178760,2715096,33.58571124749333,1098,2203,2173,1128,49042,543982,522319,2377,3535,2437,3452,4610,32.32645975048923,5.490867587491313,1158,1,244776,4350,1045,0,1279,1362
11238,0,0,0,0,48,1,251,0,1,1284990,2440060,31.85906464414798,973,2323,2281,1015,54216,603404,519264,2362,3419,2446,3670,4727,35.58089374931439,6.553889165207866,1057,1,219240,6930,1266,0,1389,1138
11239,0,0,0,0,49,1,466,0,1,915936,3030384,34.899856733230294,918,2270,1970,1218,36660,388128,584680,2188,3706,2788,3240,4758,27.422618401604176,17.650442477681178,1518,1,286230,7200,752,0,1270,1736
11240,0,0,0,0,48,1,244,1,0,1058412,2826678,34.02939905434711,1031,2199,2072,1158,34030,405206,500405,2314,3599,2568,3355,4640,30.23243291566195,11.539076697242356,1285,1,237390,10160,914,0,1283,1527
11241,0,0,0,0,47,1,259,0,0,1252232,2387815,31.575306807693888,997,2253,2253,997,52320,574800,522110,2395,3392,2395,3651,4648,35.4400902933387,0.0,997,0,217346,0,1256,0,1398,1139
11242,0,0,0,0,49,1,220,0,1,1044684,2804032,33.734255586866,968,2226,2056,1138,32548,389312,507584,2294,3602,2634,3382,4690,30.298514815086232,13.464698179561317,1308,1,234428,11560,918,0,1326,1546
11243,0,0,0,0,48,1,133,1,0,1084470,2699520,33.31666249791537,986,2211,2087,1110,30096,369664,481536,2308,3542,2556,3409,4643,31.25699921617557,11.274838741931772,1234,1,219780,8432,977,0,1322,1455
11244,0,0,0,0,52,1,443,1,0,896694,3118728,34.55430508634199,777,2362,1945,1194,43800,522400,572028,2195,3806,3029,3363,4974,27.40437921208944,20.664658287030907,1611,1,261486,46287,751,0,1418,1861
11245,0,0,0,0,49,1,6,1,0,1119355,2588970,32.48076353782343,935,2236,2116,1055,28860,382824,453990,2334,3509,2574,3515,4690,32.57299494980466,11.368551155324415,1175,1,195175,10800,1061,0,1399,1393
11246,0,0,0,0,48,1,313,1,0,1206498,2296730,30.870698080866262,911,2261,2219,953,41790,479590,506100,2368,3363,2452,3676,4671,35.58089374931439,6.570697549716149,995,1,200130,4998,1266,0,1457,1144
11247,0,0,0,0,48,1,385,1,0,1222950,2233860,30.495901363953813,900,2275,2245,930,47524,523636,523636,2372,3332,2432,3717,4677,36.26292872893749,5.483301264452448,960,1,202740,4050,1315,0,1472,1087
11248,0,0,0,0,49,1,244,1,0,973152,2782188,33.406586176980134,781,2323,1988,1116,26055,481149,336555,2158,3609,2828,3365,4816,29.5296461204668,18.624686344179032,1451,1,150660,63315,872,0,1377,1621
11249,0,0,0,0,52,1,335,1,0,937250,3042900,33.91164991562634,808,2307,1965,1150,48590,568890,597996,2304,3796,2988,3461,4953,28.548204847240395,18.694833005433797,1492,1,259900,41382,815,0,1496,1831
11250,0,0,0,0,50,1,91,0,1,1035272,2682344,32.61901286060018,806,2295,2037,1064,28014,347898,511763,2263,3585,2779,3494,4816,31.192947920964443,16.868364972133637,1322,1,215992,10836,973,0,1457,1548
11251,0,0,0,0,49,1,36,1,0,1052352,2607912,32.31098884280702,816,2280,2052,1044,30338,384692,492106,2270,3542,2726,3506,4778,31.74901573277509,15.704047635544342,1272,1,205668,16644,1008,0,1454,1490
11252,0,0,0,0,49,1,190,1,0,1140159,2412213,31.25699921617557,827,2294,2144,977,34740,444420,476517,2319,3446,2619,3636,4763,34.161381705077446,12.849476832533073,1127,1,188561,17250,1167,0,1492,1302
11253,0,0,0,0,51,1,83,1,0,1015350,2681700,32.4037034920393,731,2336,2017,1050,31284,505692,403532,2235,3604,2873,3521,4890,31.096623610932426,18.809405232831537,1369,1,165900,55506,967,0,1504,1587
11254,0,0,0,0,50,1,44,1,0,1056300,2518018,31.71750305430741,764,2298,2056,1006,30294,382959,495594,2261,3509,2745,3553,4801,32.4037034920393,16.169941716904972,1248,1,199188,16698,1050,0,1497,1453
11255,0,0,0,0,49,1,304,1,0,1141137,2289690,30.44667469527666,774,2311,2158,927,40470,469300,526110,2317,3397,2623,3701,4781,35.08560958569767,12.971229163407108,1080,1,197451,16065,1231,0,1543,1239
11256,0,0,0,0,48,1,412,1,0,1150028,2165384,29.765752132274432,762,2308,2184,886,41924,459472,545012,2320,3330,2568,3742,4752,36.02776706930364,11.136252869947771,1010,1,197578,11036,1298,0,1558,1146
11257,0,0,0,0,51,1,174,0,1,933331,2734459,32.51153641401772,523,2474,1940,1057,48555,504465,644163,2053,3644,3121,3470,5061,29.715315916207253,23.800421432717467,1591,1,263193,32574,883,0,1530,1704
11258,0,0,0,0,49,1,291,1,0,1109862,2286738,30.298514815086232,738,2307,2127,918,37310,453362,510655,2311,3409,2671,3700,4798,34.77067730142742,14.064063304453542,1098,1,188190,18540,1209,0,1573,1282
11259,0,0,0,0,50,1,176,1,0,1049040,2369740,30.659419433511783,724,2272,2056,940,32436,400839,514284,2305,3461,2737,3637,4793,33.406586176980134,15.154270372012492,1156,1,191760,15552,1116,0,1581,1405
11260,0,0,0,0,52,1,95,1,0,957164,2716415,32.046840717924134,581,2405,1959,1027,52206,597770,610995,2199,3672,3091,3577,5050,30.528675044947494,21.18741251430835,1473,1,237237,57088,932,0,1618,1713
11261,0,0,0,0,51,1,56,0,1,983280,2467840,31.04834939252005,574,2374,1984,964,28907,540160,350720,2170,3524,2950,3580,4934,31.937438845342623,19.797604633483182,1354,1,132068,81510,1020,0,1596,1540
11262,0,0,0,0,51,1,87,0,1,1005120,2479680,30.983866769659336,625,2342,2007,960,40500,581175,464940,2248,3543,2918,3630,4925,32.357379374726875,18.313434191905955,1295,1,172800,61640,1047,0,1623,1536
11263,0,0,0,0,51,1,177,1,0,1029510,2378940,30.495901363953813,696,2271,2037,930,34650,422070,537180,2324,3488,2792,3665,4829,33.27160951922825,15.413134918687012,1164,1,195300,17316,1107,0,1628,1451
11264,0,0,0,0,48,1,696,1,0,1088896,1829616,27.422618401604176,752,2200,2200,752,39060,452538,510930,2433,3185,2433,3881,4633,38.05259518088089,0.0,752,1,157920,0,1448,0,1681,985
11265,0,0,0,0,53,1,43,1,0,1008558,2733264,32.03123475609393,665,2370,2009,1026,51302,602064,604728,2303,3690,3025,3647,5034,31.352830813181765,19.067037578341814,1387,1,232902,48013,983,0,1638,1681
11266,0,0,0,0,52,1,35,1,0,959114,2638062,31.575306807693888,530,2426,1959,997,52206,597996,611226,2179,3643,3113,3608,5072,31.016124838541646,21.64776316788708,1464,1,230307,59776,962,0,1649,1684
11267,0,0,0,0,52,1,34,1,0,954240,2626148,31.52776554086889,506,2442,1954,994,52664,599734,612944,2154,3636,3130,3602,5084,30.983866769659336,22.14396020279802,1482,1,230608,62952,960,0,1648,1682
11268,0,0,0,0,52,1,32,1,0,952320,2616896,31.496031496047245,483,2461,1952,992,52650,593550,617292,2129,3630,3147,3598,5099,30.983866769659336,22.59933339486142,1501,1,232128,62098,960,0,1646,1678
11269,0,0,0,0,51,1,202,1,0,1020024,2355378,30.23243291566195,672,2272,2030,914,40874,492207,551478,2335,3491,2819,3693,4849,33.406586176980134,15.588391269727603,1156,1,195596,25410,1116,0,1663,1461
11270,0,0,0,0,51,1,230,1,0,1021064,2317238,30.033314835362415,686,2250,2034,902,36925,449575,542059,2353,3471,2785,3701,4819,33.645207682521445,14.767307884128202,1118,1,190322,18576,1132,0,1667,1437
11271,0,0,0,0,50,1,392,1,0,1045265,2150525,29.068883707497267,737,2190,2082,845,27900,394475,458100,2437,3390,2653,3782,4735,35.17101079013795,10.562698776726089,953,1,152100,10260,1237,0,1700,1308
11272,0,0,0,0,48,1,743,1,0,1064300,1773350,26.92582403567252,695,2223,2193,725,34496,430496,479416,2416,3171,2476,3914,4669,38.31448812133603,5.501408174353464,755,1,142100,3180,1468,0,1721,978
11273,0,0,0,0,53,1,11,1,0,1041390,2715125,31.85906464414798,692,2364,2041,1015,49922,583150,612575,2352,3690,2998,3701,5039,32.03123475609393,18.016139117858067,1338,1,232435,39083,1026,0,1660,1649
11274,0,0,0,0,51,1,388,1,0,1023264,2152700,28.91366458960192,728,2168,2060,836,25756,484100,352775,2467,3411,2683,3799,4743,34.9857113690718,10.518295179710192,944,1,114532,19656,1224,0,1739,1351
11275,0,0,0,0,51,1,471,1,0,1033432,2065248,28.42534080710379,741,2154,2087,808,30528,406404,490752,2489,3364,2623,3835,4710,35.76310948449533,8.314029025396882,875,1,155136,5762,1279,0,1748,1277
11276,0,0,0,0,49,1,815,1,0,1003586,1654670,25.96150997149434,589,2248,2163,674,32757,449265,439445,2370,3129,2540,3944,4703,38.58756276314948,9.370214040084857,759,1,120646,11390,1489,0,1781,966
11277,0,0,0,0,52,1,98,1,0,944328,2426424,30.397368307141328,330,2540,1946,924,50429,554086,627614,2032,3550,3220,3648,5166,31.96873472629156,24.38764222458212,1518,1,220836,58806,1022,0,1702,1604
11278,0,0,0,0,51,1,155,0,1,949500,2309400,30.0,386,2469,1955,900,45305,526030,567086,2052,3466,3080,3621,5035,32.48076353782343,22.694894781272883,1414,1,198900,59110,1055,0,1666,1511
11279,0,0,0,0,50,1,600,1,0,1033600,1929640,27.568097504180443,730,2150,2120,760,33904,413857,528112,2509,3299,2569,3899,4689,36.87817782917155,6.300703649796459,790,1,158080,2190,1360,0,1779,1179
11280,0,0,0,0,50,1,660,1,0,1038141,1866579,27.2213151776324,741,2142,2142,741,33600,403040,528990,2519,3260,2519,3920,4661,37.429934544425805,0.0,741,1,155610,0,1401,0,1778,1118
11281,0,0,0,0,49,1,829,1,0,931740,1569012,25.219040425836983,509,2228,2101,636,34034,461329,448994,2340,3103,2594,3932,4695,38.27531841800928,11.466142793898168,763,1,115752,17145,1465,0,1831,1002
11282,0,0,0,0,51,1,190,1,0,931875,2273250,29.58039891549808,274,2541,1940,875,45571,517002,594942,1997,3473,3199,3663,5139,32.63433774416144,24.515318312152907,1476,1,200375,57696,1065,0,1723,1533
11283,0,0,0,0,51,1,653,1,0,1009590,1862960,27.018512172212592,730,2113,2113,730,38325,446600,558888,2552,3282,2552,3935,4665,37.1887079635741,0.0,730,1,159870,0,1383,0,1822,1169
11284,0,0,0,0,53,1,189,1,0,1002100,2437836,30.18277654557314,494,2428,2011,911,47952,578016,594072,2259,3587,3093,3776,5104,33.166247903554,20.44694950270965,1328,1,202242,52959,1100,0,1765,1576
11285,0,0,0,0,51,1,523,1,0,973038,1962015,27.54995462791182,669,2131,2041,759,33696,558360,403260,2495,3344,2675,3867,4716,35.805027579936315,9.543708938032719,849,1,118404,17820,1282,0,1826,1303
11286,0,0,0,0,51,1,655,1,0,975384,1839540,26.70205984563738,713,2081,2081,713,44121,492780,595980,2580,3293,2580,3948,4661,36.98648401781386,0.0,713,1,164703,0,1368,0,1867,1212
11287,0,0,0,0,50,1,724,1,0,911397,1659362,25.67099530598687,599,2102,2042,659,35997,425542,536334,2458,3177,2578,3901,4620,37.1887079635741,7.745966692414834,719,1,140367,4500,1383,0,1859,1135
11288,0,0,0,0,50,1,757,1,0,875828,1578762,25.11971337416094,546,2104,2019,631,35319,457866,482886,2417,3133,2587,3890,4606,37.255872020394314,9.235136611923052,716,1,121783,10030,1388,0,1871,1114
11289,0,0,0,0,52,1,497,1,0,965430,1997415,27.65863337187866,583,2209,2027,765,46428,571809,553532,2429,3376,2793,3873,4820,35.52463933666322,13.503040937515399,947,1,162180,26208,1262,0,1846,1349
11290,0,0,0,0,50,1,737,1,0,837390,1557978,24.859605789312106,523,2068,1973,618,35148,438654,509242,2426,3139,2616,3876,4589,36.810324638611924,9.747874142570481,713,1,124836,9025,1355,0,1903,1166
11291,0,0,0,0,51,1,679,1,0,846120,1648652,25.317977802344327,556,2046,1961,641,43584,493824,583844,2487,3213,2657,3892,4618,36.3318042491699,9.235136611923052,726,1,145507,7565,1320,0,1931,1252
11292,0,0,0,0,51,1,684,1,0,839520,1631340,25.219040425836983,546,2046,1956,636,43232,495045,574560,2475,3201,2655,3885,4611,36.3318042491699,9.505517133991825,726,1,142464,8550,1320,0,1929,1245
11293,0,0,0,0,53,1,349,1,0,1037672,2311569,29.30870177950569,455,2471,2067,859,53312,602784,640458,2287,3550,3095,3899,5162,34.75629439396553,20.12384492651272,1263,1,204442,46864,1208,0,1832,1483
11294,0,0,0,0,51,1,451,0,1,900750,1927500,27.386127875258307,232,2469,1951,750,49276,498580,652780,2052,3320,3088,3771,5039,34.655446902326915,22.7774261270937,1268,1,190500,25382,1201,0,1820,1369
11295,0,0,0,0,51,1,532,0,1,905388,1866370,26.870057685088806,380,2318,1976,722,42084,651420,431695,2243,3307,2927,3839,4903,35.41186241925155,18.500984561994112,1064,1,120574,71820,1254,0,1863,1331
11296,0,0,0,0,52,1,647,1,0,852810,1718065,25.592967784139454,560,2052,1957,655,47025,548207,590175,2528,3278,2718,3925,4675,36.08323710533743,9.886585106410566,750,1,147375,10925,1302,0,1968,1321
11297,0,0,0,0,51,1,673,1,0,797838,1600002,24.859605789312106,523,2004,1909,618,40848,476376,574758,2494,3207,2684,3880,4593,35.93048844644336,9.773682308767459,713,1,137196,8075,1291,0,1971,1298
11298,0,0,0,0,51,1,691,1,0,774600,1534800,24.49489742783178,476,2015,1891,600,39480,480904,537180,2434,3158,2682,3849,4573,35.93048844644336,11.144389776194219,724,1,126000,13144,1291,0,1958,1267
11299,0,0,0,0,53,1,445,1,0,906000,2008300,27.477263328068172,122,2588,1955,755,48364,569240,601160,2027,3415,3293,3860,5248,34.64101615137755,25.167791195835193,1388,1,170630,75960,1200,0,1905,1460
11300,0,0,0,0,52,1,461,1,0,892626,1949976,27.23967694375247,42,2645,1945,742,50508,543996,641232,1928,3370,3328,3831,5273,34.68429039204925,26.46808977200699,1442,1,181048,60200,1203,0,1886,1425
11301,0,0,0,0,52,1,647,1,0,796898,1645128,25.019992006393608,502,2023,1899,626,47286,559764,583416,2504,3254,2752,3901,4651,35.679125549822544,11.274838741931772,750,1,138972,15376,1273,0,2002,1355
11302,0,0,0,0,53,1,508,1,0,888060,1919076,26.870057685088806,48,2626,1952,722,54225,598050,640578,1984,3380,3332,3888,5284,35.07135583350036,25.967808378378866,1396,1,174002,75488,1230,0,1936,1428
11303,0,0,0,0,51,1,562,0,1,865823,1779325,26.28687885618983,131,2504,1944,691,50546,512425,654050,2015,3266,3135,3828,5079,35.397740040855716,23.675177924976772,1251,1,175514,30240,1253,0,1884,1322
11304,0,0,0,0,52,1,635,0,1,774354,1623486,24.859605789312106,443,2046,1871,618,47355,606837,538535,2452,3245,2802,3880,4673,35.397740040855716,13.306788019122699,793,1,126690,28875,1253,0,2009,1374
11305,0,0,0,0,51,1,740,0,1,618261,1274945,22.338307903688676,283,1954,1738,499,44426,495670,585095,2339,3054,2771,3794,4509,35.199431813596085,14.697647169827432,715,1,114271,19440,1239,0,2056,1316
11306,0,0,0,0,52,1,639,0,1,705222,1525086,24.06241883103193,389,1987,1797,579,45458,626892,503094,2444,3213,2824,3852,4621,34.899856733230294,13.893096626134744,769,1,110589,35530,1218,0,2055,1416
11307,0,0,0,0,52,1,649,1,0,677040,1475040,23.664319132398465,380,1949,1769,560,45368,558408,563676,2454,3194,2814,3843,4583,34.77067730142742,13.534510284478205,740,1,119840,23580,1209,0,2074,1425
11308,0,0,0,0,52,1,631,0,1,852060,1735140,25.69046515733026,11,2622,1951,660,55000,578380,657250,1958,3289,3300,3920,5251,35.93048844644336,26.57926558315072,1331,1,165000,59048,1291,0,1969,1338
11309,0,0,0,0,51,1,643,0,1,745800,1536000,24.49489742783178,258,2185,1843,600,41500,640000,424960,2218,3160,2902,3803,4745,35.25620512760839,18.55307256596978,942,1,99600,69426,1243,0,1960,1317
11310,0,0,0,0,52,1,660,1,0,601749,1351242,22.64950330581225,303,1896,1686,513,56168,621624,626892,2424,3147,2844,3807,4530,34.249087579087416,14.585423422348626,723,1,122094,26670,1173,0,2121,1461
11311,0,0,0,0,52,1,669,1,0,589516,1322890,22.427661492005804,291,1887,1675,503,55418,602270,636460,2418,3133,2842,3802,4517,34.23448553724738,14.632570524736149,715,1,121726,24380,1172,0,2127,1458
11312,0,0,0,0,50,1,768,0,1,453169,988839,19.77371993328519,68,1873,1550,391,53286,541206,629721,2206,2920,2852,3688,4402,34.044089061098404,18.027756377319946,714,1,97359,22610,1159,0,2138,1370
11313,0,0,0,0,50,1,789,0,1,438040,946768,19.390719429665317,41,1876,1541,376,54340,553960,621946,2183,2894,2853,3683,4394,34.132096331752024,18.347246363109615,711,1,92872,27135,1165,0,2142,1353
11314,0,0,0,0,51,1,618,0,1,625320,1400760,23.2379000772445,216,2022,1698,540,27730,609590,306092,2270,3134,2918,3752,4616,34.02939905434711,18.00107157783166,864,1,63720,78084,1158,0,2054,1436
11315,0,0,0,0,52,1,646,0,1,530880,1233822,21.77154105707724,204,1864,1594,474,51736,603896,580469,2333,3077,2873,3723,4467,33.46640106136302,16.432183852193692,744,1,105702,30780,1120,0,2129,1483
11316,0,0,0,0,51,1,691,0,1,468152,1083233,20.518284528683193,120,1834,1533,421,54635,573779,630385,2272,2994,2874,3685,4407,33.34666400106613,17.38162353615016,722,1,103145,26187,1112,0,2152,1461
11317,0,0,0,0,51,1,698,0,1,466488,1065900,20.445048300260872,105,1847,1534,418,52328,538050,632400,2237,2968,2863,3666,4397,33.406586176980134,17.799220410962196,731,1,103664,20658,1116,0,2132,1434
11318,0,0,0,0,51,1,811,0,1,787170,1479150,23.874672772626646,12,2533,1951,570,51750,583875,596850,2013,3165,3177,3976,5128,37.16180835212409,24.724569625932443,1152,1,131100,55872,1381,0,2025,1214
11319,0,0,0,0,49,1,782,0,1,358344,808380,18.0,7,1761,1430,324,55056,553890,618760,2164,2819,2826,3601,4256,33.25657829663178,18.763820415882076,655,1,80352,28466,1106,0,2171,1389
11320,0,0,0,0,50,1,640,0,1,537600,1220640,21.908902300206645,72,2008,1600,480,24396,579804,272101,2135,3023,2951,3663,4551,33.46640106136302,20.293476923373188,888,1,51360,99960,1120,0,2063,1423
11321,0,0,0,0,52,1,614,0,1,509480,1223410,21.6794833886788,119,1905,1554,470,56144,603896,629926,2252,3073,2954,3687,4508,32.92415526630866,18.735336139997333,821,1,113740,37557,1084,0,2133,1519
11322,0,0,0,0,53,1,878,0,1,839535,1548091,24.020824298928627,21,2630,2032,577,43680,523185,600992,2085,3260,3281,4138,5313,38.144462245521304,25.65543484289993,1175,1,129248,58006,1455,0,2106,1228
11323,0,0,0,0,50,1,735,0,1,583200,1203360,21.908902300206645,30,2205,1695,480,53965,539005,629257,1997,2987,3017,3722,4712,34.85685011586675,22.792980734037897,990,1,120480,38250,1215,0,2027,1292
11324,0,0,0,0,50,1,653,0,1,496350,1134450,21.213203435596427,0,2003,1553,450,34749,612603,360503,2071,2971,2971,3624,4524,33.21144381083123,21.37077381883121,900,1,64350,103500,1103,0,2071,1418
11325,0,0,0,0,51,1,624,0,1,434097,1072524,20.42057785666214,52,1823,1458,417,51646,558124,612136,2207,2989,2937,3613,4395,32.264531609803356,19.13105506106144,782,1,99246,28470,1041,0,2155,1531
11326,0,0,0,0,49,1,723,0,1,324268,779996,17.69180601295413,28,1634,1349,313,54858,555716,613032,2207,2805,2777,3528,4126,32.18695387886216,17.50955194337864,598,1,76998,24795,1036,0,2179,1456
11327,0,0,0,0,52,1,930,0,1,740259,1353807,22.64950330581225,28,2497,1956,513,43092,451269,665028,2098,3152,3180,4082,5136,37.986839826445156,24.253934665983778,1054,1,129276,7033,1443,0,2126,1196
11328,0,0,0,0,50,1,857,0,1,643578,1222221,21.93171219946131,22,2322,1819,481,56643,607299,602217,2038,3022,3044,3879,4863,36.578682316343766,22.80978867851647,984,1,113997,60863,1338,0,2060,1203
11329,0,0,0,0,50,1,818,0,1,623040,1217280,21.908902300206645,8,2266,1778,480,55209,606104,585816,2048,3016,3024,3834,4802,36.02776706930364,22.461248425091647,968,1,110880,60512,1298,0,2056,1238
11330,0,0,0,0,50,1,891,0,1,557560,1080352,20.591260281974,30,2193,1739,424,47500,484120,637000,2094,2972,3002,3863,4741,36.26292872893749,21.79669194664825,878,1,106000,23154,1315,0,2124,1233
11331,0,0,0,0,49,1,698,0,1,225120,593280,15.491933384829668,30,1388,1178,240,54450,556200,598224,2262,2712,2682,3410,3860,30.62678566222711,15.064106383522578,450,1,58080,19110,938,0,2232,1534
11332,0,0,0,0,48,1,807,0,1,166090,414120,13.038404810405298,5,1322,1147,170,56643,582204,577332,2261,2606,2611,3413,3758,31.25699921617557,13.613476355868046,345,1,40290,21350,977,0,2266,1459
11333,0,0,0,0,53,1,1002,0,1,699624,1260840,21.77154105707724,23,2447,1950,474,54587,587860,657020,2163,3134,3157,4136,5107,38.41874542459709,23.59630090661846,971,1,117078,41748,1476,0,2186,1184
11334,0,0,0,0,49,1,756,0,1,401760,886320,18.973665961010276,30,1866,1476,360,56643,583494,588418,2072,2822,2852,3578,4328,33.406586176980134,19.8423968611796,750,1,86040,45630,1116,0,2102,1346
11335,0,0,0,0,49,1,692,0,1,353628,840294,18.49324200890693,48,1766,1376,342,48768,624078,471744,2067,2799,2847,3491,4223,32.155870381627054,19.82589599975852,732,1,65664,75270,1034,0,2115,1423
11336,0,0,0,0,49,1,663,0,1,327690,818070,18.16590212458495,60,1713,1323,330,40750,619750,404077,2089,2809,2869,3472,4192,31.51190251317746,19.91005125914351,720,1,53790,81120,993,0,2149,1486
11337,0,0,0,0,49,1,817,0,1,409968,869427,18.734993995195193,10,1880,1519,351,55278,549894,616773,2116,2828,2838,3645,4357,34.17601498127012,19.17120320542915,712,1,87399,31407,1168,0,2126,1309
11338,0,0,0,0,49,1,681,0,1,165490,466260,13.784048752090222,15,1236,1061,190,53040,588960,542334,2279,2644,2629,3325,3690,29.512709126747414,13.702086352745402,365,1,41990,22750,871,0,2264,1583
11339,0,0,0,0,48,1,793,0,1,116840,306197,11.269427669584644,7,1167,1047,127,55430,581051,554530,2291,2538,2531,3331,3578,30.331501776206203,11.193019168523147,247,1,29210,15480,920,0,2284,1491
11340,0,1,1,0,53,0,3724,0,0,18267200,7548800,52.91502622129181,2770,9354,9324,2800,43228,576944,544592,2666,5496,2726,9220,12050,80.77128202523468,5.623413251903491,2830,1,565600,4440,6524,0,104,3828
11341,0,1,1,0,55,0,2282,0,0,20329920,9729720,59.2452529743945,3415,9397,9302,3510,42560,620928,526680,2677,6282,2867,8564,12169,76.10519036176179,9.886585106410566,3605,1,666900,16435,5792,0,738,3020
11342,0,1,0,0,51,0,5343,0,0,9277740,3536940,37.14835124201342,1350,8133,8103,1380,56870,620246,602305,2533,3943,2593,9286,10696,81.99390221229869,5.531194905403055,1410,0,324300,3990,6723,0,1183,4160
11343,0,1,1,0,51,0,5886,0,0,1855800,776400,17.320508075688775,88,6698,6486,300,51304,626296,548656,2376,2888,2800,8774,9286,78.65112840894274,14.56540043043163,512,1,63600,35616,6186,0,2288,3598
11344,0,1,1,0,51,0,5831,0,0,1845732,780794,17.349351572897472,148,6586,6433,301,49560,612184,544740,2441,2895,2747,8726,9180,78.30708780180757,12.369845243052126,454,1,63210,25092,6132,0,2293,3538
11345,0,1,1,0,52,0,5577,0,0,3787668,1594872,24.73863375370596,400,7013,6801,612,53820,599380,609804,2394,3218,2818,8795,9619,78.67019766086774,14.562244128808702,824,1,143208,27136,6189,0,1994,3583
11346,0,1,0,0,49,0,4908,0,0,4083925,1808150,26.92582403567252,725,6358,6358,725,54000,598560,561150,2494,3219,2494,8127,8852,75.05331438384317,0.0,725,0,163125,0,5633,0,1769,3139
11347,0,1,1,0,54,0,2814,0,0,19680067,8913015,56.9824534396335,3097,9458,9308,3247,54531,601155,683505,2595,5992,2895,8806,12203,77.85242449660768,12.849476832533073,3397,1,808503,13500,6061,0,502,3316
11348,0,1,1,0,55,0,2514,0,0,20088976,9473624,58.29236656715869,3156,9552,9310,3398,53984,624512,671908,2546,6186,3030,8700,12340,76.88953114696434,16.090297175001925,3640,1,818918,26620,5912,0,610,3124
11349,0,1,0,0,50,0,4788,0,0,4003164,1822986,26.94438717061496,576,6390,6240,726,51448,592596,547398,2361,3237,2661,8025,8901,74.2563128629479,12.291303419254204,876,1,158268,23400,5514,0,1785,3003
11350,0,1,0,0,49,0,4635,0,0,4441750,2022830,28.548204847240395,785,6295,6265,815,53820,570860,580788,2452,3297,2512,7932,8777,73.824115301167,5.5965095842615735,845,1,190710,3840,5450,0,1667,2968
11351,0,1,0,0,54,0,4723,1,0,15874110,6185750,47.644516998286385,2175,9358,9263,2270,51948,604950,637650,2630,4995,2820,9718,12083,83.62415918859813,9.751111384664751,2365,1,531180,11305,6993,0,455,4268
11352,0,1,0,0,50,0,4740,0,0,4086325,1867715,27.294688127912362,592,6383,6230,745,54036,594159,571596,2354,3252,2660,7992,8890,74.06078584514209,12.395127579391273,898,1,169860,21879,5485,0,1762,2978
11353,0,1,0,0,49,0,4586,0,0,4570376,2098264,29.017236257093817,842,6270,6270,842,52200,578144,560700,2492,3334,2492,7920,8762,73.67496182557545,0.0,842,1,189450,0,5428,0,1650,2936
11354,0,1,1,0,57,0,425,0,0,21675104,13922161,69.80687645210892,4813,9381,9321,4873,56334,702822,654253,2797,7730,2917,7305,12238,66.69332800213226,7.772191019407321,4933,1,1115917,8700,4448,0,2016,1591
11355,0,1,0,0,50,0,4844,0,0,3564957,1643268,25.475478405713993,439,6352,6142,649,48825,569700,549444,2322,3181,2742,8025,8884,74.11477585475112,14.491458896152714,859,1,140833,30240,5493,0,1883,2961
11356,0,1,0,0,49,0,4518,0,0,4725144,2188248,29.597297173897484,791,6355,6270,876,50175,562050,557054,2413,3374,2583,7892,8853,73.44385610791416,9.235136611923052,961,1,195348,11645,5394,0,1622,2896
11357,0,1,0,0,49,0,4486,0,0,4847400,2247300,30.0,833,6353,6286,900,49506,556831,554334,2430,3397,2564,7883,8850,73.38937252763509,8.20171446926608,967,1,199800,9112,5386,0,1597,2889
11358,0,1,0,0,49,0,4530,0,0,4510800,2090760,28.982753492378876,780,6270,6210,840,50621,565003,555047,2429,3329,2549,7859,8759,73.28028384224504,7.746504550744806,900,1,187320,8340,5370,0,1649,2881
11359,0,1,0,0,49,0,4553,0,0,4344030,2013660,28.460498941515414,750,6233,6173,810,51984,566808,566808,2426,3296,2546,7849,8719,73.23250644351864,7.754559014766193,870,1,184680,8040,5363,0,1676,2877
11360,0,1,1,0,55,0,2565,0,0,20122084,9343846,58.16356247686347,3233,9481,9331,3383,55575,621450,682214,2612,6145,2912,8710,12243,77.12327793863537,12.75511514473605,3533,1,835601,14850,5948,0,621,3186
11361,0,1,0,0,53,0,4824,1,0,11537812,4711244,41.88078318274385,1646,8440,8332,1754,51983,609722,615094,2578,4440,2794,9264,11126,81.10487038396646,10.562698776726089,1862,1,401666,14256,6578,0,932,3892
11362,0,1,1,0,54,0,2619,0,0,20126812,9190448,58.0,3297,9414,9347,3364,47244,508152,693928,2665,6096,2799,8715,12146,77.34985455707076,8.642106768569302,3431,1,854456,1876,5983,0,632,3251
11363,0,1,1,0,55,0,3331,0,0,19114472,8370114,54.89080068645383,2785,9585,9357,3013,45787,602826,586158,2550,5791,3006,9122,12363,79.64923100695951,15.67997926561349,3241,1,635743,32376,6344,0,235,3566
11364,0,1,0,0,50,0,4306,0,0,4503120,2178480,29.49576240750525,743,6173,6046,870,51192,540864,593448,2377,3374,2631,7680,8677,71.9444229944198,11.45501536000853,997,1,206190,13589,5176,0,1634,2672
11365,0,1,1,0,59,0,2497,0,0,20724368,17877155,77.25930364687478,5874,9536,9441,5969,44325,673875,590015,2900,8964,3090,6467,12531,58.92367945062494,9.82390283601982,6064,1,1175893,15770,3472,0,2974,477
11366,0,1,1,0,60,0,3022,0,0,20127635,18741245,79.02531240052139,6203,9510,9468,6245,51272,663221,696232,2959,9246,3043,6224,12511,56.77147170894903,6.48074069840786,6287,1,1448840,5082,3223,0,3244,222
11367,0,1,0,0,53,0,4320,1,0,10026289,4493678,40.90232267243512,1243,8096,7666,1673,51072,601664,612408,2256,4359,3116,8679,10782,77.41446893184762,20.736889936745577,2103,1,381444,55470,5993,0,1013,3307
11368,0,1,1,0,60,0,3195,0,0,19929816,19150119,79.61783719745218,6254,9568,9483,6339,52779,661599,728061,2936,9360,3106,6165,12589,56.07138307550475,9.2729914971827,6424,1,1527699,8925,3144,0,3318,123
11369,0,1,0,0,56,0,2513,1,0,20912514,9889782,59.04235767650204,3252,9719,9485,3486,47443,643999,592933,2603,6323,3071,8836,12556,77.45321168292507,15.778461145441211,3720,1,728574,36504,5999,0,649,3162
11370,0,1,0,0,54,0,3965,1,0,17391000,7225170,51.332251070842396,2527,9343,9235,2635,51504,636144,608724,2634,5377,2850,9342,12085,81.24038404635961,10.403202108104866,2743,1,584970,15768,6600,0,107,3858
11371,0,1,0,0,50,0,3841,0,0,4126500,2189250,29.58039891549808,605,5861,5591,875,50394,567954,555444,2232,3377,2772,7218,8363,68.67313885355759,16.456470925020348,1145,1,194250,38070,4716,0,1627,2214
11372,0,1,1,0,56,0,97,0,0,22755318,13249932,68.71681017043792,4692,9571,9541,4722,42408,639768,521916,2776,7528,2836,7625,12377,69.41901756723442,5.490867587491313,4752,1,878292,5460,4819,0,1916,2013
11373,0,1,0,0,50,0,3490,0,0,6063299,3214325,35.679125549822544,978,6331,6036,1273,54240,606000,570650,2230,3798,2820,7288,8856,69.01449123191448,17.26607733472027,1568,1,287698,43660,4763,0,1252,2238
11374,0,1,1,0,59,0,1940,0,0,22127909,17232405,75.9802605944465,5472,9907,9606,5773,52851,665655,707445,2684,8758,3286,6818,12892,61.91122676865643,17.374621106145614,6074,1,1368201,34916,3833,0,2788,848
11375,0,1,1,0,61,0,3814,0,0,19973232,20731024,82.25569889071517,6706,9778,9718,6766,54450,741488,689400,3004,9830,3124,6016,12842,54.3323108288245,7.780166052320878,6826,1,1522350,9060,2952,0,3702,112
11376,0,1,1,0,59,0,1980,0,0,22571509,17382925,76.43951857514541,5709,9840,9706,5843,55388,725900,675325,2841,8818,3109,6838,12815,62.153036933041335,11.718240104647752,5977,1,1326361,18224,3863,0,2868,888
11377,0,1,1,0,53,0,3548,0,0,8693405,4427552,40.82891132518721,1559,6990,6882,1667,55860,605568,650720,2548,4323,2764,7871,9646,72.21495689952324,10.684669642126707,1775,1,408415,11556,5215,0,989,2559
11378,0,1,1,0,59,0,2600,0,0,22095129,18333336,78.59389289251423,6177,9754,9754,6177,48816,641088,670768,2968,9145,2968,6545,12722,59.80802621722272,0.0,6177,1,1396002,0,3577,0,3209,609
11379,0,1,1,0,58,0,776,0,0,23527412,12986200,66.91786009728644,4004,10206,9732,4478,36839,571300,542300,2426,7378,3374,8154,13106,72.48448109768049,22.048766985364775,4952,1,837386,67782,5254,0,1578,2354
11380,0,1,1,0,58,0,1172,0,0,23412480,15834000,73.89181280764467,5352,9856,9748,5460,43134,527800,687300,2792,8360,3008,7188,12756,65.4828221749796,10.392304845413264,5568,1,1294020,6696,4288,0,2560,1388
11381,0,1,0,0,50,0,3097,0,0,5986068,3385011,36.701498607005135,1347,5791,5791,1347,45426,567938,505113,2513,3860,2513,6957,8304,66.66333324999583,0.0,1347,0,270747,0,4444,0,1166,1931
11382,0,1,1,0,58,0,2075,0,0,23026784,17513915,77.1167945391923,5917,9849,9819,5947,47897,668515,621395,2915,8892,2975,6817,12794,62.22539674441618,5.531194905403055,5977,1,1254817,4590,3872,0,3002,927
11383,0,1,1,0,61,0,4027,0,0,8967090,17315760,74.97999733262199,5168,7671,7217,5622,56394,742280,720720,2626,8702,3534,4675,10751,39.93745109543172,21.361751940820447,6076,1,1315548,58112,1595,0,2542,1485
11384,0,1,1,0,57,0,370,0,0,24260816,14810144,71.5122367151245,4934,10038,9858,5114,33369,657392,425712,2716,8010,3076,7640,12934,68.87670143089025,14.064063304453542,5294,1,751758,38880,4744,0,2218,1848
11385,0,1,0,0,53,0,2981,1,0,8810772,4857643,42.790185790669334,1681,6793,6643,1831,53815,607537,623455,2503,4484,2803,7465,9446,69.3685807840985,12.480747566911448,1981,1,430285,18900,4812,0,822,2159
11386,0,1,1,0,56,0,872,0,0,24630228,15354612,73.60706487831179,5351,10031,9964,5418,54466,640484,682994,2767,8252,2901,7380,12865,67.42403132415029,8.230562448445415,5485,1,1305738,7571,4546,0,2584,1712
11387,0,1,0,0,51,0,2884,0,0,5538236,3403076,36.30426972134269,1018,5820,5520,1318,47264,578368,544802,2282,3900,2882,6784,8402,64.82283548256741,17.358105696309828,1618,1,278098,44700,4202,0,1264,1620
11388,0,1,1,0,52,0,2734,0,0,7494911,4435660,41.14608122288197,1540,6273,6120,1693,44051,568540,531860,2467,4313,2773,7047,8893,66.53570470055908,12.49435617882431,1846,1,343679,23256,4427,0,927,1807
11389,0,1,1,0,62,0,3943,0,0,13017620,18875549,77.99358948016176,5786,8520,8223,6083,53250,775750,660939,2806,9186,3400,5243,11623,46.26013402488151,17.349782413472987,6380,1,1295679,50787,2140,0,2980,963
11390,0,1,1,0,61,0,3789,0,0,14896570,19158042,78.70196947980399,6164,8629,8599,6194,49245,757785,621693,3063,9287,3123,5498,11722,49.040799340956916,5.477225575051661,6224,1,1244994,5460,2405,0,3101,688
11391,0,1,1,0,56,0,2887,0,0,22384170,9927502,59.18614702783076,3369,10027,9893,3503,50624,640484,634816,2700,6337,2968,9224,12861,79.93747556684536,11.616877517762624,3637,1,784672,18358,6390,0,669,3556
11392,0,1,1,0,52,0,2701,0,0,6940710,4260060,40.124805295477756,1333,6198,5921,1610,39770,542430,513324,2369,4256,2923,6957,8844,65.65820588471787,16.772016903539466,1887,1,312340,40442,4311,0,1036,1665
11393,0,1,1,0,54,0,2736,0,0,15177217,7559618,52.54521862167861,2731,8288,8258,2761,45796,585932,585932,2708,5499,2768,8235,11026,74.14175611623992,5.490867587491313,2791,0,590854,4020,5497,0,23,2759
11394,0,1,0,0,54,0,2621,1,0,11477646,6304230,48.187135212627034,2088,7499,7265,2322,51067,621735,605445,2481,5037,2949,7658,10214,70.30647196382421,15.37716437725175,2556,1,517806,33228,4943,0,393,2228
11395,0,1,1,0,60,0,3601,0,0,12682290,17552521,76.09862022402245,5415,8357,7981,5791,51865,766843,621355,2655,8822,3407,5221,11388,46.79743582719036,19.404420609326078,6167,1,1187155,68056,2190,0,2760,841
11396,0,1,1,0,59,0,1842,0,0,25131168,17921604,77.57576941287789,5699,10513,10194,6018,56376,690896,723654,2659,8996,3297,7154,13491,64.62197768561404,18.601114081787884,6337,1,1462374,33495,4176,0,3040,1198
11397,0,1,1,0,60,0,2930,0,0,23285624,19764796,80.67217612039482,5967,10627,10086,6508,47722,649918,677251,2496,9545,3578,6615,13664,59.81638571495272,23.259585505030312,7049,1,1451284,66543,3578,0,3471,541
11398,0,1,0,0,50,0,2995,0,0,2459886,1678842,25.903667693977237,348,4660,4337,671,46144,560448,515412,2179,3173,2825,6168,7162,60.54750201288241,17.996955674948754,994,1,138226,50388,3666,0,1831,1164
11399,0,1,1,0,61,0,3038,0,0,9879720,15300540,70.78135347674555,4886,7106,6982,5010,32574,558882,543612,2930,8064,3178,5026,10160,44.40720662234904,11.363102531111466,5134,1,891780,16864,1972,0,1956,1082
11400,0,1,1,0,57,0,1533,0,0,25940128,12639072,66.2117814289874,4384,10301,10301,4384,50830,637143,663090,2883,7267,2883,8800,13184,76.92203845452875,0.0,4384,0,1008320,0,5917,0,1501,3034
11401,0,1,0,0,54,0,2411,1,0,9685676,5762796,46.17358552246078,2037,6770,6675,2132,42966,624393,502758,2608,4835,2798,7246,9473,67.40178039191547,10.012227554748348,2227,1,396552,17480,4543,0,571,1840
11402,0,1,1,0,54,0,2572,0,0,6913533,4450392,40.50925820105819,1429,6066,5854,1641,48930,569520,631896,2500,4353,2924,6925,8778,64.90762667052309,14.560300768783835,1853,1,382353,22260,4213,0,1071,1501
11403,0,1,1,0,63,0,2926,0,0,8402640,14878890,68.62943974709395,4264,6940,6494,4710,54000,682344,789750,2713,7869,3605,4943,10099,42.23742416388575,21.389600909685395,5156,1,1177500,37018,1784,0,1551,1375
11404,0,1,1,0,60,0,3307,0,0,13623918,17116792,75.48509786706248,5482,8305,8089,5698,51450,735980,630840,2788,8702,3220,5395,11309,48.8978527135906,14.703313187521976,5914,1,1196580,37368,2391,0,2694,613
11405,0,1,0,0,55,0,2287,1,0,14889008,7948679,53.67494760127857,2584,8346,8049,2881,48825,620775,598703,2462,5640,3056,7927,11105,71.88880302244571,17.27185414326371,3178,1,625177,42768,5168,0,122,2409
11406,0,1,0,0,54,0,2498,1,0,6196224,4191744,39.191835884530846,1383,5723,5570,1536,50525,641315,586735,2576,4265,2882,6763,8452,63.51377803280167,12.369448974750497,1689,1,330240,24174,4034,0,1193,1305
11407,0,1,1,0,52,0,2655,0,0,3608550,2587860,31.464265445104548,629,4996,4635,990,49585,551554,614290,2253,3604,2975,6259,7610,60.37383539249432,19.24047541222726,1351,1,232650,37544,3645,0,1624,1031
11408,0,1,0,0,54,0,2273,1,0,8489624,5393619,44.62062303464621,1779,6467,6255,1991,52392,639324,601398,2497,4700,2921,6973,9176,65.29931086925804,14.560219778561036,2203,1,442002,31800,4264,0,718,1555
11409,0,1,1,0,63,0,2238,0,0,9039103,13751206,65.77993615077473,3521,7222,6416,4327,45652,718228,641956,2372,7505,3984,5267,10400,45.70557952810576,28.59301305078868,5133,1,874054,131378,2089,0,1149,1089
11410,0,1,1,0,60,0,306,0,0,28332216,16455912,74.01351227985333,4912,11216,10650,5478,47586,693924,618824,2438,8482,3570,8176,14220,71.91661838546081,24.31005654105525,6044,0,1128468,92824,5172,0,2474,2168
11411,0,1,1,0,59,0,2537,0,0,13682918,15490389,71.96526940128828,5045,7955,7821,5179,43510,568290,684939,2857,8170,3125,5633,10946,51.40038910358559,11.588869604959546,5313,1,1185991,11256,2642,0,2188,349
11412,0,1,1,0,60,0,2047,0,0,23262278,18141838,77.1621668954417,5354,10461,9861,5954,51308,773938,615494,2447,9001,3647,6954,13508,62.505999712027645,25.02835173427593,6554,1,1202708,109200,3907,0,2907,860
11413,0,1,1,0,62,0,2188,0,0,13296413,15237209,70.00714249274856,4633,7882,7614,4901,46410,606255,739942,2841,8010,3377,5822,10991,52.08646657242167,16.45669530339481,5169,1,1166438,21172,2713,0,1792,396
11414,0,1,1,0,61,0,2139,0,0,14070070,15218140,70.49822692805827,4903,7868,7801,4970,43188,560346,722632,2995,8032,3129,5893,10930,53.207142377692115,8.286047041568583,5037,1,1172920,4221,2831,0,1908,231
11415,0,1,1,0,55,0,1753,0,0,15988490,8985081,56.71860364994893,3187,8217,8187,3217,40443,511119,617253,2763,6010,2823,7763,11010,70.49822692805827,5.830951894845301,3247,1,710957,2520,4970,0,424,2177
11416,0,1,1,0,57,0,1545,0,0,28127484,17660160,78.30708780180757,6132,10719,10719,6132,53984,694080,645120,2880,9012,2880,7467,13599,67.72739475278819,0.0,6132,1,1373568,0,4587,0,3252,1707
11417,0,1,0,0,58,0,1782,0,0,16354000,14723632,70.9365914038728,4937,8377,8282,5032,49500,643720,658350,2831,7958,3021,6176,11303,57.0087712549569,9.773682308767459,5127,0,1132200,12160,3250,0,2106,324
11418,0,1,1,0,56,0,1686,0,0,15610951,9047510,56.542019772908716,3155,8122,8080,3197,43878,602790,582980,2788,6027,2872,7713,10952,69.87846592477543,6.538739683827756,3239,1,658582,6006,4883,0,367,2053
11419,0,1,1,0,57,0,1637,0,0,17456364,9935271,58.642987645583,3277,8677,8515,3439,44469,528687,702027,2727,6328,3051,7965,11566,71.2460525222275,12.890756302658941,3601,1,835677,8586,5076,0,550,2187
11420,0,1,0,0,54,0,1893,1,0,7178260,5148715,43.53159771935783,1705,5873,5683,1895,53460,597740,660231,2527,4612,2907,6505,8590,61.54673021371647,13.86916870676514,2085,1,460485,19760,3788,0,822,1071
11421,0,1,1,0,60,0,900,0,0,30933900,18276930,77.6530746332687,5550,11640,11160,6030,51336,751688,627417,2551,9061,3511,8161,14671,71.62401831787993,22.39247586002374,6510,1,1248210,85440,5130,0,2999,2099
11422,0,1,1,0,58,0,1556,0,0,18065757,10331388,59.52310475773252,3416,8769,8642,3543,55370,659016,714420,2789,6459,3043,8015,11685,71.40728254176881,11.66725943004119,3670,1,868035,13462,5099,0,627,2183
11423,0,1,0,0,53,0,2062,1,0,2558448,2327368,29.5296461204668,575,4103,3806,872,42140,523124,573835,2372,3541,2966,5603,6772,54.16641025580336,17.455230829861552,1169,1,187480,32967,2934,0,1797,265
11424,0,1,1,0,57,0,1547,0,0,15873120,9368820,57.3149195236284,3218,8184,8117,3285,44676,624588,581808,2785,6137,2919,7684,11036,69.51258878793107,8.18535277187245,3352,1,670140,10184,4832,0,433,1980
11425,0,1,1,0,59,0,1162,0,0,23223755,16207170,73.72245248226622,4924,10219,9708,5435,50020,727608,611310,2471,8417,3493,7255,13201,65.36818798161687,22.699000024375767,5946,1,1114175,90958,4273,0,2453,1291
11426,0,1,1,0,53,0,1681,0,0,5551062,4478056,40.755367744629666,1661,5003,5003,1661,45998,568856,587728,2696,4357,2696,6038,7699,57.810033731178535,0.0,1661,0,362098,0,3342,0,1035,646
11427,0,1,1,0,60,0,635,0,0,32944446,18246528,77.88452991448301,5433,12130,11497,6066,54531,748992,658752,2375,9074,3641,8439,15138,73.69531871157082,25.3119524179206,6699,1,1328454,103179,5431,0,3058,2423
11428,0,1,1,0,63,0,1023,0,0,14166970,13727350,65.6505902486794,4243,7664,7597,4310,44100,716625,624260,3118,7495,3252,6472,10849,57.33236433289665,8.314029025396882,4377,0,844760,11189,3287,1,1125,102
11429,0,1,1,0,60,0,282,0,0,33840880,17096458,75.35250493513803,4658,12658,11638,5678,49464,689519,650376,1991,8689,4031,8971,15669,77.20103626247513,31.992741976850702,6698,1,1226448,154020,5960,0,2667,2949
11430,0,1,0,0,56,0,1393,1,0,13334694,8603808,54.96362433464518,2894,7562,7435,3021,46640,603776,626560,2721,5869,2975,7262,10410,66.43794096749237,11.269427669584644,3148,1,664620,15748,4414,0,173,1566
11431,0,1,0,0,53,0,1689,1,0,2439220,2477391,30.512292604784715,446,4036,3551,931,55144,601386,649284,2176,3592,3146,5281,6697,51.18593556827891,22.109297380155272,1416,1,227164,51895,2620,0,1730,41
11432,0,1,1,0,61,0,826,0,0,16672247,13853639,67.20863039818622,3905,8820,8208,4517,42642,634869,631802,2455,7584,3679,6758,11887,60.753600716336145,25.106833246443927,5129,1,930502,83232,3691,0,1450,624
11433,0,1,0,0,53,0,1612,1,0,2922464,2908372,32.92415526630866,550,4314,3780,1084,52437,609041,619773,2149,3767,3217,5379,6997,51.92301994298868,23.24676063365046,1618,1,250404,68352,2696,0,1599,13
11434,0,1,0,0,59,0,1256,1,0,31234992,14798152,70.68238818828917,4843,11401,11248,4996,45582,633868,630906,2809,7958,3115,9214,14363,79.06958960308319,12.486530243515826,5149,1,1064148,20808,6252,0,2034,3290
11435,0,1,0,0,59,0,1271,1,0,22765922,12400304,64.63745044476924,3698,10107,9627,4178,50610,715288,623280,2488,7146,3448,8417,13075,73.81734213584231,22.027769503870733,4658,1,877380,81600,5449,0,1210,2481
11436,0,1,1,0,60,0,654,0,0,34679475,16735284,74.63913182774837,4802,12565,11796,5571,55440,720960,693924,2235,8575,3773,9229,15569,78.8986691902975,27.742846136701417,6340,1,1286901,108429,6225,0,2567,3221
11437,0,1,1,0,58,0,512,0,0,20283585,13995912,69.04346457123947,4617,9172,9022,4767,48300,675280,616560,2786,7703,3086,7191,12108,65.23036102920173,12.345470001201512,4917,0,1001070,23700,4255,1,1831,1319
11438,0,1,1,0,62,0,487,0,0,16225968,13388991,65.41406576570516,3425,8925,8071,4279,41961,666477,616413,2275,7408,3983,6921,12054,61.57921727336261,29.6553659794346,5133,1,842963,130662,3792,0,1150,663
11439,0,1,1,0,58,0,357,0,0,31233010,16900330,75.96051605933177,5399,11554,11183,5770,52070,743966,600445,2558,8699,3300,8342,14483,73.57309290766564,19.275338971516987,6141,1,1182850,66409,5413,0,2841,2484
11440,0,1,1,0,64,0,407,0,0,12857460,12310980,61.603571325045756,3645,7333,7183,3795,54044,742876,765584,3094,7039,3394,6632,10577,58.20652884342099,12.318810369945247,3945,1,895620,18600,3388,0,551,144
11441,0,1,0,0,58,0,346,0,0,22722971,14364358,70.30647196382421,4809,9674,9540,4943,53020,700346,639320,2772,7849,3040,7503,12580,67.80117993073571,11.581634647011523,5077,0,1087460,20904,4597,0,2037,1691
11442,0,1,1,0,52,0,1362,0,0,2271955,2542449,31.192947920964443,798,3483,3308,973,54560,574860,648024,2438,3586,2788,4948,6096,48.321837713398274,13.246969194075609,1148,1,241304,16450,2335,0,1640,278
11443,0,1,1,0,65,0,251,0,0,12505232,11922656,60.530983801686226,3422,7319,7077,3664,55920,758182,780960,3012,6918,3496,6667,10573,58.42088667591412,15.628168044365268,3906,1,879360,29282,3413,0,410,159
11444,0,1,1,0,55,0,1043,0,0,7091120,6098144,46.8187996428785,2192,5427,5427,2192,50609,637078,614822,2782,4974,2782,6017,8209,56.87706040223949,0.0,2192,0,484432,0,3235,0,590,453
11445,0,1,1,0,60,0,858,0,0,36721584,17073504,75.1398695766768,4983,12813,12150,5646,49203,698544,644112,2361,8670,3687,9528,15837,80.64738061462381,25.78829364743411,6309,1,1202598,104091,6504,0,2622,3480
11446,0,1,1,0,57,0,973,0,0,13031124,9016692,56.178287620752556,3126,7315,7285,3156,52670,657110,654253,2827,6013,2887,6986,10172,64.25729530566937,5.483301264452448,3186,0,722724,4050,4129,1,299,1272
11447,0,1,1,0,64,0,202,0,0,14082315,11813802,60.440052945046304,3303,7858,7508,3653,51513,747054,721182,2884,6887,3584,7089,11092,62.08864630510155,18.71473604838165,4003,0,814619,50050,3855,1,419,621
11448,0,1,1,0,59,0,964,0,0,26290176,13901304,68.32276341015489,4518,10450,10300,4668,56608,726632,690896,2828,7646,3128,8610,13428,75.04665215717488,12.318810369945247,4818,1,1082976,21000,5632,0,1690,2654
11449,0,1,1,0,59,0,960,0,0,24252304,13234216,66.84309986827361,4378,9986,9896,4468,55596,728652,669412,2872,7430,3052,8390,12948,73.67496182557545,9.515978740065268,4558,1,1009768,13680,5428,0,1506,2466
11450,0,1,1,0,57,0,889,0,0,14140002,9681774,57.810033731178535,3192,7723,7573,3342,50310,622855,677898,2747,6239,3047,7128,10620,65.04613747179766,12.286588609993126,3492,0,782028,16650,4231,1,445,1334
11451,0,1,1,0,58,0,534,0,0,22901560,13329070,67.27555276621665,4195,9917,9586,4526,41600,589000,612560,2614,7471,3276,8005,12862,71.13367697511495,18.276895446456408,4857,1,941408,41044,5060,0,1581,2115
11452,0,1,1,0,62,0,663,0,0,18660664,12439109,63.25345840347388,3584,9082,8665,4001,55902,718179,752378,2692,7110,3526,7773,12191,68.2934843158555,20.450574941819507,4418,1,968242,47955,4664,0,892,1555
11453,0,1,1,0,59,0,462,0,0,39034143,17972685,77.59510293826537,5442,13083,12504,6021,51660,752220,611925,2406,9006,3564,9468,16068,80.51707893360265,24.20331190709292,6600,1,1234305,105378,6483,0,3036,3498
11454,0,1,1,0,57,0,747,0,0,12030130,8983660,55.812185049503306,2925,7167,6977,3115,50268,680624,614292,2694,5999,3074,6746,10051,62.14499175315739,13.808421129276201,3305,1,663495,30590,3862,0,231,978
11455,0,1,1,0,59,0,735,0,0,22546350,13119075,66.29479617586888,4118,9802,9525,4395,47897,629835,677595,2708,7380,3262,8115,12787,71.62401831787993,16.79359465994813,4672,1,997665,31855,5130,0,1410,2145
11456,0,1,0,0,55,0,539,1,0,3712340,4645872,40.93897898091744,1139,4428,3891,1676,43120,543312,609840,2235,4448,3309,4987,7200,47.06378650300037,23.200714748735578,2213,1,368720,55848,2215,0,1096,557
11457,0,1,1,0,53,0,283,0,0,1902360,3327885,35.2845575287547,936,3082,2773,1245,49283,590733,596079,2364,3918,2982,4201,5755,39.08964057138413,17.580650666457768,1554,1,277635,40788,1528,0,1428,1145
11458,0,1,1,0,62,0,1171,0,0,17834622,11556276,60.64651680022522,3583,8622,8527,3678,55800,779216,706950,3047,6820,3237,7991,11764,69.63476143421474,9.773682308767459,3773,1,827550,14535,4849,0,536,1707
11459,0,1,1,0,59,0,1085,0,0,22149600,12467540,64.7688196588451,4087,9583,9475,4195,56619,722196,692476,2864,7167,3080,8252,12555,72.6636084983398,10.480278705357403,4303,1,977435,14688,5280,0,1223,2308
11460,0,1,1,0,56,0,484,0,0,7123836,6899540,49.37610758251404,2268,5530,5360,2438,51736,631090,656560,2660,5268,3000,5752,8360,54.055527006958314,13.102891263230726,2608,1,565616,21080,2922,0,392,92
11461,0,1,0,0,59,0,598,1,0,21747528,13012650,66.1362230551458,3920,9800,9346,4374,46765,699125,592025,2521,7349,3429,7947,12775,70.51241025521678,21.346475849196317,4828,1,870426,79904,4972,0,1399,1997
11462,0,1,0,0,60,0,221,1,0,31018260,16494660,73.89181280764467,4887,11714,11141,5460,52360,718998,664620,2448,8481,3594,8702,14735,75.37240874484509,23.994373745267414,6033,1,1201200,88242,5681,0,2439,2660
11463,0,1,1,0,52,0,539,0,0,952526,3396018,35.805027579936315,898,2409,2025,1282,46640,561588,582780,2265,3931,3033,3392,5058,27.258026340878022,19.597545682656683,1666,1,282040,48000,743,0,1367,1906
11464,0,1,1,0,61,0,1829,0,0,18387530,10698010,58.90670590009256,3380,8859,8769,3470,54755,718339,724505,2993,6553,3173,8382,11942,72.79423054061358,9.535934250532243,3560,1,815450,11610,5299,0,387,2216
11465,0,1,1,0,58,0,387,0,0,17531230,11726134,63.229739838148944,3458,8923,8383,3998,51750,659925,674590,2393,6931,3473,7318,11856,66.21933252457322,23.23839813007825,4538,0,919540,68580,4385,1,1065,1452
11466,0,1,1,0,58,0,276,0,0,10706581,9203958,56.00892785976178,2761,6926,6550,3137,55822,724698,663084,2558,6071,3310,6347,9860,58.42088667591412,19.63384838505529,3513,1,708962,56400,3413,0,203,479
11467,0,1,1,0,58,0,345,0,0,17138836,11623117,63.0158710167526,3491,8767,8287,3971,50394,649794,664429,2447,6898,3407,7243,11694,65.69627082262737,21.909496593036536,4451,0,901417,61440,4316,1,1044,1389
11468,0,1,1,0,59,0,1896,0,0,22227777,11397672,62.13694553162394,3477,10002,9618,3861,52779,711432,646488,2568,6813,3336,8709,12954,75.87489703452651,19.654262806518002,4245,0,845559,60672,5757,0,909,2805
11469,0,1,1,0,60,0,321,0,0,32996502,17768256,76.8570100901668,5181,12219,11493,5907,53212,755008,637696,2282,8915,3734,8594,15227,74.73954776421918,27.103289838714982,6633,1,1252284,124872,5586,0,2899,2578
11470,0,1,1,0,55,0,691,0,0,1584960,4586478,40.63249930782009,1290,2972,2611,1651,55902,641718,672276,2417,4429,3139,3738,5750,30.983866769659336,19.537214846050592,2012,1,399542,41515,960,0,1127,1818
11471,0,1,1,0,54,0,685,0,0,1224816,4100732,38.742741255621034,1218,2600,2317,1501,51865,560060,691196,2449,4233,3015,3548,5332,28.5657137141714,17.43531277089024,1784,1,379753,17546,816,0,1231,1916
11472,0,1,1,0,54,0,684,0,0,1157677,3999649,38.353617821530214,1203,2526,2258,1471,54216,587304,682469,2451,4190,2987,3506,5245,28.053520278211074,16.94436415472574,1739,1,369221,21708,787,0,1248,1932
11473,0,1,1,0,57,0,83,0,0,12230784,9977472,58.787753826796276,3281,7170,6995,3456,55932,684219,681332,2712,6343,3062,6426,10057,59.48949487094339,13.295739742362471,3631,1,815616,22925,3539,0,569,652
11474,0,1,0,1,63,0,2560,0,0,14634756,8788014,52.478567053607705,2620,8202,8068,2754,54056,743503,740312,3057,5945,3325,8505,11393,72.89718787443039,11.633585509503979,2888,1,638928,17956,5314,0,437,2123
11475,0,1,1,0,59,0,109,0,0,25757730,15379740,71.62401831787993,5045,10236,10151,5130,55448,695536,716522,2913,8128,3083,8019,13234,70.8590149522275,9.2729914971827,5215,1,1226070,10370,5021,0,2132,2023
11476,0,1,1,0,54,0,706,0,0,1260720,4167720,39.11521443121589,1314,2570,2354,1530,55029,602004,678276,2508,4254,2940,3548,5294,28.705400188814647,15.068492412224764,1746,1,380970,19656,824,0,1194,1900
11477,0,1,1,0,54,0,711,0,0,1253070,4161600,39.11521443121589,1338,2541,2349,1530,55632,620160,663680,2528,4250,2912,3539,5261,28.61817604250837,14.24875755244167,1722,1,373320,20928,819,0,1190,1901
11478,0,1,1,0,53,0,710,0,0,987000,3780210,37.54996671103717,1276,2244,2110,1410,50200,536200,672931,2547,4091,2815,3381,4925,26.457513110645905,11.862977636309136,1544,1,353910,8442,700,0,1271,1981
11479,0,1,1,0,52,0,708,0,0,807840,3494040,36.3318042491699,1235,2017,1932,1320,52710,555870,664397,2562,3967,2732,3259,4664,24.73863375370596,9.511914438752074,1405,1,331320,6460,612,0,1327,2035
11480,0,1,0,0,55,0,743,1,0,3278940,6158280,47.11687595755899,1952,3965,3697,2220,55458,657438,649116,2506,4994,3042,4251,6739,38.43175770115127,16.37890479225383,2488,1,519480,35912,1477,0,554,1297
11481,0,1,1,0,54,0,718,0,0,1461240,4435560,40.24922359499622,1404,2738,2522,1620,55647,627002,665334,2522,4358,2954,3640,5476,30.033314835362415,15.009398570404464,1836,1,393660,24192,902,0,1118,1836
11482,0,1,1,0,54,0,715,0,0,1109850,3970470,38.34057902536163,1336,2359,2225,1470,55029,596921,672549,2567,4171,2835,3456,5060,27.477263328068172,11.916523028262294,1604,1,366030,12060,755,0,1231,1946
11483,0,1,1,0,58,0,112,0,0,18008400,12241524,64.71475874945375,4098,8578,8488,4188,53599,721981,634291,2833,7111,3013,7223,11501,65.57438524302,9.543708938032719,4278,1,908796,14850,4300,0,1265,1377
11484,0,1,1,0,53,0,760,0,0,926825,3765315,37.61648574760805,1415,2070,2070,1415,43263,550827,556149,2661,4076,2661,3316,4731,25.592967784139454,0.0,1415,1,295735,0,655,0,1246,2006
11485,0,1,1,0,58,0,2372,0,0,26071968,11815128,63.686733312362634,3864,10676,10484,4056,52598,693294,643773,2721,6969,3105,9341,13589,80.17480901130978,13.856782324338932,4248,0,896376,29568,6428,0,1143,3515
11486,0,1,1,0,54,0,775,0,0,1538544,4578518,41.0731055558257,1602,2684,2599,1687,56643,648646,643218,2629,4401,2799,3626,5398,30.199337741083,9.428020440933057,1772,1,399819,10880,912,0,1027,1802
11487,0,1,1,0,53,0,773,0,0,1315928,4303915,39.96248240537617,1537,2481,2421,1597,56876,636020,649495,2635,4292,2755,3519,5176,28.705400188814647,7.772191019407321,1657,1,384877,7080,824,0,1098,1871
11488,0,1,1,0,57,0,173,0,0,14028780,11088869,61.91122676865643,3623,7703,7493,3833,54050,679855,665390,2683,6726,3103,6553,10596,60.4979338490167,14.50130676499154,4043,1,881590,29190,3660,0,940,767
11489,0,1,0,0,55,0,713,1,0,6511260,8153740,54.15717865620402,2763,5323,5153,2933,55575,686660,625500,2610,5713,2950,5000,8103,47.11687595755899,13.078932278133562,3103,1,659925,25670,2220,0,153,560
11490,0,1,1,0,56,0,574,0,0,8496672,9014448,56.7097875150313,3186,5888,5858,3216,54612,622266,689538,2773,6019,2833,5445,8691,51.40038910358559,5.572104574801163,3246,0,791136,2970,2642,0,413,161
11491,0,1,1,0,52,0,789,0,0,400140,2970840,33.76388603226827,840,1791,1491,1140,52628,615016,581138,2306,3746,2906,2957,4397,18.734993995195193,17.480138223797354,1440,1,254220,44700,351,0,1466,2255
11492,0,1,0,0,57,0,355,1,0,13382400,11120640,61.96773353931867,3394,7771,7325,3840,46020,683456,564720,2450,6736,3342,6381,10667,59.033888572581766,21.126378616251674,4286,1,748800,80726,3485,0,944,589
11493,0,1,1,0,55,0,755,0,0,6989064,8415528,55.20869496736904,3048,5341,5341,3048,53058,612942,659879,2761,5809,2761,5054,8102,47.885279575251516,0.0,3048,0,728472,0,2293,0,287,468
11494,0,1,1,0,51,0,644,0,0,230400,2308500,30.0,815,1241,1156,900,56608,595080,625860,2480,3465,2650,2821,3806,16.0,9.568061544601736,985,1,219600,9180,256,0,1665,2309
11495,0,1,1,0,51,0,689,0,0,379050,2705850,32.4037034920393,923,1538,1411,1050,54948,587556,621057,2450,3627,2704,2938,4115,19.0,11.413542506858095,1177,1,253050,14605,361,0,1527,2216
11496,0,1,0,0,53,0,766,1,0,1861200,4852800,42.42640687119285,1705,2929,2834,1800,52206,622776,609296,2601,4496,2791,3730,5625,32.155870381627054,9.773682308767459,1895,1,406800,13205,1034,0,896,1662
11497,0,1,1,0,58,0,375,0,0,17600644,12761783,66.23443213314356,4217,8569,8399,4387,55695,689433,683615,2739,7296,3079,6921,11478,63.340350488452465,13.04122362038737,4557,1,1030945,22440,4012,0,1478,1103
11498,0,1,0,0,58,0,574,1,0,11875395,10860500,61.196405123176966,3246,7415,6916,3745,50609,664100,640900,2401,6645,3399,6071,10315,56.31163290120435,22.494904991189944,4244,1,827645,71856,3171,0,845,271
11499,0,1,1,0,58,0,618,0,0,17967019,13362429,67.52036729757918,4287,8772,8500,4559,49500,659475,644820,2659,7490,3203,6872,11703,62.77738446287803,16.532900187082934,4831,1,1002980,38352,3941,0,1628,1010
11500,0,1,1,0,60,0,1132,0,0,21088773,15620544,72.06247289678588,5013,9434,9254,5193,55440,694848,721920,2828,8201,3188,7069,12442,63.72597586541927,13.548605186119353,5373,1,1246320,21600,4061,0,2185,1053
11501,0,1,1,0,51,0,477,0,0,902538,3143658,34.899856733230294,1176,2001,1959,1218,34916,523943,443932,2539,3799,2623,3322,4582,27.2213151776324,6.653712290320142,1260,1,209496,7014,741,0,1363,1840
11502,0,1,1,0,58,0,1553,0,0,22384278,11700416,63.387695966961914,3894,9713,9589,4018,50609,666848,643552,2788,6930,3036,8483,12625,74.63913182774837,11.136252869947771,4142,0,887978,17856,5571,0,1106,2659
11503,0,1,1,0,58,0,902,0,0,16353360,13311400,67.23094525588644,4308,8350,8138,4520,47532,600780,686185,2733,7465,3157,6563,11295,60.149812967290266,14.843417048062975,4732,1,1053160,20564,3618,0,1575,673
11504,0,1,1,0,59,0,1319,0,0,23717370,16582650,74.65922581972036,5131,10272,9829,5574,41082,731850,496825,2532,8549,3418,7230,13247,65.23036102920173,21.196789994221753,6017,1,930858,95245,4255,0,2599,1280
11505,0,1,1,0,54,0,330,0,0,5448375,6851175,50.049975024968795,2385,4800,4680,2505,55920,637255,656400,2615,5240,2855,4910,7535,46.636895265444075,11.111005581829925,2625,1,601200,14520,2175,0,230,560
11506,0,1,1,0,58,0,1737,0,0,20835670,11126210,61.465437442517235,3436,9635,9293,3778,48319,621395,674405,2603,6723,3287,8460,12580,74.2630459919333,18.528714688884364,4120,1,865162,38304,5515,0,833,2570
11507,0,1,1,0,61,0,1943,0,0,21414900,17424900,75.49834435270749,5042,10115,9457,5700,47560,709224,626685,2399,8757,3715,6814,13172,61.29437168288782,25.75786106970016,6358,1,1168500,109228,3757,0,2643,700
11508,0,1,0,0,52,0,153,1,0,736330,2055130,28.0178514522438,543,1965,1723,785,51060,602140,581196,2376,3403,2860,3556,4583,30.62678566222711,15.55873930426897,1027,1,174270,34606,938,0,1833,1680
11509,0,1,0,0,50,0,754,1,0,461600,1017200,20.0,58,1896,1554,400,54054,587433,595062,2201,2943,2885,3697,4439,33.97057550292606,18.55307256596978,742,1,93600,44118,1154,0,2143,1389
11510,0,1,0,0,56,0,267,1,0,9682288,9107392,56.991227395100026,3058,6419,6229,3248,56386,678568,653332,2614,6052,2994,5785,9223,54.59853477887479,14.025893816633586,3438,1,756784,26220,2981,0,444,177
11511,0,1,1,0,60,0,2911,0,0,18461352,9286134,55.50675634551167,2746,9408,9073,3081,44472,657052,614856,2679,6095,3349,9006,12422,77.40800992145451,18.34461467674761,3416,1,628524,50250,5992,0,67,2978
11512,0,1,1,0,57,0,1057,0,0,13734480,12328992,65.36053855347276,4212,7547,7487,4272,54240,652236,692640,2826,7158,2946,6101,10433,56.70097000933934,7.745966692414834,4332,1,1025280,6900,3215,0,1386,329
11513,0,1,1,0,61,0,1863,0,0,17790388,16052307,72.46378405796926,4979,8911,8639,5251,51246,669483,715338,2785,8308,3329,6445,11968,58.20652884342099,16.67678278604415,5523,1,1228734,31552,3388,0,2194,331
11514,0,1,1,0,55,0,218,0,0,9916920,9075840,57.09640969448079,3136,6426,6302,3260,56635,670944,654240,2660,6044,2908,5826,9210,55.154328932550705,11.305585981900606,3384,1,766100,16368,3042,0,476,258
11515,0,1,1,0,59,0,1714,0,0,19704992,10900400,60.530983801686226,3387,9319,9042,3664,49880,639625,690200,2698,6639,3252,8353,12294,73.33484846919642,16.664965739633967,3941,1,850048,31301,5378,0,689,2403
11516,0,1,1,0,55,0,544,0,0,11418116,10235290,60.51446108162907,3620,6822,6780,3662,55056,693160,620490,2753,6457,2837,5913,9617,55.839054433254866,6.481658975540136,3704,1,812964,6678,3118,0,867,323
11517,0,1,1,0,59,0,1642,0,0,19548968,10925072,60.63002556489647,3464,9206,8994,3676,48792,636008,677616,2760,6648,3184,8290,12178,72.92461861401813,14.573887982115558,3888,1,838128,24804,5318,0,704,2346
11518,0,1,0,0,51,0,1045,1,0,489996,897156,18.734993995195193,161,1937,1747,351,53824,592992,592992,2366,2907,2746,3952,4493,37.36308338453881,13.791774304255147,541,1,81432,25270,1396,0,2205,1160
11519,0,1,0,0,52,0,705,1,0,817614,1630902,24.859605789312106,406,2153,1941,618,54412,588497,643916,2427,3257,2851,3962,4792,36.373066958946424,14.618906374886377,830,1,150792,22048,1323,0,2021,1316
11520,0,1,1,0,51,0,1173,0,0,389610,690390,16.431676725154983,203,1780,1713,270,56608,623908,593224,2490,2827,2624,4000,4337,37.986839826445156,8.230562448445415,337,1,62640,9313,1443,0,2287,1114
11521,0,1,1,0,61,0,2226,0,0,18007000,16923500,74.16198487095663,4921,9353,8774,5500,52704,750788,664632,2498,8577,3656,6351,12430,57.21887800367987,24.17085564940789,6079,1,1188000,95535,3274,0,2423,197
11522,0,1,1,0,61,0,2600,0,0,17284736,9348304,55.281099844341014,2822,8946,8712,3056,47174,630154,700511,2825,6115,3293,8715,12005,75.20638270785267,15.34052413788951,3290,1,699824,24570,5656,0,3,2597
11523,0,1,1,0,58,0,1972,0,0,12452700,13657050,68.19090848492928,4422,7556,7328,4650,56364,716628,678447,2709,7587,3165,5615,10493,51.749396131742444,15.14852031581832,4878,1,1074150,32148,2678,0,1713,259
11524,0,1,1,0,53,0,1050,0,0,1276891,1915697,26.851443164195103,479,2734,2492,721,55912,616424,640337,2415,3378,2899,4428,5391,42.08325082500163,15.556946818928349,963,1,173761,28556,1771,0,1936,886
11525,0,1,1,0,60,0,2621,0,0,16768290,16874880,74.89993324429602,4888,9321,8599,5610,51408,715904,649728,2286,8618,3730,5997,12329,54.67174773134658,26.995477195250785,6332,1,1211760,115520,2989,0,2602,19
11526,0,1,1,0,52,0,1233,0,0,964368,1429719,23.302360395462088,315,2547,2319,543,56882,626654,629287,2405,3176,2861,4409,5180,42.14261501141095,15.492538503022523,771,1,129777,27588,1776,0,2090,857
11527,0,1,1,0,57,0,1031,0,0,8900016,10267614,59.52310475773252,3325,6273,6055,3543,39294,512946,643356,2680,6441,3116,5410,9171,50.11985634456667,15.34495421481017,3761,1,786546,16568,2512,0,645,386
11528,0,1,1,0,51,0,1460,0,0,812700,1100370,20.73644135332772,363,2387,2320,430,55527,570657,637191,2492,2989,2626,4449,4946,43.474130238568314,8.19672545160342,497,1,107070,6231,1890,0,2129,669
11529,0,1,1,0,51,0,1441,0,0,291780,463860,13.416407864998739,53,1928,1801,180,41772,608172,456129,2450,2757,2704,4198,4505,40.26164427839479,11.565669838633895,307,1,31860,25273,1621,0,2397,956
11530,0,1,0,0,57,0,181,1,0,7327782,7469154,51.16639522186413,2130,5905,5417,2618,54520,670455,661896,2365,5471,3341,5652,8758,52.905576265645195,22.15316392227345,3106,1,607376,66368,2799,0,235,54
11531,0,1,0,0,55,0,480,1,0,5483716,5895946,45.9782557302906,1987,4835,4708,2114,54502,663782,638681,2662,4903,2916,5383,7624,50.93132631298737,11.313881128525134,2241,1,484106,18161,2594,0,675,195
11532,0,1,1,0,60,0,828,0,0,18001773,11600886,62.0403094769844,3312,9063,8526,3849,47736,651024,666094,2477,6863,3551,7691,12077,68.38859554048467,23.176654905997488,4386,1,850629,68736,4677,0,835,1663
11533,0,1,1,0,59,0,59,0,0,18476232,12945048,65.7875368135941,3776,9149,8597,4328,45269,607173,666993,2439,7319,3543,7260,12140,65.33758489567853,23.540827329659216,4880,1,965144,60720,4269,0,1337,1278
11534,0,1,1,0,61,0,1409,0,0,17307860,10815655,59.28743543112655,3155,8799,8439,3515,45668,603092,716941,2717,6592,3437,8001,11876,70.17121917139534,18.97600795524867,3875,1,818995,30960,4924,0,438,1847
11535,0,1,0,0,55,0,721,1,0,4190202,4733090,41.44876355212541,1460,4415,4157,1718,47760,548245,661200,2497,4473,3013,5194,7170,49.38623289946298,16.071058428130073,1976,1,412320,21156,2439,0,1037,316
11536,0,1,1,0,51,0,966,0,0,167400,388650,12.24744871391589,40,1456,1266,150,44099,541519,546701,2401,2741,2781,3707,4047,33.406586176980134,13.941784393794311,340,1,31650,24890,1116,0,2441,1475
11537,0,1,1,0,58,0,865,0,0,17973326,13734644,68.51277253184256,4574,8643,8523,4694,54056,681758,678832,2806,7620,3046,6755,11569,61.87891401761993,10.986451322313634,4814,0,1089008,16200,3829,1,1768,903
11538,0,1,0,0,60,0,2266,1,0,9091152,13075062,65.98484674529449,3993,6803,6442,4354,52360,714714,660660,2642,7357,3364,5091,9806,45.69463863518345,19.26401857715617,4715,1,957880,55955,2088,0,1351,915
11539,0,1,0,0,59,0,2213,1,0,8935814,12873412,65.5286197016235,3892,6777,6375,4294,52658,677548,698534,2596,7292,3400,5079,9775,45.617978911828175,20.280691681783875,4696,1,1000502,50250,2081,0,1296,917
11540,0,1,1,0,61,0,698,0,0,17175480,11673840,61.72519744804386,3206,8922,8318,3810,44485,664888,628120,2460,6874,3668,7572,11986,67.14164132637808,24.579711753166805,4414,1,781050,89996,4508,0,746,1444
11541,0,1,1,0,56,0,623,0,0,6618840,8209684,53.879495172096775,2783,5303,5183,2903,54635,630644,692860,2708,5731,2948,5108,8131,47.74934554525329,11.090536506409418,3023,1,711235,12480,2280,0,75,548
11542,0,1,1,0,54,0,1283,0,0,1986330,2464319,30.116440692751194,624,3380,3097,907,44660,551551,597740,2434,3624,3000,4907,6097,46.79743582719036,16.82685571859981,1190,1,199540,31979,2190,0,1810,527
11543,0,1,0,0,58,0,1649,1,0,6836022,10348532,59.715994507334464,3506,5543,5483,3566,56876,699382,684872,2842,6468,2962,4819,8445,43.78355855797927,7.754559014766193,3626,1,841576,7740,1917,0,664,985
11544,0,1,1,0,56,0,721,0,0,6451830,8295210,54.092513345194085,2802,5255,5131,2926,52488,612360,688905,2711,5761,2959,5040,8090,46.95742752749558,11.33917216041645,3050,1,711018,12276,2205,0,91,630
11545,0,1,0,0,54,0,594,1,0,5792416,5822208,46.130250378683186,1953,5025,4850,2128,55596,618336,673056,2561,4864,2911,5458,7761,52.172789842982326,13.871510878377256,2303,1,523488,18025,2722,0,608,14
11546,0,1,1,0,59,0,2782,0,0,8758019,13964356,68.27151675479314,4253,6948,6540,4661,47670,680092,629160,2588,7657,3404,4875,9944,43.347433603386484,20.341913054676336,5069,1,978810,63648,1879,0,1665,1117
11547,0,1,1,0,55,0,569,0,0,6342750,7856553,53.094255809833136,2789,5099,5069,2819,54560,613140,691176,2757,5606,2817,5037,7886,47.43416490252569,5.490867587491313,2849,1,699112,2760,2250,0,32,537
11548,0,1,1,0,59,0,3303,0,0,10467604,15640640,72.69112738154499,4826,7723,7265,5284,49532,722240,600880,2502,8244,3418,4941,10683,44.50842616853577,21.441627892851734,5742,1,1072652,81982,1981,0,2324,979
11549,0,1,1,0,53,0,777,0,0,5317650,5263050,44.15880433163923,1842,4785,4677,1950,36158,545198,483121,2591,4649,2807,5426,7484,52.22068555658763,10.781717396486519,2058,1,349050,16956,2727,0,749,28
11550,0,1,1,0,54,0,609,0,0,6005710,7603534,52.66877632905477,2707,5006,4939,2774,49938,556423,674286,2674,5515,2808,4906,7747,46.52956049652737,8.250220863768833,2841,1,682404,5092,2165,0,33,576
11551,0,1,1,0,53,0,218,0,0,5961255,6870123,50.52722038663912,2523,4918,4888,2553,55176,651222,613548,2661,5244,2721,5026,7609,48.321837713398274,5.514871952411144,2583,1,582084,3930,2335,0,138,356
11552,0,1,0,0,57,0,1605,1,0,5984044,9675105,58.111960903070546,3269,5257,5149,3377,53680,630300,699060,2757,6242,2973,4637,8122,42.09513035969837,10.539713118296461,3485,1,823988,10908,1772,0,512,1093
11553,0,1,1,0,55,0,1262,0,0,4850520,4589900,40.74309757492672,1600,4642,4582,1660,36890,600005,470050,2705,4425,2825,5687,7407,54.055527006958314,8.038779614196052,1720,1,282200,11100,2922,0,1105,157
11554,0,1,1,0,54,0,757,0,0,5896044,7773476,53.25410782277739,2728,5023,4915,2836,53676,583833,690732,2633,5577,2849,4820,7764,45.59605246071199,10.83458558167471,2944,1,714672,7992,2079,0,95,662
11555,0,1,1,0,59,0,3199,0,0,7285506,14182578,68.82586723027906,4482,6530,6275,4737,52416,670656,700596,2739,7731,3249,4532,9524,39.21734310225516,16.164558115055296,4992,1,1108458,30600,1538,0,1743,1456
11556,0,1,1,0,57,0,2897,0,0,6090030,12464520,65.6505902486794,4250,5783,5723,4310,54033,720108,627564,2832,7202,2952,4305,8675,37.589892258425,7.896951773353783,4370,1,935270,9180,1413,0,1418,1479
11557,0,1,1,0,63,0,1884,0,0,14385100,9408152,54.46099521676041,2492,8290,7816,2966,51959,707356,739076,2698,6138,3646,8022,11462,69.6419413859206,21.79331131911622,3440,1,691078,57354,4850,0,206,1678
11558,0,1,1,0,57,0,2464,0,0,5547140,11175970,62.369864518050704,3715,5491,5316,3890,54500,718250,626314,2698,6763,3048,4299,8364,37.76241517699841,13.57796224751577,4065,1,848020,27650,1426,0,1017,1447
11559,0,1,1,0,61,0,358,0,0,14453595,12170190,63.12685640834652,3685,7912,7612,3985,40964,638286,598584,2754,7039,3354,6681,10966,60.22457969965419,17.321277824732988,4285,1,781060,44700,3627,0,931,573
11560,0,1,1,0,58,0,3281,0,0,5967066,13460271,67.69785816405124,4583,5885,5885,4583,52668,678447,669636,2937,7520,2937,4239,8822,36.08323710533743,0.0,4583,1,1044924,0,1302,0,1646,1635
11561,0,1,1,0,62,0,269,0,0,14093202,11311506,60.18305409332431,3406,7729,7513,3622,50609,690183,715167,2907,6745,3339,7014,10852,62.37788069500277,14.719644992803179,3838,0,829438,26784,3891,1,499,768
11562,0,1,1,0,57,0,3080,0,0,4832256,12063744,64.99230723708769,4116,5476,5368,4224,43456,554064,639744,2748,7080,2964,4000,8332,33.823069050575526,10.613247510664669,4332,1,946176,10368,1144,0,1368,1712
11563,0,1,1,0,56,0,952,0,0,4196033,4555600,40.33608806019741,1330,4503,4206,1627,45114,576800,613200,2503,4427,3097,5379,7303,50.78385570237849,17.395698044788446,1924,1,356313,35046,2579,0,1173,221
11564,0,1,1,0,62,0,1118,0,0,13682600,10010572,56.40921910468182,3074,7590,7482,3182,48816,679536,710996,3038,6328,3254,7446,10736,65.57438524302,10.39586690415236,3290,0,719132,13284,4300,1,36,1154
11565,0,1,1,0,53,0,942,0,0,2537080,3203480,34.49637662132068,1190,3322,3322,1190,53105,578780,664924,2692,3882,2692,4824,6014,46.17358552246078,0.0,1190,0,293930,0,2132,1,1502,560
11566,0,1,1,0,57,0,894,0,0,5210467,7930780,52.65928218272634,2285,5140,4652,2773,36417,569140,523380,2372,5633,3348,4739,8000,43.347433603386484,22.703765299051057,3261,1,507459,72712,1879,0,87,981
11567,0,1,1,0,52,0,808,0,0,1238640,2059980,27.92848008753788,646,2502,2368,780,45796,565174,565174,2507,3421,2775,4229,5143,39.84971769034255,11.64626725886957,914,1,166920,17956,1588,0,1861,1053
11568,0,1,1,0,54,0,945,0,0,3275514,3829122,37.389838191679836,1368,3771,3741,1398,52875,616275,643665,2709,4137,2769,5082,6510,48.40454524112379,5.501408174353464,1428,0,328530,3600,2343,1,1341,396
11569,0,1,1,0,54,0,951,0,0,2852170,3491670,35.76310948449533,1194,3594,3509,1279,35190,565110,464100,2645,4009,2815,4960,6324,47.22287581247038,9.321211371972165,1364,1,217430,14705,2230,0,1451,500
11570,0,1,1,0,56,0,2188,0,0,4635389,9944506,59.23681287847955,3251,5088,4830,3509,27876,572468,391092,2576,6343,3092,4155,7922,36.345563690772494,16.58115007057891,3767,1,484242,51342,1321,0,675,1513
11571,0,1,1,0,54,0,946,0,0,3344592,3881256,37.62977544445356,1386,3808,3778,1416,48384,592056,613984,2711,4157,2771,5103,6549,48.60041152089147,5.531194905403055,1446,0,317184,3750,2362,1,1325,379
11572,0,1,1,0,59,0,3530,0,0,9197856,15621588,72.62231062146122,5006,7286,7018,5274,46563,737538,553894,2694,8236,3230,4706,10248,41.7612260356422,16.489969848905996,5542,1,986238,53332,1744,0,2312,1218
11573,0,1,1,0,55,0,955,0,0,2910206,3571440,35.9722114972099,1132,3705,3543,1294,52640,648600,618240,2598,4054,2922,5009,6465,47.4236228055175,12.781057885822433,1456,1,289856,23814,2249,0,1466,511
11574,0,1,1,0,56,0,778,0,0,5812043,5830520,45.31004303683677,1693,5244,4884,2053,53536,636160,678760,2480,4893,3200,5671,8084,53.207142377692115,19.095609193505354,2413,1,490667,41040,2831,0,787,9
11575,0,1,1,0,58,0,2363,0,0,4347270,10422714,59.81638571495272,3148,5223,4793,3578,29290,588426,422385,2483,6491,3343,4128,8136,34.85685011586675,21.537657059941598,4008,1,518810,82130,1215,0,665,1698
11576,0,1,1,0,60,0,4273,0,0,6627738,16610460,74.04052944165107,4887,7286,6691,5482,39444,690840,524190,2435,8512,3625,4239,10316,34.77067730142742,24.44269614822366,6077,1,948386,116025,1209,0,2452,1821
11577,0,1,1,0,56,0,3001,0,0,3578310,11055960,62.56996084384263,3781,4963,4829,3915,34565,629752,437720,2690,6739,2958,3738,7787,30.23243291566195,12.019627717482168,4049,1,606825,27604,914,0,1091,1910
11578,0,1,1,0,60,0,4017,0,0,7468200,16205400,73.48469228349535,4979,7204,6783,5400,38804,654218,534178,2580,8401,3422,4384,10205,37.1887079635741,20.72426240805686,5821,1,961200,75359,1383,0,2399,1618
11579,0,1,1,0,63,0,250,0,0,12729275,10937875,58.69412236331676,2745,7840,7140,3445,44712,685800,657225,2475,6620,3875,6870,11015,60.78651166171653,26.50925027877733,4145,1,713115,101500,3695,0,270,520
11580,0,1,1,0,59,0,4024,0,0,2317385,13459880,67.34240862933252,4105,5476,5046,4535,56350,727160,682640,2538,7503,3398,3479,8444,22.60530911091463,20.811842160186252,4965,1,1043050,60630,511,0,1567,2457
11581,0,1,1,0,57,0,3005,0,0,3548184,11211792,62.545983084447556,3702,5029,4819,3912,28408,607592,384044,2656,6778,3076,3773,7895,30.116440692751194,15.22304946459335,4122,1,524208,44730,907,0,1046,1959
11582,0,1,1,0,58,0,3909,0,0,2189782,12874332,66.37770710110436,4123,5186,4903,4406,54312,639918,724656,2639,7328,3205,3419,8108,22.293496809607955,17.54372795785932,4689,1,1092688,22357,497,0,1484,2425
11583,0,1,1,0,54,0,954,0,0,4326427,4553436,40.70626487409524,1627,4298,4268,1657,49062,607308,610056,2718,4405,2778,5359,7046,51.09794516416487,5.477225575051661,1687,0,367854,4020,2611,1,1091,137
11584,0,1,1,0,60,0,3992,0,0,7064960,15981280,72.93833011524188,4930,7038,6648,5320,50148,757008,597796,2614,8324,3394,4332,10042,36.4417343165772,20.035063931231317,5710,1,1058680,73320,1328,0,2316,1676
11585,0,1,0,0,60,0,2106,1,0,4204216,10087432,57.94825277780168,2912,5056,4610,3358,54587,741988,663884,2558,6362,3450,4256,8060,35.38361202590826,21.384413076464483,3804,1,742118,71360,1252,0,354,1752
11586,0,1,1,0,61,0,1347,0,0,11294154,12643383,64.03905058634146,4016,6940,6855,4101,46008,656679,665928,2998,7184,3168,5837,10023,52.478567053607705,9.220820253968727,4186,1,885816,11135,2754,0,1018,329
11587,0,1,1,0,57,0,3419,0,0,2883300,11759745,64.17943595888016,4029,4909,4819,4119,35960,662360,442525,2765,6974,2945,3555,7764,26.457513110645905,9.808573176892017,4209,1,638445,19350,700,0,1264,2155
11588,0,1,1,0,57,0,454,0,0,6084000,6484500,47.43416490252569,1781,5423,4954,2250,45600,657096,576400,2413,5132,3351,5586,8305,52.0,21.750409914410408,2719,1,450000,77854,2704,0,632,178
11589,0,1,0,0,53,0,1247,1,0,837804,1298572,22.0,165,2534,2215,484,48138,571479,606358,2364,3167,3002,4414,5217,41.60528812542944,17.917168335174814,803,1,109384,37961,1731,0,2199,952
11590,0,1,1,0,60,0,1790,0,0,10576104,12949112,65.3299318842443,3991,7023,6746,4268,51623,634106,749398,2757,7302,3311,5512,10057,49.77951385861457,16.67710618738016,4545,1,1054196,22714,2478,0,1234,556
11591,0,1,1,0,60,0,4519,0,0,4304216,16194080,72.98630008433089,5042,6420,6135,5327,50995,659680,714400,2755,8367,3325,3848,9460,28.42534080710379,17.137991190847185,5612,1,1251845,31920,808,0,2287,2232
11592,0,1,1,0,57,0,499,0,0,5947602,7719458,51.97114584074513,2509,5095,4903,2701,36839,563026,534446,2666,5559,3050,5060,7953,46.92547282660026,13.858755107602944,2893,1,505087,27456,2202,0,157,656
11593,0,1,1,0,57,0,320,0,0,6239409,6743154,48.40454524112379,1977,5372,5006,2343,54747,664818,682086,2512,5221,3244,5541,8250,51.60426338976267,19.25012033518906,2709,1,555291,45384,2663,0,535,215
11594,0,1,1,0,57,0,3619,0,0,2618466,12092398,65.09224224129939,4207,4885,4855,4237,33496,605048,450932,2824,7091,2884,3472,7739,24.859605789312106,5.652706486041966,4267,1,669446,5730,618,0,1383,2236
11595,0,1,1,0,54,0,762,0,0,3506760,4169250,39.11521443121589,1500,3852,3822,1530,45828,621300,547725,2695,4255,2755,5017,6577,47.8748368143433,5.477225575051661,1560,0,307530,4980,2292,0,1195,433
11596,0,1,0,0,51,0,861,1,0,474826,985178,19.544820285692065,99,1908,1625,382,51600,618960,554485,2296,2961,2862,3822,4487,35.25620512760839,16.822813886195444,665,0,82130,45846,1243,1,2197,1336
11597,0,1,1,0,58,0,468,0,0,6145344,7924116,52.191953402799555,2291,5413,4980,2724,56376,706887,674888,2476,5633,3342,5165,8322,47.49736834815167,20.898220449737707,3157,1,631968,60620,2256,0,185,653
11598,0,1,1,0,54,0,791,0,0,3905820,4430700,40.24922359499622,1620,4031,4031,1620,48608,612640,593495,2735,4355,2735,5146,6766,49.10193478876367,0.0,1620,0,351540,0,2411,0,1115,324
11599,0,1,1,0,60,0,4702,0,0,3909983,16502189,73.64102117705865,5041,6526,6144,5423,52864,681632,718148,2661,8466,3425,3764,9569,26.851443164195103,19.77152077627701,5805,1,1279828,45458,721,0,2380,2322
11600,0,1,0,0,51,0,616,1,0,532400,1253560,22.0,154,1914,1584,484,47053,577570,546490,2260,3074,2920,3690,4504,33.166247903554,18.24976848257582,814,0,102124,49170,1100,1,2106,1490
11601,0,1,1,0,58,0,3868,0,0,1819808,12532640,65.5133574166368,4142,4866,4716,4292,39770,598600,566480,2770,7212,3070,3344,7786,20.591260281974,12.318810369945247,4442,1,832648,21900,424,0,1372,2496
11602,0,1,1,0,60,0,4491,0,0,4877080,16206580,73.45066371381542,4907,6787,6299,5395,53750,751000,645860,2516,8399,3492,3908,9791,30.066592756745816,22.386127475619137,5883,1,1159925,82472,904,0,2391,2100
11603,0,1,1,0,57,0,4785,0,0,608716,13990650,70.06425622241343,4842,5100,5033,4909,50250,572850,712500,2783,7759,2917,2974,7950,11.135528725660043,8.329212945039274,4976,1,1227250,4355,124,0,2059,2726
11604,0,1,1,0,58,0,2967,0,0,7870330,13547213,68.24221567329127,4627,6377,6347,4657,47264,651616,613799,2879,7566,2939,4599,9286,41.10960958218893,5.490867587491313,4687,0,982627,4470,1690,0,1748,1219
11605,0,1,1,0,56,0,268,0,0,6443808,6792968,49.07137658554119,2408,5084,5084,2408,48090,646009,592410,2821,5229,2821,5497,7905,51.73006862551025,0.0,2408,0,505680,0,2676,1,413,145
11606,0,1,1,0,55,0,882,0,0,5778655,5508250,44.75488800120049,2003,4888,4888,2003,55221,651750,640750,2750,4753,2750,5635,7638,53.71219600798314,0.0,2003,0,466699,0,2885,0,747,135
11607,0,1,0,0,55,0,536,1,0,3730676,4652412,41.012193308819754,1532,4050,3900,1682,55460,652776,650010,2616,4448,2916,4984,6816,47.095647357266465,12.338422017092807,1832,1,395270,19650,2218,0,1084,548
11608,0,1,1,0,58,0,1946,0,0,5243415,10095737,58.83026432033091,3394,5043,4976,3461,39388,667993,501724,2850,6378,2984,4432,7960,38.92300091205713,8.345174736691893,3528,1,595292,13199,1515,0,544,1402
11609,0,1,1,0,56,0,4767,0,0,2077938,14654115,71.89575787207477,5139,5601,5571,5169,47532,660555,578340,2805,8004,2865,3237,8436,20.049937655763422,5.514871952411144,5199,0,1054476,5040,402,1,2334,2433
11610,0,1,1,0,55,0,745,0,0,6833484,6295968,47.62352359916263,2226,5323,5281,2268,44522,627376,546872,2734,5044,2818,5789,8099,54.89080068645383,6.589126398255297,2310,0,446796,7056,3013,1,508,237
11611,0,1,1,0,54,0,216,0,0,1213785,2708289,31.606961258558215,639,2574,2214,999,49940,615397,596420,2351,3710,3071,3926,5285,34.85685011586675,18.978093064054832,1359,0,219780,51120,1215,1,1712,1496
11612,0,1,0,0,54,0,45,1,0,1086300,2771340,31.937438845342623,570,2535,2085,1020,46512,619476,554268,2267,3737,3167,3782,5252,32.63433774416144,21.213622449422108,1470,1,208080,73350,1065,0,1697,1652
11613,0,1,1,0,57,0,790,0,0,6310824,8417370,54.20332093147061,2908,5116,5086,2938,50127,661815,621705,2835,5803,2895,5013,7981,46.34652090502587,5.478746393072713,2968,1,637546,4560,2148,0,73,717
11614,0,1,1,0,62,0,906,0,0,9780391,11221978,60.108235708594876,3316,6617,6320,3613,46384,646048,692638,2809,6719,3403,5813,9723,52.028838157314254,17.28663384116569,3910,1,805699,34452,2707,0,507,399
11615,0,1,1,0,59,0,1956,0,0,5813920,10603960,59.833101206606365,3219,5565,5204,3580,51067,678298,660526,2601,6542,3323,4586,8527,40.29888335921977,19.105403371455346,3941,1,798340,50901,1624,0,618,1338
11616,0,1,1,0,57,0,130,0,0,6600675,7522925,51.332251070842396,2527,5248,5140,2635,54707,688055,648085,2747,5490,2963,5360,8103,50.049975024968795,10.45608800483739,2743,1,598145,15876,2505,0,220,350
11617,0,1,1,0,59,0,4607,0,0,1820118,14819540,70.51950084905593,4432,5880,5339,4973,32929,658580,444020,2439,7953,3521,3346,8860,19.131126469708992,23.259585505030312,5514,1,740977,113069,366,0,1993,2614
11618,0,1,1,0,61,0,1209,0,0,9484762,11491010,61.180062111769715,3393,6627,6277,3743,53966,684610,742940,2720,6813,3420,5604,9697,50.33885179461288,19.043732725381645,4093,1,905806,37800,2534,0,673,536
11619,0,1,1,0,57,0,539,0,0,6483530,8113610,53.19774431308154,2745,5206,5121,2830,52824,711016,610671,2782,5697,2952,5158,8073,47.86439177509728,9.265143265380413,2915,1,602790,14450,2291,0,37,576
11620,0,1,0,0,54,0,224,1,0,1121681,3224980,34.307433596816885,600,2707,2130,1177,48972,632940,580880,2163,3917,3317,3693,5447,30.870698080866262,24.02435886825619,1754,1,249524,90012,953,0,1563,1787
11621,0,1,1,0,61,0,787,0,0,9676518,10904610,59.405386961116584,3206,6594,6271,3529,56643,738510,732330,2767,6619,3413,5832,9684,52.364109846344185,18.156929296565615,3852,1,836373,41021,2742,0,439,348
11622,0,1,1,0,57,0,4600,0,0,4689281,15650953,73.8850458482635,5399,6378,6318,5459,42364,682346,510326,2807,8326,2927,3726,9245,29.30870177950569,7.780166052320878,5519,1,971702,11940,859,0,2592,2008
11623,0,1,0,0,57,0,12,1,0,7193088,7688148,51.73006862551025,2408,5632,5364,2676,44512,597584,614822,2605,5549,3141,5561,8505,51.84592558726288,16.46112489689083,2944,1,572664,33768,2688,0,197,185
11624,0,1,0,0,52,0,1111,1,0,305292,3513536,36.59234892706397,1339,1567,1567,1339,51040,608768,577280,2624,3963,2624,2852,4191,15.0996688705415,0.0,1339,0,294580,0,228,1,1285,2396
11625,0,1,1,0,61,0,4194,0,0,3192616,14987828,69.65629906907199,4634,5728,5510,4852,35244,611622,549842,2871,7941,3307,3747,8817,25.65151067676132,14.90638655193511,5070,1,863656,33790,658,0,1763,2431
11626,0,1,1,0,53,0,1115,0,0,102000,3188400,34.64101615137755,999,1486,1285,1200,46440,571255,573912,2456,3857,2858,2742,4143,9.219544457292887,14.186211702904327,1401,0,259200,26934,85,1,1457,2572
11627,0,1,1,0,60,0,3112,0,0,4697088,12743808,64.99230723708769,3968,5592,5336,4224,52440,693910,687876,2761,7241,3273,4129,8609,33.34666400106613,16.12761547088173,4480,1,963072,34816,1112,0,1207,1905
11628,0,1,1,0,58,0,2300,0,0,5139264,10810176,60.76183012385325,3565,5211,5084,3692,43485,652944,570960,2801,6620,3055,4320,8139,37.30951621235526,11.269602342001788,3819,1,719940,21209,1392,0,764,1536
11629,0,1,1,0,62,0,340,0,0,9755484,9285162,54.38749856354859,2808,6406,6256,2958,55225,737665,737665,2989,6097,3289,6437,9545,57.428216061444914,12.36812780528175,3108,1,695130,19500,3298,0,181,159
11630,0,1,1,0,59,0,2076,0,0,8965117,12431685,64.8613906727261,3828,6717,6338,4207,49560,697380,620550,2576,7162,3334,5086,9672,46.16275555033516,19.46914200544827,4586,0,883470,62156,2131,1,1252,824
11631,0,1,1,0,58,0,3497,0,0,7652004,14606089,70.8590149522275,4913,6653,6545,5021,44392,721432,520711,2801,7930,3017,4433,9562,39.03844259188627,10.424232425346673,5129,1,898759,22248,1524,0,2112,1385
11632,0,1,0,0,58,0,514,1,0,7662351,8825522,55.10898293381942,2769,5828,5560,3037,50504,621884,685816,2638,5943,3174,5429,8734,50.22947341949744,16.470309108515075,3305,1,716732,28408,2523,0,131,383
11633,0,1,0,0,57,0,353,1,0,3441480,5818080,45.16635916254486,1709,4058,3727,2040,47025,641700,596068,2521,4892,3183,4539,6910,41.0731055558257,18.313271376155587,2371,1,426360,50643,1687,0,812,1165
11634,0,1,1,0,62,0,4388,0,0,4397589,16398144,72.3118247591637,4653,6646,6070,5229,43020,749504,564480,2560,8365,3712,3977,9782,29.0,24.145162055063107,5805,1,941220,114624,841,0,2093,2295
11635,0,1,0,0,57,0,88,1,0,7737588,8059752,53.16013544000805,2784,5606,5564,2826,47040,638848,598920,2810,5678,2894,5590,8458,52.32590180780452,6.488991180673202,2868,1,593460,6342,2738,0,26,114
11636,0,1,1,0,58,0,2994,0,0,8412687,13821183,69.0,4676,6613,6528,4761,48180,638660,635757,2818,7664,2988,4670,9516,42.035699113967404,9.224644470006377,4846,0,1042659,11560,1767,1,1858,1136
11637,0,1,1,0,58,0,3186,0,0,8253576,14190102,69.8426803609369,4836,6612,6570,4878,44308,607981,616708,2867,7787,2951,4601,9521,41.13392760240627,6.538739683827756,4920,0,1034136,5502,1692,1,1969,1217
11638,0,1,1,0,58,0,3477,0,0,8123200,14840071,71.25307010929424,4957,6797,6677,5077,45000,730750,526140,2803,8000,3043,4523,9720,40.0,10.973419967718494,5197,1,913860,24720,1600,0,2154,1323
11639,0,1,0,0,58,0,565,1,0,7802250,8961000,55.58776843874919,2937,5768,5615,3090,53124,661200,675700,2747,5990,3053,5425,8668,50.24937810560445,12.537074729344036,3243,1,719970,19431,2525,0,190,375
11640,0,1,1,0,58,0,2924,0,0,8778972,13921486,69.03622237637282,4681,6693,6608,4766,48954,718566,581279,2836,7687,3006,4763,9614,42.91852746774987,9.235136611923052,4851,1,948434,15810,1842,0,1845,1079
11641,0,1,1,0,58,0,3157,0,0,8627228,14291917,70.09279563550022,4883,6699,6669,4913,48530,669070,613799,2879,7822,2939,4665,9608,41.90465367951393,5.501408174353464,4943,0,1036643,4710,1756,1,2004,1153
11642,0,1,1,0,58,0,3204,0,0,8595877,14384130,70.30647196382421,4901,6724,6682,4943,45046,648930,587820,2868,7853,2952,4649,9634,41.701318923986086,6.488991180673202,4985,0,998486,6678,1739,1,2033,1171
11643,0,1,1,0,58,0,3248,0,0,8571728,14473492,70.51241025521678,4905,6763,6696,4972,43425,654975,561823,2844,7883,2978,4635,9674,41.52107898405339,8.187175587434018,5039,0,959596,11524,1724,1,2061,1187
11644,0,1,1,0,54,0,1047,0,0,825300,4250688,39.64845520319802,1512,2157,2097,1572,50635,554320,667888,2644,4276,2764,3229,4861,22.9128784747792,7.849311256600636,1632,0,388284,4680,525,0,1132,2179
11645,0,1,1,0,58,0,3438,0,0,9023560,15270640,71.97221686178632,4814,7288,6922,5180,42770,692780,536536,2582,8128,3314,4690,10236,41.737273509418415,19.187998961435614,5546,1,942760,70638,1742,0,2232,1206
11646,0,1,0,0,57,0,503,1,0,4979018,7171384,49.969990994595946,2255,4733,4491,2497,54273,657688,680664,2630,5369,3114,4866,7605,44.654227123532216,15.790094819097714,2739,1,591789,29524,1994,0,375,878
11647,0,1,1,0,55,0,813,0,0,3134430,6217731,47.148700936505136,2163,3693,3633,2223,55216,648904,665686,2737,5020,2857,4207,6490,37.54996671103717,7.83531632499182,2283,1,529074,7440,1410,0,574,1387
11648,0,1,1,0,58,0,2502,0,0,9704448,13588992,67.88225099390856,4488,6834,6714,4608,52377,651729,698913,2829,7557,3069,5055,9783,45.89117562233506,11.07142749248319,4728,0,1092096,13560,2106,1,1659,843
11649,0,1,1,0,59,0,3416,0,0,9262836,15443258,72.09715667070374,4778,7400,6980,5198,40182,659562,537751,2551,8169,3391,4753,10371,42.21374183841087,20.552465428990793,5618,1,940838,75600,1782,0,2227,1189
11650,0,1,1,0,61,0,4237,0,0,2788464,14905520,69.39740629158989,4515,5696,5395,4816,48048,643760,714945,2794,7911,3396,3674,8791,24.06241883103193,17.40125187133656,5117,1,1112496,31906,579,0,1721,2516
11651,0,1,1,0,59,0,2451,0,0,10211656,13744136,68.17624219623724,4588,6905,6845,4648,51959,688981,659411,2897,7605,3017,5154,9862,46.87216658103186,7.772191019407321,4708,0,1036504,8700,2197,1,1691,760
11652,0,1,1,0,59,0,2720,0,0,10170489,14244477,69.476614770727,4737,7024,6934,4827,46332,690534,584298,2861,7778,3041,5058,9975,45.902069670114,9.552038418812673,4917,1,955746,15840,2107,0,1876,844
11653,0,1,1,0,59,0,2381,0,0,6021966,11722656,62.5939294181153,3810,5563,5455,3918,52441,685168,685168,2884,6910,3100,4529,8555,39.20459156782532,10.406531168715494,4026,1,897222,14364,1537,0,926,1455
11654,0,1,1,0,60,0,2096,0,0,10380240,13343488,66.60330322138685,4178,7034,6776,4436,51684,709888,658752,2750,7444,3266,5348,10042,48.373546489791295,16.205304098330032,4694,1,971484,39732,2340,0,1428,668
11655,0,1,1,0,59,0,2646,0,0,10297512,14151888,69.23871749245504,4727,7009,6942,4794,46886,702576,581544,2885,7746,3019,5100,9961,46.34652090502587,8.230562448445415,4861,1,944418,12127,2148,0,1842,804
11656,0,1,1,0,60,0,3227,0,0,4190460,12740180,64.96152707564686,4178,5255,5213,4220,50955,715503,649085,2977,7239,3061,4012,8274,31.51190251317746,6.48074069840786,4262,1,907300,6720,993,0,1201,2026
11657,0,1,1,0,62,0,716,0,0,10564736,11377408,60.23288138550239,2967,7201,6540,3628,41392,652288,624064,2475,6764,3797,6048,10337,53.96295025292817,25.752710164505036,4289,1,721972,95184,2912,0,492,224
11658,0,1,1,0,63,0,4446,0,0,6884992,17959864,75.24626236564843,5152,7388,6878,5662,52514,767624,688324,2662,8834,3682,4388,10560,34.87119154832539,22.67156809750927,6172,1,1228654,82620,1216,0,2490,1956
11659,0,1,1,0,59,0,2442,0,0,10780168,13935800,68.73136110975832,4694,7036,7006,4724,51120,708000,628350,2920,7674,2980,5232,9986,47.77028364998475,5.478746393072713,4754,0,1006212,4980,2282,1,1774,668
11660,0,1,1,0,59,0,2534,0,0,10764000,14141504,69.16646586316233,4694,7124,7034,4784,51120,709440,629628,2866,7740,3046,5206,10080,47.43416490252569,9.543708938032719,4874,1,1018992,14850,2250,0,1828,706
11661,0,1,1,0,62,0,4596,0,0,3374560,16254480,72.38784428341543,5173,5951,5884,5240,45507,716562,611094,3035,8342,3169,3746,9053,25.37715508089904,8.187175587434018,5307,1,1032280,11658,644,0,2138,2458
11662,0,1,1,0,58,0,613,0,0,8981214,9708075,57.61076288333631,3010,6334,6025,3319,47475,617175,658125,2616,6244,3234,5631,9259,52.01922721455981,17.644483600297345,3628,1,746775,36153,2706,0,394,219
11663,0,1,1,0,64,0,660,0,0,11207596,11924232,60.778285596090974,3299,7123,6728,3694,39600,645600,639144,2833,6922,3623,6262,10351,55.08175741568164,19.918060315580586,4089,1,731412,53720,3034,0,466,194
11664,0,1,1,0,59,0,3248,0,0,10963968,15686336,72.8834686331544,5204,7484,7376,5312,54289,688049,688049,2845,8265,3061,5017,10437,45.43126676640219,10.403202108104866,5420,1,1237696,14256,2064,0,2359,889
11665,0,1,1,0,62,0,5061,0,0,307260,15936552,71.56116265125938,4946,5356,5181,5121,49000,622400,762440,2937,8233,3287,3172,8468,7.745966692414834,13.249871956203288,5296,1,1254645,13125,60,0,2009,3052
11666,0,1,1,0,59,0,1053,0,0,9003960,10543923,59.77457653551382,3290,6376,6093,3573,48024,684632,610857,2668,6524,3234,5471,9327,50.19960159204453,16.90600117849037,3856,1,739611,46129,2520,0,622,431
11667,0,1,1,0,61,0,5047,0,0,213738,15730099,71.33722730804723,4969,5251,5131,5089,49725,683111,695475,2971,8180,3211,3133,8342,6.48074069840786,10.96129127279285,5209,1,1145025,15600,42,0,1998,3049
11668,0,1,0,0,51,0,438,1,0,1204200,2325600,30.0,718,2420,2238,900,45580,547808,555560,2402,3484,2766,3922,5004,36.578682316343766,13.650779037925874,1082,0,193500,23842,1338,1,1684,1246
11669,0,1,1,0,59,0,2220,0,0,7803936,12282144,64.15605972938177,3848,6280,6012,4116,48108,629624,680352,2716,7100,3252,4880,9264,43.54308211415448,16.45669530339481,4384,1,938448,30284,1896,0,1132,1088
11670,0,1,1,0,61,0,3884,0,0,4277205,14614182,69.13031173081747,4626,5827,5674,4779,45704,709456,602426,2905,7837,3211,3953,8885,29.916550603303182,12.451065397773466,4932,1,941463,26775,895,0,1721,2163
11671,0,1,1,0,63,0,5083,0,0,1965284,17175820,73.78346698278686,5234,6015,5805,5444,50621,703565,716185,2945,8599,3365,3516,9170,19.0,14.733734538837195,5654,1,1235788,27300,361,0,2289,2794
11672,0,1,1,0,59,0,2460,0,0,12805756,14921664,70.80960386840192,4774,7808,7568,5014,49725,669600,657696,2736,7990,3216,5530,10784,50.53711507397311,15.524375156057674,5254,1,1108094,33120,2554,0,2038,422
11673,0,1,1,0,62,0,4900,0,0,1753725,16286085,72.35329985563892,5101,5704,5570,5235,48048,718641,647088,2977,8346,3245,3446,8815,18.303005217723125,11.675279088410905,5369,1,1088880,21708,335,0,2124,2776
11674,0,1,1,0,59,0,2774,0,0,12814152,15474186,72.29107828771127,5196,7708,7678,5226,52170,657342,695835,2931,8187,2991,5413,10669,49.51767361255979,5.5503012171862105,5256,0,1228110,3570,2452,1,2265,509
11675,0,1,1,0,61,0,4770,0,0,9250000,19293750,79.05694150420949,5576,8404,7730,6250,47000,771750,580356,2413,9337,3761,4567,11491,38.47076812334269,26.12961751256204,6924,1,1175000,134126,1480,0,3163,1607
11676,0,1,1,0,59,0,1942,0,0,9470688,12556218,64.79197481170026,3988,6664,6454,4198,55144,729804,675966,2781,7189,3201,5247,9655,47.49736834815167,14.614743587758587,4408,1,948748,31710,2256,0,1207,735
11677,0,1,0,1,65,0,921,0,0,12238252,10023156,55.389529696504916,2785,7340,7057,3068,52668,744876,754677,2984,6335,3550,7256,10607,63.15853069855251,17.020926117136145,3351,1,708708,36790,3989,0,199,722
11678,0,1,1,0,58,0,661,0,0,10404576,10422441,59.77457653551382,3391,6667,6485,3573,46125,597985,656325,2735,6490,3099,5829,9584,53.96295025292817,13.6587328104449,3755,1,803925,19838,2912,0,656,5
11679,0,1,1,0,61,0,1630,0,0,14312675,14354840,68.4470598345904,4595,7830,7740,4685,56386,713912,741488,2974,7749,3154,6119,10894,55.27205442174191,9.510461639168101,4775,1,1133770,9720,3055,0,1621,9
11680,0,1,1,0,59,0,2675,0,0,8621396,13641796,67.55738301621814,4440,6577,6453,4564,51957,750239,618723,2865,7553,3113,4878,9566,43.46262762420146,11.222142929558922,4688,1,944748,22196,1889,0,1575,1100
11681,0,1,1,0,61,0,4059,0,0,5888862,16051563,72.06247289678588,5031,6489,6327,5193,51012,723294,673838,2929,8284,3253,4225,9580,33.67491648096547,12.733858961110672,5355,1,1132074,24786,1134,0,2102,1957
11682,0,1,1,0,61,0,3987,0,0,6224400,16053765,72.02083032012335,4959,6615,6387,5187,50778,724230,671615,2867,8282,3323,4295,9710,34.64101615137755,15.108447856955953,5415,1,1125579,35112,1200,0,2092,1895
11683,0,1,1,0,63,0,4957,0,0,4286708,18042988,75.55130707009641,5538,6629,6459,5708,52156,745996,698581,2991,8869,3331,3912,9790,27.40437921208944,13.078932278133562,5878,1,1261468,25670,751,0,2547,2410
11684,0,1,1,0,58,0,1575,0,0,9783694,11822298,63.34824385884742,3983,6481,6451,4013,56640,707040,695256,2916,6959,2976,5384,9427,49.37610758251404,5.514871952411144,4043,0,947068,3930,2438,0,1067,508
11685,0,1,1,0,59,0,3149,0,0,12805140,16342320,74.05403432629447,5484,7819,7819,5484,51296,682420,667520,2980,8464,2980,5315,10799,48.321837713398274,0.0,5484,0,1228416,0,2335,1,2504,645
11686,0,1,1,0,61,0,4333,0,0,5891540,16774900,73.62064927722385,5335,6592,6507,5420,46782,699470,640665,3010,8515,3180,4182,9687,32.96968304366907,9.219544457292887,5505,0,1121940,13260,1087,0,2325,2008
11687,0,1,1,0,59,0,3188,0,0,12630189,16313308,74.08778576796583,5459,7820,7790,5489,49946,656812,671672,2942,8461,3002,5273,10792,47.968739820845826,5.514871952411144,5519,0,1240514,3840,2301,0,2517,671
11688,0,1,1,0,62,0,4551,0,0,5861106,17448966,74.81978348003956,5386,6857,6645,5598,52851,695091,738729,2905,8715,3329,4164,9974,32.357379374726875,14.599262058563324,5810,1,1326726,24592,1047,0,2481,2070
11689,0,1,1,0,57,0,285,0,0,4738636,5862125,45.155287619502545,1716,4686,4363,2039,49450,618125,661250,2552,4914,3198,5199,7561,48.2078831727758,18.051306284727975,2362,1,468970,37468,2324,0,836,551
11690,0,1,1,0,61,0,3422,0,0,7896579,15358071,70.71774883294857,4492,7089,6580,5001,51684,672549,724756,2562,8072,3580,4650,10160,39.736632972611055,22.62659694430589,5510,1,1180236,57517,1579,0,1930,1492
11691,0,1,1,0,63,0,4764,0,0,6249285,18450270,76.38717169787084,5336,7405,6906,5835,29925,540702,553350,2663,8997,3661,4233,10567,32.72613634390714,22.43536952191756,6334,1,1021125,60878,1071,0,2673,2091
11692,0,1,1,0,56,0,730,0,0,4484976,5071912,42.23742416388575,1784,4298,4298,1784,47742,619774,622617,2843,4627,2843,5357,7141,50.1398045468867,0.0,1784,0,390696,0,2514,0,1059,329
11693,0,1,1,0,61,0,3795,0,0,10919404,17437940,75.55130707009641,5389,7940,7621,5708,48070,772915,580450,2736,8763,3374,4968,10995,43.73785545725808,17.941155833945835,6027,1,1084520,62843,1913,0,2653,1142
11694,0,1,1,0,59,0,528,0,0,6778993,8510474,53.67494760127857,2641,5474,5234,2881,49104,732592,584892,2714,5835,3194,5307,8428,48.507731342539614,15.885744871983722,3121,1,570438,45120,2353,0,73,601
11695,0,1,1,0,55,0,1370,0,0,2909019,3222635,33.95585369269929,963,3866,3676,1153,50380,640055,614900,2605,3948,2985,5318,6661,50.22947341949744,13.784430565831073,1343,1,253660,27550,2523,0,1642,272
11696,0,1,1,0,59,0,593,0,0,5946480,8234223,52.46903848937962,2382,5284,4913,2753,50369,720831,625119,2620,5744,3362,5151,8275,46.475800154489,19.657061117059968,3124,1,575377,63070,2160,0,238,831
11697,0,1,1,0,58,0,88,0,0,4759188,6535536,47.18050444834179,2159,4431,4364,2226,51075,660600,666472,2869,5162,3003,5074,7367,46.238512086787566,8.185808589931957,2293,1,505302,8844,2138,0,710,798
11698,0,1,1,0,58,0,211,0,0,4279982,5724992,44.339598554790726,1871,4238,4143,1966,42622,588224,614432,2817,4878,3007,5089,7150,46.65833258915282,9.756499634156611,2061,1,414826,11685,2177,0,946,735
11699,0,1,1,0,60,0,2676,0,0,12779245,15547480,71.79832867135558,5125,7664,7634,5155,49248,687648,651456,2986,8171,3046,5495,10680,49.78955713801841,5.478746393072713,5185,0,1113480,4470,2479,1,2139,537
11700,0,1,1,0,55,0,1940,0,0,2146149,2174481,28.053520278211074,271,4030,3514,787,48600,596808,621675,2247,3550,3279,5490,6793,52.22068555658763,22.72503352655097,1303,1,177075,63984,2727,0,1976,36
11701,0,1,1,0,58,0,64,0,0,4279737,5994891,45.13313638558703,1952,4223,4138,2037,38745,603315,556227,2858,4980,3028,5044,7166,45.83666654546336,9.344583777936014,2122,1,384993,12835,2101,0,906,842
11702,0,1,1,0,56,0,1113,0,0,3008170,3601455,35.566838487557476,1115,3793,3643,1265,50388,629187,649116,2697,4112,2997,5225,6640,48.76474136094644,12.254111330655777,1415,1,288420,18750,2378,0,1582,469
11703,0,1,1,0,65,0,4793,0,0,10332878,20870748,80.03749121505496,5506,8919,8019,6406,46716,746082,664632,2358,9664,4158,4871,12177,40.162171256046406,30.119616030076866,7306,1,1306824,148500,1613,0,3148,1645
11704,0,1,1,0,61,0,3074,0,0,10197567,15654561,71.28113354878694,4947,7222,7088,5081,54988,727116,717873,2947,8162,3215,5088,10303,44.799553569204235,11.576481526871955,5215,1,1183873,18090,2007,0,2000,1074
11705,0,1,1,0,59,0,1115,0,0,6317244,9358416,55.96427431853289,2982,5299,5149,3132,45173,678276,594612,2838,6120,3138,5005,8287,44.91102314577124,12.420125667085228,3282,1,623268,25050,2017,0,144,971
11706,0,1,1,0,64,0,4069,0,0,10687160,18914390,76.71375365604267,5442,8144,7701,5885,51302,729578,726364,2771,9099,3657,5030,11358,42.61455150532503,21.163399899352207,6328,1,1330010,59805,1816,0,2671,1398
11707,0,1,1,0,59,0,1283,0,0,6854198,9917564,57.766772456144714,3337,5391,5391,3337,46945,680588,609260,2972,6309,2972,5026,8363,45.32107677449864,0.0,3337,0,684085,0,2054,1,365,918
11708,0,1,1,0,59,0,721,0,0,4165296,7226010,49.3254498205541,2433,4145,4145,2433,52598,706860,656370,2970,5403,2970,4682,7115,41.376321731154405,0.0,2433,1,537693,0,1712,0,537,1258
11709,0,1,1,0,60,0,1731,0,0,11399620,13266199,65.96211033616193,4161,7161,6971,4351,51600,655535,731760,2859,7400,3239,5669,10210,51.18593556827891,13.793584592280734,4541,1,1044240,19190,2620,0,1302,429
11710,0,1,1,0,58,0,399,0,0,3462712,6086669,45.50824101193101,2041,3773,3743,2071,52192,684787,658336,2909,5010,2969,4611,6712,40.890096600521744,5.478746393072713,2101,1,463904,4320,1672,0,868,1267
11711,0,1,1,0,62,0,3225,0,0,11518650,16834950,73.28028384224504,5370,7515,7515,5370,50848,702240,711645,3135,8505,3135,5280,10650,46.314144707637645,0.0,5370,0,1218990,0,2145,1,2235,990
11712,0,1,1,0,64,0,3924,0,0,12214620,19354740,77.26577508832743,5489,8497,8016,5970,47936,693788,726208,2761,9212,3723,5288,11739,45.232731511594565,22.138179003634377,6451,1,1337280,58682,2046,0,2728,1196
11713,0,1,1,0,63,0,1109,0,0,14250570,13922820,66.10597552415364,3763,8238,7631,4370,43834,643572,691362,2579,7556,3793,6447,11424,57.105166141076936,24.675795845709743,4977,1,948290,70412,3261,0,1184,75
11714,0,1,1,0,54,0,1561,0,0,1497672,1843237,25.903667693977237,611,2963,2903,671,54054,634557,642798,2687,3418,2807,4979,5710,47.24404724407086,7.780166052320878,731,1,157014,7740,2232,0,2076,515
11715,0,1,1,0,63,0,991,0,0,14282012,13778093,65.62773803811922,3738,8192,7623,4307,46926,633402,758163,2630,7506,3768,6515,11391,57.584720195551874,24.132026498178778,4876,1,1020759,48365,3316,0,1108,117
11716,0,1,1,0,61,0,2650,0,0,13399824,16029696,72.2357252334328,4976,8028,7786,5218,49396,715776,651264,2830,8290,3314,5640,11100,50.67543783727971,15.558009107250758,5460,0,1106216,38478,2568,1,2146,504
11717,0,1,1,0,61,0,1441,0,0,14107680,14025870,67.4166151627327,4450,7744,7649,4545,54288,722124,715952,2991,7631,3181,6190,10830,55.71355310873648,9.779300676839927,4640,1,1054440,12825,3104,0,1459,18
11718,0,1,1,0,59,0,944,0,0,2903040,6670720,47.32863826479693,2087,3689,3536,2240,50370,652182,684940,2825,5218,3131,4274,6667,36.0,12.478946871590342,2393,1,515200,18666,1296,0,738,1682
11719,0,1,1,0,63,0,2547,0,0,13351228,16262166,71.71471257698799,4866,8016,7739,5143,55225,743070,743070,2885,8305,3439,5758,11178,50.950956811427986,16.671929506701524,5420,1,1208605,36287,2596,0,1981,566
11720,0,1,1,0,64,0,3014,0,0,14220672,17956800,74.61903242471053,5084,8606,8122,5568,45126,703050,667575,2741,8793,3709,5779,11831,50.53711507397311,22.137902498177198,6052,1,1152576,71148,2554,0,2343,671
11721,0,1,1,0,55,0,1257,0,0,1594498,2184908,27.964262908219126,722,2881,2821,782,39208,648208,472186,2734,3576,2854,4833,5675,45.155287619502545,7.822290851349969,842,1,132158,12120,2039,0,2012,755
11722,0,1,1,0,60,0,1129,0,0,2211030,6477930,46.42197755374064,1921,3415,3181,2155,55932,709416,712422,2772,5161,3240,4032,6421,32.03123475609393,15.297058540778355,2389,1,510735,29952,1026,0,851,1980
11723,0,1,1,0,57,0,1906,0,0,1194291,1416450,22.293496809607955,16,3381,2900,497,42402,544350,632700,2369,3347,3331,5253,6231,49.02040391510457,22.639190042305035,978,1,110334,45695,2403,0,2353,447
11724,0,1,0,1,66,0,450,0,0,14473096,11884004,59.88321968631947,3013,8195,7622,3586,51282,765534,735708,2741,6900,3887,7350,11509,63.52952069707436,23.988453765358567,4159,1,796092,83085,4036,0,272,722
11725,0,1,1,0,62,0,2006,0,0,14858280,15651054,70.61161377563892,4610,8342,7966,4986,45510,643495,696858,2763,8125,3515,6119,11481,54.589376255824725,19.585810231911047,5362,1,1106892,42864,2980,0,1847,159
11726,0,1,1,0,63,0,2249,0,0,13538756,15686660,70.51241025521678,4942,7725,7695,4972,48548,722495,668860,3125,8127,3185,5878,10880,52.182372502598994,5.490867587491313,5002,0,1054064,4620,2723,1,1817,432
11727,0,1,1,0,55,0,2196,0,0,774045,852531,17.578395831246947,14,3109,2814,309,47385,538005,670437,2464,3068,3054,5264,5868,50.049975024968795,17.419064154957447,604,1,75087,20945,2505,0,2450,254
11728,0,1,1,0,60,0,1494,0,0,1989207,7096947,48.40454524112379,2042,3493,3192,2343,51744,678496,699699,2728,5372,3330,3878,6522,29.13760456866693,17.370425120633413,2644,1,541233,37926,849,0,686,2180
11729,0,1,1,0,65,0,3036,0,0,16652992,19242544,76.62897624267207,5277,9303,8708,5872,51959,763541,730771,2682,9149,3872,6113,12580,53.25410782277739,24.51903343170353,6467,1,1309456,86870,2836,0,2595,441
11730,0,1,1,0,60,0,1657,0,0,1998270,7502147,49.66890375275057,2136,3608,3277,2467,49932,693348,665979,2710,5508,3372,3851,6649,28.460498941515414,18.238446961558925,2798,1,540273,47995,810,0,574,2231
11731,0,1,0,0,57,0,1452,1,0,1598688,2116944,27.055498516937366,337,3311,2916,732,43931,644916,569724,2497,3624,3287,5076,6203,46.73328578219169,20.249209532014284,1127,1,144204,64780,2184,0,2160,708
11732,0,1,1,0,62,0,2077,0,0,16073540,16177140,71.97221686178632,4990,8473,8283,5180,49952,699552,696429,2933,8303,3313,6226,11596,55.70457790882182,13.927000263998286,5370,0,1155140,25840,3103,1,2057,20
11733,0,1,1,0,55,0,1925,0,0,902850,1073280,19.748417658131498,30,3065,2705,390,46662,555904,635712,2392,3142,3112,5067,5817,48.11444689487763,19.18704342521298,750,1,90090,35640,2315,0,2362,437
11734,0,1,1,0,56,0,1854,0,0,1475455,1709244,24.515301344262525,28,3629,3056,601,45540,563112,654120,2271,3445,3417,5299,6473,49.54795656734998,24.44762509134384,1174,1,138230,53862,2455,0,2243,389
11735,0,1,1,0,55,0,1871,0,0,666162,842112,17.4928556845359,21,2768,2483,306,42180,509120,627456,2467,3058,3037,4929,5520,46.65833258915282,17.27927296180667,591,1,69768,22515,2177,0,2446,575
11736,0,1,1,0,54,0,1857,0,0,355600,476350,13.228756555322953,5,2377,2207,175,49922,593396,623338,2552,2897,2892,4754,5099,45.077710678338576,13.261035176436632,345,1,40075,20570,2032,0,2547,690
11737,0,1,1,0,62,0,2423,0,0,6617760,12712425,63.67888189973188,3960,5782,5687,4055,51465,736725,686565,3040,7190,3230,4767,8917,40.39801975344831,9.746794344808963,4150,0,888045,14535,1632,1,920,1503
11738,0,1,1,0,57,0,139,0,0,2093322,3993584,37.134889255254286,1349,2927,2897,1379,52664,657392,671872,2866,4275,2926,4414,5823,38.961519477556315,5.514871952411144,1409,1,319928,3840,1518,0,1517,1378
11739,0,1,1,0,57,0,1804,0,0,1478592,1750932,24.73863375370596,23,3617,3028,612,44928,549312,669474,2272,3473,3450,5277,6478,49.15282290977803,24.859052501999045,1201,1,143208,47709,2416,0,2249,445
11740,0,1,1,0,56,0,1817,0,0,984998,1225785,20.904544960366874,19,3109,2691,437,45668,549780,653565,2387,3242,3223,5059,5914,47.47630988187688,20.97327805293841,855,1,101821,36366,2254,0,2368,551
11741,0,1,1,0,54,0,1827,0,0,500698,661870,15.556349186104045,8,2545,2311,242,49450,588025,629050,2501,2977,2969,4804,5280,45.48626166217664,15.55873930426897,476,1,55660,27378,2069,0,2493,666
11742,0,1,1,0,57,0,1785,0,0,1485054,1771188,24.859605789312106,20,3619,3021,618,45355,553138,673510,2268,3484,3464,5269,6485,49.02040391510457,25.055177060591557,1216,1,145230,47242,2403,0,2248,463
11743,0,1,1,0,57,0,1722,0,0,1446120,1771188,24.859605789312106,77,3499,2958,618,43740,515880,696438,2325,3484,3407,5206,6365,48.373546489791295,23.332983957167702,1159,1,150174,26509,2340,0,2248,526
11744,0,1,1,0,54,0,1731,0,0,446652,623352,15.0996688705415,10,2405,2187,228,45800,546800,626086,2516,2962,2952,4693,5139,44.26059195266146,14.99436719831913,446,1,52212,21146,1959,0,2506,775
11745,0,1,1,0,63,0,2493,0,0,8843638,14101534,66.86553671361654,4120,6800,6449,4471,51756,719112,715958,2803,7625,3505,5132,9954,44.474711915874174,18.747299416603965,4822,1,1014917,47736,1978,0,1317,1176
11746,0,1,1,0,58,0,412,0,0,2062965,4846725,40.70626487409524,1590,2969,2902,1657,53586,684450,669825,2858,4582,2992,4170,5894,35.2845575287547,8.222029866439447,1724,1,379453,9313,1245,0,1268,1680
11747,0,1,1,0,55,0,1702,0,0,788699,1059305,19.467922333931785,8,2831,2460,379,37932,486330,609310,2424,3174,3166,4876,5626,45.617978911828175,19.73102882145761,750,1,82622,28196,2081,0,2416,714
11748,0,1,1,0,54,0,1702,0,0,359480,517180,13.784048752090222,15,2257,2082,190,44004,525346,620616,2547,2912,2897,4614,4979,43.497126341863094,13.415268981669886,365,1,43320,15750,1892,0,2532,830
11749,0,1,1,0,54,0,1703,0,0,302130,439668,12.727922061357855,12,2177,2027,162,45571,540086,621506,2564,2876,2864,4579,4891,43.18564576337837,12.410850817228189,312,1,37098,14550,1865,0,2552,849
11750,0,1,1,0,60,0,2507,0,0,1176044,8852351,53.95368384086484,2844,3382,3315,2911,50358,702471,662938,2974,5952,3108,3445,6423,20.09975124224178,8.187175587434018,2978,0,634598,9983,404,1,130,2637
11751,0,1,1,0,55,0,1679,0,0,674690,929960,18.303005217723125,12,2672,2349,335,36023,452488,613496,2453,3111,3099,4790,5448,44.87761134463375,18.429271353684506,658,1,74035,18088,2014,0,2441,762
11752,0,1,1,0,57,0,1653,0,0,1346098,1705496,24.454038521274967,139,3308,2849,598,47025,596068,641700,2393,3450,3311,5103,6160,47.44470465710583,21.565877877306434,1057,1,134550,52785,2251,0,2254,601
11753,0,1,1,0,55,0,1652,0,0,574365,816265,17.175564037317667,12,2525,2242,295,40443,506361,611507,2484,3062,3050,4714,5292,44.12482294582042,17.259468159879052,578,1,65195,23772,1947,0,2472,820
11754,0,1,1,0,55,0,1651,0,0,514292,739412,16.3707055437449,12,2443,2187,268,41132,502138,623534,2503,3027,3015,4678,5202,43.80639222761902,16.368026731500475,524,1,60568,19712,1919,0,2491,840
11755,0,1,1,0,62,0,2546,0,0,6853392,13146128,64.68384651518491,4099,5907,5822,4184,52392,741512,697524,3057,7326,3227,4780,9049,40.47221268969612,9.227509513928014,4269,0,928848,12750,1638,1,1042,1504
11756,0,1,1,0,54,0,1601,0,0,301070,461040,13.038404810405298,20,2091,1941,170,46284,550536,618336,2562,2882,2862,4483,4803,42.08325082500163,12.514175867137965,320,1,38760,15300,1771,0,2542,941
11757,0,1,1,0,55,0,1590,0,0,517159,764520,16.64331697709324,19,2402,2144,277,41580,496800,637560,2502,3037,3018,4627,5162,43.2087954009366,16.44434083993029,535,1,63987,17544,1867,0,2483,893
11758,0,1,1,0,55,0,1569,0,0,653562,955206,18.49324200890693,18,2577,2253,342,39725,488775,634011,2469,3135,3117,4704,5370,43.71498598878879,18.53295774431812,666,1,77634,20736,1911,0,2451,882
11759,0,1,1,0,64,0,1766,0,0,15036840,15746400,69.7137002317335,4336,8478,7954,4860,46492,638280,764640,2716,8100,3764,6334,11718,55.62373594069352,23.267171019007957,5384,1,1146960,44540,3094,0,1620,146
11760,0,1,1,0,61,0,2646,0,0,3493771,11182235,60.108235708594876,3328,4865,4580,3613,55370,758275,699470,2810,6708,3380,4062,7960,31.096623610932426,16.882150854007477,3898,1,816538,42750,967,0,518,2128
11761,0,1,1,0,64,0,2887,0,0,16956440,18599821,76.20367445208925,5403,9131,8727,5807,51756,730284,727081,2799,9010,3607,6123,12334,54.037024344425184,20.106674748541334,6211,1,1318189,54540,2920,0,2604,283
11762,0,1,1,0,54,0,1483,0,0,244950,408300,12.24744871391589,30,1903,1783,150,39715,460018,639670,2602,2872,2842,4355,4625,40.4103947023535,11.453518157187645,270,1,35250,5400,1633,0,2572,1089
11763,0,1,1,0,59,0,834,0,0,2157840,5769792,44.090815370097204,1836,3162,3054,1944,41630,682640,537208,2860,4912,3076,4078,6130,33.31666249791537,10.518295179710192,2052,1,351864,20412,1110,0,1024,1858
11764,0,1,1,0,54,0,1469,0,0,248166,417537,12.36931687685298,29,1899,1775,153,36888,433911,633128,2605,2882,2853,4351,4628,40.27406113120453,11.718395466430005,277,1,35496,4340,1622,0,2576,1107
11765,0,1,1,0,61,0,2790,0,0,1258075,9742915,56.43580423808985,2957,3808,3580,3185,50808,709688,669921,2831,6244,3287,3454,6867,19.87460691435179,15.106925328558159,3413,0,697515,33972,395,1,126,2664
11766,0,1,1,0,60,0,1726,0,0,1502232,7100172,48.60041152089147,2192,3168,2998,2362,56153,724446,700398,2836,5368,3176,3642,6174,25.219040425836983,13.166877513752253,2532,1,550346,23460,636,0,644,2370
11767,0,1,1,0,55,0,1413,0,0,290290,502138,13.490737563232042,20,1939,1777,182,34255,427645,609739,2597,2941,2921,4354,4698,39.93745109543172,13.37689542335996,344,1,40222,6966,1595,0,2577,1164
11768,0,1,1,0,54,0,1413,0,0,190588,338148,11.135528725660043,16,1769,1661,124,39560,469044,627210,2619,2851,2835,4264,4496,39.20459156782532,10.871351968433055,232,1,28520,6156,1537,0,2603,1190
11769,0,1,1,0,59,0,299,0,0,2623152,4386690,38.43175770115127,1182,3548,3253,1477,49946,671220,656370,2675,4447,3265,4746,6518,42.14261501141095,17.191528214751017,1772,0,326417,41595,1776,1,1493,1194
11770,0,1,1,0,55,0,1380,0,0,366624,636120,15.0996688705415,18,2046,1836,228,41040,502200,636120,2580,3018,3000,4398,4836,40.099875311526844,15.35214491697784,438,1,51984,14910,1608,0,2562,1182
11771,0,1,1,0,55,0,1375,0,0,271250,483700,13.228756555322953,25,1875,1725,175,34350,414600,632956,2614,2939,2914,4314,4639,39.370039370059054,13.056526021193557,325,1,40075,3750,1550,0,2589,1214
11772,0,1,1,0,64,0,3329,0,0,15749552,19187120,77.25283166331187,5404,9171,8607,5968,49126,778030,652645,2651,9183,3779,5854,12386,51.37119815616529,23.832030294889,6532,0,1211504,100956,2639,1,2753,576
11773,0,1,1,0,60,0,2605,0,0,609336,8519420,53.113086899558006,2413,3445,3037,2821,46031,727820,576820,2612,5841,3428,3236,6465,14.696938456699069,20.20495299218492,3229,0,538811,77520,216,1,199,2804
11774,0,1,1,0,58,0,1383,0,0,1947634,2538246,29.427877939124322,836,3145,3115,866,51296,671199,656544,2901,3797,2961,5180,6076,47.4236228055175,5.490867587491313,896,0,193984,4200,2249,1,2065,682
11775,0,1,1,0,56,0,1362,0,0,436840,752812,16.3707055437449,28,2138,1898,268,43758,525283,657306,2569,3077,3049,4439,4947,40.3732584763727,16.46403862829034,508,1,62712,17520,1630,0,2541,1179
11776,0,1,1,0,61,0,2815,0,0,1611864,10153422,57.47173218200405,2899,4195,3791,3303,51840,737760,663984,2670,6377,3478,3562,7269,22.090722034374522,20.110856157897164,3707,0,713448,65044,488,1,229,2586
11777,0,1,1,0,60,0,2720,0,0,1023425,9274980,55.27205442174191,2631,3814,3390,3055,48364,649704,686136,2612,6091,3460,3371,6850,18.303005217723125,20.609133626484592,3479,0,690430,50880,335,1,19,2701
11778,0,1,1,0,55,0,1305,0,0,218250,413700,12.24744871391589,26,1729,1605,150,38962,444038,667436,2634,2908,2882,4213,4487,38.144462245521304,12.261169997086926,274,1,36300,2604,1455,0,2608,1303
11779,0,1,1,0,64,0,1426,0,0,12229392,13907936,65.43699259593154,3911,7509,7138,4282,49494,734048,711312,2877,7530,3619,6104,10757,53.44155686354955,19.42580488081921,4653,0,937758,53053,2856,1,1034,392
11780,0,1,1,0,61,0,2804,0,0,4593117,12257559,62.95236294214857,3933,5152,5122,3963,49648,717576,661902,3063,7056,3123,4252,8245,34.044089061098404,5.483301264452448,3993,0,848082,4680,1159,1,870,1934
11781,0,1,1,0,61,0,2815,0,0,3974984,11905712,62.03224967708329,3698,5031,4881,3848,45492,689962,631176,2944,6942,3244,4127,8125,32.14031735997639,12.256148736246766,3998,1,784992,23550,1033,0,754,2061
11782,0,1,1,0,62,0,2821,0,0,3302790,11541210,60.91797764207213,3405,4907,4601,3711,40934,656210,603340,2804,6821,3416,4000,8017,29.832867780352597,17.543496456814072,4017,1,719934,46818,890,0,601,2220
11783,0,1,1,0,55,0,1250,0,0,273600,528960,13.784048752090222,100,1720,1630,190,42656,478848,690432,2694,2974,2874,4224,4504,37.94733192202055,9.486832980505138,280,1,47120,2520,1440,0,2594,1344
11784,0,1,1,0,60,0,2347,0,0,1933478,9017909,54.70831746635972,2963,3669,3639,2993,52731,732159,653821,2983,6006,3043,3659,6682,25.41653005427767,5.477225575051661,3023,1,649481,4890,646,0,20,2367
11785,0,1,1,0,62,0,2861,0,0,4920630,12698400,63.796551630946325,3920,5429,5279,4070,40906,705120,564720,2970,7190,3270,4329,8549,34.77067730142742,12.312788037888811,4220,1,736670,27600,1209,0,950,1911
11786,0,1,1,0,60,0,697,0,0,2967354,6421194,45.89117562233506,1914,3707,3515,2106,49796,719564,643339,2857,5155,3241,4458,6756,37.53664875824692,13.924408195132685,2298,0,444366,31488,1409,1,943,1640
11787,0,1,1,0,63,0,3758,0,0,12823295,18918062,76.96102909914862,5561,8450,8088,5923,51624,763366,689904,2832,9117,3556,5359,11644,46.52956049652737,19.05078740134747,6285,0,1279368,57920,2165,1,2729,1029
11788,0,1,1,0,60,0,2964,0,0,1672765,10505654,58.728187440104094,3419,3964,3934,3449,53572,691442,718856,3016,6495,3076,3531,7010,22.02271554554524,5.483301264452448,3479,1,813964,3660,485,0,403,2561
11789,0,1,1,0,60,0,2985,0,0,1320016,10222528,58.1033561853358,3316,3827,3767,3376,49248,654048,690384,2968,6404,3088,3419,6855,19.77371993328519,7.745966692414834,3436,1,769728,7200,391,0,348,2637
11790,0,1,1,0,59,0,430,0,0,2995311,4554891,39.102429592034305,1499,3518,3488,1529,54692,673254,720918,2949,4508,3009,4938,6497,44.26059195266146,5.490867587491313,1559,0,370018,3330,1959,1,1450,1020
11791,0,1,1,0,60,0,2015,0,0,2080784,8317602,52.602281319349636,2737,3549,3519,2767,44884,688374,589176,2976,5773,3036,3758,6555,27.422618401604176,5.490867587491313,2797,0,542332,5190,752,1,239,2254
11792,0,1,1,0,55,0,1157,0,0,233100,484050,13.228756555322953,22,1660,1507,175,47336,536604,674904,2613,2941,2919,4098,4426,36.49657518178932,13.003639800167623,328,1,42700,10404,1332,0,2591,1434
11793,0,1,1,0,55,0,1152,0,0,195300,413250,12.24744871391589,26,1576,1452,150,48020,539980,674975,2631,2905,2879,4057,4331,36.08323710533743,11.755504904747838,274,1,36750,8680,1302,0,2605,1453
11794,0,1,1,0,61,0,3172,0,0,1613628,11060226,60.149812967290266,3618,4064,4064,3618,54240,733680,690882,3057,6675,3057,3503,7121,21.118712081942874,0.0,3618,0,817668,0,446,0,561,2611
11795,0,1,1,0,64,0,2639,0,0,9551880,15107040,68.41052550594829,4505,6896,6721,4680,53815,758580,739212,3053,7908,3403,5269,10124,45.17742799230607,13.239542342149937,4855,0,1071720,24325,2041,1,1452,1187
11796,0,1,1,0,60,0,1651,0,0,2365320,7826124,50.70502933634887,2329,3733,3491,2571,47959,733604,605756,2802,5615,3286,3964,6777,30.331501776206203,15.760547165865924,2813,1,511629,44044,920,0,473,2124
11797,0,1,1,0,64,0,2774,0,0,9399456,15306192,68.93475175845634,4632,6850,6730,4752,52658,750493,727946,3101,7973,3341,5199,10071,44.474711915874174,10.969823458961839,4872,0,1073952,17160,1978,1,1531,1243
11798,0,1,1,0,63,0,3105,0,0,11746150,16965480,72.90404652692469,4739,8101,7525,5315,51465,750120,699048,2616,8507,3768,5402,11293,47.01063709417264,24.001464709658645,5891,0,1163985,88128,2210,0,2123,982
11799,0,1,1,0,54,0,1132,0,0,192300,412350,12.24744871391589,16,1566,1432,150,37848,456334,626772,2615,2899,2883,4031,4315,35.805027579936315,12.168439873279091,284,1,34200,6834,1282,0,2599,1467
11800,0,1,1,0,60,0,1754,0,0,2268920,7964800,51.18593556827891,2378,3728,3486,2620,46215,720480,592800,2798,5660,3282,3906,6768,29.427877939124322,15.66152960069583,2862,1,510900,44044,866,0,420,2174
11801,0,1,1,0,60,0,114,0,0,3076776,5116074,41.20679555607303,1668,3540,3510,1698,48832,656834,674912,2983,4711,3043,4825,6553,42.567593307585526,5.478746393072713,1728,0,380352,3810,1812,1,1315,1201
11802,0,1,1,0,54,0,1115,0,0,189750,411900,12.24744871391589,23,1542,1415,150,39960,494280,609612,2619,2896,2873,4011,4288,35.566838487557476,11.682811935442459,277,1,33300,10033,1265,0,2596,1481
11803,0,1,1,0,62,0,3170,0,0,6888131,14571583,68.19824044651006,4561,6222,6132,4651,31603,585871,529477,3043,7784,3223,4614,9355,38.48376280978771,9.883997062654284,4741,0,786019,13410,1481,1,1518,1652
11804,0,1,1,0,60,0,2176,0,0,1854305,8569437,53.207142377692115,2764,3553,3486,2831,43240,696210,569076,2960,5858,3094,3682,6580,25.592967784139454,8.250220863768833,2898,0,532228,12194,655,1,196,2372
11805,0,1,1,0,57,0,1137,0,0,542638,1035320,19.026297590440446,20,2203,1861,362,43844,554840,646360,2518,3222,3202,4359,5063,38.71692136521188,19.647179386747723,704,1,81812,31806,1499,0,2498,1361
11806,0,1,1,0,64,0,4181,0,0,10564170,19067910,77.1686464828819,5697,7987,7729,5955,49473,765278,662814,2944,9157,3460,4976,11189,42.118879377305376,16.07779984738014,6213,0,1232685,43860,1774,1,2753,1428
11807,0,1,1,0,55,0,1114,0,0,328152,675906,15.556349186104045,14,1826,1598,242,39715,472017,656355,2565,3035,3021,4149,4619,36.823905279043935,15.740905584311482,470,1,56870,10260,1356,0,2551,1437
11808,0,1,1,0,56,0,1114,0,0,439707,875397,17.578395831246947,14,2027,1732,309,47040,543936,694085,2538,3142,3128,4256,4860,37.72267222772003,18.034963157243123,604,1,75705,18880,1423,0,2524,1410
11809,0,1,1,0,55,0,1114,0,0,305976,635436,15.0996688705415,12,1786,1570,228,42320,512808,641010,2571,3015,3003,4129,4573,36.6333181680284,15.37441339508947,444,1,52440,16200,1342,0,2559,1445
11810,0,1,1,0,55,0,1114,0,0,264315,558378,14.177446878757825,9,1708,1516,201,43130,527820,630606,2586,2979,2970,4093,4486,36.26292872893749,14.651366005938826,393,1,45627,16512,1315,0,2577,1463
11811,0,1,1,0,63,0,3334,0,0,4291392,13722072,65.7723346096214,4007,5637,5318,4326,52341,758108,694668,2853,7498,3491,4164,8809,31.496031496047245,17.864957355783794,4645,1,947394,50083,992,0,1154,2180
11812,0,1,1,0,61,0,949,0,0,2888310,6880447,47.31807265728392,2131,3637,3529,2239,51304,651476,743666,2965,5312,3181,4363,6710,35.91656999213594,10.429745618880121,2347,1,541838,10368,1290,0,834,1783
11813,0,1,1,0,55,0,1109,0,0,314262,652860,15.297058540778355,6,1805,1577,234,45435,544050,650070,2562,3024,3018,4133,4595,36.64696440361739,15.740905584311482,462,1,54522,19608,1343,0,2556,1447
11814,0,1,1,0,59,0,1134,0,0,1749232,2592456,29.5296461204668,490,3260,2878,872,47499,633249,662979,2591,3845,3355,4979,6233,44.78839135311738,19.680552676414116,1254,1,194456,46604,2006,0,2101,967
11815,0,1,1,0,59,0,1129,0,0,1710540,2555060,29.32575659723036,436,3273,2849,860,49910,644707,683330,2547,3831,3395,4960,6244,44.598206241955516,20.700459972629584,1284,1,197800,50032,1989,0,2111,982
11816,0,1,1,0,64,0,3515,0,0,10128054,17338495,73.43704787094863,4935,7729,7271,5393,45458,765170,614065,2757,8608,3673,5093,10944,43.3358973600409,21.40256675417939,5851,0,1030063,85646,1878,1,2178,1337
11817,0,1,1,0,56,0,1148,0,0,379488,754152,16.3707055437449,12,1940,1684,268,43739,537474,644406,2558,3082,3070,4230,4754,37.62977544445356,17.390186430427917,524,1,61372,21760,1416,0,2546,1398
11818,0,1,1,0,54,0,1172,0,0,160704,338148,11.135528725660043,16,1528,1420,124,21879,269973,602667,2619,2851,2835,4023,4255,36.0,11.4174078303941,232,1,27404,0,1296,0,2603,1431
11819,0,1,1,0,56,0,1161,0,0,382972,753884,16.3707055437449,12,1953,1697,268,43616,528844,652616,2557,3081,3069,4242,4766,37.8021163428716,17.42090858072987,524,1,62176,19712,1429,0,2545,1384
11820,0,1,1,0,54,0,1182,0,0,176344,366356,11.575836902790225,10,1574,1450,134,22644,278868,606948,2610,2868,2858,4050,4308,36.27671429443411,11.974455588104178,258,1,29748,0,1316,0,2600,1418
11821,0,1,1,0,61,0,445,0,0,3301224,6261650,45.31004303683677,1806,3908,3661,2053,46662,704550,616100,2803,5103,3297,4658,6958,40.099875311526844,15.716233645501712,2300,0,414706,41496,1608,1,997,1442
11822,0,1,1,0,56,0,1162,0,0,454539,875706,17.578395831246947,14,2075,1780,309,39039,478946,654654,2539,3143,3129,4305,4909,38.353617821530214,18.646164486794436,604,1,71379,15045,1471,0,2525,1363
11823,0,1,1,0,56,0,1165,0,0,409784,798343,16.822603841260722,15,1999,1731,283,40680,507780,637546,2553,3104,3089,4269,4820,38.05259518088089,17.755166452023676,551,1,63958,19832,1448,0,2538,1373
11824,0,1,1,0,62,0,3473,0,0,3377880,13259885,65.30696746902278,3995,5327,5057,4265,55029,687089,774141,2839,7374,3379,3901,8436,28.142494558940577,16.50027477956775,4535,1,1061985,23220,792,0,1156,2317
11825,0,1,1,0,56,0,1196,0,0,392352,758440,16.3707055437449,10,1990,1732,268,40788,560340,582980,2572,3098,3088,4294,4820,38.262252939417984,17.54641270049294,526,1,55208,31734,1464,0,2562,1366
11826,0,1,1,0,60,0,3321,0,0,1402300,11244300,60.8276253029822,3670,4109,4079,3700,50838,695931,674658,3009,6739,3069,3418,7148,19.467922333931785,5.477225575051661,3730,0,821400,4260,379,1,661,2660
11827,0,1,1,0,59,0,1117,0,0,2566190,3406034,33.734255586866,561,3970,3393,1138,47264,631523,670432,2416,4131,3570,5248,6963,47.486840282335066,24.051088090581324,1715,1,254912,68663,2255,0,1855,738
11828,0,1,1,0,57,0,1235,0,0,451350,845765,17.175564037317667,94,2026,1825,295,37596,447252,690947,2666,3162,3068,4397,4893,39.11521443121589,14.545050792182467,496,1,71095,2814,1530,0,2572,1337
11829,0,1,1,0,62,0,3466,0,0,5022600,14277882,67.5721836261046,4439,5793,5666,4566,56153,753607,728591,3000,7693,3254,4227,8920,33.166247903554,11.319573475552495,4693,0,1063878,17526,1100,1,1439,2027
11830,0,1,1,0,63,0,3468,0,0,6295744,15098304,69.16646586316233,4622,6262,6100,4784,56643,747972,754284,2994,7940,3318,4472,9418,36.27671429443411,12.727922061357855,4946,1,1143376,19926,1316,0,1628,1840
11831,0,1,1,0,55,0,1313,0,0,304314,558579,14.177446878757825,201,1715,1715,201,36900,455756,625275,2779,2980,2779,4293,4494,38.91015291668744,0.0,201,1,45225,0,1514,0,2578,1265
11832,0,1,0,1,66,0,2312,0,0,6436608,13050696,62.80127387243033,3902,5618,5576,3944,44312,632019,767688,3267,7253,3351,4941,8927,40.39801975344831,6.570697549716149,3986,1,915008,3444,1632,0,635,1677
11833,0,1,1,0,56,0,1295,0,0,469050,832785,17.175564037317667,265,1915,1885,295,42408,525078,643644,2793,3118,2853,4413,4738,39.87480407475377,5.531194905403055,325,1,67260,2400,1590,0,2528,1233
11834,0,1,1,0,60,0,1140,0,0,3228325,3987080,36.26292872893749,749,4336,3770,1315,48351,688264,645816,2466,4347,3598,5487,7368,49.54795656734998,23.840798502460068,1881,1,280095,85466,2455,0,1717,577
11835,0,1,1,0,54,0,1396,0,0,205020,368232,11.575836902790225,10,1788,1664,134,36729,436932,634788,2624,2882,2872,4278,4536,39.11521443121589,11.17604416185178,258,1,30954,4340,1530,0,2614,1218
11836,0,1,1,0,66,0,3100,0,0,5331461,14322617,65.81033353509159,4097,5796,5562,4331,51759,704391,803601,3073,7638,3541,4538,9103,35.08560958569767,15.656385866328812,4565,1,1052433,22464,1231,0,1024,2076
11837,0,1,1,0,64,0,4231,0,0,7409916,18012994,74.58552138317464,5161,7297,6895,5563,55460,764168,760930,2836,8801,3640,4570,10535,36.49657518178932,20.069295279733563,5965,0,1307305,53466,1332,1,2325,1906
11838,0,1,1,0,58,0,1287,0,0,1112368,1735744,24.331050121192877,592,2471,2471,592,49533,612788,694884,2932,3524,2932,4811,5403,43.347433603386484,0.0,592,1,140304,0,1879,0,2340,1053
11839,0,1,1,0,58,0,1311,0,0,935712,1491804,22.64950330581225,513,2337,2337,513,46512,593232,663024,2908,3421,2908,4732,5245,42.708313008125245,0.0,513,1,116964,0,1824,0,2395,1084
11840,0,1,1,0,63,0,1615,0,0,3605976,9080973,53.58171329847526,2624,4374,4127,2871,46440,680045,683208,2916,6034,3410,4419,7537,35.4400902933387,15.762973270088374,3118,1,620136,32851,1256,0,292,1907
11841,0,1,1,0,63,0,1515,0,0,3667734,8890452,53.075418038862395,2577,4359,4119,2817,48178,688008,697476,2916,5973,3396,4458,7515,36.08323710533743,15.518759343963225,3057,0,622557,31440,1302,1,339,1854
11842,0,1,1,0,63,0,889,0,0,4248192,8059821,50.52722038663912,2283,4487,4217,2553,47286,672441,700854,2887,5710,3427,4821,7644,40.792156108742276,16.6117754205124,2823,1,566766,33480,1664,0,604,1493
11843,0,1,1,0,55,0,1565,0,0,376724,585756,14.560219778561036,20,2181,1989,212,39600,455895,663120,2571,2975,2955,4540,4944,42.15447781671598,14.8754195086894,404,1,50880,6144,1777,0,2551,986
11844,0,1,1,0,58,0,1429,0,0,1093512,1608528,23.49468024894146,340,2745,2533,552,49742,609026,693532,2702,3466,3126,4895,5659,44.50842616853577,14.610577240468603,764,1,131376,20564,1981,0,2362,933
11845,0,1,1,0,56,0,1551,0,0,506356,775600,16.64331697709324,19,2363,2105,277,43259,506800,669200,2542,3077,3058,4628,5163,42.7551166528639,17.10521698680489,535,1,66203,14706,1828,0,2523,972
11846,0,1,1,0,54,0,1624,0,0,266100,406950,12.24744871391589,30,2044,1924,150,42282,472062,659259,2593,2863,2833,4487,4757,42.118879377305376,11.641833359781362,270,1,36450,4800,1774,0,2563,939
11847,0,1,1,0,63,0,1751,0,0,4058112,9815040,55.42562584220407,2832,4633,4393,3072,48300,734850,670950,2955,6267,3435,4516,7828,36.345563690772494,15.513673112502369,3312,1,645120,37920,1321,0,123,1874
11848,0,1,1,0,61,0,3280,0,0,6448929,14441311,68.28616258071617,4596,6113,6046,4663,42120,724698,557460,3030,7760,3164,4480,9210,37.1887079635741,8.2732738280919,4730,0,839340,12998,1383,1,1566,1714
11849,0,1,1,0,60,0,1224,0,0,3713940,4280760,37.54996671103717,1091,4363,4044,1410,51067,695244,677028,2717,4446,3355,5670,7399,51.32250968142536,17.863378675720252,1729,1,314430,45298,2634,0,1626,402
11850,0,1,1,0,63,0,3172,0,0,5761733,14129858,66.80568838055633,4154,6063,5754,4463,42224,734512,576212,2857,7629,3475,4457,9229,35.93048844644336,17.939900288779864,4772,0,812266,58710,1291,1,1297,1875
11851,0,1,1,0,53,0,1763,0,0,202068,290736,10.392304845413264,18,2069,1979,108,46116,508788,656848,2602,2800,2782,4563,4761,43.255057507764334,10.099504938362077,198,1,26352,5400,1871,0,2584,821
11852,0,1,0,1,64,0,4979,0,0,3059196,17967936,74.3774159271482,5424,6193,6085,5532,49560,766528,682080,3140,8780,3356,3801,9441,23.515952032609693,10.393195703494003,5640,1,1161720,17820,553,0,2284,2695
11853,0,1,1,0,60,0,1272,0,0,3163825,3786566,35.397740040855716,1129,3902,3778,1253,51983,685994,692038,2898,4275,3146,5547,6924,50.24937810560445,11.150165195519998,1377,1,286937,16368,2525,0,1769,497
11854,0,1,1,0,61,0,1087,0,0,4577664,5081856,40.792156108742276,1313,4766,4415,1664,50167,693258,674934,2703,4718,3405,5805,7820,52.44997616777342,18.73959237475018,2015,1,367744,49842,2751,0,1390,303
11855,0,1,1,0,62,0,2433,0,0,4767628,11675672,60.959002616512684,3674,5041,4999,3716,42780,722660,584412,3100,6858,3184,4425,8183,35.81898937714463,6.48074069840786,3758,0,691176,7728,1283,1,574,1859
11856,0,1,1,0,56,0,1745,0,0,667964,905692,17.97220075561143,113,2601,2391,323,38157,451444,664548,2594,3127,3014,4872,5405,45.47526800360829,15.457933012562789,533,1,76551,6300,2068,0,2481,736
11857,0,1,1,0,61,0,1082,0,0,4892048,5334728,41.66533331199932,1526,4764,4554,1736,45675,623819,691425,2863,4809,3283,5891,7837,53.08483775994799,14.527470118487207,1946,1,390600,22470,2818,0,1337,255
11858,0,1,1,0,63,0,4496,0,0,5515497,17569305,74.15524256584965,5499,6502,6502,5499,51863,763605,693315,3195,8694,3195,4198,9697,31.670175244226233,0.0,5499,0,1193283,0,1003,0,2304,2192
11859,0,1,1,0,63,0,3516,0,0,5389180,14794560,68.33739825307956,4469,6025,5824,4670,41760,734976,570240,2967,7838,3369,4322,9193,33.97057550292606,14.231962604003044,4871,0,840600,38592,1154,1,1502,2014
11860,0,1,1,0,58,0,1786,0,0,1264647,1581216,23.302360395462088,543,2872,2872,543,45144,576576,663936,2912,3455,2912,5241,5784,48.25971404805462,0.0,543,1,123804,0,2329,0,2369,583
11861,0,1,1,0,65,0,5159,0,0,2897370,18659970,75.2994023880668,5400,6451,6181,5670,48952,763512,694401,3021,8961,3561,3802,9742,22.60530911091463,16.469637613853525,5940,0,1196370,42930,511,1,2379,2780
11862,0,1,1,0,54,0,2174,0,0,348600,408600,12.24744871391589,26,2598,2474,150,47250,514836,681000,2600,2874,2848,5048,5322,48.2078831727758,12.059737629881619,274,1,37500,6200,2324,0,2574,400
11863,0,1,1,0,65,0,6012,0,0,2046205,20620425,79.59271323431561,6245,6748,6658,6335,53586,761670,745395,3165,9590,3345,3578,10003,17.97220075561143,9.489467114586667,6425,0,1450715,12510,323,1,3080,2932
11864,0,1,0,1,65,0,5101,0,0,1126356,17400075,72.89032857656768,5271,5567,5525,5313,51754,740150,749975,3233,8588,3317,3487,8842,14.560219778561036,6.481658975540136,5355,1,1216677,5460,212,0,2038,3063
11865,0,1,1,0,59,0,1927,0,0,1905840,2149920,26.832815729997478,625,3462,3367,720,40809,665878,546438,2891,3706,3081,5633,6448,51.44900387762624,9.85304212894363,815,1,131760,17005,2647,0,2266,339
11866,0,1,1,0,54,0,2410,0,0,303600,325200,10.954451150103322,0,2770,2650,120,44856,482380,682920,2590,2830,2830,5240,5480,50.299105359837164,11.702672623215602,240,1,30240,3480,2530,0,2590,180
11867,0,1,1,0,57,0,2253,0,0,940680,1032120,18.973665961010276,118,3215,2973,360,45431,518927,719617,2625,3227,3109,5480,6082,51.11751167652823,16.266520760650316,602,1,90360,8712,2613,0,2507,254
11868,0,1,1,0,63,0,65,0,0,6529524,8071077,50.22947341949744,2396,5238,5111,2523,51067,732571,713377,3072,5722,3326,5787,8437,50.872389367907616,11.308525934296243,2650,0,562629,18034,2588,1,676,611
11869,0,1,1,0,54,0,2469,0,0,310680,324840,10.954451150103322,12,2817,2709,120,41664,454776,671336,2599,2827,2815,5296,5524,50.882216932834204,11.07198010139901,228,1,29760,2376,2589,0,2587,118
11870,0,1,1,0,64,0,4319,0,0,3051066,15916888,70.26378868236469,4803,5689,5555,4937,47916,780208,638352,3090,8161,3358,3842,8913,24.859605789312106,11.633585509503979,5071,0,977526,24656,618,1,1713,2606
11871,0,1,1,0,64,0,4133,0,0,3223484,15574568,69.31089380465383,4527,5752,5475,4804,51728,791048,687304,2965,8046,3519,3913,8994,25.903667693977237,16.68566947568206,5081,0,1018448,47090,671,1,1562,2571
11872,0,1,1,0,55,0,2362,0,0,484880,525160,13.784048752090222,70,2862,2742,190,45540,497520,699292,2644,2954,2884,5316,5626,50.51732376126036,11.621977114038057,310,1,48070,3480,2552,0,2574,212
11873,0,0,1,0,51,1,799,0,0,1066956,1834428,26.60826939130014,678,2245,2215,708,56165,619249,608885,2561,3299,2621,4098,4836,38.82009788756334,5.490867587491313,738,0,166380,4020,1507,0,1883,1084
11874,0,1,1,0,63,0,184,0,0,6658260,7965510,49.8998997994986,2395,5259,5164,2490,52640,751765,716576,3104,5689,3294,5873,8458,51.710733895391584,9.80698324197389,2585,0,557760,13870,2674,1,709,525
11875,0,1,1,0,58,0,2044,0,0,1305605,1500296,22.60530911091463,391,3186,3066,511,53136,634176,722256,2816,3447,3056,5491,6122,50.547007824400445,10.966602528904897,631,1,125706,11160,2555,0,2425,381
11876,0,1,1,0,54,0,2396,0,0,312480,337528,11.135528725660043,57,2711,2644,124,45287,487238,688666,2655,2846,2789,5242,5433,50.19960159204453,8.361900766312248,191,1,31372,1742,2520,0,2598,202
11877,0,1,1,0,64,0,4457,0,0,2462138,15996466,70.3846574190711,4846,5559,5451,4954,51906,794334,681319,3121,8183,3337,3726,8788,22.293496809607955,10.44206354473662,5062,0,1045294,18576,497,1,1725,2732
11878,0,1,1,0,64,0,3883,0,0,3378180,14878760,67.93379129711516,4399,5563,5347,4615,53058,770536,715728,3008,7839,3440,3956,8787,27.055498516937366,14.698906851197428,4831,1,1024530,33048,732,0,1391,2492
11879,0,0,1,0,53,1,554,0,0,2359992,3441120,35.832945734337834,1199,3207,3122,1284,41410,541360,549400,2595,3964,2765,4518,5887,42.871902220452036,9.227509513928014,1369,1,263220,11050,1838,0,1396,842
11880,0,1,1,0,54,0,2187,0,0,358020,420138,12.36931687685298,68,2578,2493,153,37352,442106,637072,2661,2899,2831,5086,5324,48.373546489791295,9.332611979058527,238,1,35496,3145,2340,0,2593,406
11881,0,1,1,0,56,0,2066,0,0,571311,693082,15.716233645501712,157,2650,2560,247,35183,423706,653798,2716,3053,2896,5119,5456,48.093658625644196,9.883997062654284,337,1,57551,1890,2313,0,2559,493
11882,0,1,0,1,65,0,5836,0,0,1821501,20042644,78.31347265956222,6073,6490,6430,6133,47824,797392,640528,3208,9401,3328,3565,9758,17.233687939614086,7.780166052320878,6193,1,1202068,11220,297,0,2865,2971
11883,0,0,1,0,54,1,564,0,0,2913376,3953040,38.05259518088089,1363,3545,3460,1448,37944,556920,507780,2645,4178,2815,4742,6275,44.85532298401161,9.2729914971827,1533,1,269328,13005,2012,0,1282,718
11884,0,1,0,1,64,0,3865,0,0,3359676,14868060,67.79380502671317,4488,5435,5327,4596,47560,750520,663175,3127,7831,3343,3966,8670,27.03701166919155,10.397868954212262,4704,1,942180,17820,731,0,1361,2504
11885,0,1,1,0,64,0,473,0,0,6974520,7788375,49.14264950122246,2330,5388,5303,2415,52425,725625,751425,3140,5640,3310,6113,8613,53.74011537017761,9.257905235465769,2500,1,562695,10625,2888,0,810,337
11886,0,1,1,0,65,0,5848,0,0,2175849,20438103,78.7337284776988,5998,6751,6550,6199,52102,787983,718746,3096,9496,3498,3648,10048,18.734993995195193,14.227711161464027,6400,0,1351382,31557,351,1,2902,2946
11887,0,1,1,0,65,0,1086,0,0,6732952,10476320,56.515484603779164,2893,5603,5302,3194,56386,793760,764240,2979,6474,3581,5388,8883,45.91296113299599,17.49757092286831,3495,1,744202,40936,2108,0,86,1172
11888,0,1,1,0,64,0,587,0,0,6949614,7588903,48.569537778323564,2317,5347,5305,2359,53815,736693,755995,3175,5576,3259,6163,8564,54.27706698044764,6.5252844928085345,2401,1,554365,5250,2946,0,858,271
11889,0,1,1,0,64,0,821,0,0,5969496,6628869,45.46427168667722,1827,5195,4955,2067,52891,727989,747231,2967,5274,3447,6095,8402,53.74011537017761,15.491933384829668,2307,1,481611,30000,2888,0,1140,319
11890,0,1,1,0,55,0,1948,0,0,387660,503594,13.490737563232042,2,2492,2312,182,41236,467623,675148,2587,2949,2947,4897,5259,46.151923036857305,14.50622318509218,362,1,44408,5400,2130,0,2585,637
11891,0,1,1,0,64,0,785,0,0,6063486,6750513,45.83666654546336,1889,5199,4987,2101,54756,751842,751842,3001,5314,3425,6099,8412,53.72150407425317,14.563134575526412,2313,1,491634,27984,2886,0,1112,327
11892,0,1,1,0,58,0,1719,0,0,835030,1147080,19.87460691435179,125,2779,2509,395,44750,519816,726000,2634,3299,3174,5018,5683,45.9782557302906,16.43257825187635,665,1,98750,9450,2114,0,2509,790
11893,0,1,0,1,64,0,3074,0,0,4665432,13606812,64.71475874945375,3978,5512,5302,4188,46740,740772,666045,3039,7437,3459,4363,8761,33.37663853655727,14.527470118487207,4398,1,858540,34020,1114,0,939,2135
11894,0,1,1,0,65,0,1162,0,0,6700848,10546074,56.868268832451726,3016,5524,5306,3234,56619,792423,759813,3043,6495,3479,5333,8785,45.51922670696417,14.870024067276628,3452,1,753522,29648,2072,0,27,1189
11895,0,1,1,0,64,0,385,0,0,7009314,9235668,53.3572862878164,2667,5489,5309,2847,55822,801268,733144,3064,6091,3424,5706,8733,49.61854492022111,13.485847547000814,3027,1,643422,27000,2462,0,397,782
11896,0,1,1,0,57,0,1710,0,0,772051,1071077,19.261360284258224,71,2752,2452,371,43225,505225,713089,2587,3258,3187,4968,5639,45.617978911828175,17.32743212587264,671,1,91637,10500,2081,0,2516,806
11897,0,1,1,0,58,0,1646,0,0,838032,1184832,20.199009876724155,78,2792,2462,408,45136,528528,720192,2574,3312,3234,4958,5696,45.32107677449864,18.166569338591717,738,1,101184,14190,2054,0,2496,850
11898,0,1,1,0,56,0,1749,0,0,602980,836030,17.175564037317667,10,2624,2339,295,39674,470444,677326,2549,3129,3119,4878,5458,45.21061822182926,18.302026586942322,580,1,70505,9975,2044,0,2539,790
11899,0,1,1,0,65,0,5120,0,0,3801924,19015398,76.01315675591957,5670,6544,6436,5778,53336,776676,743766,3183,9069,3399,3949,9835,25.65151067676132,10.508183387917892,5886,0,1305828,15660,658,1,2487,2633
11900,0,1,1,0,64,0,276,0,0,7045920,9025488,52.87721626560914,2676,5436,5316,2796,55552,800544,723072,3108,6024,3348,5748,8664,50.19960159204453,11.002816348706927,2916,1,626304,18240,2520,0,432,708
11901,0,1,1,0,55,0,1776,0,0,470340,653094,15.297058540778355,18,2460,2244,234,39746,466097,664258,2575,3025,3007,4801,5251,44.83302354291979,16.07779984738014,450,1,55692,8208,2010,0,2557,781
11902,0,1,1,0,55,0,1798,0,0,426120,588088,14.560219778561036,20,2414,2222,212,39105,457710,657438,2582,2986,2966,4784,5188,44.83302354291979,15.047110924338881,404,1,50244,7104,2010,0,2562,764
11903,0,1,0,1,66,0,2490,0,0,5499000,12905100,62.44997998398398,3510,5700,5310,3900,47925,744525,704817,2919,7209,3699,4719,9009,37.54996671103717,19.958024287770556,4290,1,830700,58110,1410,0,591,1899
11904,0,1,1,0,64,0,43,0,0,7083120,8674139,51.79768334587948,2575,5431,5323,2683,51957,811483,669231,3125,5916,3341,5873,8664,51.38093031466052,10.640744280253392,2791,1,555381,19332,2640,0,550,593
11905,0,1,1,0,57,0,1612,0,0,747488,1080248,19.390719429665317,14,2726,2364,376,47250,542997,718250,2511,3249,3235,4861,5599,44.58699361921591,20.5190948348977,738,1,94000,17738,1988,0,2497,885
11906,0,0,1,0,54,1,887,0,0,2465100,3259872,34.46737587922817,1068,3383,3263,1188,41736,609168,515872,2624,3932,2864,4819,6127,45.552167895721496,11.15593165433301,1308,1,223344,20760,2075,0,1556,669
11907,0,1,1,0,63,0,426,0,0,7067520,7835622,49.53786430600334,2424,5364,5334,2454,55278,708846,795057,3163,5647,3223,6073,8557,53.665631459994955,5.830951894845301,2484,1,611046,2760,2880,0,739,313
11908,0,1,1,0,56,0,1654,0,0,579447,835164,17.233687939614086,20,2525,2248,297,46624,528656,697376,2535,3109,3089,4763,5337,44.170125650715555,17.857586598316747,574,1,73656,14681,1951,0,2515,861
11909,0,1,1,0,61,0,935,0,0,2845694,3936244,35.81898937714463,1093,3691,3501,1283,51504,681096,711776,2878,4351,3258,5286,6759,47.095647357266465,13.858285473715528,1473,1,297656,23180,2218,0,1785,850
11910,0,1,1,0,58,0,1455,0,0,938476,1411828,22.0,60,2847,2423,484,45942,542562,720499,2493,3401,3341,4856,5764,44.034077712607996,20.76768840072744,908,1,119548,21624,1939,0,2433,978
11911,0,1,0,1,66,0,4783,0,0,2241590,17343651,72.20110802473879,4822,6034,5643,5213,31659,575571,608841,2936,8540,3718,3757,9361,20.73644135332772,19.934743816433652,5604,1,953979,45356,430,0,1886,2897
11912,0,1,0,1,64,0,712,0,0,6991488,9728208,54.99090833947008,3024,5336,5336,3024,50127,743127,698089,3217,6241,3217,5529,8553,48.08326112068523,0.0,3024,1,656208,0,2312,0,193,905
11913,0,1,1,0,56,0,1531,0,0,683012,1019825,19.0,22,2592,2253,361,47808,542400,703425,2486,3186,3164,4717,5417,43.497126341863094,19.405823341421346,700,1,89889,18984,1892,0,2464,933
11914,0,1,0,1,64,0,1133,0,0,6805308,10439336,56.88585061331157,3206,5369,5339,3236,52864,761336,722624,3196,6462,3256,5329,8595,45.858477951192405,5.483301264452448,3266,1,724864,4410,2103,0,10,1123
11915,0,1,1,0,64,0,420,0,0,7100829,9225600,53.693575034635195,2883,5346,5346,2883,54948,729600,771200,3200,6083,3200,5663,8546,49.628620774710235,0.0,2883,1,694803,0,2463,0,317,737
11916,0,1,1,0,63,0,408,0,0,7130068,7857424,49.73932046178355,2407,5423,5356,2474,55860,724128,778120,3109,5650,3243,6058,8599,53.68426212587819,8.616819548034314,2541,1,606130,7169,2882,0,702,294
11917,0,1,0,1,66,0,5405,0,0,4009626,20029932,77.88452991448301,5946,6847,6727,6066,53586,772668,756158,3182,9368,3422,3963,10149,25.709920264364882,11.275536377596524,6186,1,1389114,16680,661,0,2764,2641
11918,0,1,0,1,66,0,2146,0,0,5977571,12363129,61.180062111769715,3335,5748,5340,3743,50996,690327,805932,2895,7046,3711,4900,9051,39.96248240537617,20.341913054676336,4151,1,913292,35904,1597,0,440,1706
11919,0,1,0,1,64,0,1437,0,0,6647410,10969245,58.26662852782886,3328,5420,5353,3395,52170,759285,717282,3164,6626,3298,5189,8651,44.24929377967517,8.187175587434018,3462,1,753690,10050,1958,0,164,1273
11920,0,1,1,0,62,0,555,0,0,5164804,6303596,44.85532298401161,1982,4609,4579,2012,54056,726856,729989,3103,5145,3163,5700,7742,50.665570163573605,5.490867587491313,2042,1,468796,3930,2567,0,1121,566
11921,0,1,1,0,54,0,1653,0,0,276318,416007,12.36931687685298,3,2109,1959,153,48755,541081,666155,2569,2872,2869,4525,4828,42.49705872175156,12.801484421932168,303,1,37485,10950,1806,0,2566,913
11922,0,1,1,0,63,0,39,0,0,7227652,8476744,51.66236541235796,2602,5444,5377,2669,56364,774944,733656,3109,5845,3243,5884,8620,52.03844732503075,8.222029866439447,2736,1,616539,9380,2708,0,507,468
11923,0,1,1,0,55,0,1435,0,0,592950,935655,18.303005217723125,5,2435,2105,335,47310,530670,695457,2463,3128,3123,4563,5228,42.07136793592526,19.028366212642688,665,1,83415,17490,1770,0,2458,1023
11924,0,1,1,0,62,0,433,0,0,5821634,6922428,46.968074263269514,2176,4875,4845,2206,51600,753120,674670,3108,5344,3168,5777,8013,51.37119815616529,5.477225575051661,2236,0,474290,4890,2639,1,932,499
11925,0,1,1,0,62,0,467,0,0,5205620,6466340,45.387222871640866,2000,4647,4587,2060,50561,731387,681163,3079,5199,3199,5666,7786,50.269274910227224,7.746504550744806,2120,1,447020,9180,2527,0,1079,612
11926,0,1,1,0,57,0,1224,0,0,850905,1415700,22.24859546128699,11,2698,2214,495,47177,546260,706420,2376,3355,3344,4579,5558,41.46082488325576,22.943575064115898,979,1,122265,28556,1719,0,2365,1141
11927,0,0,1,0,56,1,827,0,0,4304358,4838786,41.255302689472536,1635,4298,4231,1702,38448,614088,506054,2776,4545,2910,5372,7141,50.28916384272063,8.185808589931957,1769,1,302956,11859,2529,0,1141,314
11928,0,1,0,1,66,0,2112,0,0,6035140,12327650,61.07372593840988,3340,5738,5348,3730,51408,713880,786590,2915,7035,3695,4923,9043,40.22437072223753,19.91005125914351,4120,1,887740,41730,1618,0,425,1687
11929,0,1,1,0,62,0,454,0,0,4943696,6303112,44.81071300481616,1918,4560,4470,2008,49940,712553,690580,3049,5147,3229,5601,7699,49.61854492022111,9.48712577043745,2098,1,441760,12870,2462,0,1131,677
11930,0,1,1,0,56,0,1291,0,0,655590,1096290,19.748417658131498,19,2442,2071,390,46754,545334,677451,2440,3201,3182,4492,5253,41.0,20.051860438197924,761,1,93990,27454,1681,0,2421,1130
11931,0,1,0,1,66,0,2262,0,0,5679883,12531925,61.39218191268331,3259,5786,5276,3769,53312,791350,744800,2815,7094,3835,4832,9111,38.82009788756334,22.760821961945823,4279,1,844256,76500,1507,0,444,1818
11932,0,1,1,0,57,0,1176,0,0,797017,1370850,21.93171219946131,15,2604,2138,481,47671,550050,703950,2384,3331,3316,4507,5454,40.70626487409524,22.572144722358047,947,1,118807,28892,1657,0,2369,1193
11933,0,1,1,0,54,0,1500,0,0,218956,364078,11.575836902790225,10,1892,1768,134,42781,486343,649363,2593,2851,2841,4351,4609,40.422765862815474,12.125477655183026,258,1,32026,6820,1634,0,2583,1083
11934,0,1,0,1,66,0,4415,0,0,5115704,17913016,73.2666363360568,5098,6591,6321,5368,46134,777521,660726,3067,8705,3607,4290,9928,30.870698080866262,16.69362850474855,5638,1,1062864,46980,953,0,2031,2384
11935,0,1,1,0,64,0,270,0,0,7374736,9167048,53.422841556772326,2854,5438,5438,2854,47730,690580,713064,3212,6066,3212,5796,8650,50.83306010855534,0.0,2854,1,633588,0,2584,0,358,628
11936,0,0,0,0,56,1,913,1,0,2217414,3098214,33.18132004607411,693,3523,3115,1101,36675,458682,633150,2406,3915,3222,4828,6337,44.87761134463375,20.274424975986076,1509,1,247725,20808,2014,0,1713,800
11937,0,0,1,0,57,1,963,0,0,3960414,4488156,39.57271787481876,1458,4203,4095,1566,33400,573200,478622,2758,4432,2974,5395,7069,50.28916384272063,10.655033166942168,1674,1,261522,18144,2529,0,1300,337
11938,0,0,1,0,58,1,1668,0,0,2262844,2590664,29.765752132274432,70,4256,3440,886,28182,675444,356728,2108,3810,3740,5478,7180,50.53711507397311,31.342897421764217,1702,1,108092,194208,2554,0,2038,370
11939,0,1,1,0,64,0,683,0,0,7371810,9981954,55.47972602672079,2886,5665,5473,3078,53088,726432,768591,3051,6321,3435,5638,8908,48.938737212968626,13.957625053734988,3270,1,729486,22656,2395,0,165,848
11940,0,0,0,0,51,1,529,1,0,1050462,2041374,28.178005607210743,578,2333,2117,794,51480,601614,565620,2355,3365,2787,3894,4904,36.373066958946424,15.0,1010,1,174680,32400,1323,0,1777,1248
11941,0,0,0,0,51,1,507,1,0,1045600,2056000,28.284271247461902,608,2299,2107,800,49050,578250,560260,2378,3370,2762,3877,4869,36.15245496505044,14.094608812369348,992,1,174400,27456,1307,0,1770,1263
11942,0,0,0,0,51,1,460,1,0,1041216,2096304,28.5657137141714,666,2242,2092,816,44200,567749,513800,2419,3385,2719,3845,4811,35.7211421989835,12.470060607585795,966,1,163200,24000,1276,0,1753,1293
11943,0,0,0,0,51,1,605,0,1,1148376,2071294,28.478061731796284,476,2562,2227,811,48514,648716,487814,2219,3365,2889,3970,5116,37.62977544445356,18.52816444970838,1146,1,154901,64990,1416,0,1743,1138
11944,0,1,1,0,55,0,1205,0,0,306936,594000,14.696938456699069,126,1727,1637,216,44954,500500,679250,2660,2966,2840,4171,4477,37.69615364994153,9.924141172814958,306,1,53352,4140,1421,0,2534,1329
11945,0,0,1,0,48,1,1001,0,0,1070850,1580964,25.475478405713993,649,2299,2299,649,44128,545664,479892,2436,3085,2436,4086,4735,40.620192023179804,0.0,649,1,127853,0,1650,0,1787,786
11946,0,1,1,0,56,0,1001,0,0,472850,983850,18.708286933869708,149,1902,1701,350,49200,576255,674640,2610,3161,3012,4162,4713,36.75595189897821,14.623465348308441,551,1,84000,17889,1351,0,2461,1460
11947,0,1,1,0,66,0,1715,0,0,5836226,11432982,58.489315263559035,3060,5488,5127,3421,48906,661716,825474,2981,6763,3703,5048,8830,41.30375285612676,19.097798943771966,3782,1,844987,24187,1706,0,79,1636
11948,0,1,1,0,56,0,932,0,0,466773,1011522,19.0,208,1807,1654,361,49200,560400,689292,2649,3163,2955,4095,4609,35.958309192730404,12.737731642481698,514,1,88806,11016,1293,0,2441,1509
11949,0,0,1,0,49,1,603,0,0,680860,1428075,24.020824298928627,292,2042,1757,577,31200,514800,371250,2190,3052,2760,3655,4517,34.351128074635334,17.360256321981996,862,1,86550,55290,1180,0,1898,1295
11950,0,1,1,0,57,0,669,0,0,768892,1744956,24.576411454889016,242,2239,1877,604,54064,629802,716472,2527,3493,3251,4162,5128,35.679125549822544,19.51273007336971,966,1,149792,32942,1273,0,2285,1616
11951,0,1,1,0,57,0,692,0,0,732213,1661183,24.020824298928627,242,2181,1846,577,53250,613227,719750,2544,3456,3214,4148,5060,35.62302626111375,18.761095184901134,912,1,144250,27135,1269,0,2302,1610
11952,0,0,1,0,48,1,413,0,0,346110,1018731,20.42057785666214,417,1247,1247,417,50370,535017,561890,2443,2860,2443,3273,3690,28.809720581775867,0.0,417,0,95910,0,830,0,2026,1613
11953,1,0,0,0,41,0,88,0,1,79860,678810,18.16590212458495,60,842,572,330,36300,497794,308550,1787,2387,2327,2299,2899,15.556349186104045,16.64413033141471,600,1,49500,61020,242,0,1727,1815
11954,0,0,1,0,51,1,890,0,0,1562904,2252628,29.698484809834994,748,2788,2654,882,32264,556772,377992,2420,3436,2688,4326,5342,42.09513035969837,11.9305333824295,1016,1,130536,27738,1772,0,1672,782
11955,0,1,0,1,66,0,652,0,0,7070765,9925515,54.817880294662984,2897,5466,5358,3005,51246,723357,772902,3195,6308,3411,5656,8769,48.507731342539614,10.480278705357403,3113,1,703170,12420,2353,0,298,950
11956,0,1,1,0,56,0,645,0,0,671274,1589742,23.62202362203543,302,2017,1761,558,54780,626780,709401,2593,3407,3105,4052,4866,34.68429039204925,16.359068810614975,814,1,138942,23296,1203,0,2291,1646
11957,0,0,1,0,59,1,823,0,0,3713538,4613081,39.48417404479927,1108,4392,3941,1559,52756,716078,645062,2508,4518,3410,5341,7351,48.80573736764972,21.556874244631672,2010,1,339862,72611,2382,0,1400,577
11958,0,0,1,0,51,1,838,0,0,1582715,2318292,30.116440692751194,783,2776,2652,907,37730,626220,393624,2432,3463,2680,4301,5332,41.773197148410844,11.388237031910945,1031,1,139678,27776,1745,0,1649,811
11959,0,1,1,0,61,0,25,0,0,4241384,6394192,45.51922670696417,2030,4161,4119,2072,50140,672748,709780,3044,5158,3128,5133,7247,45.24378410345447,6.488991180673202,2114,1,476560,5082,2047,0,1014,1039
11960,0,0,1,0,51,1,471,0,0,202096,1896136,27.258026340878022,593,1165,1015,743,25893,482328,349624,2402,3295,2702,2824,3717,16.492422502470642,12.81730439318685,893,1,101791,27450,272,0,1809,2280
11961,0,0,1,0,51,1,781,0,0,1736760,2549544,31.368774282716245,794,2939,2749,984,38844,606294,430106,2401,3575,2781,4356,5530,42.01190307520001,14.266784873633224,1174,1,163344,39520,1765,0,1607,826
11962,0,1,1,0,54,0,1106,0,0,147120,324720,10.954451150103322,25,1441,1346,120,41382,462726,654852,2611,2826,2801,3932,4147,35.014282800023196,10.453462715764566,215,1,29040,3420,1226,0,2586,1480
11963,1,0,0,0,41,0,114,0,1,71280,446472,14.696938456699069,82,680,546,216,40508,510549,338988,1933,2283,2201,2397,2747,18.16590212458495,12.372354058352016,350,1,35424,29212,330,0,1851,1737
11964,1,0,0,0,42,0,321,0,1,170932,1269608,24.576411454889016,94,1397,887,604,44856,374156,529704,1592,2706,2612,2385,3499,16.822603841260722,23.002876093999088,1114,1,152208,0,283,0,1498,1819
11965,0,1,1,0,54,0,997,0,0,211860,492840,13.416407864998739,30,1507,1357,180,50715,566766,670810,2588,2918,2888,3915,4245,34.307433596816885,13.1493192969221,330,1,44100,12600,1177,0,2558,1561
11966,0,1,0,1,66,0,883,0,0,6510588,10053827,55.054518434003214,3001,5209,5179,3031,44460,756276,646815,3287,6348,3347,5465,8526,46.34652090502587,5.531194905403055,3061,1,591045,5160,2148,0,286,1169
11967,0,1,1,0,62,0,110,0,0,6097875,7938600,50.24937810560445,2495,4970,4940,2525,45780,685392,660240,3114,5669,3174,5559,8114,49.14264950122246,5.477225575051661,2555,0,530250,4320,2415,1,619,729
11968,0,0,0,0,52,1,416,1,0,691185,2800950,32.63433774416144,885,1894,1714,1065,43092,449730,662760,2450,3695,2810,3279,4524,25.475478405713993,13.78605292037375,1245,1,268380,3060,649,0,1565,1981
11969,0,0,0,0,51,1,444,1,0,587520,2620380,31.937438845342623,900,1716,1596,1020,48070,488110,649957,2449,3589,2689,3145,4285,24.0,11.167976299283184,1140,1,258060,5400,576,0,1549,1993
11970,0,0,1,0,51,1,478,0,0,314979,2184477,29.13760456866693,699,1370,1220,849,25671,512027,331917,2423,3422,2723,2944,3943,19.261360284258224,12.932914451756053,999,1,109521,30450,371,0,1724,2202
11971,0,0,1,0,48,1,445,0,0,1779750,2767370,33.61547262794322,1100,2735,2705,1130,47632,560821,509392,2419,3579,2479,4024,5184,39.68626966596886,5.514871952411144,1160,0,235040,4770,1575,0,1319,874
11972,1,0,0,0,41,0,407,1,0,92178,338256,12.727922061357855,38,855,731,162,43524,388368,488592,1964,2250,2212,2657,2943,23.853720883753127,11.230094695077256,286,1,37908,8928,569,0,1926,1519
11973,0,1,1,0,54,0,1022,0,0,137040,324720,10.954451150103322,25,1357,1262,120,45250,489786,676500,2611,2826,2801,3848,4063,33.793490497431605,10.453462715764566,215,1,30000,3610,1142,0,2586,1564
11974,0,0,1,0,60,1,784,0,0,5957120,6287840,45.60701700396552,1527,5497,4944,2080,50600,695290,665060,2470,5103,3576,5887,8520,53.51635264103861,24.115501069577252,2633,1,457600,80738,2864,0,943,159
11975,0,0,0,0,50,1,468,1,0,563040,2592840,31.937438845342623,960,1632,1572,1020,46930,482980,627874,2482,3562,2602,3094,4174,23.49468024894146,7.952707287670506,1080,1,251940,3420,552,0,1522,1990
11976,0,0,1,0,51,1,582,0,0,1670944,2636700,32.155870381627054,944,2740,2650,1034,30530,548250,362100,2460,3584,2640,4166,5290,40.19950248448356,9.773414525644373,1124,1,146828,18900,1616,0,1516,934
11977,1,0,0,0,41,0,42,0,1,44928,397632,13.856406460551018,107,511,426,192,37448,513608,312721,1986,2263,2156,2305,2582,15.297058540778355,10.285995397119937,277,1,28992,18785,234,0,1879,1837
11978,1,0,0,0,40,0,110,0,1,84000,714700,18.708286933869708,65,875,590,350,32264,302216,445156,1757,2392,2327,2282,2917,15.491933384829668,17.21298994954198,635,1,76300,10545,240,0,1692,1802
11979,0,1,0,1,66,0,767,0,0,6460398,9833866,54.35071296680477,2912,5183,5141,2954,42639,775657,609207,3287,6283,3371,5516,8512,46.76537180435969,6.5135556243263055,2996,1,540582,7980,2187,0,375,1142
11980,0,1,1,0,54,0,925,0,0,161250,408450,12.24744871391589,0,1375,1225,150,46550,517370,667135,2573,2873,2873,3798,4098,32.78719262151,12.882345016608866,300,1,36750,9300,1075,0,2573,1648
11981,0,0,1,0,51,1,480,0,0,1740681,2839479,33.18132004607411,981,2802,2682,1101,30816,551906,371376,2459,3680,2699,4160,5381,39.761790704142086,11.602338718189415,1221,1,158544,24840,1581,0,1478,998
11982,1,0,0,0,40,0,38,0,1,82008,543236,16.3707055437449,40,802,574,268,35724,316212,464183,1799,2295,2255,2333,2829,17.4928556845359,15.42479684557981,496,1,61372,7752,306,0,1759,1721
11983,0,1,0,1,67,0,1558,0,0,5618184,11003914,57.21887800367987,2815,5449,4990,3274,44368,793196,631868,2902,6635,3820,5077,8810,41.42463035441596,21.435487888755123,3733,1,615512,86292,1716,0,87,1645
11984,0,1,1,0,54,0,940,0,0,127200,325200,10.954451150103322,0,1300,1180,120,42657,479670,653110,2590,2830,2830,3770,4010,32.55764119219941,11.58292185288269,240,1,28920,5880,1060,0,2590,1650
11985,0,0,1,0,51,1,510,0,0,584611,2710855,32.57299494980466,994,1679,1612,1061,35840,572320,408800,2488,3616,2622,3106,4234,23.473389188611005,8.499160266369426,1128,1,169760,13534,551,0,1494,2004
11986,1,0,0,0,43,0,244,0,0,116160,518400,15.491933384829668,50,914,724,240,31500,302400,486000,1970,2400,2350,2644,3074,22.0,14.590255326703758,430,1,54000,2850,484,0,1920,1676
11987,1,0,0,0,44,0,320,0,1,191556,1379078,25.019992006393608,152,1406,932,626,35979,394337,442803,1729,2829,2677,2509,3609,17.4928556845359,22.549066971205306,1100,1,125826,49296,306,0,1577,1897
11988,0,0,1,0,58,1,1021,0,0,4745796,5060110,41.557189510360296,1444,4758,4475,1727,51972,714920,624090,2647,4657,3213,5678,7688,52.421369688324624,17.053532484707173,2010,1,367851,47544,2748,0,1203,182
11989,0,0,0,0,50,1,551,1,0,2115980,3037805,34.713109915419565,1138,3028,2961,1205,32279,481511,426049,2454,3726,2588,4277,5549,41.90465367951393,8.19672545160342,1272,1,203645,10318,1756,0,1316,765
11990,0,1,1,0,65,0,95,0,0,7028196,8522892,51.02940328869229,2392,5515,5303,2604,52080,687330,811704,3061,5877,3485,5972,8788,51.95190083144215,14.790851390782576,2816,1,645792,17172,2699,0,669,574
11991,0,1,1,0,55,0,387,0,0,427000,1360544,22.090722034374522,488,1363,1363,488,49950,618936,627300,2788,3276,2788,3663,4151,29.58039891549808,0.0,488,0,109800,0,875,1,2300,1913
11992,0,0,1,0,52,1,271,0,0,1749210,3105594,34.55430508634199,1104,2749,2659,1194,33726,569619,400554,2511,3795,2691,4066,5350,38.27531841800928,10.122963352881786,1284,1,183876,18180,1465,0,1407,1136
11993,0,0,1,0,58,1,1166,0,0,4844840,4990524,41.15823125451335,1375,4873,4554,1694,54720,671688,707040,2627,4640,3265,5806,7819,53.47896782848375,18.089944299917967,2013,1,406560,37323,2860,0,1252,86
11994,0,0,0,0,50,1,513,1,0,2476638,3353028,36.578682316343766,1278,3249,3189,1338,29181,533778,343322,2446,3844,2566,4357,5755,43.02324952859791,8.086478275311649,1398,1,183306,12660,1851,0,1168,655
11995,1,0,0,0,41,0,173,0,0,124650,570897,16.64331697709324,49,955,727,277,46020,401895,486396,1833,2338,2289,2511,3016,21.213203435596427,15.830327909517015,505,1,65372,18696,450,0,1784,1611
11996,0,1,1,0,66,0,110,0,0,6710256,8821764,51.43928459844674,2434,5394,5182,2646,51959,743482,776822,3122,5980,3546,5870,8728,50.35871324805669,14.570009798918585,2858,1,616518,25652,2536,0,688,798
11997,0,1,1,0,55,0,628,0,0,228588,714918,16.06237840420901,2,1400,1144,258,47610,573597,637330,2515,3029,3027,3657,4171,29.765752132274432,17.03975449203616,514,1,59340,26880,886,0,2513,1885
11998,0,0,1,0,60,1,498,0,0,3250399,4736565,39.63584236521283,881,4330,3640,1571,53984,726615,675360,2325,4586,3705,5084,7345,45.48626166217664,26.494435770005282,2261,1,351904,104190,2069,0,1444,946
11999,0,0,1,0,49,1,322,0,0,2553315,3603830,38.01315561749642,1415,3242,3212,1445,52416,558656,583596,2464,3939,2524,4261,5736,42.035699113967404,5.514871952411144,1475,0,338130,3600,1767,0,1049,727
12000,1,0,0,0,40,0,190,0,0,85224,432480,14.560219778561036,50,776,614,212,50635,418200,503880,1878,2252,2202,2442,2816,20.049937655763422,13.491653849526754,374,1,52364,12636,402,0,1828,1638
12001,0,0,1,0,54,1,872,0,0,1594800,2468700,30.0,348,3224,2672,900,17181,567801,227669,2191,3643,3295,4515,5967,42.09513035969837,24.70156250529137,1452,1,74700,135792,1772,0,1843,971
12002,1,0,0,0,44,0,374,0,1,12120,66540,5.477225575051661,270,734,434,30,42504,512358,408112,1918,2248,2518,2622,2952,20.09975124224178,18.26582943959784,330,1,5520,56100,404,0,2188,1814
12003,0,1,1,0,54,0,737,0,0,154190,463250,13.038404810405298,0,1247,1077,170,47280,536825,654000,2555,2895,2895,3632,3972,30.116440692751194,13.64605912284091,340,1,40800,13430,907,0,2555,1818
12004,0,0,1,0,52,1,468,0,0,895869,3147027,34.77067730142742,1114,2045,1950,1209,30464,583072,354008,2508,3812,2698,3344,4648,27.2213151776324,10.232047425710157,1304,1,164424,21185,741,0,1394,1862
12005,0,0,1,0,52,1,58,0,0,1744200,3392792,35.94440151122286,1225,2709,2642,1292,36907,580346,438542,2559,3918,2693,3976,5335,36.742346141747674,8.544404542961196,1359,1,215764,12864,1350,0,1334,1276
12006,1,0,0,0,44,0,137,0,0,58058,403494,13.490737563232042,30,713,501,182,41743,374673,547599,2005,2399,2429,2536,2930,17.86057109949175,16.20553907189115,394,1,44954,5300,319,0,2035,1898
12007,0,1,1,0,55,0,536,0,0,231777,785325,16.822603841260722,6,1379,1102,283,44850,541125,638250,2498,3058,3052,3594,4154,28.61817604250837,17.48041905554699,560,1,65090,24930,819,0,2492,1956
12008,0,0,0,0,56,1,894,1,0,3360960,4066560,37.94733192202055,1440,3774,3774,1440,55200,649520,677760,2824,4264,2824,5158,6598,48.31148931672465,0.0,1440,1,345600,0,2334,0,1384,490
12009,0,0,1,0,51,1,128,0,0,948480,2341104,30.199337741083,882,1982,1952,912,44928,533936,554472,2537,3479,2597,3607,4549,32.2490309931942,5.623413251903491,942,0,196992,3720,1040,0,1655,1527
12010,1,0,0,0,45,0,230,0,1,42000,270000,10.954451150103322,157,747,470,120,50932,481500,535500,1973,2370,2527,2600,2997,18.708286933869708,18.296804569605385,397,1,28560,28808,350,0,2130,1900
12011,0,1,1,0,65,0,175,0,0,6671984,8222621,49.969990994595946,2305,5361,5169,2497,51106,665186,833129,3101,5790,3485,5965,8654,51.69139193328034,14.0855823095486,2689,1,631741,11520,2672,0,796,621
12012,0,1,1,0,55,0,415,0,0,267750,975800,18.708286933869708,94,1371,1115,350,49056,624512,610572,2532,3138,3044,3553,4159,27.65863337187866,16.00219681314721,606,1,76650,36352,765,0,2438,2023
12013,0,0,1,0,52,1,424,0,0,1807377,4136990,39.66106403010388,1573,2722,2722,1573,43672,557560,541780,2630,4203,2630,3779,5352,33.896902513356586,0.0,1573,0,324038,0,1149,0,1057,1481
12014,0,0,1,0,54,1,324,0,0,807325,2949800,32.78719262151,675,2226,1826,1075,32705,578984,425320,2344,3819,3144,3495,4970,27.40437921208944,20.993085885319626,1475,1,166625,77200,751,0,1669,1993
12015,0,1,0,1,67,0,1017,0,0,5904234,10130517,54.69003565550127,2649,5307,4965,2991,50225,829815,694335,3045,6378,3729,5361,8694,44.429719783046124,18.49802299861395,3333,1,613155,61218,1974,0,396,1413
12016,0,1,1,0,55,0,457,0,0,227100,832800,17.320508075688775,15,1342,1057,300,49938,563528,682896,2491,3076,3061,3533,4118,27.51363298439521,17.663975351813487,585,1,73800,22230,757,0,2476,2019
12017,0,0,1,0,55,1,555,0,0,1752250,2977750,32.78719262151,564,3216,2705,1075,37050,684190,415500,2259,3845,3281,4400,5986,40.3732584763727,23.814501809754606,1586,1,161250,114975,1630,0,1695,1140
12018,0,0,1,0,52,1,454,0,0,1138752,3442616,36.30426972134269,1228,2272,2182,1318,32634,579864,383964,2522,3930,2702,3476,4884,29.393876913398138,9.773414525644373,1408,1,193746,19080,864,0,1294,1748
12019,1,0,0,0,41,0,182,0,0,215448,1170300,23.748684174075834,394,1116,946,564,49644,522900,408775,1905,2639,2245,2457,3191,19.544820285692065,13.402306702748659,734,1,111108,29920,382,0,1511,1693
12020,0,1,0,1,67,0,459,0,0,6184836,9189990,52.22068555658763,2727,4995,4995,2727,49693,771730,731290,3370,6097,3370,5638,8365,47.62352359916263,0.0,2727,1,591759,0,2268,0,643,1102
12021,0,1,0,1,65,0,298,0,0,6572423,7922225,49.18333050943175,2269,5286,5136,2419,52164,677925,825300,3125,5694,3425,5992,8561,52.124850119688595,12.30702509692623,2569,1,609588,10500,2717,0,856,558
12022,0,1,1,0,54,0,627,0,0,145260,490140,13.416407864998739,0,1167,987,180,46494,514647,669858,2543,2903,2903,3530,3890,28.407745422683583,14.078868216031408,360,1,44280,10440,807,0,2543,1916
12023,0,0,0,0,54,1,945,1,0,2067426,2821110,32.264531609803356,756,3312,3027,1041,32660,623300,384820,2425,3751,2995,4696,6022,44.56455991031439,17.734315937968685,1326,1,147822,63840,1986,0,1669,724
12024,0,1,0,1,67,0,503,0,0,6144320,9257625,52.373657500693994,2701,5025,4983,2743,49932,769500,739125,3333,6118,3417,5615,8400,47.32863826479693,6.48074069840786,2785,1,600717,6132,2240,0,632,1135
12025,0,1,0,1,67,0,247,0,0,6262278,8862359,51.273774973177076,2521,5119,5011,2629,50055,792185,718023,3263,6000,3479,5753,8490,48.80573736764972,10.403202108104866,2737,1,559977,17280,2382,0,742,989
12026,0,0,1,0,51,1,159,0,0,976752,2783529,32.72613634390714,1041,2013,1983,1071,39330,493810,537993,2569,3670,2629,3511,4612,30.199337741083,5.623413251903491,1101,0,221697,3330,912,0,1528,1687
12027,0,0,0,0,52,1,735,1,0,2397816,3226464,34.9857113690718,1100,3307,3183,1224,29488,511384,400672,2512,3860,2760,4595,5943,44.26059195266146,11.546879086349044,1348,1,186048,21700,1959,0,1412,677
12028,1,0,0,0,40,0,671,0,0,49446,134603,8.18535277187245,37,835,805,67,42336,450016,379701,1979,2076,2039,2747,2844,27.16615541441225,5.531194905403055,97,0,12663,5220,738,0,1942,1271
12029,1,0,0,0,40,0,114,1,0,108307,558432,16.64331697709324,247,698,668,277,36673,340704,437472,1986,2293,2046,2407,2714,19.77371993328519,5.623413251903491,307,1,60109,2100,391,0,1739,1625
12030,1,0,0,0,41,0,119,0,0,148950,935100,21.213203435596427,365,866,781,450,51484,438458,507032,1993,2528,2163,2409,2944,18.193405398660254,10.172010733280942,535,1,109800,5525,331,0,1628,1747
12031,1,0,0,0,41,0,17,0,0,226028,1005268,22.0,350,1085,951,484,42670,521327,353090,1943,2561,2211,2544,3162,21.61018278497431,11.959283984848298,618,1,82280,28676,467,0,1593,1610
12032,0,1,0,1,67,0,505,0,0,6128876,9261839,52.354560450833695,2681,5037,4977,2741,49720,743380,763654,3319,6120,3439,5615,8416,47.286361670147556,7.750803389552748,2801,1,619466,7620,2236,0,638,1143
12033,0,1,0,1,67,0,419,0,0,6163682,9118576,51.97114584074513,2701,4983,4983,2701,49932,769728,739344,3376,6077,3376,5658,8359,47.77028364998475,0.0,2701,1,591519,0,2282,0,675,1094
12034,0,1,0,1,66,0,49,0,0,6357362,8362453,49.969990994595946,2220,5320,5043,2497,54635,746827,820505,3072,5846,3626,5895,8669,50.457903246171455,16.81082874730089,2774,1,611765,28531,2546,0,852,803
12035,0,1,1,0,53,0,740,0,0,74700,240840,9.486832980505138,0,1010,920,90,47817,505764,677028,2586,2766,2766,3506,3686,28.809720581775867,9.987225542826152,180,1,22770,3870,830,0,2586,1846
12036,0,1,0,1,67,0,420,0,0,6146044,9116542,51.94227565288221,2668,5006,4976,2698,50167,767033,746759,3349,6077,3409,5657,8385,47.7283982551269,5.490867587491313,2728,1,596258,4230,2278,0,681,1101
12037,0,1,0,1,66,0,90,0,0,6338299,8272185,49.72926703662542,2218,5291,5036,2473,54880,749280,819525,3090,5818,3600,5908,8636,50.62608023538856,16.091617306053514,2728,1,605885,26265,2563,0,872,782
12038,0,1,0,1,65,0,341,0,0,6435236,7825228,48.703182647543684,2238,5219,5085,2372,47616,633408,818152,3165,5671,3433,6012,8518,52.08646657242167,11.616877517762624,2506,1,588256,7772,2713,0,927,586
12039,0,0,0,0,52,1,263,1,0,2502864,3854032,38.157568056677825,1366,3265,3175,1456,31512,534694,412932,2557,4103,2737,4366,5912,41.46082488325576,9.808573176892017,1546,1,227136,16200,1719,0,1191,928
12040,0,0,0,0,53,1,314,1,0,2497095,3793581,37.82856063875548,1371,3236,3176,1431,36465,516945,495737,2591,4082,2711,4396,5887,41.773197148410844,8.246211251235321,1491,1,267597,8460,1745,0,1220,906
12041,0,1,0,1,67,0,379,0,0,6146772,9047556,51.73006862551025,2634,5015,4973,2676,49952,757344,753963,3339,6057,3423,5678,8396,47.92702786528704,6.488991180673202,2718,1,596748,5712,2297,0,705,1084
12042,0,1,0,1,66,0,299,0,0,6376020,7899220,48.78524367060187,2230,5209,5059,2380,53703,733499,806517,3169,5699,3469,5998,8528,51.75905717843013,12.420125667085228,2530,1,578340,15450,2679,0,939,640
12043,0,1,1,0,56,0,192,0,0,226980,1092390,19.748417658131498,66,1296,972,390,52560,613419,672240,2477,3191,3125,3383,4097,24.124676163629637,18.00107157783166,714,1,93600,34992,582,0,2411,2219
12044,0,0,0,0,51,1,26,1,0,2518400,4150400,40.0,1492,3282,3174,1600,23200,518800,300904,2486,4194,2702,4168,5876,39.67366884975475,11.25033949080533,1708,1,185600,23220,1574,0,994,1020
12045,1,0,0,0,40,0,154,0,0,267600,1214400,24.49489742783178,600,1046,1046,600,36966,408848,370392,2024,2624,2024,2470,3070,21.118712081942874,0.0,600,0,109800,0,446,0,1424,1578
12046,0,0,0,0,53,1,355,1,0,2507736,3765144,37.62977544445356,1416,3187,3187,1416,37436,507869,521164,2659,4075,2659,4430,5846,42.08325082500163,0.0,1416,1,277536,0,1771,0,1243,888
12047,1,0,0,0,41,0,438,0,0,164560,505054,15.556349186104045,60,1104,922,242,32412,463314,304702,1905,2329,2269,2767,3191,26.076809620810597,14.128681407423223,424,1,35332,38766,680,0,1845,1407
12048,1,0,0,0,40,0,114,0,0,263007,1160325,23.93741840717165,573,1032,1032,573,35697,443475,330075,2025,2598,2025,2484,3057,21.42428528562855,0.0,573,0,93399,0,459,0,1452,1566
12049,1,0,0,0,40,0,138,1,0,290088,1249092,24.73863375370596,582,1116,1086,612,31450,377585,346970,2011,2653,2071,2515,3157,21.77154105707724,5.8721273231371045,642,1,104040,4380,474,0,1429,1567
12050,1,0,0,0,40,0,56,0,0,274841,1120931,23.515952032609693,553,1050,1050,553,47064,429724,449994,2027,2580,2027,2524,3077,22.293496809607955,0.0,553,0,122766,0,497,0,1474,1530
12051,1,0,0,0,42,0,303,0,0,202198,681530,17.97220075561143,189,1083,949,323,48930,491630,443100,1976,2433,2244,2736,3193,25.019992006393608,12.533901830365668,457,1,67830,21574,626,0,1787,1484
12052,0,1,1,0,53,0,555,0,0,108324,412641,12.36931687685298,29,985,861,153,45250,488157,674250,2573,2850,2821,3405,3682,26.60826939130014,11.83231048371444,277,1,38250,4836,708,0,2544,1989
12053,0,1,1,0,53,0,608,0,0,90768,332320,11.135528725660043,29,951,856,124,45750,490440,670000,2585,2804,2775,3412,3631,27.055498516937366,10.316868480755375,219,1,31000,3800,732,0,2556,1948
12054,0,0,1,0,53,1,406,0,0,958791,3244491,34.68429039204925,1028,2175,2000,1203,33950,523218,471975,2522,3900,2872,3494,4872,28.231188426986208,14.197057572168386,1378,1,210525,26600,797,0,1494,1900
12055,0,0,0,0,53,1,324,1,0,2520972,3828780,37.86819245752297,1434,3192,3192,1434,36091,515310,499290,2670,4104,2670,4428,5862,41.92851058647326,0.0,1434,1,268158,0,1758,0,1236,912
12056,1,0,0,0,40,0,89,0,0,277332,1159752,23.93741840717165,573,1057,1057,573,33284,429088,317768,2024,2597,2024,2508,3081,22.0,0.0,573,0,89961,0,484,0,1451,1540
12057,0,0,1,0,54,1,570,0,0,2308891,3418571,35.510561809129406,1261,3092,3092,1261,55930,637085,645218,2711,3972,2711,4542,5803,42.790185790669334,0.0,1261,0,300118,0,1831,0,1450,880
12058,1,0,0,0,40,0,42,0,0,281520,1116696,23.49468024894146,552,1062,1062,552,29546,378301,319634,2023,2575,2023,2533,3085,22.58317958127243,0.0,552,0,87216,0,510,0,1471,1513
12059,1,0,0,0,40,0,62,1,0,292803,1162617,23.93741840717165,573,1084,1084,573,25900,375365,284060,2029,2602,2029,2540,3113,22.60530911091463,0.0,573,1,80220,0,511,0,1456,1518
12060,1,0,0,0,40,0,50,1,0,289896,1044962,22.67156809750927,472,1120,1078,514,41664,390336,441161,1991,2547,2075,2597,3153,23.748684174075834,6.570697549716149,556,1,111538,4326,564,0,1519,1469
12061,1,0,0,0,42,0,312,0,0,189108,644130,17.4928556845359,186,1044,924,306,51912,530460,433630,1985,2411,2225,2723,3149,24.859605789312106,11.940678465487732,426,1,63036,21600,618,0,1799,1487
12062,0,1,0,1,68,0,425,0,0,6117650,9206120,51.91338940966964,2461,5199,4965,2695,51754,782264,772016,3182,6111,3650,5686,8615,47.644516998286385,15.407601596450576,2929,1,609070,32292,2270,0,721,1146
12063,0,1,0,1,67,0,169,0,0,6160632,8700384,50.67543783727971,2418,5117,4967,2568,51529,769076,769076,3238,5956,3538,5787,8505,48.979587585033826,12.261034368426225,2718,1,582936,20250,2399,0,820,989
12064,0,1,1,0,55,0,49,0,0,196980,1172220,20.493901531919196,36,1273,889,420,55920,650303,669840,2407,3211,3175,3260,4064,21.656407827707714,19.59711387269376,804,1,100800,46080,469,0,2371,2322
12065,0,1,1,0,55,0,149,0,0,183240,1000440,18.973665961010276,30,1199,869,360,55056,616938,689192,2449,3139,3109,3288,3978,22.561028345356956,19.006848607041135,690,1,89280,31020,509,0,2419,2270
12066,0,1,1,0,53,0,580,0,0,84000,321480,10.954451150103322,30,910,820,120,46686,498294,672429,2589,2799,2769,3379,3589,26.457513110645905,10.076370665412547,210,1,30120,3960,700,0,2559,1979
12067,0,0,1,0,59,1,571,0,0,4069896,5199936,41.8568990729127,1510,4317,4075,1752,50525,697480,638120,2726,4720,3210,5291,7285,48.19751030914356,15.597688780746328,1994,1,376680,38236,2323,0,1216,645
12068,1,0,0,0,43,0,161,0,1,39530,293996,11.575836902790225,104,459,429,134,54990,513396,515590,2164,2328,2224,2489,2653,17.175564037317667,5.478746393072713,164,1,31490,3930,295,0,2060,1899
12069,1,0,0,0,40,0,12,1,0,288333,1082709,23.043437243605826,489,1116,1074,531,26871,344591,324201,1997,2570,2081,2582,3155,23.302360395462088,6.78953034358522,573,1,84429,5754,543,0,1508,1496
12070,1,0,0,0,37,0,639,0,0,91080,226680,10.954451150103322,30,1029,879,120,37925,349465,387245,1739,2009,2039,2648,2918,27.54995462791182,12.318810369945247,270,1,24600,16200,759,0,1769,1130
12071,0,1,0,1,65,0,667,0,0,6166308,7137192,46.604720790924176,2130,5053,5011,2172,46225,706490,706490,3244,5458,3328,6125,8339,53.28226721902888,6.48074069840786,2214,1,466980,5712,2839,0,1114,447
12072,0,1,1,0,61,0,371,0,0,1849346,4806430,39.4715087119811,1121,3182,2745,1558,49504,691040,681785,2648,4643,3522,4272,6267,34.45286635390443,21.15741035310621,1995,1,344318,60306,1187,0,1527,1898
12073,0,1,1,0,53,0,506,0,0,100827,411876,12.36931687685298,29,936,812,153,48384,516864,678384,2568,2845,2816,3351,3628,25.67099530598687,11.736839560195943,277,1,38556,6200,659,0,2539,2033
12074,0,0,0,0,51,1,334,1,0,2497032,4558576,41.90465367951393,1661,3273,3178,1756,31800,550352,389400,2501,4352,2691,4018,5869,37.70941526992961,10.172010733280942,1851,1,263400,18905,1422,0,840,1174
12075,1,0,0,0,38,0,571,0,1,63270,183065,9.746794344808963,25,881,761,95,21903,283269,287123,1807,2022,2047,2593,2808,25.80697580112788,11.963374327610032,215,1,14155,13920,666,0,1832,1261
12076,0,1,0,1,67,0,215,0,0,6186054,8032104,48.80573736764972,2140,5221,4979,2382,54502,772188,802536,3130,5754,3614,5969,8593,50.96076922496363,15.651367469510182,2624,1,566916,29282,2597,0,990,775
12077,0,0,1,0,58,1,221,0,0,3003222,5356300,42.9767378938886,1667,3653,3473,1847,51376,716300,603200,2720,4747,3080,4526,6553,40.32369030731191,13.436652244415649,2027,1,384176,31680,1626,0,1053,1274
12078,0,0,0,0,55,1,500,1,0,2591141,3806040,37.134889255254286,1255,3382,3258,1379,31310,557520,427800,2636,4139,2884,4639,6142,43.347433603386484,11.144389776194219,1503,1,213745,22692,1879,0,1381,881
12079,0,0,0,0,55,1,742,1,0,2584859,3563294,35.76310948449533,1087,3492,3300,1279,36900,571130,501480,2594,4065,2978,4807,6278,44.955533585978046,13.877501437522838,1471,1,230220,30912,2021,0,1507,765
12080,0,1,0,1,65,0,493,0,0,4641630,6317614,43.840620433565945,1583,4676,4337,1922,48841,726427,726427,2948,5209,3626,5702,7963,49.14264950122246,18.770477097315638,2261,1,424762,45426,2415,0,1365,872
12081,0,1,1,0,55,0,26,0,0,170400,1110800,20.0,105,1121,826,400,53874,608163,683142,2482,3177,3072,3203,3898,20.639767440550294,17.43267074223099,695,1,98400,28615,426,0,2377,2351
12082,0,0,1,0,58,1,1073,0,0,3151338,3876238,36.30426972134269,1251,3776,3709,1318,40984,641138,552908,2874,4259,3008,5332,6717,48.8978527135906,8.299636160530056,1385,1,247784,11323,2391,0,1623,550
12083,1,0,0,0,43,0,180,0,1,55404,354942,12.727922061357855,132,534,504,162,53502,486402,528031,2161,2353,2221,2533,2725,18.49324200890693,5.572104574801163,192,1,39042,3300,342,0,2029,1849
12084,1,0,0,0,37,0,695,0,1,101556,235476,11.135528725660043,29,1096,943,124,34710,370305,338022,1746,2023,2052,2718,2995,28.61817604250837,12.60665128010484,277,1,22072,23103,819,0,1775,1080
12085,0,1,1,0,55,0,54,0,0,164107,1048314,19.467922333931785,124,1067,812,379,53165,600222,677670,2511,3145,3021,3199,3833,20.808652046684813,16.199661663980073,634,1,92855,24480,433,0,2387,2333
12086,0,0,1,0,51,1,112,0,0,1389264,2905540,33.52610922848042,1057,2427,2360,1124,22176,579040,255915,2518,3709,2652,3821,5012,35.156791662493895,8.833574853908106,1191,1,111276,16549,1236,0,1461,1349
12087,0,0,1,0,57,1,307,0,0,2912520,5401231,43.2087954009366,1743,3551,3427,1867,50049,720357,581493,2769,4760,3017,4453,6444,39.496835316262995,11.144389776194219,1991,0,375267,23064,1560,1,1026,1333
12088,0,0,1,0,57,1,312,0,0,3052180,5535180,43.70354676682432,1790,3628,3508,1910,53136,712908,625968,2778,4808,3018,4496,6526,39.97499218261337,10.981735174982626,2030,0,412560,20040,1598,1,988,1300
12089,0,0,1,0,58,1,319,0,0,3274232,5742256,44.45222154178574,1852,3757,3633,1976,49196,729406,569576,2782,4882,3030,4563,6663,40.70626487409524,11.207254246462899,2100,0,387296,23684,1657,1,930,1249
12090,0,0,1,0,55,1,648,0,0,782388,3508086,35.58089374931439,1010,2140,1884,1266,32111,451673,545887,2515,4037,3027,3389,4911,24.859605789312106,17.095668131953637,1522,1,249402,21760,618,0,1505,2153
12091,1,0,0,0,40,0,183,0,0,284850,917550,21.213203435596427,420,1113,1083,450,44100,499555,367020,2009,2489,2069,2672,3152,25.15949125081825,5.477225575051661,480,0,81000,6120,633,0,1589,1406
12092,1,0,0,0,41,0,218,0,0,131760,561870,16.431676725154983,95,933,758,270,38552,328798,507764,1906,2351,2256,2569,3014,22.090722034374522,13.522191576281958,445,1,65880,2275,488,0,1811,1593
12093,1,0,0,0,38,0,597,0,1,141778,350350,13.490737563232042,28,1171,961,182,34672,379225,338800,1715,2107,2135,2704,3096,27.910571473905726,14.921685106015376,392,1,32032,32550,779,0,1743,1146
12094,0,1,1,0,55,0,80,0,0,163236,1238988,21.118712081942874,190,1068,812,446,54412,619494,677832,2522,3224,3034,3144,3846,19.131126469708992,16.116877164043522,702,1,108824,26624,366,0,2332,2412
12095,0,1,1,0,54,0,135,0,0,157450,920580,18.303005217723125,143,997,805,335,52430,588072,673260,2556,3083,2940,3218,3745,21.6794833886788,14.034855041500148,527,1,82075,17664,470,0,2413,2278
12096,0,1,1,0,54,0,241,0,0,148292,772024,16.822603841260722,121,969,807,283,51088,561968,676544,2566,3011,2890,3252,3697,22.891046284519195,13.009547964816395,445,1,70184,12474,524,0,2445,2204
12097,0,0,1,0,57,1,1202,0,0,1982760,2673750,30.495901363953813,822,3170,3062,930,52896,655500,667000,2767,3805,2983,5007,6045,46.17358552246078,10.393195703494003,1038,1,215760,13932,2132,0,1945,743
12098,0,0,1,0,56,1,1200,0,0,1980900,2648640,30.495901363953813,835,3155,3060,930,52500,598080,712000,2753,3778,2943,4978,6003,46.151923036857305,10.06192246325636,1025,1,232500,7315,2130,0,1918,718
12099,0,0,1,0,56,1,84,0,0,2144461,4008591,37.72267222772003,1211,3142,2930,1423,41040,535230,608472,2605,4240,3029,4324,5959,38.82009788756334,14.852658030956366,1635,1,307368,21412,1507,0,1394,1310
12100,0,0,0,0,54,1,8,1,0,2617908,4420746,40.17461885320133,1547,3303,3236,1614,38485,588885,490281,2672,4353,2806,4361,6042,40.27406113120453,8.261328108906353,1681,1,288906,11591,1622,0,1125,1117
12101,1,0,0,0,43,0,188,0,1,87264,471096,14.696938456699069,186,650,620,216,54289,508173,508173,2151,2397,2211,2585,2831,20.09975124224178,5.483301264452448,246,1,50328,3990,404,0,1965,1777
12102,1,0,0,0,41,0,191,0,0,148092,631197,17.349351572897472,131,963,793,301,48552,427788,499086,1927,2398,2267,2589,3060,22.181073012818835,13.477685679468587,471,1,71638,15470,492,0,1796,1605
12103,1,0,0,0,38,0,441,0,0,143662,418996,14.7648230602334,110,985,877,218,36135,317130,420918,1814,2140,2030,2581,2907,25.67099530598687,10.781717396486519,326,1,47742,6696,659,0,1704,1263
12104,1,0,0,0,39,0,736,0,1,164880,351540,13.416407864998739,2,1278,1096,180,29145,283185,392553,1771,2133,2135,2869,3231,30.265491900843113,14.377326693209262,362,1,36180,9828,916,0,1773,1037
12105,0,1,1,0,58,0,694,0,0,483320,3280956,33.52610922848042,742,1936,1554,1124,47477,575043,703479,2537,4043,3301,3349,4855,20.73644135332772,19.822269905162543,1506,1,270884,29414,430,0,1795,2489
12106,0,0,1,0,57,1,394,0,0,2824055,5438431,43.46262762420146,1804,3469,3384,1889,47250,719750,544131,2794,4768,2964,4374,6348,38.66522985836241,9.231007614073922,1974,0,357021,16745,1495,1,990,1384
12107,0,0,1,0,55,1,676,0,0,628800,3308400,34.64101615137755,1025,1899,1724,1200,41630,499017,634110,2582,3957,2932,3281,4656,22.891046284519195,13.932549828874421,1375,1,276000,12250,524,0,1557,2233
12108,1,0,0,0,40,0,147,0,0,305404,982520,22.0,484,1115,1115,484,51528,458780,462840,2030,2514,2030,2661,3145,25.11971337416094,0.0,484,0,110352,0,631,0,1546,1399
12109,1,0,0,0,39,0,717,0,0,194670,410340,14.491376746189438,8,1355,1137,210,33015,302870,416202,1736,2164,2172,2881,3309,30.44667469527666,15.47340938113697,428,1,44730,11990,927,0,1744,1027
12110,1,0,0,0,39,0,602,0,1,202080,470160,15.491933384829668,30,1352,1082,240,25092,299727,321276,1689,2199,2229,2801,3311,29.017236257093817,17.052826732986624,510,1,39360,29700,842,0,1719,1117
12111,0,1,1,0,56,0,444,0,0,122112,1789704,25.219040425836983,424,1040,828,636,55216,652848,669732,2602,3450,3026,3006,3854,13.856406460551018,14.618906374886377,848,1,151368,26288,192,0,2178,2622
12112,0,0,0,0,55,1,295,1,0,2725550,4220450,38.8587184554509,1510,3315,3315,1510,34830,600925,452790,2795,4305,2795,4600,6110,42.485291572496,0.0,1510,1,244620,0,1805,0,1285,990
12113,1,0,0,0,42,0,145,0,0,143354,658552,17.69180601295413,133,951,771,313,42320,387136,483920,1924,2417,2284,2562,3055,21.400934559032695,13.858755107602944,493,1,71990,13500,458,0,1791,1646
12114,1,0,0,0,38,0,503,0,0,178320,463680,15.491933384829668,210,1013,983,240,38038,477204,297528,1902,2172,1962,2675,2945,27.258026340878022,5.623413251903491,270,1,36960,6720,743,0,1692,1189
12115,0,0,1,0,56,1,477,0,0,2381400,5086800,42.42640687119285,1710,3213,3123,1800,53130,714978,593460,2736,4626,2916,4149,6039,36.373066958946424,9.864521623431754,1890,0,378000,15300,1323,1,1026,1503
12116,0,0,0,0,54,1,284,1,0,2610720,4819248,42.0,1548,3460,3244,1764,34815,576452,450780,2516,4496,2948,4212,6192,38.47076812334269,14.728338324716063,1980,1,291060,39744,1480,0,968,1252
12117,0,0,0,0,55,1,182,1,0,2642103,4727250,41.46082488325576,1549,3426,3256,1719,31311,585750,404250,2580,4469,2920,4287,6176,39.20459156782532,13.067183365512706,1889,1,252693,34340,1537,0,1031,1213
12118,1,0,0,0,41,0,574,0,1,263375,625177,17.349351572897472,29,1506,1176,301,29328,390476,324012,1747,2378,2407,2952,3583,29.58039891549808,20.02756794822073,631,1,46956,54120,875,0,1776,1202
12119,0,1,1,0,57,0,741,0,0,255232,2865378,31.575306807693888,781,1469,1253,997,50020,589170,701256,2658,3871,3090,3130,4343,16.0,14.867894671866425,1213,1,243268,17712,256,0,1877,2618
12120,0,1,1,0,55,0,10,0,0,156000,1073670,19.748417658131498,282,898,790,390,52245,591895,668979,2645,3143,2861,3153,3651,20.0,10.471798365004291,498,1,94770,10584,400,0,2363,2353
12121,0,1,1,0,54,0,248,0,0,139860,732780,16.431676725154983,228,830,788,270,49532,550942,662216,2672,2984,2756,3232,3544,22.759613353482084,6.570697549716149,312,1,65880,3318,518,0,2444,2196
12122,0,0,1,0,53,1,353,0,0,1585560,3905256,38.05259518088089,1388,2603,2543,1448,48216,663462,528612,2637,4145,2757,3792,5300,33.090784215548595,7.748117453886108,1508,0,283808,11340,1095,1,1249,1602
12123,0,0,1,0,57,1,531,0,0,2787300,5631324,44.22668877499196,1896,3441,3381,1956,45318,716871,523978,2819,4835,2939,4304,6320,37.749172176353746,7.765259411425052,2016,0,355992,12240,1425,1,923,1454
12124,0,0,1,0,56,1,564,0,0,2854845,4055454,37.82856063875548,1269,3588,3426,1431,44254,617812,575302,2672,4265,2996,4829,6422,44.66542286825459,12.815404336892843,1593,1,290493,24624,1995,0,1403,839
12125,1,0,0,0,40,0,94,0,0,333032,1088472,23.065125189341593,502,1188,1158,532,47061,386694,509454,2016,2578,2076,2672,3234,25.019992006393608,5.7180036243905645,562,1,132468,1560,626,0,1514,1420
12126,1,0,0,0,39,0,348,0,0,117180,414120,14.491376746189438,48,930,768,210,42560,374680,441728,1810,2182,2134,2530,2902,23.62202362203543,12.745345677861021,372,1,47040,14580,558,0,1762,1414
12127,1,0,0,0,40,0,575,0,0,262500,600000,17.320508075688775,60,1415,1175,300,48530,422000,460000,1760,2300,2240,2875,3415,29.58039891549808,15.885744871983722,540,1,69000,26640,875,0,1700,1125
12128,1,0,0,0,41,0,578,0,1,299640,686070,18.16590212458495,30,1598,1238,330,23814,392931,261954,1719,2409,2439,2987,3677,30.133038346638727,20.668821622576274,690,1,41580,69480,908,0,1749,1171
12129,0,1,1,0,58,0,749,0,0,497352,3449793,34.249087579087416,838,1932,1597,1173,50953,597023,738191,2606,4114,3276,3365,4873,20.591260281974,18.81132089379512,1508,1,294423,22780,424,0,1768,2517
12130,0,1,1,0,56,0,526,0,0,88440,1855260,25.69046515733026,536,918,794,660,53297,626853,671829,2687,3471,2935,2945,3729,11.575836902790225,11.238381877778293,784,1,157740,14012,134,0,2151,2677
12131,0,1,1,0,55,0,55,0,0,153300,1158780,20.493901531919196,325,880,785,420,53703,609739,670437,2664,3179,2854,3124,3639,19.1049731745428,9.85304212894363,515,1,102060,9880,365,0,2339,2394
12132,0,1,1,0,54,0,124,0,0,149820,902880,18.16590212458495,270,844,784,330,50264,563616,667584,2676,3066,2796,3190,3580,21.307275752662516,7.748117453886108,390,1,80520,5040,454,0,2406,2282
12133,0,1,1,0,54,0,303,0,0,130320,648960,15.491933384829668,240,783,783,240,49490,546208,662480,2704,2944,2704,3247,3487,23.302360395462088,0.0,240,1,58800,0,543,0,2464,2161
12134,0,1,1,0,53,0,363,0,0,120330,565320,14.491376746189438,210,783,783,210,48510,533016,659540,2692,2902,2692,3265,3475,23.93741840717165,0.0,210,1,51450,0,573,0,2482,2119
12135,0,0,1,0,54,1,512,0,0,1827840,4461888,40.39801975344831,1602,2782,2752,1632,45632,678032,503056,2704,4366,2764,3854,5516,33.46640106136302,5.5503012171862105,1662,0,300288,6060,1120,1,1102,1614
12136,0,0,1,0,57,1,575,0,0,2843154,5748246,44.69899327725402,1956,3463,3421,1998,51045,716373,589785,2835,4875,2919,4300,6340,37.72267222772003,6.495386533491135,2040,0,409590,7602,1423,1,879,1454
12137,0,0,1,0,56,1,393,0,0,2863300,4272345,38.82009788756334,1399,3515,3407,1507,39405,603855,524475,2727,4342,2943,4735,6350,43.58898943540674,10.62681426149494,1615,1,278795,17820,1900,0,1328,935
12138,1,0,0,0,41,0,398,1,0,100275,363825,13.228756555322953,67,856,748,175,27693,318087,376299,1971,2254,2187,2652,2935,23.93741840717165,11.159351262885526,283,1,31675,9720,573,0,1904,1506
12139,1,0,0,0,43,0,80,1,0,150500,755650,18.708286933869708,67,1063,780,350,29000,500888,269875,1876,2509,2442,2589,3222,20.73644135332772,17.819358186706626,633,1,43750,67071,430,0,1809,1729
12140,1,0,0,0,39,0,504,0,0,275220,658350,18.16590212458495,120,1374,1164,330,44100,502740,349125,1785,2325,2205,2829,3369,28.879058156387302,14.910611547535398,540,1,57750,43890,834,0,1665,1161
12141,1,0,0,0,40,0,592,0,1,344033,733913,19.0,29,1704,1314,361,19875,323247,254125,1643,2394,2423,2986,3737,30.870698080866262,20.7455194991212,751,1,45125,61230,953,0,1672,1080
12142,1,0,0,0,38,0,905,0,1,123000,228600,10.954451150103322,30,1235,1145,120,47236,373380,459105,1815,2025,1995,2930,3140,32.01562118716424,9.883997062654284,210,1,28920,6750,1025,0,1785,880
12143,0,1,1,0,58,0,751,0,0,446522,3340350,33.793490497431605,847,1828,1533,1142,53000,620100,731250,2630,4067,3220,3316,4753,19.77371993328519,17.630996989473235,1437,1,285500,23305,391,0,1783,2534
12144,0,1,1,0,55,0,238,0,0,138720,1416270,22.58317958127243,420,872,782,510,55176,633156,672034,2687,3287,2867,3049,3649,16.492422502470642,9.489467114586667,600,1,123420,10260,272,0,2267,2505
12145,0,1,1,0,54,0,301,0,0,129840,648960,15.491933384829668,240,781,781,240,51129,559728,667888,2704,2944,2704,3245,3485,23.259406699226016,0.0,240,1,59280,0,541,0,2464,2163
12146,0,0,1,0,52,1,338,0,0,1385160,3587836,36.851051545376556,1316,2420,2378,1358,38394,642006,417436,2600,4000,2684,3662,5062,31.937438845342623,6.570697549716149,1400,0,214564,9240,1020,1,1284,1622
12147,1,0,0,0,42,0,42,1,0,149328,772992,19.131126469708992,186,954,774,366,29464,489984,268224,1932,2478,2292,2520,3066,20.199009876724155,14.064063304453542,546,1,46482,42660,408,0,1746,1704
12148,1,0,0,0,39,0,74,0,0,8040,118620,7.745966692414834,30,224,194,60,33740,276780,476457,1947,2037,2007,2111,2201,11.575836902790225,6.148342568763683,90,1,14460,0,134,0,1917,1843
12149,1,0,0,0,41,0,587,0,1,381030,816270,19.748417658131498,28,1729,1367,390,21294,380926,244881,1731,2483,2455,3070,3822,31.25699921617557,19.056750627144165,752,1,45630,69866,977,0,1703,1116
12150,1,0,0,0,39,0,742,0,1,273240,532710,16.431676725154983,30,1522,1282,270,42768,347248,479439,1733,2243,2213,2985,3495,31.811947441173732,16.197720714781266,510,1,65610,10080,1012,0,1703,961
12151,0,1,1,0,61,0,363,0,0,950130,3588207,34.249087579087416,477,2679,1983,1173,50218,645449,728042,2363,4232,3755,3869,5738,28.460498941515414,27.08594501137193,1869,1,279174,69600,810,0,1886,2249
12152,0,1,1,0,57,0,780,0,0,207900,2823480,31.464265445104548,863,1327,1200,990,55304,635996,707296,2725,3842,2979,3062,4179,14.491376746189438,11.377048979465448,1117,1,245520,12065,210,0,1862,2642
12153,0,1,1,0,54,0,240,0,0,137700,732240,16.431676725154983,270,780,780,270,53250,577656,678000,2712,2982,2712,3222,3492,22.58317958127243,0.0,270,1,67500,0,510,0,2442,2202
12154,0,0,1,0,51,1,301,0,0,1294106,3365714,36.02776706930364,1298,2295,2295,1298,37513,604169,417473,2593,3891,2593,3590,4888,31.575306807693888,0.0,1298,1,208978,0,997,0,1295,1596
12155,0,0,1,0,57,1,670,0,0,2554464,5614704,44.36214602563767,1968,3266,3266,1968,43740,693279,513540,2853,4821,2853,4151,6119,36.02776706930364,0.0,1968,0,354240,0,1298,1,885,1555
12156,0,0,1,0,57,1,662,0,0,2959943,6013621,45.639894828976104,2053,3534,3504,2083,51045,718863,591835,2857,4970,2917,4308,6421,37.69615364994153,5.490867587491313,2113,0,427015,5400,1421,1,804,1466
12157,1,0,0,0,40,0,496,0,0,345540,783900,19.748417658131498,89,1577,1276,390,39270,478380,331650,1709,2400,2311,2896,3587,29.765752132274432,17.70875669762007,691,1,64350,63812,886,0,1620,1124
12158,1,0,0,0,41,0,592,0,1,425040,880320,20.493901531919196,70,1782,1432,420,28633,438064,287152,1746,2516,2446,3108,3878,31.811947441173732,18.747261474170593,770,1,57540,72450,1012,0,1676,1084
12159,0,1,1,0,57,0,773,0,0,245630,2898840,31.85906464414798,881,1391,1257,1015,52624,594048,722568,2722,3871,2990,3098,4247,15.556349186104045,11.709062801829726,1149,1,256795,9246,242,0,1841,2614
12160,0,1,1,0,53,0,299,0,0,130922,652190,15.556349186104045,200,825,783,242,53383,568645,681835,2653,2937,2737,3236,3520,23.259406699226016,6.7040592262067955,284,1,61226,2982,541,0,2453,2154
12161,0,0,1,0,53,1,551,0,0,1492856,4117960,39.08964057138413,1498,2535,2505,1528,45384,657580,501270,2665,4223,2725,3672,5230,31.25699921617557,5.531194905403055,1558,0,284208,5910,977,1,1167,1718
12162,0,0,1,0,56,1,722,0,0,2306400,5433494,43.840620433565945,1862,3182,3122,1922,44160,678480,520168,2767,4749,2887,4027,6009,34.64101615137755,8.16338338718601,1982,0,353648,11760,1200,1,905,1627
12163,0,0,0,0,56,1,29,1,0,2860962,4845040,41.30375285612676,1505,3584,3383,1706,37053,587880,508360,2639,4546,3041,4517,6424,40.95119045888654,14.351854469902573,1907,1,305374,33165,1677,0,1134,1163
12164,1,0,0,0,42,0,551,0,1,450450,947700,21.213203435596427,68,1833,1451,450,21082,349596,267462,1724,2556,2488,3107,3939,31.63858403911275,19.603621211550667,832,1,57150,62648,1001,0,1656,1105
12165,0,1,1,0,57,0,759,0,0,248482,2868106,31.71750305430741,882,1377,1253,1006,52961,601561,715601,2727,3857,2975,3098,4228,15.716233645501712,11.238381877778293,1130,1,252506,9672,247,0,1845,2604
12166,0,0,1,0,56,1,774,0,0,2181960,5368770,43.749285708454714,1824,3144,3054,1914,45000,701250,504900,2715,4719,2895,3945,5949,33.76388603226827,9.79077483409882,2004,1,344520,18540,1140,0,891,1665
12167,0,0,1,0,57,1,758,0,0,2655288,5876928,45.2990066116245,1992,3406,3346,2052,48057,713136,552752,2804,4916,2924,4158,6270,35.9722114972099,7.810249675906654,2112,0,396036,11640,1294,1,812,1570
12168,0,0,1,0,57,1,745,0,0,3013644,6190536,46.34652090502587,2063,3636,3551,2148,47674,697444,567754,2797,5030,2967,4285,6518,37.456641600656084,9.219863456115478,2233,0,423156,15640,1403,1,734,1479
12169,1,0,0,0,42,0,47,1,0,147288,864144,20.199009876724155,366,811,769,408,37026,419364,396066,2076,2526,2160,2479,2929,19.0,6.678188844436455,450,1,76296,6048,361,0,1710,1757
12170,1,0,0,0,40,0,20,0,0,463661,1370853,25.903667693977237,641,1392,1362,671,54216,441288,512793,2013,2714,2073,2734,3435,26.28687885618983,5.5503012171862105,701,1,168421,2400,691,0,1372,1352
12171,1,0,0,0,40,0,490,0,0,435591,939573,21.42428528562855,77,1790,1408,459,37975,501515,317285,1665,2506,2429,2996,3837,30.805843601498726,19.54816788437431,841,1,71145,85568,949,0,1588,1098
12172,1,0,0,0,43,0,573,0,1,506974,1037998,21.93171219946131,234,1782,1535,481,43739,494182,412178,1911,2639,2405,3212,3940,32.46536616149585,16.256753867442068,728,1,91871,43966,1054,0,1677,1104
12173,0,1,1,0,56,0,732,0,0,132300,2493414,29.698484809834994,882,1032,1032,882,53118,641729,661518,2827,3709,2827,2977,3859,12.24744871391589,0.0,882,1,206388,0,150,0,1945,2677
12174,0,1,1,0,56,0,605,0,0,77004,1997113,26.70205984563738,671,863,821,713,54280,644230,661036,2759,3514,2843,2909,3664,10.392304845413264,6.495386533491135,755,1,168268,5292,108,0,2088,2693
12175,0,1,1,0,54,0,59,0,0,159530,1176480,20.73644135332772,430,801,801,430,53924,604656,667584,2736,3166,2736,3107,3537,19.261360284258224,0.0,430,1,104920,0,371,0,2306,2365
12176,0,1,1,0,54,0,117,0,0,156978,929214,18.49324200890693,282,861,801,342,54834,603174,671099,2657,3059,2777,3176,3578,21.42428528562855,7.9730082341141015,402,1,84474,5880,459,0,2375,2258
12177,1,0,0,0,40,0,5,0,0,472650,1396030,26.1725046566048,685,1375,1375,685,54492,464664,487082,2038,2723,2038,2728,3413,26.267851073127396,0.0,685,1,163715,0,690,0,1353,1348
12178,1,0,0,0,40,0,3,0,0,398790,1293219,25.15949125081825,603,1293,1263,633,35581,451503,328923,2013,2676,2073,2673,3336,25.099800796022265,5.5503012171862105,663,0,101913,5940,630,0,1410,1413
12179,1,0,0,0,40,0,198,0,0,97128,456228,15.0996688705415,161,721,654,228,46056,404202,456228,1934,2229,2068,2427,2722,20.639767440550294,8.299636160530056,295,1,51984,6834,426,0,1773,1575
12180,1,0,0,0,39,0,180,1,0,204421,736806,19.261360284258224,329,964,922,371,39004,395214,389256,1944,2357,2028,2537,2950,23.473389188611005,6.653712290320142,413,1,72716,5712,551,0,1615,1435
12181,1,0,0,0,42,0,551,0,0,541110,1093950,22.58317958127243,282,1799,1571,510,41000,536250,351780,1917,2655,2373,3206,3944,32.57299494980466,15.555087290566727,738,1,83640,49704,1061,0,1635,1084
12182,1,0,0,0,43,0,519,0,1,530962,1110240,22.67156809750927,302,1759,1547,514,55440,518400,498960,1948,2674,2372,3193,3919,32.14031735997639,15.255261758639925,726,1,118734,29892,1033,0,1646,1127
12183,1,0,0,0,41,0,546,0,1,357120,794112,19.595917942265423,2,1696,1314,384,45864,376376,521136,1686,2452,2450,2998,3764,30.495901363953813,20.43805316076028,766,1,96768,7640,930,0,1684,1138
12184,0,1,1,0,56,0,607,0,0,90644,2048993,27.03701166919155,701,885,855,731,53823,647493,653099,2773,3534,2833,2927,3688,11.135528725660043,5.483301264452448,761,1,170323,3900,124,0,2072,2679
12185,0,1,1,0,55,0,476,0,0,109820,1804924,25.41653005427767,646,816,816,646,51296,625856,639826,2794,3440,2794,2964,3610,13.038404810405298,0.0,646,1,147934,0,170,0,2148,2624
12186,0,1,1,0,55,0,269,0,0,143916,1486953,23.173260452512935,477,865,805,537,51574,592566,667329,2709,3306,2829,3037,3634,16.3707055437449,7.810249675906654,597,1,129417,5940,268,0,2232,2501
12187,0,1,1,0,53,0,229,0,0,154580,792960,17.175564037317667,187,927,819,295,51562,545664,682752,2580,2983,2796,3212,3615,22.891046284519195,10.781717396486519,403,1,74930,6048,524,0,2393,2164
12188,0,0,0,0,57,1,39,1,0,1367350,3328100,33.91164991562634,882,2607,2339,1150,33376,648256,431206,2626,4044,3162,4083,5501,34.48187929913333,16.987366343099428,1418,1,171350,56816,1189,0,1744,1705
12189,0,0,0,0,57,1,202,1,0,2896824,5159742,42.49705872175156,1500,3716,3410,1806,41449,654253,517117,2551,4663,3163,4461,6573,40.049968789001575,17.669687961213416,2112,1,326886,57528,1604,0,1051,1253
12190,1,0,0,0,43,0,425,0,0,105000,378000,13.228756555322953,145,805,775,175,53172,455760,544320,2130,2335,2190,2760,2965,24.49489742783178,5.652706486041966,205,1,44100,2130,600,0,1985,1560
12191,1,0,0,0,40,0,62,0,0,482064,1483944,26.94438717061496,726,1390,1390,726,53320,439460,506912,2044,2770,2044,2708,3434,25.768197453450252,0.0,726,1,180048,0,664,0,1318,1380
12192,1,0,0,0,40,0,9,0,0,483700,1426600,26.457513110645905,700,1391,1391,700,50561,474854,442246,2038,2738,2038,2729,3429,26.28687885618983,0.0,700,0,151900,0,691,0,1338,1347
12193,1,0,0,0,42,0,139,1,0,74412,750789,18.734993995195193,56,858,563,351,23520,314433,342240,1844,2490,2434,2351,2997,14.560219778561036,18.506548454011323,646,1,56160,30680,212,0,1788,1927
12194,1,0,0,0,40,0,108,0,0,6300,304200,12.24744871391589,42,300,192,150,36450,328536,456300,1920,2178,2136,2070,2328,6.48074069840786,11.368721298642535,258,1,33750,5400,42,0,1878,1986
12195,0,1,1,0,63,0,209,0,0,1415910,3437860,33.015148038438355,795,2684,2389,1090,54752,744344,731728,2859,4244,3449,4453,5838,36.0416425818802,17.182664721034936,1385,1,252880,40120,1299,0,2064,1855
12196,0,1,1,0,55,0,444,0,0,122112,1777620,25.219040425836983,606,858,828,636,52658,631670,651235,2765,3431,2825,2987,3653,13.856406460551018,5.478746393072713,666,1,148188,3750,192,0,2159,2603
12197,0,1,1,0,55,0,345,0,0,135486,1611936,24.06241883103193,512,880,813,579,54189,620832,676512,2717,3363,2851,3018,3664,15.297058540778355,8.20759886765899,646,1,140697,7102,234,0,2205,2550
12198,0,0,1,0,57,1,810,0,0,3065184,6379194,46.92547282660026,2022,3774,3594,2202,50715,709765,599679,2717,5099,3077,4289,6671,37.30951621235526,13.45362404707371,2382,1,455814,31680,1392,0,695,1505
12199,0,0,1,0,56,1,637,0,0,203814,2475382,29.512709126747414,421,1555,1105,871,34216,534296,517244,2392,3713,3292,3076,4397,15.297058540778355,21.233705978698662,1321,1,158522,62100,234,0,1971,2608
12200,0,0,1,0,54,1,403,0,0,795708,3041100,33.406586176980134,1074,1871,1829,1116,33582,525925,474150,2683,3841,2767,3438,4596,26.70205984563738,6.553889165207866,1158,1,194184,6384,713,0,1609,2012
12201,1,0,0,0,40,0,19,1,0,13716,257683,11.269427669584644,32,330,235,127,27216,328698,340872,1934,2156,2124,2137,2359,10.392304845413264,10.702660118511865,222,1,21336,11210,108,0,1902,1921
12202,0,0,1,0,57,1,865,0,0,2990250,6405780,47.06378650300037,2014,3766,3565,2215,49490,708540,584184,2691,5107,3093,4242,6658,36.742346141747674,14.240973470021874,2416,1,447430,36582,1350,0,677,1542
12203,1,0,0,0,41,0,544,0,0,263577,1764004,29.206163733020468,823,1192,1162,853,54948,498388,471504,2038,2921,2098,2377,3260,17.578395831246947,5.7180036243905645,883,1,194484,3870,309,0,1215,1759
12204,1,0,0,0,40,0,23,1,0,19050,306900,12.24744871391589,26,401,277,150,28710,356004,337590,1922,2196,2170,2173,2447,11.269427669584644,12.547211850808306,274,1,24750,16864,127,0,1896,1919
12205,0,1,1,0,57,0,623,0,0,249300,2572200,30.0,815,1262,1177,900,46056,577316,651624,2773,3758,2943,3135,4120,16.64331697709324,9.476861953055495,985,1,205200,8670,277,0,1958,2581
12206,0,0,1,0,57,1,816,0,0,2948761,6297354,46.61544808322666,1933,3770,3530,2173,44650,681030,550620,2658,5071,3138,4255,6668,36.837480912787726,15.56464348447047,2413,1,412870,44400,1357,0,725,1541
12207,1,0,0,0,43,0,355,1,0,124914,1246275,23.93741840717165,393,971,791,573,32436,443700,345825,1995,2748,2355,2393,3146,14.7648230602334,13.630290597404818,753,1,91107,32400,218,0,1602,1957
12208,1,0,0,0,41,0,581,0,0,227532,1750638,29.13760456866693,819,1147,1117,849,56350,474260,505190,2032,2911,2092,2330,3209,16.3707055437449,5.5503012171862105,879,1,208005,3150,268,0,1213,1794
12209,1,0,0,0,41,0,577,0,0,257240,1791960,29.5296461204668,872,1167,1167,872,56133,499365,474705,2055,2927,2055,2350,3222,17.175564037317667,0.0,872,1,201432,0,295,0,1183,1760
12210,1,0,0,0,41,0,563,0,0,357018,1937694,30.692018506445613,942,1321,1321,942,52624,520421,427856,2057,2999,2057,2436,3378,19.467922333931785,0.0,942,0,195936,0,379,0,1115,1678
12211,1,0,0,0,40,0,90,1,0,263200,947520,21.6794833886788,320,1180,1030,470,35280,338688,423360,1866,2486,2166,2576,3196,23.664319132398465,12.459604606992961,620,1,98700,11700,560,0,1546,1456
12212,1,0,0,0,40,0,252,0,0,512653,1212217,24.515301344262525,250,1805,1454,601,44103,486097,369111,1666,2618,2368,2870,3822,29.206163733020468,18.795527393413874,952,1,109983,69147,853,0,1416,1164
12213,0,1,1,0,56,0,563,0,0,209664,2319408,28.61817604250837,759,1135,1075,819,49533,591888,671184,2772,3651,2892,3088,3967,16.0,7.789174875971784,879,1,194103,6000,256,0,2013,2576
12214,0,1,1,0,56,0,424,0,0,165737,1884839,25.903667693977237,581,1008,918,671,54168,623598,685396,2719,3480,2899,3056,3817,15.716233645501712,9.48712577043745,761,1,163724,9270,247,0,2138,2562
12215,0,0,1,0,52,1,213,0,0,1703448,3736824,37.62977544445356,1416,2619,2619,1416,41924,588497,496132,2639,4055,2639,3842,5258,34.68429039204925,0.0,1416,0,266208,0,1203,0,1223,1436
12216,1,0,0,0,41,0,428,0,0,447008,1896120,30.265491900843113,886,1434,1404,916,51088,513360,426420,2040,2986,2100,2558,3504,22.090722034374522,5.5965095842615735,946,1,188696,4770,488,0,1154,1582
12217,1,0,0,0,41,0,8,1,0,56628,485550,15.297058540778355,84,626,476,234,29070,354825,352750,1925,2309,2225,2317,2701,15.556349186104045,12.613010185831968,384,1,39780,19200,242,0,1841,1833
12218,1,0,0,0,43,0,391,1,0,127836,1320570,24.55605831561735,363,1055,815,603,37100,383250,464280,1950,2793,2430,2402,3245,14.560219778561036,15.728519877504674,843,1,127836,20400,212,0,1587,1978
12219,1,0,0,0,41,0,644,0,0,158460,1723878,28.879058156387302,804,1054,1024,834,48576,396864,522951,2037,2901,2097,2257,3121,13.784048752090222,5.572104574801163,864,1,211002,1440,190,0,1233,1877
12220,1,0,0,0,41,0,448,0,0,451088,1914328,30.528675044947494,932,1416,1416,932,54718,515554,447772,2054,2986,2054,2538,3470,22.0,0.0,932,0,203176,0,484,0,1122,1570
12221,1,0,0,0,40,0,339,0,0,478926,1806336,29.698484809834994,840,1467,1425,882,56635,481280,493568,2006,2930,2090,2591,3515,23.302360395462088,6.484411467763075,924,1,212562,4956,543,0,1166,1505
12222,1,0,0,0,39,0,42,1,0,16200,296700,12.24744871391589,16,392,258,150,19096,304612,245272,1844,2128,2112,2086,2370,10.392304845413264,12.727073254321974,284,1,18600,20234,108,0,1828,1870
12223,1,0,0,0,41,0,33,1,0,195534,877986,20.639767440550294,359,952,885,426,27633,377163,311211,1994,2487,2128,2520,3013,21.42428528562855,8.922530860130468,493,1,64326,10921,459,0,1635,1602
12224,0,1,1,0,55,0,193,0,0,190050,1495422,23.302360395462088,368,1068,893,543,53000,583848,688500,2579,3297,2929,3104,3822,18.708286933869708,13.470838687753037,718,1,135750,11900,350,0,2211,2404
12225,0,1,1,0,54,0,100,0,0,185856,1321804,22.0,283,1069,868,484,53655,598089,669095,2530,3215,2932,3115,3800,19.595917942265423,14.74661454265269,685,1,118580,16080,384,0,2247,2347
12226,0,0,1,0,54,1,1013,0,0,1250214,4681800,41.641325627314025,1734,2455,2455,1734,45888,645300,518400,2700,4434,2700,3421,5155,26.851443164195103,0.0,1734,1,332928,0,721,0,966,1979
12227,1,0,0,0,40,0,413,0,0,472164,1890504,30.397368307141328,924,1435,1435,924,52884,478764,462396,2046,2970,2046,2557,3481,22.60530911091463,0.0,924,0,208824,0,511,0,1122,1535
12228,0,1,1,0,56,0,404,0,0,293280,2219100,27.92848008753788,605,1331,1156,780,56608,660040,694180,2670,3625,3020,3221,4176,19.390719429665317,13.28071670500598,955,1,190320,18900,376,0,2065,2469
12229,0,1,1,0,55,0,360,0,0,228721,1929272,26.28687885618983,529,1184,1022,691,55552,625408,692416,2630,3483,2954,3123,3976,18.193405398660254,12.835667595140963,853,1,171368,14580,331,0,2101,2461
12230,1,0,0,0,45,0,163,0,1,215670,1255863,23.515952032609693,311,1185,943,553,47096,461013,526872,2029,2824,2513,2661,3456,19.748417658131498,16.842470750656727,795,1,128296,23958,390,0,1718,1881
12231,1,0,0,0,41,0,692,0,0,156960,1797192,29.5296461204668,872,1052,1052,872,52858,441054,509067,2061,2933,2061,2241,3113,13.416407864998739,0.0,872,1,215384,0,180,0,1189,1881
12232,1,0,0,0,41,0,111,1,0,529090,1636725,28.0178514522438,743,1501,1459,785,27392,446190,266880,2043,2870,2127,2759,3586,25.96150997149434,6.5135556243263055,827,1,100480,9240,674,0,1300,1411
12233,1,0,0,0,41,0,33,1,0,165784,878104,20.591260281974,394,845,815,424,22627,387277,250591,2041,2495,2101,2462,2916,19.77371993328519,6.300703649796459,454,1,51304,5880,391,0,1647,1680
12234,1,0,0,0,41,0,7,1,0,234728,1023824,22.090722034374522,380,1077,969,488,30798,365052,371346,1990,2586,2206,2579,3175,21.93171219946131,10.394308954048586,596,1,86376,13392,481,0,1610,1617
12235,0,1,1,0,57,0,242,0,0,382259,2140350,27.40437921208944,432,1579,1260,751,55596,701100,644100,2531,3601,3169,3359,4429,22.561028345356956,17.8837378312632,1070,1,169726,48169,509,0,2099,2341
12236,0,1,1,0,56,0,333,0,0,312750,2131500,27.386127875258307,534,1383,1167,750,56882,676396,679238,2626,3592,3058,3259,4225,20.42057785666214,14.725285665086579,966,1,179250,26352,417,0,2092,2425
12237,0,1,1,0,56,0,389,0,0,270750,2100000,27.386127875258307,570,1291,1111,750,56334,641200,688800,2620,3550,2980,3161,4091,19.0,13.466234094236986,930,1,184500,18180,361,0,2050,2439
12238,0,0,1,0,54,1,1169,0,0,1415310,5218120,43.70354676682432,1910,2651,2651,1910,47083,652948,538204,2732,4642,2732,3473,5383,27.2213151776324,0.0,1910,1,376270,0,741,0,822,1991
12239,0,0,1,0,59,1,197,0,0,2865018,4767045,39.96248240537617,1530,3458,3391,1597,55926,698490,713415,2918,4582,3052,4779,6443,42.35563716909474,8.2732738280919,1664,1,381683,8174,1794,0,1388,1191
12240,1,0,0,0,44,0,363,1,0,120330,469560,14.491376746189438,90,903,783,210,32190,413660,389064,2116,2446,2356,2809,3139,23.93741840717165,11.507543736956848,330,1,36540,17040,573,0,2026,1663
12241,1,0,0,0,45,0,29,0,1,308370,1291620,23.874672772626646,436,1245,1111,570,32038,437338,376156,2132,2836,2400,2807,3511,23.259406699226016,12.276872470465587,704,1,94620,21440,541,0,1696,1725
12242,1,0,0,0,40,0,211,0,0,54150,303750,12.24744871391589,30,631,511,150,30114,255150,483975,1905,2175,2145,2386,2656,19.0,12.24744871391589,270,1,35850,0,361,0,1875,1664
12243,1,0,0,0,41,0,56,1,0,173940,930356,21.118712081942874,416,866,836,446,21830,385910,246148,2056,2532,2116,2476,2952,19.748417658131498,6.300703649796459,476,1,52628,5880,390,0,1640,1696
12244,0,0,1,0,54,1,1215,0,0,1382596,5279354,43.94314508543966,1901,2677,2647,1931,45825,642490,533130,2704,4665,2764,3450,5411,26.758176320519304,5.531194905403055,1961,1,376545,5400,716,0,803,2018
12245,1,0,0,0,43,0,59,1,0,108360,776520,18.973665961010276,60,961,661,360,35640,355905,465912,1857,2517,2457,2458,3118,17.349351572897472,17.82818839664469,660,1,77760,19500,301,0,1797,1856
12246,1,0,0,0,40,0,257,1,0,52394,270814,11.575836902790225,26,633,525,134,25368,305171,339528,1913,2155,2129,2412,2654,19.77371993328519,12.132063136325693,242,1,22512,11016,391,0,1887,1630
12247,0,1,1,0,55,0,263,0,0,297990,1937628,26.324893162176366,453,1363,1123,693,56628,654264,676632,2556,3489,3036,3226,4159,20.73644135332772,15.537188462367766,933,1,167706,27600,430,0,2103,2366
12248,0,0,1,0,59,1,1128,0,0,615060,1191126,20.049937655763422,294,2040,1932,402,50358,645934,684453,2855,3365,3071,4493,5003,39.11521443121589,10.498474454302341,510,1,92862,12744,1530,0,2561,1433
12249,1,0,0,0,44,0,661,0,1,0,1483945,25.709920264364882,271,1051,661,661,43618,433285,507370,1855,2906,2635,2245,3296,0.0,20.16436884155414,1051,1,149386,35880,0,0,1584,2245
12250,1,0,0,0,44,0,481,0,1,51390,1269904,23.895606290697042,171,1061,661,571,45305,455920,491504,1824,2795,2624,2314,3285,9.486832980505138,20.323592775672303,971,1,126191,45600,90,0,1653,2134
12251,1,0,0,0,41,0,732,0,0,187533,1921980,30.54504869860253,903,1164,1134,933,53312,461440,490280,2030,2993,2090,2261,3224,14.177446878757825,5.490867587491313,963,1,222054,3480,201,0,1127,1859
12252,0,1,0,1,66,0,2024,0,0,8314992,13603392,63.7808748764079,3338,6842,6112,4068,51562,849376,678832,2614,7412,4074,5388,10186,45.21061822182926,27.19037653850056,4798,1,825804,130670,2044,0,724,1300
12253,0,0,1,0,54,1,551,0,0,919106,3447284,35.679125549822544,1213,2055,1995,1273,53280,601176,649920,2648,3981,2768,3430,4763,26.870057685088806,7.822290851349969,1333,1,305520,6600,722,0,1435,1986
12254,0,0,1,0,55,1,136,0,0,1007412,2990016,32.77193921634788,755,2331,2012,1074,32574,509472,495552,2465,3858,3103,3722,5115,30.62678566222711,18.903073335319583,1393,1,191172,43384,938,0,1710,1846
12255,1,0,0,0,44,0,273,1,0,179838,689997,17.578395831246947,156,1044,891,309,28750,513590,279125,2080,2542,2386,2815,3277,24.124676163629637,14.377494932704868,462,1,38625,36108,582,0,1924,1651
12256,1,0,0,0,42,0,292,1,0,598053,1983558,30.54504869860253,848,1659,1574,933,19312,289136,301892,2041,3059,2211,2767,3785,25.317977802344327,9.714504923012402,1018,1,132486,9265,641,0,1193,1485
12257,1,0,0,0,42,0,69,1,0,336952,1320704,24.819347291981714,492,1287,1163,616,25208,293728,394496,2020,2760,2268,2691,3431,23.388031127053,11.363102531111466,740,1,113344,7812,547,0,1528,1597
12258,0,0,1,0,55,1,1357,0,0,1560300,5802300,45.8257569495584,2058,2885,2843,2100,47096,641016,560889,2721,4863,2805,3506,5648,27.258026340878022,6.503581472166948,2142,1,426300,7056,743,0,663,2020
12259,0,0,1,0,58,1,1088,0,0,602768,1188164,20.09975124224178,404,1896,1896,404,46487,597023,673489,2941,3345,2941,4433,4837,38.62641583165593,0.0,404,1,92516,0,1492,0,2537,1449
12260,1,0,0,0,41,0,742,0,0,179328,1927776,30.56141357987225,934,1126,1126,934,55224,487104,482976,2064,2998,2064,2256,3190,13.856406460551018,0.0,934,1,218556,0,192,0,1130,1872
12261,1,0,0,0,42,0,45,1,0,521500,1592065,27.294688127912362,498,1692,1445,745,25245,352605,326961,1890,2882,2384,2837,3829,26.457513110645905,15.83398173593815,992,1,113985,33592,700,0,1392,1437
12262,0,1,0,1,66,0,2384,0,0,8332265,14252445,65.68865959965997,3644,6917,6246,4315,52961,829053,696933,2632,7618,3974,5234,10220,43.94314508543966,25.986348491885177,4986,1,910465,116083,1931,0,1012,1372
12263,0,1,1,0,55,0,68,0,0,319200,1668600,24.49489742783178,323,1409,1132,600,56640,656316,667440,2504,3381,3058,3313,4190,23.065125189341593,16.940303019898575,877,1,144000,32409,532,0,2181,2249
12264,0,0,1,0,55,1,1400,0,0,1532084,5863086,46.06517122512408,2055,2911,2844,2122,46332,646542,547074,2696,4885,2830,3485,5674,26.870057685088806,8.19672545160342,2189,1,420156,11792,722,0,641,2041
12265,0,0,1,0,55,1,1387,0,0,1873748,6198296,47.20169488482379,2228,3069,3069,2228,49692,684372,561964,2782,5010,2782,3623,5851,29.0,0.0,2228,1,450056,0,841,0,554,1941
12266,1,0,0,0,44,0,181,0,1,111872,972762,20.904544960366874,66,1064,693,437,43485,434070,496398,1855,2663,2597,2482,3290,16.0,20.26400759412332,808,1,97451,36729,256,0,1789,1970
12267,1,0,0,0,45,0,237,0,1,350170,1648326,26.870057685088806,439,1490,1207,722,48840,502260,506826,2000,3005,2566,2768,3773,22.02271554554524,17.008542307442752,1005,1,160284,37639,485,0,1561,1798
12268,1,0,0,0,41,0,741,0,0,206712,1980033,30.93541659651604,957,1173,1173,957,38675,457249,362075,2069,3026,2069,2285,3242,14.696938456699069,0.0,957,0,167475,0,216,0,1112,1853
12269,1,0,0,0,43,0,150,1,0,607464,1847274,29.29163703175362,858,1566,1566,858,30340,441365,318644,2153,3011,2153,2861,3719,26.60826939130014,0.0,858,1,126984,0,708,0,1295,1445
12270,0,0,1,0,54,1,1369,0,0,927402,5073654,43.197222132910355,1638,2591,2363,1866,41174,647122,470387,2491,4585,2947,3216,5310,22.293496809607955,15.104314208383881,2094,1,322818,46740,497,0,853,2222
12271,0,0,1,0,55,1,1425,0,0,1853176,6254469,47.4236228055175,2249,3073,3073,2249,46920,639630,567324,2781,5030,2781,3605,5854,28.705400188814647,0.0,2249,1,458796,0,824,0,532,1957
12272,0,0,1,0,55,1,1422,0,0,1928079,6329277,47.65501022977542,2271,3120,3120,2271,43621,671667,504447,2787,5058,2787,3636,5907,29.13760456866693,0.0,2271,1,411051,0,849,0,516,1938
12273,1,0,0,0,42,0,361,1,0,106176,405120,13.856406460551018,65,872,745,192,31482,335490,417780,1983,2302,2237,2663,2982,23.515952032609693,11.851580430773744,319,1,38016,10033,553,0,1918,1557
12274,1,0,0,0,41,0,732,0,0,218880,1987200,30.983866769659336,960,1188,1188,960,45045,478170,403650,2070,3030,2070,2298,3258,15.0996688705415,0.0,960,0,187200,0,228,0,1110,1842
12275,1,0,0,0,41,0,737,0,0,236918,2036320,31.28897569432403,949,1251,1221,979,33150,459680,312000,2050,3059,2110,2322,3331,15.556349186104045,5.830951894845301,1009,0,146850,6240,242,0,1101,1838
12276,1,0,0,0,41,0,285,0,0,116964,467628,15.0996688705415,18,951,741,228,46046,373282,518903,1841,2279,2261,2564,3002,22.64950330581225,15.749295835151889,438,1,57684,6720,513,0,1823,1538
12277,1,0,0,0,39,0,150,1,0,45000,298950,12.24744871391589,23,577,450,150,15366,392621,155454,1866,2143,2120,2293,2570,17.320508075688775,12.617493041379154,277,1,11700,30480,300,0,1843,1693
12278,1,0,0,0,43,0,123,1,0,326268,1396020,25.219040425836983,606,1179,1149,636,19635,410465,230475,2165,2831,2225,2708,3374,22.64950330581225,5.753771868478424,666,1,66780,6300,513,0,1559,1682
12279,1,0,0,0,43,0,72,1,0,559705,1706590,28.0178514522438,545,1738,1498,785,25344,382624,313056,1934,2959,2414,2887,3912,26.70205984563738,15.494353432296254,1025,1,113040,38640,713,0,1389,1461
12280,0,1,1,0,55,0,49,0,0,318060,1490400,23.2379000772445,322,1347,1129,540,56404,659640,651360,2542,3300,2978,3349,4107,24.269322199023193,14.986277477014655,758,1,127440,26378,589,0,2220,2171
12281,0,1,1,0,54,0,18,0,0,315763,1516879,23.515952032609693,285,1392,1124,553,56643,650091,655577,2475,3296,3011,3314,4135,23.895606290697042,16.44816246538944,821,1,132167,31356,571,0,2190,2172
12282,0,0,1,0,56,1,1395,0,0,2020966,6402767,47.75981574503821,2251,3197,3167,2281,42212,684908,485611,2777,5088,2837,3693,6004,29.765752132274432,5.5965095842615735,2311,1,394613,6270,886,0,526,1921
12283,0,0,1,0,56,1,1342,0,0,2055648,6354026,47.47630988187688,2212,3208,3166,2254,40920,699112,465135,2777,5073,2861,3731,6027,30.199337741083,6.589126398255297,2296,1,371910,9114,912,0,565,1907
12284,0,0,1,0,57,1,880,0,0,1311929,2249246,28.053520278211074,787,2454,2454,787,50740,614470,674488,2858,3645,2858,4525,5312,40.82891132518721,0.0,787,1,185732,0,1667,0,2071,1191
12285,1,0,0,0,46,0,100,0,1,530400,1799460,27.92848008753788,630,1610,1460,780,42630,468321,484470,2157,3087,2457,2987,3917,26.076809620810597,12.296281753706847,930,1,163800,18750,680,0,1527,1627
12286,1,0,0,0,41,0,719,0,0,238602,2003484,31.080540535840107,936,1243,1213,966,51448,452132,489464,2044,3040,2104,2321,3317,15.716233645501712,5.501408174353464,996,0,227976,3330,247,0,1108,1827
12287,1,0,0,0,43,0,150,1,0,666775,1953785,29.916550603303182,865,1670,1640,895,26469,377659,333999,2153,3078,2213,2928,3853,27.294688127912362,5.8721273231371045,925,1,136935,4410,745,0,1288,1438
12288,1,0,0,0,40,0,401,0,1,82650,300750,12.24744871391589,120,731,701,150,29510,455135,260650,1975,2155,2035,2556,2736,23.473389188611005,6.004624280888846,180,1,19500,6900,551,0,1855,1454
12289,0,1,1,0,64,0,462,0,0,6990355,7865058,49.22397789695587,2393,5338,5308,2423,53105,801762,697890,3216,5669,3276,6131,8584,53.71219600798314,5.490867587491313,2453,1,520945,5040,2885,0,823,361
12290,0,1,1,0,55,0,161,0,0,342210,1407090,22.58317958127243,328,1363,1181,510,55029,686991,609739,2577,3269,2941,3430,4122,25.903667693977237,13.6587328104449,692,1,112710,27664,671,0,2249,2088
12291,0,1,1,0,55,0,136,0,0,329460,1405560,22.58317958127243,330,1336,1156,510,55632,672464,628368,2576,3266,2936,3402,4092,25.41653005427767,13.668043639186044,690,1,116280,24300,646,0,2246,2110
12292,0,0,1,0,56,1,1234,0,0,2084211,6211080,46.76537180435969,2127,3200,3140,2187,37128,675920,443040,2780,5027,2900,3793,6040,30.870698080866262,7.896951773353783,2247,0,341172,13200,953,0,653,1887
12293,0,0,1,0,57,1,1070,0,0,2181816,6044220,45.89117562233506,2039,3209,3142,2106,43788,706020,510860,2803,4976,2937,3906,6079,32.18695387886216,8.230562448445415,2173,0,374868,13802,1036,0,764,1834
12294,0,0,1,0,59,1,1003,0,0,950810,1774885,24.392621835300936,219,2569,2193,595,37904,614498,548872,2607,3578,3359,4581,5552,39.97499218261337,19.73802238270061,971,1,109480,59408,1598,0,2388,1385
12295,1,0,0,0,46,0,15,1,0,311866,1317082,23.790754506740637,365,1318,1117,566,28770,488670,318799,2126,2893,2528,2878,3645,23.473389188611005,14.177797783946604,767,1,77542,42009,551,0,1761,1776
12296,1,0,0,0,42,0,742,0,0,429368,2400864,33.52610922848042,1029,1601,1506,1124,42588,538272,360984,2041,3260,2231,2518,3737,19.544820285692065,10.406752992522598,1219,1,189956,20045,382,0,1012,1754
12297,1,0,0,0,41,0,220,1,0,106236,481806,15.297058540778355,72,850,688,234,21945,273847,339735,1897,2293,2221,2513,2909,21.307275752662516,14.477638060374888,396,1,38610,12798,454,0,1825,1605
12298,1,0,0,0,44,0,130,1,0,426111,1620087,26.851443164195103,626,1407,1312,721,34161,397719,433671,2152,2968,2342,2838,3654,24.310491562286437,10.755290438465057,816,1,139153,10450,591,0,1526,1656
12299,0,1,1,0,54,0,184,0,0,318720,1316640,21.908902300206645,330,1294,1144,480,56364,669292,633633,2593,3223,2893,3407,4037,25.768197453450252,12.429640165330436,630,1,110880,20250,664,0,2263,2079
12300,0,1,1,0,54,0,168,0,0,311040,1314240,21.908902300206645,318,1290,1128,480,56386,662596,637954,2576,3218,2900,3386,4028,25.45584412271571,12.850301615905524,642,1,111840,21384,648,0,2258,2090
12301,0,0,1,0,58,1,404,0,0,2424096,5206136,42.09513035969837,1742,3170,3140,1772,47561,702182,584662,2908,4710,2968,4306,6108,36.98648401781386,5.490867587491313,1802,0,352628,5370,1368,0,1166,1570
12302,0,0,1,0,60,1,1162,0,0,173664,404680,11.575836902790225,10,1554,1430,134,48108,637220,688560,2896,3154,3144,4316,4574,36.0,11.284767849177381,258,1,30552,14012,1296,0,2886,1724
12303,0,0,1,0,57,1,65,0,0,250446,1544328,23.108440016582687,333,1204,1003,534,36234,572616,529236,2691,3426,3093,3361,4096,21.656407827707714,14.255752335575957,735,1,97722,29949,469,0,2358,2423
12304,1,0,0,0,44,0,492,1,0,258709,704033,17.86057109949175,42,1407,1130,319,33948,456849,361948,1930,2526,2484,3018,3614,28.478061731796284,17.984633970072554,596,1,52316,49860,811,0,1888,1396
12305,1,0,0,0,41,0,709,1,0,310590,2111200,31.85906464414798,973,1363,1321,1015,41327,388960,459680,2038,3095,2122,2386,3443,17.4928556845359,6.589126398255297,1057,1,224315,3780,306,0,1065,1774
12306,1,0,0,0,41,0,85,1,0,143736,711561,18.411952639521967,71,1031,763,339,25440,335840,333741,1831,2438,2367,2523,3130,20.591260281974,16.500441727537666,607,1,53901,33232,424,0,1760,1675
12307,1,0,0,0,40,0,274,1,0,101640,420630,14.491376746189438,210,694,694,210,35335,382573,370555,2003,2213,2003,2487,2697,22.0,0.0,210,1,38850,0,484,0,1793,1519
12308,1,0,0,0,42,0,2,1,0,87615,628749,17.233687939614086,20,869,592,297,21518,429751,224402,1840,2414,2394,2412,2986,17.175564037317667,18.840995148590093,574,1,31482,62602,295,0,1820,1822
12309,1,0,0,0,45,0,145,1,0,416594,1627388,26.870057685088806,637,1384,1299,722,29435,457562,326830,2169,2976,2339,2831,3638,24.020824298928627,10.144105028098583,807,1,104690,16405,577,0,1532,1677
12310,0,1,1,0,65,0,2225,0,0,8814414,14035391,65.4446330878247,3759,6865,6341,4283,54093,809419,717663,2753,7560,3801,5335,10142,45.36518488885502,22.942974759366177,4807,0,937977,84888,2058,1,1006,1219
12311,0,1,1,0,63,0,1344,0,0,2642497,3470791,32.96968304366907,427,4178,3518,1087,53500,683302,798250,2533,4280,3853,5624,7371,49.3051721424842,25.7128619298132,1747,1,271750,46860,2431,0,2106,762
12312,0,0,1,0,56,1,1285,0,0,1972674,6213267,46.76537180435969,2187,3089,3089,2187,34854,630702,446037,2841,5028,2841,3743,5930,30.033314835362415,0.0,2187,1,343359,0,902,0,654,1939
12313,1,0,0,0,44,0,491,1,0,281370,749190,18.411952639521967,42,1466,1169,339,43497,537030,395590,1913,2549,2507,3040,3676,28.809720581775867,18.39317890756856,636,1,60681,60291,830,0,1871,1380
12314,1,0,0,0,41,0,723,0,0,376974,2225328,32.77193921634788,1032,1467,1425,1074,46258,418544,474488,2030,3146,2114,2423,3539,18.734993995195193,6.481658975540136,1116,0,245946,4200,351,0,998,1721
12315,1,0,0,0,46,0,85,0,1,377034,1526560,25.65151067676132,402,1487,1231,658,35872,352640,547520,2064,2978,2576,2893,3807,23.93741840717165,16.054650996402273,914,1,155288,4096,573,0,1662,1747
12316,1,0,0,0,41,0,152,1,0,104448,531968,16.0,161,759,664,256,36188,344948,453004,1983,2334,2173,2486,2837,20.199009876724155,10.338881435266707,351,1,55808,6080,408,0,1822,1670
12317,0,0,1,0,57,1,1116,0,0,2044861,6006910,45.749316934791494,2093,3070,3070,2093,44103,691670,525210,2870,4963,2870,3847,5940,31.25699921617557,0.0,2093,0,383019,0,977,0,777,1893
12318,1,0,0,0,41,0,618,0,0,180144,452088,14.696938456699069,6,1260,1050,216,40488,504413,351624,1883,2309,2303,2927,3353,28.879058156387302,14.67705273044268,426,1,36288,44520,834,0,1877,1259
12319,1,0,0,0,45,0,238,1,0,354288,1114104,22.090722034374522,106,1596,1214,488,33572,497694,351582,1901,2771,2665,3009,3879,26.94438717061496,19.572920166965222,870,1,75152,76782,726,0,1795,1557
12320,1,0,0,0,48,0,300,1,0,587461,2250227,30.512292604784715,836,1657,1562,931,34969,451979,451979,2322,3348,2512,3048,4074,25.11971337416094,10.115242524801646,1026,1,174097,12350,631,0,1486,1786
12321,1,0,0,0,42,0,76,1,0,109445,619500,17.175564037317667,187,774,666,295,41174,363300,499800,1992,2395,2208,2471,2874,19.261360284258224,11.029743904822288,403,1,70210,5076,371,0,1805,1729
12322,1,0,0,0,41,0,94,1,0,108015,593655,16.881943016134134,200,749,664,285,44073,368691,518667,1998,2368,2168,2462,2832,19.467922333931785,9.67057657670449,370,1,70965,2805,379,0,1798,1704
12323,1,0,0,0,40,0,180,1,0,121500,550530,16.431676725154983,240,750,720,270,24366,379254,267109,2009,2309,2069,2489,2789,21.213203435596427,6.148342568763683,300,1,35370,5580,450,0,1769,1589
12324,0,0,1,0,57,1,1278,0,0,1905120,6166800,46.475800154489,2100,3102,3042,2160,36792,625245,479640,2795,5015,2915,3737,5957,29.698484809834994,8.016064826688304,2220,1,362880,11340,882,0,695,1973
12325,1,0,0,0,41,0,408,0,1,145008,477660,15.0996688705415,228,864,864,228,53946,465090,509085,2095,2323,2095,2731,2959,25.219040425836983,0.0,228,1,55404,0,636,0,1867,1459
12326,1,0,0,0,41,0,728,0,0,497940,2400534,34.02939905434711,1158,1588,1588,1158,43875,466425,404235,2073,3231,2073,2503,3661,20.73644135332772,0.0,1158,0,225810,0,430,0,915,1643
12327,1,0,0,0,45,0,144,0,1,631620,1988820,29.49576240750525,636,1830,1596,870,28175,368046,400050,2052,3156,2520,3012,4116,26.94438717061496,16.014932695390826,1104,1,152250,25272,726,0,1416,1560
12328,1,0,0,0,45,0,68,1,0,748800,2049300,30.0,565,2067,1732,900,31603,425799,384813,1942,3177,2612,3109,4344,28.844410203711913,18.667722384469624,1235,1,152100,49915,832,0,1377,1445
12329,0,0,1,0,60,1,453,0,0,495558,1554903,22.64950330581225,428,1564,1479,513,40898,733502,512239,2946,3544,3116,3997,4595,31.080540535840107,9.257905235465769,598,1,86697,17935,966,0,2518,2065
12330,0,0,1,0,56,1,415,0,0,2107566,3570524,35.482389998420345,1135,3057,2933,1259,31590,553020,459432,2712,4095,2960,4510,5893,40.91454509095757,11.388237031910945,1383,1,203958,20708,1674,0,1577,1162
12331,1,0,0,0,41,0,719,0,0,519590,2431355,34.132096331752024,1135,1641,1611,1165,38701,352703,477923,2057,3252,2117,2533,3728,21.118712081942874,5.753771868478424,1195,0,266785,1620,446,0,922,1641
12332,1,0,0,0,45,0,189,1,0,662650,2093060,30.23243291566195,914,1639,1639,914,37910,510670,389300,2290,3204,2290,3015,3929,26.92582403567252,0.0,914,1,155380,0,725,0,1376,1565
12333,1,0,0,0,45,0,55,1,0,760500,2061000,30.0,570,2075,1745,900,36839,451130,428230,1960,3190,2620,3135,4365,29.068883707497267,18.50903282713177,1230,1,168300,47190,845,0,1390,1445
12334,1,0,0,0,40,0,74,0,1,133320,665940,18.16590212458495,160,904,734,330,42315,393510,437906,1848,2348,2188,2422,2922,20.09975124224178,13.30116108744132,500,1,71610,18190,404,0,1688,1614
12335,1,0,0,0,41,0,262,0,0,176439,644883,17.578395831246947,309,880,880,309,55932,492532,494619,2087,2396,2087,2658,2967,23.895606290697042,0.0,309,0,73233,0,571,0,1778,1516
12336,1,0,0,0,43,0,348,1,0,166860,582390,16.431676725154983,162,996,888,270,15440,416301,172560,2049,2427,2265,2775,3153,24.859605789312106,11.4174078303941,378,1,21600,25488,618,0,1887,1539
12337,1,0,0,0,41,0,716,0,0,564060,2487100,34.49637662132068,1160,1694,1664,1190,46000,384560,522500,2060,3280,2120,2564,3784,21.77154105707724,5.684275577662207,1220,0,297500,0,474,0,900,1616
12338,1,0,0,0,43,0,147,0,1,112590,902805,20.42057785666214,264,840,687,417,40176,350730,536920,2012,2582,2318,2435,3005,16.431676725154983,13.813071468500196,570,1,103416,1530,270,0,1748,1895
12339,1,0,0,0,41,0,37,0,1,116964,740772,19.0,361,685,685,361,41314,465804,373464,2052,2413,2052,2376,2737,18.0,0.0,361,1,65702,0,324,0,1691,1728
12340,1,0,0,0,42,0,201,1,0,331540,1033824,22.0,187,1466,1169,484,40635,459240,403704,1839,2620,2433,2821,3602,26.1725046566048,17.234127512836046,781,1,91476,48708,685,0,1652,1451
12341,0,1,1,0,65,0,1183,0,0,9281840,12189805,60.78651166171653,3143,6759,6207,3695,53000,824750,699388,2747,6994,3851,5811,10058,50.11985634456667,23.60814683906498,4247,0,783340,94944,2512,1,396,787
12342,0,0,1,0,60,1,291,0,0,106636,639816,14.560219778561036,62,865,715,212,47586,621708,697158,2868,3230,3168,3521,3883,22.427661492005804,12.587015179069688,362,1,48972,15450,503,0,2806,2515
12343,1,0,0,0,41,0,175,0,1,198006,765672,19.131126469708992,366,907,907,366,56640,493712,502080,2092,2458,2092,2633,2999,23.259406699226016,0.0,366,1,87840,0,541,0,1726,1551
12344,1,0,0,0,43,0,470,0,0,387000,926220,20.73644135332772,40,1720,1330,430,39093,536346,338178,1764,2584,2544,3054,3874,30.0,20.12326204592415,820,1,67510,86190,900,0,1724,1254
12345,1,0,0,0,46,0,247,0,1,386070,1769109,27.51363298439521,545,1479,1267,757,42090,427671,537510,2125,3094,2549,2847,3816,22.58317958127243,14.735922616710878,969,1,174110,15476,510,0,1580,1827
12346,1,0,0,0,43,0,203,0,1,106320,959095,21.047565179849187,293,833,683,443,39273,344235,534755,2015,2608,2315,2405,2998,15.491933384829668,13.726027160737042,593,1,109421,1200,240,0,1722,1925
12347,1,0,0,0,42,0,403,1,0,330888,871896,20.199009876724155,29,1598,1219,408,41600,427400,444496,1758,2545,2516,2948,3735,28.478061731796284,19.748579954106315,787,1,84864,46996,811,0,1729,1326
12348,1,0,0,0,46,0,270,0,1,491571,1990905,29.13760456866693,715,1562,1428,849,38817,532315,400995,2211,3194,2479,2924,3907,24.06241883103193,12.035289626712379,983,1,145179,26264,579,0,1496,1766
12349,1,0,0,0,44,0,292,0,1,129228,1194024,23.108440016582687,264,1046,776,534,39816,375648,529932,1966,2770,2506,2478,3282,15.556349186104045,18.09142219343363,804,1,126558,11070,242,0,1702,1994
12350,1,0,0,0,44,0,288,0,1,117648,1143972,22.715633383201094,276,984,744,516,42558,383541,545382,1977,2733,2457,2445,3201,15.0996688705415,17.08259376953534,756,1,126936,8160,228,0,1701,1989
12351,1,0,0,0,42,0,228,0,1,97228,946858,21.118712081942874,356,754,664,446,39184,335434,526504,2033,2569,2213,2341,2877,14.7648230602334,10.735745725090142,536,1,110608,270,218,0,1677,1905
12352,1,0,0,0,41,0,166,0,1,109392,870472,20.591260281974,424,682,682,424,48930,431130,478349,2053,2477,2053,2311,2735,16.06237840420901,0.0,424,1,98792,0,258,0,1629,1795
12353,1,0,0,0,43,0,8,0,1,386868,1334880,24.859605789312106,288,1574,1244,618,38376,336960,531360,1830,2778,2490,2786,3734,25.019992006393608,18.170946107335194,948,1,152028,0,626,0,1542,1534
12354,1,0,0,0,42,0,105,1,0,183436,803859,19.467922333931785,294,948,863,379,37518,470862,358449,2036,2500,2206,2605,3069,22.0,9.548881526149486,464,1,64051,16320,484,0,1742,1637
12355,1,0,0,0,44,0,191,1,0,198360,794160,18.973665961010276,168,1103,911,360,24062,500762,233836,2014,2566,2398,2757,3309,23.473389188611005,15.047110924338881,552,1,38160,47040,551,0,1846,1655
12356,1,0,0,0,42,0,359,1,0,342936,928352,20.808652046684813,25,1633,1225,433,41160,420224,450240,1736,2577,2552,2936,3777,28.142494558940577,20.41972640286493,841,1,90930,47328,792,0,1711,1352
12357,1,0,0,0,44,0,340,0,1,108741,1198856,23.259406699226016,299,984,742,541,43172,381152,556216,1974,2757,2458,2417,3200,14.177446878757825,16.78101775240627,783,1,135791,4840,201,0,1675,2015
12358,1,0,0,0,43,0,328,0,1,92820,1110270,22.58317958127243,328,874,692,510,44781,385329,550781,1995,2687,2359,2359,3051,13.490737563232042,14.878152983881654,692,1,129030,3640,182,0,1667,1995
12359,1,0,0,0,43,0,317,0,1,89460,1071532,22.293496809607955,344,830,677,497,44528,379456,545468,2003,2653,2309,2336,2986,13.416407864998739,13.622187971478935,650,1,125741,2754,180,0,1659,1976
12360,1,0,0,0,42,0,303,0,1,88270,1035960,22.02271554554524,361,791,667,485,44958,378072,542544,2012,2621,2260,2318,2927,13.490737563232042,12.261169997086926,609,1,123190,2480,182,0,1651,1954
12361,1,0,0,0,42,0,284,0,1,90060,1002510,21.77154105707724,379,759,664,474,42840,359550,532980,2020,2589,2210,2305,2874,13.784048752090222,10.702660118511865,569,1,119448,1235,190,0,1641,1925
12362,1,0,0,0,43,0,262,1,0,392439,1105039,22.561028345356956,359,1430,1280,509,36330,375583,455910,2021,2680,2321,2942,3601,27.76688675382964,12.561867176898298,659,1,106890,12600,771,0,1662,1400
12363,1,0,0,0,43,0,13,0,1,449528,1459472,25.768197453450252,381,1624,1341,664,43848,382452,553896,1915,2862,2481,2875,3822,26.019223662515376,16.8579902899916,947,1,167328,5660,677,0,1534,1521
12364,1,0,0,0,45,0,159,0,0,601300,1594600,26.457513110645905,190,2069,1559,700,32562,553554,305252,1768,2978,2788,3137,4347,29.30870177950569,22.639427039507105,1210,1,93800,117810,859,0,1578,1419
12365,1,0,0,0,43,0,736,1,0,950340,3099180,37.54996671103717,1209,2285,2084,1410,26322,470372,270354,1997,3608,2399,2872,4483,25.96150997149434,15.384996586793083,1611,1,173430,45024,674,0,788,1524
12366,1,0,0,0,45,0,384,0,1,144612,1404714,24.859605789312106,309,1161,852,618,46552,418232,575069,1964,2891,2582,2507,3434,15.297058540778355,19.115039334119135,927,1,156354,10815,234,0,1655,2039
12367,1,0,0,0,44,0,391,0,1,99050,1251992,23.790754506740637,338,969,741,566,41250,364980,553000,1984,2778,2440,2387,3181,13.228756555322953,16.357012689701328,794,1,141500,2280,175,0,1646,2037
12368,1,0,0,0,41,0,272,0,1,102608,998976,22.0,442,738,696,484,49504,429312,491232,2022,2548,2106,2276,2802,14.560219778561036,6.570697549716149,526,1,115192,4032,212,0,1580,1852
12369,1,0,0,0,42,0,94,1,0,188760,1038664,22.0,334,1024,874,484,37620,489288,354090,1996,2630,2296,2536,3170,19.748417658131498,13.07479579843849,634,1,79860,30300,390,0,1662,1756
12370,0,1,1,0,65,0,1069,0,0,9570770,12072764,60.61352984276695,3207,6746,6279,3674,53136,808356,709776,2819,6960,3753,5891,10032,51.03920062069938,21.714093482707845,4141,0,793584,77522,2605,1,388,681
12371,0,0,1,0,54,1,373,0,0,1494150,2868600,32.4037034920393,1020,2503,2473,1050,49940,620164,601040,2702,3782,2762,4155,5235,37.72267222772003,5.490867587491313,1080,0,231000,4260,1423,0,1682,1309
12372,1,0,0,0,42,0,127,0,1,352974,1395371,25.709920264364882,661,1195,1195,661,51465,496085,462309,2111,2772,2111,2645,3306,23.108440016582687,0.0,661,1,144759,0,534,0,1450,1577
12373,1,0,0,0,42,0,122,0,1,329208,1345542,25.25866188063018,638,1154,1154,638,52560,506160,461871,2109,2747,2109,2625,3263,22.715633383201094,0.0,638,1,139722,0,516,0,1471,1593
12374,1,0,0,0,42,0,117,0,1,307384,1300376,24.819347291981714,616,1115,1115,616,52416,531972,439088,2111,2727,2111,2610,3226,22.338307903688676,0.0,616,1,128128,0,499,0,1495,1612
12375,1,0,0,0,42,0,88,0,0,238164,1127274,23.108440016582687,534,980,980,534,54044,483419,498196,2111,2645,2111,2557,3091,21.118712081942874,0.0,534,0,126024,0,446,0,1577,1665
12376,1,0,0,0,41,0,699,0,0,813906,2732775,36.29049462324811,1317,1935,1935,1317,40542,483475,361050,2075,3392,2075,2693,4010,24.859605789312106,0.0,1317,0,229158,0,618,0,758,1457
12377,1,0,0,0,46,0,405,0,1,206500,1622600,26.457513110645905,324,1371,995,700,46552,426512,586454,1942,3018,2694,2613,3689,17.175564037317667,21.006907292134862,1076,1,177100,9024,295,0,1618,2023
12378,1,0,0,0,46,0,412,0,1,182240,1564000,26.076809620810597,329,1299,948,680,46872,427800,579600,1949,2980,2651,2568,3599,16.3707055437449,20.26259535821986,1031,1,171360,9126,268,0,1620,2032
12379,1,0,0,0,45,0,426,0,1,138672,1454772,25.337718918639855,347,1153,858,642,50600,453200,573298,1971,2908,2561,2482,3419,14.696938456699069,18.703283323631105,937,1,162426,14455,216,0,1624,2050
12380,1,0,0,0,42,0,417,0,1,67084,1146920,23.259406699226016,433,773,665,541,45974,383720,538480,2012,2661,2228,2244,2893,11.135528725660043,10.948360265819424,649,1,137414,2808,124,0,1579,1996
12381,1,0,0,0,43,0,15,0,1,291004,1154440,23.065125189341593,290,1321,1079,532,36477,410130,418810,1928,2702,2412,2717,3491,23.388031127053,16.057610462698644,774,1,102676,30492,547,0,1638,1623
12382,1,0,0,0,47,0,371,0,1,502146,2158218,30.298514815086232,702,1681,1465,918,54026,559538,533677,2135,3269,2567,2898,4032,23.388031127053,14.94637983906396,1134,1,208386,31104,547,0,1433,1804
12383,1,0,0,0,47,0,384,0,1,425536,2050944,29.5296461204668,617,1615,1360,872,47817,595056,444528,2097,3224,2607,2840,3967,22.090722034374522,16.171360672227685,1127,1,164808,50490,488,0,1480,1864
12384,1,0,0,0,42,0,489,0,1,52110,1237323,24.06241883103193,455,793,669,579,42168,359016,536387,2013,2716,2261,2227,2930,9.486832980505138,11.83231048371444,703,1,145329,0,90,0,1558,2047
12385,0,1,1,0,65,0,1345,0,0,9797346,12664106,62.24146527838174,3597,6680,6403,3874,52920,823788,686490,2992,7143,3546,5798,9949,50.28916384272063,16.742690253690217,4151,0,813540,48198,2529,1,605,740
12386,0,0,1,0,59,1,421,0,0,282302,1072170,19.0,119,1385,1143,361,56120,683100,724680,2728,3331,3212,3752,4355,27.964262908219126,15.767758349010741,603,1,88084,24442,782,0,2609,2188
12387,0,0,1,0,54,1,429,0,0,1545372,2869827,32.357379374726875,1047,2523,2523,1047,42064,655099,482416,2741,3788,2741,4217,5264,38.41874542459709,0.0,1047,0,184272,0,1476,0,1694,1265
12388,1,0,0,0,42,0,216,0,0,456192,1679040,28.142494558940577,792,1368,1368,792,51948,496080,470640,2120,2912,2120,2696,3488,24.0,0.0,792,0,175824,0,576,0,1328,1544
12389,1,0,0,0,43,0,163,1,0,189164,1137080,22.891046284519195,416,993,885,524,23056,381920,284270,2062,2694,2278,2531,3163,19.0,11.227269336102799,632,1,68644,18684,361,0,1646,1809
12390,1,0,0,0,41,0,665,0,0,880464,2759584,36.4417343165772,1328,1991,1991,1328,54520,482096,488330,2078,3406,2078,2741,4069,25.748786379167466,0.0,1328,1,312080,0,663,0,750,1415
12391,1,0,0,0,47,0,387,0,1,550080,2258880,30.983866769659336,732,1761,1533,960,54752,545896,555308,2125,3313,2581,2926,4114,23.93741840717165,15.346337827304712,1188,1,226560,29184,573,0,1393,1780
12392,1,0,0,0,43,0,546,0,1,53635,1375580,25.11971337416094,469,878,716,631,42336,366240,549360,2018,2811,2342,2265,3058,9.219544457292887,13.953485904069112,793,1,159012,1134,85,0,1549,2095
12393,1,0,0,0,42,0,547,0,1,36420,1294731,24.63736998950984,499,775,667,607,43344,366876,537516,2025,2740,2241,2193,2908,7.745966692414834,11.137157851700797,715,1,152964,0,60,0,1526,2073
12394,0,0,0,0,56,1,458,1,0,1109643,2394180,29.13760456866693,674,2331,2156,849,49530,549900,716280,2645,3669,2995,4127,5151,36.15245496505044,13.784144208499974,1024,1,215646,8225,1307,0,1971,1513
12395,1,0,0,0,44,0,64,1,0,301476,1164464,22.759613353482084,72,1546,1100,518,37909,375416,510296,1802,2766,2694,2830,3794,24.124676163629637,21.799009182438454,964,1,117586,23638,582,0,1730,1666
12396,1,0,0,0,45,0,508,0,1,181500,1694250,27.386127875258307,467,1275,992,750,49698,447282,567009,1976,3009,2542,2501,3534,15.556349186104045,18.016865855193082,1033,1,188250,12169,242,0,1509,2017
12397,1,0,0,0,43,0,561,0,1,84940,1506315,26.1725046566048,473,1021,809,685,52500,461790,549750,1987,2884,2411,2323,3220,11.135528725660043,15.623712400849232,897,1,171250,13568,124,0,1514,2075
12398,1,0,0,0,43,0,107,1,0,394668,1254398,24.020824298928627,482,1356,1261,577,30464,517412,278272,2079,2751,2269,2858,3530,26.153393661244042,10.890370454394295,672,1,73856,22610,684,0,1597,1490
12399,1,0,0,0,42,0,285,0,0,604584,1995687,30.54504869860253,933,1581,1581,933,54984,496248,506943,2139,3072,2139,2787,3720,25.45584412271571,0.0,933,0,221121,0,648,0,1206,1491
12400,1,0,0,0,42,0,314,0,0,612155,2039880,30.903074280724887,955,1596,1596,955,50380,489144,469920,2136,3091,2136,2777,3732,25.317977802344327,0.0,955,0,210100,0,641,0,1181,1495
12401,1,0,0,0,44,0,269,1,0,170700,1255783,23.853720883753127,399,1039,869,569,26775,386225,337671,2037,2776,2377,2507,3246,17.320508075688775,14.025893816633586,739,1,87057,25500,300,0,1638,1907
12402,1,0,0,0,45,0,174,1,0,197640,1217700,23.2379000772445,231,1215,906,540,19436,387860,254815,1946,2795,2564,2621,3470,19.131126469708992,18.691082135373232,849,1,61020,57165,366,0,1715,1889
12403,1,0,0,0,47,0,408,0,1,704880,2540772,32.68026927673638,798,1998,1728,1068,55000,523380,594750,2109,3447,2649,3039,4377,25.69046515733026,16.82449396250488,1338,1,267000,23760,660,0,1311,1719
12404,1,0,0,0,47,0,415,0,1,658350,2465155,32.32645975048923,773,1947,1675,1045,48006,445851,599186,2087,3404,2631,2989,4306,25.099800796022265,16.72299974844108,1317,1,265430,8976,630,0,1314,1729
12405,1,0,0,0,46,0,422,0,1,613200,2393524,31.96873472629156,745,1899,1622,1022,53250,498846,585500,2065,3364,2619,2942,4241,24.49489742783178,16.76687462490817,1299,1,255500,19113,600,0,1320,1742
12406,1,0,0,0,46,0,453,0,1,447840,2175756,30.54504869860253,609,1737,1413,933,44275,589996,408100,2008,3265,2656,2812,4069,21.908902300206645,18.061583101502052,1257,1,163275,66096,480,0,1399,1852
12407,1,0,0,0,45,0,522,0,1,213840,1788336,28.142494558940577,515,1339,1062,792,49082,438052,571274,1981,3050,2535,2528,3597,16.431676725154983,17.857586598316747,1069,1,200376,10803,270,0,1466,1988
12408,1,0,0,0,43,0,608,0,1,62820,1518848,26.419689627245813,523,963,788,698,52416,452608,548352,2001,2874,2351,2266,3139,9.486832980505138,14.162333245144376,873,1,175896,10675,90,0,1478,2086
12409,1,0,0,0,42,0,644,0,1,20220,1443034,25.96150997149434,554,824,704,674,44275,374675,541673,2021,2815,2261,2171,2965,5.477225575051661,11.641833359781362,794,1,170522,2160,30,0,1467,2111
12410,1,0,0,0,42,0,664,0,1,0,1407680,25.768197453450252,574,754,664,664,45212,377360,538480,2030,2784,2210,2120,2874,0.0,10.099504938362077,754,1,168656,1890,0,0,1456,2120
12411,1,0,0,0,41,0,588,0,1,38880,1351080,25.45584412271571,618,738,708,648,49082,404490,527505,2055,2733,2115,2145,2823,7.745966692414834,5.7180036243905645,678,1,163944,1500,60,0,1437,2025
12412,1,0,0,0,43,0,246,1,0,248040,1385208,25.219040425836983,420,1242,1026,636,34697,481338,341946,1962,2814,2394,2568,3420,19.748417658131498,15.628102547800594,852,1,99852,43632,390,0,1542,1788
12413,1,0,0,0,45,0,98,0,1,578243,1847458,28.478061731796284,461,1874,1524,811,52152,560388,482936,1928,3089,2628,2991,4152,26.70205984563738,18.882386696959433,1161,1,171932,59850,713,0,1467,1565
12414,1,0,0,0,41,0,30,0,1,119491,681198,18.193405398660254,246,777,692,331,50096,415716,510384,1973,2389,2143,2419,2835,19.0,9.905159296613471,416,1,82088,4250,361,0,1727,1697
12415,0,0,1,0,55,1,1411,0,0,661122,4937922,42.21374183841087,1566,2369,2153,1782,54970,662269,637330,2555,4553,2987,3142,5140,19.261360284258224,14.867894671866425,1998,1,409860,30672,371,0,989,2400
12416,0,0,0,0,58,1,512,1,0,405060,1256460,20.73644135332772,218,1584,1372,430,55890,710046,672060,2710,3352,3134,3864,4506,30.692018506445613,14.910913195537242,642,1,98900,27984,942,0,2492,1980
12417,1,0,0,0,43,0,308,1,0,635628,2077866,31.080540535840107,906,1684,1624,966,34034,402237,391482,2091,3117,2211,2809,3835,25.65151067676132,7.896951773353783,1026,1,175812,8160,658,0,1185,1493
12418,1,0,0,0,46,0,377,0,1,1215510,3042696,36.15245496505044,903,2641,2237,1307,55176,563376,530784,1924,3635,2732,3258,4969,30.495901363953813,20.13524692498938,1711,1,297996,59388,930,0,1021,1398
12419,1,0,0,0,47,0,419,0,1,767010,2637360,33.31666249791537,809,2102,1801,1110,52710,596376,498960,2075,3486,2677,3067,4478,26.28687885618983,17.662659759960558,1411,1,233100,52675,691,0,1266,1685
12420,1,0,0,0,46,0,433,0,1,671384,2497208,32.61901286060018,763,1996,1695,1064,47058,436542,593791,2046,3411,2648,2978,4343,25.11971337416094,17.48229092140404,1365,1,269192,8127,631,0,1283,1716
12421,1,0,0,0,46,0,491,0,1,383952,2136816,30.199337741083,551,1694,1333,912,55527,583407,522489,1982,3255,2704,2764,4037,20.518284528683193,20.715240645526293,1273,1,203376,56316,421,0,1431,1922
12422,1,0,0,0,46,0,501,0,1,348772,2081036,29.866369046136157,553,1622,1283,892,49841,459601,590249,1994,3225,2672,2724,3955,19.77371993328519,20.13013068237102,1231,1,225676,18306,391,0,1441,1942
12423,1,0,0,0,45,0,522,0,1,282343,1955076,29.206163733020468,556,1481,1184,853,40662,371304,575292,1995,3145,2589,2623,3773,18.193405398660254,18.74836171121922,1150,1,214103,1188,331,0,1439,1961
12424,1,0,0,0,43,0,599,0,1,115056,1646880,27.422618401604176,562,1095,905,752,52920,459900,551880,2000,2942,2380,2343,3285,12.36931687685298,14.637116746262372,942,1,189504,12160,153,0,1438,2037
12425,1,0,0,0,43,0,646,0,1,47771,1535089,26.70205984563738,579,914,780,713,51562,437059,546862,2019,2866,2287,2220,3067,8.18535277187245,12.391975741304819,847,1,181102,7906,67,0,1440,2086
12426,1,0,0,0,41,0,610,0,1,45359,1408837,26.019223662515376,647,774,744,677,51543,430767,518169,2051,2758,2111,2148,2855,8.18535277187245,5.5965095842615735,707,1,168573,2280,67,0,1404,2014
12427,1,0,0,0,41,0,576,0,1,63745,1392996,25.903667693977237,671,766,766,671,49115,487860,433884,2076,2747,2076,2171,2842,9.746794344808963,0.0,671,1,140239,0,95,0,1405,1981
12428,1,0,0,0,40,0,37,0,1,66480,482880,15.491933384829668,210,547,517,240,54970,462760,480868,1982,2252,2042,2289,2559,16.64331697709324,5.490867587491313,270,1,57360,3030,277,0,1772,1735
12429,1,0,0,0,40,0,37,0,1,51870,421050,14.491376746189438,180,487,457,210,54752,465160,473180,1975,2215,2035,2252,2492,15.716233645501712,5.478746393072713,240,1,49560,3210,247,0,1795,1758
12430,0,1,0,1,65,0,1889,0,0,10421052,14044080,65.63535632568775,4090,6945,6727,4308,48792,697640,743280,3042,7568,3478,5679,10205,49.18333050943175,14.848688813420488,4526,1,982224,25506,2419,0,1048,841
12431,0,0,1,0,59,1,235,0,0,2067000,4633200,39.496835316262995,1076,3369,2885,1560,49600,736560,594000,2486,4530,3454,4295,6339,36.40054944640259,22.259188947958496,2044,1,312000,90024,1325,0,1410,1645
12432,0,0,0,0,55,1,547,1,0,1207754,2379430,29.30870177950569,769,2355,2265,859,51865,567850,700810,2680,3629,2860,4176,5125,37.49666651850535,9.65116822864259,949,1,217327,5940,1406,0,1911,1364
12433,1,0,0,0,42,0,187,0,0,671058,1970946,30.298514815086232,918,1649,1649,918,56644,510986,510986,2147,3065,2147,2878,3796,27.03701166919155,0.0,918,0,218484,0,731,0,1229,1416
12434,1,0,0,0,41,0,656,0,0,1124516,2992478,37.92097045171708,1438,2220,2220,1438,46398,461982,434929,2081,3519,2081,2863,4301,27.964262908219126,0.0,1438,0,300542,0,782,0,643,1299
12435,1,0,0,0,46,0,386,0,1,1296776,3138144,36.71511950137164,902,2756,2310,1348,54288,540096,544752,1882,3676,2774,3290,5084,31.016124838541646,21.1493282801982,1794,1,315432,57534,962,0,980,1366
12436,1,0,0,0,46,0,396,0,1,1170796,3010062,36.02776706930364,890,2608,2200,1298,56334,570474,531051,1911,3617,2727,3221,4927,30.033314835362415,20.21794286726886,1706,1,297242,57936,902,0,1021,1417
12437,1,0,0,0,46,0,412,0,1,993888,2842128,34.9857113690718,862,2398,2036,1224,52118,587466,478332,1960,3546,2684,3134,4720,28.495613697550013,19.054691236615497,1586,1,252144,64436,812,0,1098,1510
12438,1,0,0,0,47,0,436,0,1,782397,2674601,33.60059523282288,798,2153,1822,1129,56350,580405,544870,2038,3498,2700,3062,4522,26.324893162176366,18.422557650747752,1460,1,259670,47002,693,0,1240,1676
12439,1,0,0,0,46,0,451,0,1,686172,2532224,32.92415526630866,753,2048,1717,1084,47311,436832,591008,2005,3420,2667,2969,4384,25.15949125081825,18.26619863064172,1415,1,274252,9268,633,0,1252,1703
12440,1,0,0,0,46,0,459,0,1,640386,2462778,32.58834147360065,727,2000,1665,1062,52208,482352,582069,1984,3381,2654,2922,4319,24.55605831561735,18.32843530268791,1397,1,266562,20100,603,0,1257,1716
12441,1,0,0,0,46,0,475,0,1,552774,2343436,31.906112267087632,667,1912,1561,1018,56133,559386,531762,1951,3320,2653,2845,4214,23.302360395462088,18.737426617716924,1369,1,235158,46683,543,0,1284,1759
12442,1,0,0,0,46,0,519,0,1,361030,2133276,30.23243291566195,595,1628,1309,914,52118,480804,590502,2015,3248,2653,2729,3962,19.87460691435179,19.728587456624908,1233,1,231242,21373,395,0,1420,1939
12443,1,0,0,0,43,0,603,0,1,150670,1738256,28.160255680657446,618,1158,983,793,51816,447168,556768,2017,2985,2367,2382,3350,13.784048752090222,14.060916850644618,968,1,201422,9975,190,0,1399,2002
12444,1,0,0,0,42,0,661,0,1,43260,1525636,26.851443164195103,654,848,781,721,43848,368184,533232,2049,2837,2183,2176,2964,7.745966692414834,8.77644402059324,788,1,181692,1340,60,0,1395,2056
12445,1,0,0,0,45,0,87,0,1,661518,1965678,29.29163703175362,535,1952,1629,858,35066,451327,407798,1968,3149,2614,3062,4243,27.76688675382964,18.248328731643245,1181,1,152724,49742,771,0,1433,1520
12446,1,0,0,0,44,0,30,0,1,950400,2221560,31.464265445104548,960,1980,1950,990,49784,439824,569976,2214,3234,2274,3204,4224,30.983866769659336,5.791460926441345,1020,1,251460,1500,960,0,1254,1284
12447,1,0,0,0,44,0,34,0,1,896520,2059020,30.495901363953813,930,1894,1894,930,47775,431730,542430,2214,3144,2214,3178,4108,31.04834939252005,0.0,930,1,227850,0,964,0,1284,1250
12448,1,0,0,0,43,0,35,0,1,735000,1832880,28.982753492378876,840,1715,1715,840,36708,351302,497496,2182,3022,2182,3057,3897,29.58039891549808,0.0,840,1,191520,0,875,0,1342,1307
12449,1,0,0,0,40,0,43,0,1,84510,542430,16.431676725154983,270,583,583,270,55890,462070,488187,2009,2279,2009,2322,2592,17.69180601295413,0.0,270,1,65610,0,313,0,1739,1696
12450,1,0,0,0,39,0,46,0,1,53760,419160,14.491376746189438,210,466,466,210,53040,441116,479040,1996,2206,1996,2252,2462,16.0,0.0,210,1,50400,0,256,0,1786,1740
12451,0,0,1,0,57,1,55,0,0,1540566,3501176,34.84250278036869,578,3119,2483,1214,38872,651784,496048,2248,4098,3520,4153,6003,35.62302626111375,25.219040425836983,1850,1,208808,122748,1269,0,1670,1615
12452,0,0,0,0,58,1,606,1,0,335907,1018953,18.734993995195193,176,1483,1308,351,56880,696720,688011,2728,3254,3078,3860,4386,30.93541659651604,13.470838687753037,526,1,83187,22050,957,0,2552,1946
12453,0,0,0,0,55,1,582,1,0,1088208,2210472,28.142494558940577,658,2300,2166,792,50292,552618,708914,2657,3583,2925,4165,5091,37.067505985701274,11.779285910768088,926,1,201168,6968,1374,0,1999,1417
12454,1,0,0,0,42,0,155,0,0,710556,1980132,30.397368307141328,894,1723,1693,924,51935,503605,473603,2113,3067,2173,2912,3866,27.730849247724095,5.753771868478424,954,0,204204,4530,769,0,1219,1374
12455,1,0,0,0,42,0,573,0,0,1151128,2940685,37.376463182061514,1397,2221,2221,1397,56364,486255,513620,2105,3502,2105,2929,4326,28.705400188814647,0.0,1397,1,340868,0,824,0,708,1281
12456,1,0,0,0,41,0,624,0,0,1166032,2998368,37.89459064299283,1436,2248,2248,1436,46866,457272,446832,2088,3524,2088,2900,4336,28.495613697550013,0.0,1436,0,307304,0,812,0,652,1276
12457,1,0,0,0,45,0,565,1,0,1383084,3410712,38.62641583165593,1126,2785,2419,1492,23100,502920,240030,1920,3778,2652,3213,5071,30.44667469527666,20.481720970669983,1858,1,156660,88938,927,0,794,1359
12458,1,0,0,0,46,0,401,0,1,1315860,3177720,36.945906403822335,896,2798,2329,1365,52800,512160,558720,1859,3693,2797,3292,5126,31.04834939252005,21.68480561125266,1834,1,327600,51121,964,0,963,1364
12459,1,0,0,0,46,0,415,0,1,1128750,2977320,35.91656999213594,873,2582,2165,1290,55800,572384,519300,1891,3598,2725,3183,4890,29.58039891549808,20.426329719357806,1707,1,290250,62133,875,0,1018,1433
12460,1,0,0,0,46,0,440,0,1,902225,2796300,34.56877203488721,824,2321,1950,1195,33040,552240,327600,1969,3535,2711,3095,4661,27.477263328068172,19.334965095384067,1566,1,167300,85330,755,0,1145,1585
12461,1,0,0,0,46,0,460,0,1,749916,2639344,33.555923471125034,766,2152,1792,1126,47817,443016,593032,1984,3470,2704,3010,4496,25.80697580112788,19.064512501182005,1486,1,284878,11160,666,0,1218,1678
12462,1,0,0,0,46,0,509,0,1,486536,2301076,31.575306807693888,631,1851,1485,997,39432,572384,366972,1942,3305,2674,2796,4159,22.090722034374522,20.364329596131398,1363,1,158523,80886,488,0,1311,1820
12463,1,0,0,0,44,0,580,0,1,246525,1931545,29.410882339705484,653,1362,1150,865,46805,413105,564949,2021,3098,2445,2518,3595,16.881943016134134,15.753198174302588,1077,1,218845,5300,285,0,1368,1948
12464,1,0,0,0,43,0,630,0,1,140875,1747655,28.372521918222215,671,1114,980,805,52624,451568,549263,2037,2976,2305,2346,3285,13.228756555322953,12.31452873038128,939,1,203665,8576,175,0,1366,1996
12465,1,0,0,0,42,0,653,0,1,99060,1675440,27.92848008753788,660,1027,907,780,54180,461820,541296,2028,2928,2268,2275,3175,11.269427669584644,11.526037434995047,900,1,196560,8880,127,0,1368,2021
12466,1,0,0,0,44,0,6,0,1,974160,2215620,31.464265445104548,990,1974,1974,990,50250,449838,559500,2238,3228,2238,3222,4212,31.368774282716245,0.0,990,1,247500,0,984,0,1248,1254
12467,1,0,0,0,44,0,37,0,1,957120,2136960,30.983866769659336,960,1957,1957,960,48800,445200,543144,2226,3186,2226,3223,4183,31.575306807693888,0.0,960,1,234240,0,997,0,1266,1229
12468,0,0,0,0,55,1,608,1,0,1144128,2244624,28.42534080710379,713,2319,2224,808,53105,597270,686166,2683,3586,2873,4194,5097,37.62977544445356,9.886585106410566,903,1,199576,8455,1416,0,1970,1362
12469,1,0,0,0,46,0,465,1,0,133866,1534464,25.80697580112788,347,1186,867,666,27900,414720,357120,1985,2970,2623,2505,3490,14.177446878757825,19.309076840943675,985,1,103230,49445,201,0,1638,2103
12470,1,0,0,0,46,0,33,1,0,613600,1778673,27.694764848252458,436,1898,1567,767,36200,463800,419739,1988,3086,2650,3119,4217,28.284271247461902,19.19680440745928,1098,1,138827,50974,800,0,1552,1519
12471,1,0,0,0,46,0,419,0,1,1272866,3142812,36.837480912787726,883,2769,2295,1357,51294,477096,576684,1842,3673,2790,3254,5085,30.62678566222711,21.78325673221013,1831,1,337893,36024,938,0,959,1378
12472,1,0,0,0,45,0,430,0,1,1148424,3007092,36.16628264005025,865,2629,2186,1308,56105,563255,526471,1856,3607,2742,3177,4928,29.631064780058107,21.048235455869463,1751,1,299532,64678,878,0,991,1421
12473,1,0,0,0,46,0,435,0,1,1090116,2955768,35.832945734337834,854,2563,2133,1284,49335,582406,448890,1872,3586,2732,3151,4865,29.13760456866693,20.73823551235931,1714,1,250380,82560,849,0,1018,1453
12474,1,0,0,0,47,0,461,0,1,869430,2805996,34.51086785347479,796,2316,1921,1191,53000,589000,499472,1961,3547,2751,3086,4672,27.018512172212592,19.99590499249018,1586,1,252492,68335,730,0,1165,1626
12475,1,0,0,0,46,0,475,0,1,768966,2674764,33.85262175962151,756,2207,1817,1146,47817,441126,590502,1944,3480,2724,3005,4541,25.903667693977237,19.80014938525094,1536,1,289938,12480,671,0,1188,1663
12476,1,0,0,0,46,0,483,0,1,720484,2600936,33.52610922848042,733,2156,1765,1124,48006,437346,587756,1923,3438,2705,2955,4470,25.317977802344327,19.786641322078566,1515,1,285496,12903,641,0,1190,1673
12477,1,0,0,0,46,0,524,0,1,504405,2347776,31.921779399024736,677,1856,1514,1019,37944,571392,352512,1962,3323,2646,2799,4160,22.24859546128699,19.706737610150405,1361,1,155907,76608,495,0,1285,1809
12478,1,0,0,0,42,0,45,0,1,507150,1457970,26.267851073127396,690,1425,1425,690,49044,424713,515572,2113,2803,2113,2848,3538,27.110883423451916,0.0,690,1,168360,0,735,0,1423,1378
12479,1,0,0,0,40,0,62,0,0,108600,602400,17.320508075688775,300,662,662,300,52440,461840,457824,2008,2308,2008,2370,2670,19.026297590440446,0.0,300,0,68400,0,362,0,1708,1646
12480,0,1,1,0,65,0,773,0,0,10254468,11775120,60.09991680526688,3303,6760,6451,3612,53250,815000,694380,2951,6872,3569,6099,10020,53.28226721902888,17.736467029578773,3921,0,769356,53148,2839,1,352,421
12481,0,1,1,0,59,0,1860,0,0,2059200,2314260,27.92848008753788,430,3770,3420,780,56635,697245,715047,2617,3747,3317,5607,6737,51.38093031466052,18.98449042348587,1130,1,187980,41300,2640,0,2187,327
12482,0,0,1,0,57,1,1353,0,0,1577250,6052434,45.858477951192405,1683,3273,2853,2103,53628,707988,627404,2458,4981,3298,3628,6151,27.386127875258307,20.880420790854828,2523,1,458454,68460,750,0,775,2128
12483,0,0,1,0,57,1,713,0,0,297360,850780,17.175564037317667,175,1423,1303,295,56880,683508,692160,2764,3179,3004,3892,4307,31.74901573277509,11.111005581829925,415,1,70800,14520,1008,0,2589,1876
12484,1,0,0,0,46,0,337,0,1,54840,278880,10.954451150103322,326,1023,577,120,46128,576352,432264,1878,2444,2770,2781,3347,21.37755832643195,21.461306299797045,566,1,22320,89200,457,0,2204,1867
12485,1,0,0,0,43,0,82,0,0,783315,1998612,30.44667469527666,927,1772,1772,927,54988,508816,502348,2156,3083,2156,3001,3928,29.068883707497267,0.0,927,0,215991,0,845,0,1229,1311
12486,1,0,0,0,42,0,462,0,0,1198800,2837700,36.742346141747674,1350,2238,2238,1350,50429,502378,443522,2102,3452,2102,2990,4340,29.79932885150268,0.0,1350,0,284850,0,888,0,752,1214
12487,1,0,0,0,46,0,455,0,1,1053896,2957048,35.76310948449533,833,2549,2103,1279,39184,573376,365296,1866,3591,2758,3136,4861,28.705400188814647,21.127306522853235,1725,1,202082,99012,824,0,1033,1488
12488,1,0,0,0,46,0,498,0,1,742608,2640384,33.85262175962151,725,2215,1794,1146,49530,449280,585216,1883,3450,2725,2952,4519,25.45584412271571,21.388630075347756,1567,1,291084,16840,648,0,1158,1656
12489,1,0,0,0,43,0,647,0,1,182108,1848568,29.30870177950569,774,1156,1071,859,52250,449768,538000,2067,3011,2237,2364,3308,14.560219778561036,9.982202543931885,944,1,214750,5270,212,0,1293,1940
12490,1,0,0,0,42,0,655,0,1,162624,1811733,29.103264421710495,780,1106,1039,847,51792,444912,532611,2072,2986,2206,2331,3245,13.856406460551018,8.804782210438667,914,1,210903,3953,192,0,1292,1947
12491,1,0,0,0,42,0,663,0,1,133650,1742400,28.722813232690143,765,1047,987,825,52500,443520,528000,2052,2937,2172,2274,3159,12.727922061357855,7.822290851349969,885,1,206250,3780,162,0,1287,1950
12492,1,0,0,0,46,0,125,0,1,845256,2293704,31.368774282716245,744,2083,1843,984,40768,484848,456876,2091,3315,2571,3190,4414,29.30870177950569,15.793903546707567,1224,1,192864,35280,859,0,1347,1472
12493,1,0,0,0,42,0,54,0,1,430920,1323630,25.099800796022265,630,1314,1314,630,42315,409695,455917,2101,2731,2101,2785,3415,26.153393661244042,0.0,630,1,136710,0,684,0,1471,1417
12494,1,0,0,0,41,0,55,0,1,393000,1256400,24.49489742783178,600,1255,1255,600,42020,399954,460680,2094,2694,2094,2749,3349,25.592967784139454,0.0,600,1,132000,0,655,0,1494,1439
12495,1,0,0,0,40,0,70,0,1,154800,729720,18.973665961010276,330,820,790,360,54216,437832,508777,1997,2387,2057,2457,2847,20.73644135332772,5.572104574801163,390,1,90360,2490,430,0,1667,1597
12496,0,1,1,0,65,0,412,0,0,10165589,11107666,58.31809324729333,3129,6662,6390,3401,56088,803436,744648,2994,6667,3538,6255,9928,54.67174773134658,16.926401096657948,3673,0,775428,39984,2989,1,135,277
12497,0,0,1,0,57,1,231,0,0,1714570,3444727,34.62657938636157,688,3140,2629,1199,37760,678028,459680,2362,4072,3384,4303,6013,37.815340802378074,23.62926551936173,1710,1,191840,109354,1430,0,1674,1443
12498,0,0,0,0,56,1,703,1,0,764754,1680804,24.310491562286437,501,1975,1885,591,52405,668340,634212,2754,3435,2934,4138,4819,35.9722114972099,9.613403705477898,681,1,131793,10620,1294,0,2253,1550
12499,0,0,0,0,56,1,692,1,0,864348,1833348,25.41653005427767,556,2074,1984,646,53724,630036,686796,2748,3484,2928,4176,4912,36.578682316343766,9.740037464252968,736,1,156332,7650,1338,0,2192,1500
12500,1,0,0,0,42,0,389,0,0,1228920,2779920,36.3318042491699,1290,2281,2251,1320,56643,499122,503334,2076,3426,2136,3037,4387,30.512292604784715,5.514871952411144,1350,1,315480,3660,931,0,786,1175
12501,1,0,0,0,42,0,396,0,0,1219680,2773320,36.3318042491699,1320,2244,2244,1320,53536,502139,470624,2101,3421,2101,3025,4345,30.397368307141328,0.0,1320,0,295680,0,924,0,781,1177
12502,1,0,0,0,45,0,512,0,1,764385,2677098,34.161381705077446,759,2230,1822,1167,50853,461094,580382,1886,3461,2702,2949,4524,25.592967784139454,21.005585720479342,1575,1,295251,20808,655,0,1127,1639
12503,1,0,0,0,43,0,618,0,1,305208,2068632,30.692018506445613,792,1416,1266,942,48323,419436,555588,2046,3138,2346,2520,3612,18.0,13.130475867068439,1092,1,238326,5250,324,0,1254,1872
12504,1,0,0,0,43,0,644,0,1,229245,1933749,29.9833287011299,814,1239,1154,899,52000,447408,537750,2066,3050,2236,2406,3390,15.968719422671311,9.855393472241717,984,1,224750,5100,255,0,1252,1896
12505,1,0,0,0,45,0,229,0,1,966000,2531472,33.2264954516723,1009,2074,1979,1104,49266,474651,545734,2198,3397,2388,3168,4367,29.58039891549808,9.981197033715764,1199,1,262752,9025,875,0,1189,1418
12506,1,0,0,0,40,0,74,0,1,235800,916200,21.213203435596427,420,1004,974,450,54064,443848,504928,2006,2486,2066,2560,3040,22.891046284519195,5.684275577662207,480,1,111600,2730,524,0,1586,1512
12507,1,0,0,0,40,0,83,0,1,159480,727560,18.973665961010276,330,833,803,360,54747,466851,478977,1991,2381,2051,2464,2854,21.047565179849187,5.531194905403055,390,1,85320,3720,443,0,1661,1578
12508,0,0,1,0,56,1,985,0,0,1210674,4793454,41.20679555607303,1307,2802,2411,1698,53655,618237,691635,2432,4521,3214,3536,5625,26.70205984563738,19.94845734369946,2089,1,416010,38709,713,0,1125,2110
12509,0,0,1,0,57,1,819,0,0,256762,695266,15.556349186104045,182,1363,1303,242,56165,675155,686647,2813,3115,2933,3934,4236,32.57299494980466,7.748117453886108,302,1,57838,7380,1061,0,2631,1812
12510,0,0,1,0,57,1,814,0,0,302207,793328,16.64331697709324,235,1410,1368,277,56406,681632,678768,2822,3141,2906,3955,4274,33.03028912982749,6.553889165207866,319,1,65649,5418,1091,0,2587,1773
12511,1,0,0,0,43,0,186,1,0,776347,2115619,31.28897569432403,949,1802,1772,979,38579,481903,373853,2131,3140,2191,2954,3963,28.160255680657446,5.652706486041966,1009,1,169367,5670,793,0,1182,1368
12512,1,0,0,0,42,0,330,0,0,1238400,2711580,35.91656999213594,1290,2250,2250,1290,47840,483460,437216,2102,3392,2102,3062,4352,30.983866769659336,0.0,1290,0,268320,0,960,0,812,1142
12513,1,0,0,0,42,0,337,0,0,1229370,2715450,35.91656999213594,1290,2243,2243,1290,38804,458890,374690,2105,3395,2105,3058,4348,30.870698080866262,0.0,1290,0,229620,0,953,0,815,1152
12514,1,0,0,0,42,0,362,1,0,1210464,2764368,36.0,1266,2260,2230,1296,43200,409536,479925,2103,3429,2163,3067,4393,30.56141357987225,6.004624280888846,1326,1,291600,2790,934,0,837,1199
12515,1,0,0,0,42,0,386,0,0,1228376,2778344,36.30426972134269,1288,2280,2250,1318,30956,459544,299336,2078,3426,2138,3040,4388,30.528675044947494,5.531194905403055,1348,0,187156,6360,932,0,790,1176
12516,1,0,0,0,45,0,415,0,1,1434384,3247286,37.72267222772003,1088,2766,2431,1423,39388,522578,392504,1947,3705,2617,3290,5048,31.74901573277509,19.844252633452047,1758,1,244756,65995,1008,0,859,1274
12517,1,0,0,0,45,0,469,0,1,1220780,3115376,36.932370625238775,840,2783,2259,1364,54492,520752,545876,1760,3648,2808,3179,5067,29.916550603303182,22.892734314123068,1888,1,325996,62356,895,0,920,1389
12518,1,0,0,0,46,0,494,0,1,991667,2946995,35.679125549822544,785,2540,2052,1273,50292,588010,458370,1827,3588,2803,3094,4855,27.910571473905726,22.100941954408,1761,1,252054,89792,779,0,1042,1536
12519,1,0,0,0,44,0,617,0,1,359778,2166532,31.352830813181765,821,1511,1349,983,46990,407740,559816,2042,3187,2366,2570,3715,19.131126469708992,13.631179030466164,1145,1,249682,4698,366,0,1221,1838
12520,1,0,0,0,42,0,656,0,1,235812,1941336,30.23243291566195,872,1214,1172,914,51912,437544,535248,2082,3038,2166,2382,3338,16.06237840420901,6.82047017429532,956,1,230328,2394,258,0,1210,1866
12521,1,0,0,0,42,0,660,0,1,218284,1903220,30.033314835362415,872,1174,1144,902,54718,459980,529610,2080,3012,2140,2352,3284,15.556349186104045,5.623413251903491,932,1,226402,2430,242,0,1208,1868
12522,1,0,0,0,46,0,275,0,1,535374,2038302,29.698484809834994,626,1745,1489,882,37513,538463,372071,2055,3193,2567,2918,4056,24.63736998950984,16.865655847341852,1138,1,142002,54016,607,0,1429,1704
12523,1,0,0,0,46,0,194,0,1,768515,2288902,31.28897569432403,679,2064,1764,979,40953,512022,437206,2038,3317,2638,3123,4402,28.0178514522438,18.06005542932632,1279,1,183073,51300,785,0,1359,1553
12524,1,0,0,0,44,0,60,0,1,864000,1999800,30.0,773,1987,1860,900,34808,337744,508838,2095,3122,2349,3182,4209,30.983866769659336,11.325601443997241,1027,1,206100,3556,960,0,1322,1262
12525,1,0,0,0,42,0,67,0,1,566640,1547280,26.832815729997478,630,1597,1507,720,39694,382522,479227,2059,2869,2239,2936,3746,28.053520278211074,9.613403705477898,810,1,160560,6840,787,0,1429,1362
12526,0,1,1,0,64,0,1152,0,0,10757124,12565602,62.49799996799898,3876,6690,6660,3906,53482,778514,710957,3187,7123,3247,5971,9907,52.478567053607705,5.478746393072713,3936,0,863226,4680,2754,1,689,463
12527,0,1,1,0,56,0,782,0,0,108240,340680,10.954451150103322,30,1112,1022,120,29952,545088,442884,2749,2959,2929,3741,3951,30.033314835362415,9.756499634156611,210,1,18720,15120,902,0,2719,1937
12528,0,0,1,0,56,1,1042,0,0,1214520,4898100,41.71330722922842,1390,2788,2438,1740,53240,619300,681230,2465,4555,3165,3513,5603,26.419689627245813,18.87242696235298,2090,1,421080,36750,698,0,1075,2117
12529,1,0,0,0,46,0,229,0,1,86430,466119,14.177446878757825,159,991,631,201,45264,570474,426696,1959,2520,2679,2749,3310,20.73644135332772,19.09147892580721,561,1,36984,72000,430,0,2118,1889
12530,1,0,0,0,42,0,209,0,0,1345140,2681397,35.62302626111375,1239,2359,2329,1269,54390,517685,469086,2083,3382,2143,3173,4472,32.55764119219941,5.490867587491313,1299,1,281718,4710,1060,0,844,1053
12531,1,0,0,0,42,0,227,0,0,1308468,2671245,35.53871128783372,1233,2329,2299,1263,50400,475875,473760,2085,3378,2145,3151,4444,32.18695387886216,5.514871952411144,1293,0,282912,4110,1036,0,852,1079
12532,1,0,0,0,46,0,462,0,1,1437480,3378804,38.1051177665153,905,2989,2442,1452,50292,460746,591058,1780,3779,2874,3317,5316,31.464265445104548,24.490218242231776,1999,1,368808,28991,990,0,875,1337
12533,1,0,0,0,45,0,521,0,1,915212,2873340,35.38361202590826,822,2413,1983,1252,52974,500310,557685,1865,3547,2725,3026,4708,27.03701166919155,21.460901627181787,1682,1,304236,33540,731,0,1043,1564
12534,1,0,0,0,44,0,616,0,1,417792,2267136,32.0,862,1594,1432,1024,51106,447228,560142,2052,3238,2376,2622,3808,20.199009876724155,13.816864184801691,1186,1,259072,8262,408,0,1190,1806
12535,1,0,0,0,42,0,607,0,1,234500,1846250,29.58039891549808,875,1143,1143,875,37944,430440,392460,2110,2985,2110,2378,3253,16.3707055437449,0.0,875,1,162750,0,268,0,1235,1842
12536,1,0,0,0,45,0,443,1,0,278694,1802380,28.178005607210743,499,1440,1145,794,30044,335960,460810,1975,3064,2565,2621,3710,18.734993995195193,17.733957346589627,1089,1,161182,16520,351,0,1476,1919
12537,1,0,0,0,45,0,241,1,0,593100,2057400,30.0,776,1683,1559,900,26800,457200,306324,2162,3186,2410,2945,3969,25.67099530598687,12.059737629881619,1024,1,120600,24800,659,0,1386,1627
12538,1,0,0,0,40,0,109,0,0,194610,791310,19.748417658131498,390,889,889,390,35000,405800,355075,2029,2419,2029,2528,2918,22.338307903688676,0.0,390,0,68250,0,499,0,1639,1530
12539,0,0,1,0,56,1,957,0,0,1317330,4869816,41.49698784249286,1340,2869,2487,1722,52779,619332,681548,2446,4550,3210,3593,5697,27.65863337187866,19.745430697781345,2104,1,415002,39728,765,0,1106,2063
12540,0,0,1,0,56,1,1621,0,0,1426782,6396852,47.47630988187688,2038,3103,2887,2254,54312,703824,621522,2622,5092,3054,3471,5941,25.15949125081825,15.188419967974726,2470,1,493626,35208,633,0,584,2205
12541,1,0,0,0,42,0,169,0,0,1311912,2613960,35.11409973215888,1233,2297,2297,1233,44310,445200,447320,2120,3353,2120,3184,4417,32.61901286060018,0.0,1233,0,260163,0,1064,0,887,1056
12542,1,0,0,0,46,0,430,0,1,1493856,3386656,38.157568056677825,932,3006,2482,1456,55104,521024,572196,1802,3782,2850,3352,5332,32.03123475609393,24.095278918271468,1980,1,358176,47160,1026,0,870,1300
12543,1,0,0,0,46,0,474,0,1,1466587,3406836,38.353617821530214,930,3009,2468,1471,53463,493308,581316,1775,3787,2857,3313,5325,31.575306807693888,23.711153886107905,2012,1,369221,37870,997,0,845,1319
12544,1,0,0,0,46,0,480,0,1,1401664,3334744,38.05259518088089,923,2941,2416,1448,52624,479024,582659,1778,3751,2828,3271,5244,31.11269837220809,23.337863112244207,1973,1,366344,34125,968,0,855,1335
12545,1,0,0,0,45,0,492,0,1,1278133,3198840,37.456641600656084,906,2811,2314,1403,55876,522120,556320,1783,3683,2777,3191,5091,30.18277654557314,22.621998676291618,1900,1,342332,54173,911,0,877,1369
12546,1,0,0,0,45,0,504,0,1,1159732,3098956,36.851051545376556,888,2682,2212,1358,50546,579628,454118,1812,3640,2752,3136,4964,29.223278392404914,22.11969948476542,1828,1,270242,86480,854,0,924,1428
12547,1,0,0,0,45,0,518,0,1,1048055,3013980,36.26292872893749,872,2555,2112,1315,52998,554664,501948,1849,3607,2735,3089,4847,28.231188426986208,21.641427028467483,1758,1,287985,59362,797,0,977,1495
12548,1,0,0,0,44,0,568,0,1,707888,2612388,34.23448553724738,889,2059,1776,1172,56406,530502,528273,1946,3401,2512,2833,4288,24.576411454889016,17.353993386644653,1455,1,277764,33677,604,0,1057,1625
12549,1,0,0,0,44,0,591,0,1,585900,2494260,33.406586176980134,904,1853,1641,1116,52598,531930,493935,2023,3351,2447,2760,4088,22.9128784747792,15.454412244081965,1328,1,246636,26712,525,0,1119,1710
12550,1,0,0,0,44,0,608,0,1,512868,2403122,32.89376840679705,912,1726,1556,1082,52779,486399,535261,2051,3303,2391,2695,3947,21.77154105707724,14.06199587275475,1252,1,260762,13600,474,0,1139,1747
12551,1,0,0,0,47,0,315,0,1,762850,2457840,32.32645975048923,722,2098,1775,1045,50032,555072,498624,2029,3397,2675,3082,4450,27.018512172212592,18.304024457889557,1368,1,221540,52326,730,0,1307,1622
12552,0,1,1,0,64,0,1008,0,0,10894905,12336030,61.99193495931547,3801,6720,6678,3843,55647,780030,735090,3168,7053,3252,6045,9930,53.24471804789655,6.48074069840786,3885,0,880047,6090,2835,1,633,375
12553,0,0,0,0,57,1,782,1,0,1477848,4783824,40.84115571332428,1218,3004,2554,1668,49600,573600,711264,2418,4536,3318,3754,5872,29.765752132274432,21.545660055176604,2118,1,413664,31050,886,0,1200,1982
12554,0,0,1,0,56,1,1012,0,0,1326528,4976244,42.0,1425,2855,2516,1764,51646,612157,671398,2482,4585,3160,3573,5676,27.422618401604176,18.610623549342986,2103,1,419832,36612,752,0,1057,2069
12555,0,0,1,0,56,1,1600,0,0,1459601,6375915,47.4236228055175,2057,3090,2898,2249,52539,705915,598185,2643,5084,3027,3484,5925,25.475478405713993,14.462785965443908,2441,1,474539,33408,649,0,586,2186
12556,1,0,0,0,42,0,62,0,0,1436640,2600220,35.07135583350036,1200,2428,2398,1230,54960,484106,507360,2084,3344,2144,3282,4542,34.17601498127012,5.490867587491313,1260,0,295200,3540,1168,0,884,946
12557,1,0,0,0,42,0,70,0,0,1412496,2583864,34.9857113690718,1224,2378,2378,1224,48138,477086,449643,2111,3335,2111,3265,4489,33.97057550292606,0.0,1224,0,260712,0,1154,0,887,957
12558,1,0,0,0,42,0,86,0,0,1367051,2572773,34.828149534535996,1213,2340,2340,1213,29008,415716,313908,2121,3334,2121,3248,4461,33.57082066318904,0.0,1213,0,179524,0,1127,0,908,994
12559,1,0,0,0,42,0,152,1,0,1257600,2568000,34.64101615137755,1140,2308,2248,1200,23808,410880,265360,2080,3340,2200,3188,4448,32.37282811247729,8.275039169881914,1260,1,148800,11940,1048,0,940,1092
12560,1,0,0,0,43,0,213,1,0,1266688,2665735,35.17101079013795,1129,2369,2261,1237,27945,446085,290925,2047,3392,2263,3179,4524,32.0,10.83458558167471,1345,1,166995,22248,1024,0,918,1131
12561,1,0,0,0,45,0,515,0,1,1191456,3134467,37.134889255254286,936,2686,2243,1379,55029,565977,502333,1830,3652,2716,3137,4959,29.393876913398138,21.393533990778415,1822,1,304759,69108,864,0,894,1409
12562,1,0,0,0,45,0,535,0,1,1025700,2985050,36.26292872893749,913,2497,2095,1315,54984,526640,537990,1868,3585,2672,3050,4767,27.92848008753788,20.5547400195117,1717,1,311655,42612,780,0,955,1490
12563,1,0,0,0,44,0,562,0,1,827343,2759454,35.11409973215888,910,2227,1904,1233,55056,496836,555024,1915,3471,2561,2909,4465,25.903667693977237,18.454740605320104,1556,1,305784,28101,671,0,1005,1567
12564,1,0,0,0,44,0,577,0,1,738510,2651705,34.56877203488721,927,2081,1813,1195,56350,510370,543655,1951,3414,2487,2837,4300,24.859605789312106,16.842732377612712,1463,1,292775,28140,618,0,1024,1601
12565,1,0,0,0,44,0,607,0,1,579468,2486322,33.51119216023208,953,1809,1639,1123,54516,511434,522504,2044,3337,2384,2730,4023,22.715633383201094,13.852363991743774,1293,1,265028,17850,516,0,1091,1698
12566,1,0,0,0,42,0,654,0,1,373320,2176680,31.937438845342623,978,1428,1386,1020,48768,409728,542036,2092,3154,2176,2500,3562,19.131126469708992,6.852548980306203,1062,1,259080,1638,366,0,1114,1768
12567,1,0,0,0,42,0,662,0,1,333995,2103670,31.575306807693888,997,1332,1332,997,52640,495850,472640,2110,3107,2110,2445,3442,18.303005217723125,0.0,997,1,223328,0,335,0,1113,1775
12568,1,0,0,0,45,0,356,0,1,579840,2204160,30.983866769659336,798,1726,1564,960,51816,583184,468384,2134,3256,2458,2900,4022,24.576411454889016,13.631179030466164,1122,1,195840,28998,604,0,1336,1692
12569,1,0,0,0,46,0,424,0,1,884352,2750664,34.292856398964496,984,2120,1928,1176,36966,428037,472478,2147,3515,2531,3091,4459,27.422618401604176,14.369918301307246,1368,1,237552,20736,752,0,1163,1587
12570,1,0,0,0,40,0,123,0,0,293788,983972,22.0,484,1091,1091,484,49693,465557,441161,2033,2517,2033,2640,3124,24.63736998950984,0.0,484,0,105028,0,607,0,1549,1426
12571,1,0,0,0,47,0,306,1,0,264960,907008,19.595917942265423,34,1424,1074,384,38637,573966,375558,2012,2746,2712,3052,3786,26.267851073127396,19.146282702031215,734,1,61056,77000,690,0,1978,1672
12572,1,0,0,0,42,0,1,0,0,1460472,2558544,34.75629439396553,1208,2417,2417,1208,53924,516792,468078,2118,3326,2118,3327,4535,34.77067730142742,0.0,1208,0,266968,0,1209,0,910,909
12573,1,0,0,0,42,0,6,0,0,1435195,2543718,34.655446902326915,1201,2396,2396,1201,46284,482904,429954,2118,3319,2118,3313,4514,34.56877203488721,0.0,1201,0,243803,0,1195,0,917,923
12574,1,0,0,0,42,0,78,1,0,1277640,2490930,34.20526275297414,1085,2347,2262,1170,26928,398123,306576,2044,3299,2214,3221,4476,33.04542328371661,9.265143265380413,1255,1,168480,14790,1092,0,959,1037
12575,1,0,0,0,43,0,105,1,0,1246050,2554110,34.20526275297414,1062,2343,2235,1170,21583,416953,246679,2075,3353,2291,3248,4526,32.63433774416144,11.466806094325776,1278,1,132210,22464,1065,0,1013,1118
12576,1,0,0,0,42,0,647,0,1,457098,2304804,32.7566787083184,1013,1559,1499,1073,52297,466116,517668,2088,3221,2208,2574,3707,20.639767440550294,8.137062211202972,1133,1,258593,4620,426,0,1075,1722
12577,1,0,0,0,42,0,660,0,1,389536,2189068,32.18695387886216,1036,1412,1412,1036,55200,485990,507120,2113,3149,2113,2489,3525,19.390719429665317,0.0,1036,1,248640,0,376,0,1077,1737
12578,1,0,0,0,42,0,663,0,1,371050,2163775,32.01562118716424,1025,1387,1387,1025,48585,500307,432755,2111,3136,2111,2473,3498,19.026297590440446,0.0,1025,1,210125,0,362,0,1086,1749
12579,1,0,0,0,45,0,469,0,1,390566,2043932,30.033314835362415,902,1335,1335,902,44036,493988,457732,2266,3168,2266,2699,3601,20.808652046684813,0.0,902,1,182204,0,433,0,1364,1833
12580,1,0,0,0,46,0,361,0,1,605022,2278133,31.28897569432403,817,1759,1597,979,36188,507286,386282,2165,3306,2489,2945,4086,24.859605789312106,13.836064238161292,1141,1,162514,30780,618,0,1348,1709
12581,1,0,0,0,41,0,146,1,0,247680,887090,20.73644135332772,363,1073,1006,430,24250,400222,257875,1996,2493,2130,2639,3136,24.0,8.47749576439433,497,1,53750,13400,576,0,1633,1487
12582,1,0,0,0,41,0,160,1,0,197001,775019,19.261360284258224,276,997,902,371,22264,384376,252769,1994,2460,2184,2620,3086,23.043437243605826,10.477236849499048,466,1,44891,18240,531,0,1718,1558
12583,1,0,0,0,42,0,77,0,0,1544810,2547370,34.713109915419565,1205,2487,2487,1205,56350,486220,517930,2114,3319,2114,3396,4601,35.805027579936315,0.0,1205,1,295225,0,1282,0,909,832
12584,1,0,0,0,42,0,56,0,0,1456065,2493585,34.336569426778794,1149,2444,2414,1179,45410,505485,401850,2085,3294,2145,3350,4559,35.14256678161116,5.477225575051661,1209,0,224010,5670,1235,0,936,880
12585,1,0,0,0,42,0,49,0,0,1431012,2489328,34.23448553724738,1142,2423,2393,1172,36126,473652,344088,2094,3296,2154,3345,4547,34.942810419312295,5.531194905403055,1202,0,189864,5970,1221,0,952,903
12586,1,0,0,0,44,0,600,1,0,763776,2711160,34.9857113690718,1008,2064,1848,1224,40710,392055,509450,1999,3439,2431,2839,4279,24.979991993593593,15.284541480537822,1440,1,281520,14040,624,0,991,1591
12587,1,0,0,0,43,0,614,1,0,685440,2607290,34.49637662132068,1028,1928,1766,1190,55647,501739,532413,2029,3381,2353,2767,4119,24.0,13.211877862761103,1352,1,289170,18144,576,0,1001,1615
12588,1,0,0,0,43,0,573,1,0,412830,2130480,31.464265445104548,990,1407,1407,990,37185,432552,398120,2152,3142,2152,2569,3559,20.42057785666214,0.0,990,1,183150,0,417,0,1162,1735
12589,1,0,0,0,45,0,114,1,0,58752,438528,13.856406460551018,18,708,498,192,50369,550444,477356,2074,2476,2494,2590,2992,17.4928556845359,14.530975064444453,402,1,40128,35700,306,0,2092,1978
12590,1,0,0,0,43,0,444,0,0,613312,2255372,32.18695387886216,1006,1658,1628,1036,34717,507241,324373,2147,3213,2207,2769,3835,24.331050121192877,5.684275577662207,1066,0,154364,6630,592,0,1141,1585
12591,1,0,0,0,42,0,15,0,0,1775500,2852860,36.60601043544625,1310,2695,2665,1340,51429,504573,461993,2099,3469,2159,3454,4824,36.40054944640259,5.478746393072713,1370,0,290780,4710,1325,0,789,804
12592,1,0,0,0,42,0,46,0,0,1726067,2748539,35.93048844644336,1261,2658,2628,1291,50007,504573,449219,2099,3420,2159,3466,4787,36.565010597564445,5.483301264452448,1321,0,272401,4950,1337,0,838,792
12593,1,0,0,0,42,0,66,0,0,1712392,2715328,35.7211421989835,1234,2660,2618,1276,51660,523488,446880,2086,3404,2170,3470,4788,36.6333181680284,6.538739683827756,1318,0,267960,7308,1342,0,852,786
12594,1,0,0,0,42,0,136,0,0,1570401,2515253,34.45286635390443,1187,2510,2510,1187,55328,474656,523393,2119,3306,2119,3442,4629,36.373066958946424,0.0,1187,0,293189,0,1323,0,932,796
12595,1,0,0,0,42,0,106,0,0,1425216,2434744,33.793490497431605,1082,2450,2390,1142,27772,451984,279292,2072,3274,2192,3380,4582,35.32704346531139,7.880145860644973,1202,0,149602,12900,1248,0,990,884
12596,1,0,0,0,43,0,8,1,0,1245440,2457280,33.46640106136302,970,2382,2232,1120,32300,372980,416860,2044,3314,2344,3306,4576,33.34666400106613,12.849476832533073,1270,1,212800,15600,1112,0,1074,1082
12597,1,0,0,0,44,0,600,1,0,843156,2832042,35.58089374931439,1038,2160,1932,1266,45171,422793,534643,2009,3503,2465,2903,4397,25.80697580112788,15.87006892192627,1494,1,302574,15732,666,0,971,1571
12598,1,0,0,0,44,0,607,1,0,801858,2776527,35.34119409414458,1048,2092,1891,1249,42898,395694,535743,2022,3472,2424,2865,4315,25.337718918639855,14.881946979595815,1450,1,301009,10050,642,0,974,1581
12599,1,0,0,0,44,0,613,1,0,760758,2714355,35.08560958569767,1056,2024,1849,1231,44103,403515,531405,2030,3436,2380,2823,4229,24.859605789312106,13.856594396268251,1406,1,296671,9975,618,0,974,1587
12600,1,0,0,0,43,0,631,1,0,653016,2570659,34.39476704383968,1088,1830,1735,1183,51000,443292,543250,2078,3356,2268,2725,4003,23.49468024894146,10.316868480755375,1278,1,295750,6650,552,0,990,1621
12601,1,0,0,0,45,0,562,0,0,507795,2385066,32.357379374726875,939,1640,1532,1047,45720,578612,410040,2170,3325,2386,2763,3918,22.02271554554524,10.871351968433055,1155,1,188460,21600,485,0,1231,1793
12602,1,0,0,0,46,0,451,0,1,580380,2369460,31.937438845342623,858,1751,1589,1020,46305,569135,439047,2161,3343,2485,2892,4074,23.853720883753127,13.240404067118192,1182,1,192780,31590,569,0,1303,1754
12603,1,0,0,0,41,0,148,0,0,396480,1148000,23.664319132398465,560,1268,1268,560,40296,448950,377200,2050,2610,2050,2758,3318,26.60826939130014,0.0,560,0,103040,0,708,0,1490,1342
12604,1,0,0,0,41,0,226,0,1,124872,539220,16.06237840420901,42,958,742,258,36400,365750,434720,1874,2348,2306,2574,3048,22.0,15.068492412224764,474,1,53664,19440,484,0,1832,1606
12605,0,0,0,0,56,1,996,1,0,1544917,5189525,42.86023798347368,1554,2961,2678,1837,54675,635625,686475,2542,4662,3108,3666,5786,29.0,17.08128969730302,2120,1,446391,30564,841,0,988,1984
12606,1,0,0,0,45,0,529,1,0,781046,2681433,34.45286635390443,1025,2007,1845,1187,24898,476649,266562,2097,3446,2421,2917,4266,25.65151067676132,13.631179030466164,1349,1,140066,36450,658,0,1072,1601
12607,1,0,0,0,42,0,1,0,0,1823850,2872800,36.742346141747674,1320,2731,2701,1350,51983,487312,483056,2098,3478,2158,3479,4859,36.75595189897821,5.477225575051661,1380,0,306450,4080,1351,0,778,777
12608,1,0,0,0,42,0,60,0,0,1762684,2768634,36.02776706930364,1298,2656,2656,1298,41989,450063,424467,2133,3431,2133,3491,4789,36.851051545376556,0.0,1298,0,258302,0,1358,0,835,775
12609,1,0,0,0,42,0,199,0,0,1632342,2517660,34.38022687534217,1140,2605,2563,1182,55822,481380,526110,2088,3312,2172,3511,4735,37.16180835212409,6.678188844436455,1224,1,291954,4200,1381,0,948,749
12610,1,0,0,0,42,0,195,0,0,1597050,2482740,34.20526275297414,1140,2565,2535,1170,55596,479572,522012,2092,3292,2152,3487,4687,36.945906403822335,5.490867587491313,1200,0,287820,3060,1365,0,952,757
12611,1,0,0,0,42,0,162,0,0,1419075,2384046,33.36165463522455,1023,2478,2388,1113,30150,481950,287028,2052,3255,2232,3417,4620,35.70714214271425,9.613403705477898,1203,0,149142,20340,1275,0,1029,867
12612,1,0,0,0,45,0,594,0,1,970632,2994108,36.41428291206625,1079,2305,2058,1326,51584,469664,559984,2011,3584,2505,2990,4563,27.055498516937366,16.545057470939174,1573,1,328848,19760,732,0,932,1526
12613,1,0,0,0,42,0,656,0,1,576345,2450910,33.98529093593286,1155,1654,1654,1155,50310,496548,456230,2122,3277,2122,2621,3776,22.338307903688676,0.0,1155,1,248325,0,499,0,967,1623
12614,1,0,0,0,46,0,531,0,1,627570,2586249,33.18132004607411,818,1954,1671,1101,38528,526176,404028,2066,3450,2632,2919,4303,23.874672772626646,17.57765937056636,1384,1,189372,54053,570,0,1248,1779
12615,1,0,0,0,41,0,167,1,0,348840,1061910,22.64950330581225,453,1253,1193,513,32742,442980,316710,2010,2583,2130,2750,3323,26.076809620810597,8.16338338718601,573,1,78489,11880,680,0,1557,1390
12616,1,0,0,0,46,0,111,0,1,121176,683694,17.233687939614086,147,855,705,297,54500,575500,501836,2152,2599,2452,2710,3157,20.199009876724155,12.459604606992961,447,1,64746,24450,408,0,2005,1894
12617,1,0,0,0,46,0,792,0,1,304225,2483250,32.78719262151,833,1600,1358,1075,47652,526680,482790,2068,3385,2552,2593,3910,16.822603841260722,16.02581635611341,1317,1,224675,37994,283,0,1235,2027
12618,1,0,0,0,42,0,16,0,0,1708185,2814100,36.26292872893749,1273,2656,2614,1315,46221,464380,455820,2098,3455,2182,3439,4796,36.0416425818802,6.48074069840786,1357,0,280095,5838,1299,0,825,841
12619,1,0,0,0,42,0,156,1,0,1731040,2657320,35.21363372331802,1240,2636,2636,1240,38760,407170,437172,2143,3383,2143,3539,4779,37.36308338453881,0.0,1240,1,252960,0,1396,0,903,747
12620,1,0,0,0,42,0,256,0,0,1660641,2485710,34.161381705077446,1137,2620,2590,1167,56406,506940,504810,2100,3297,2160,3553,4750,37.72267222772003,5.483301264452448,1197,0,276579,3870,1423,0,963,707
12621,1,0,0,0,46,0,266,0,1,1405560,3076320,36.41428291206625,922,2790,2386,1326,39083,484880,433840,1916,3646,2724,3380,5110,32.55764119219941,20.654224737826034,1730,1,247962,64236,1060,0,994,1260
12622,1,0,0,0,45,0,582,0,1,1158544,3214116,37.49666651850535,1150,2486,2230,1406,54656,512064,557784,2030,3692,2542,3110,4772,28.705400188814647,16.917940215049025,1662,1,343064,27392,824,0,880,1462
12623,1,0,0,0,45,0,588,0,1,1108213,3158199,37.242448899072144,1145,2428,2186,1387,54282,496386,566973,2035,3664,2519,3076,4705,28.26658805020514,16.421806575503073,1629,1,345363,21780,799,0,890,1478
12624,1,0,0,0,45,0,594,0,1,1058832,3099888,36.98648401781386,1140,2370,2142,1368,52920,475860,571032,2038,3634,2494,3040,4636,27.820855486487112,16.051508547267655,1596,1,344736,16644,774,0,898,1492
12625,1,0,0,0,45,0,600,0,1,1012500,3040200,36.742346141747674,1132,2318,2100,1350,52070,461660,572008,2034,3602,2470,3002,4570,27.386127875258307,15.655278323665375,1568,1,342900,13298,750,0,902,1502
12626,1,0,0,0,43,0,630,0,1,805176,2772540,35.58089374931439,1142,2026,1902,1266,51816,446760,556260,2066,3456,2314,2826,4216,25.219040425836983,11.736839560195943,1390,1,321564,7316,636,0,924,1554
12627,1,0,0,0,43,0,522,1,0,602640,2372760,32.863353450309965,1080,1638,1638,1080,31042,410839,364702,2197,3277,2197,2755,3835,23.62202362203543,0.0,1080,1,179280,0,558,0,1117,1639
12628,1,0,0,0,45,0,640,0,0,386201,2324339,31.921779399024736,1019,1398,1398,1019,51959,508663,531473,2281,3300,2281,2660,3679,19.467922333931785,0.0,1019,0,237427,0,379,0,1262,1902
12629,1,0,0,0,42,0,261,1,0,121726,511104,15.556349186104045,30,957,745,242,28417,331584,382272,1900,2354,2324,2615,3069,22.427661492005804,15.607890301298308,454,1,43802,20352,503,0,1870,1609
12630,1,0,0,0,40,0,216,1,0,152361,602316,17.233687939614086,237,870,810,297,31400,405600,318396,1968,2325,2088,2541,2898,22.64950330581225,8.1903625881272,357,1,46629,10680,513,0,1731,1515
12631,0,0,1,0,56,1,1091,0,0,1594430,5392247,43.829214001622255,1720,2952,2751,1921,52998,614733,679294,2606,4728,3008,3637,5759,28.809720581775867,14.417702721914399,2122,1,464882,20703,830,0,886,1977
12632,1,0,0,0,43,0,371,0,1,333432,1740816,28.142494558940577,792,1213,1213,792,56350,505540,538510,2198,2990,2198,2619,3411,20.518284528683193,0.0,792,1,194040,0,421,0,1406,1777
12633,1,0,0,0,43,0,536,0,0,493680,2223600,31.937438845342623,1020,1504,1504,1020,50400,490500,488320,2180,3200,2180,2664,3684,22.0,0.0,1020,0,228480,0,484,0,1160,1696
12634,1,0,0,0,43,0,548,1,0,522453,2284554,32.357379374726875,1047,1546,1546,1047,38544,477858,384032,2182,3229,2182,2681,3728,22.338307903688676,0.0,1047,1,184272,0,499,0,1135,1683
12635,1,0,0,0,42,0,25,0,0,1807524,2909408,36.837480912787726,1315,2731,2689,1357,37698,392352,441664,2102,3501,2186,3476,4875,36.49657518178932,6.63067838716079,1399,0,279542,4326,1332,0,787,812
12636,1,0,0,0,42,0,12,0,0,1871388,2937612,37.067505985701274,1344,2766,2736,1374,41790,425462,448980,2108,3512,2168,3500,4904,36.90528417449187,5.5503012171862105,1404,0,288540,3600,1362,0,764,776
12637,1,0,0,0,42,0,89,0,0,1862610,2826940,36.345563690772494,1321,2731,2731,1321,40796,464380,402320,2140,3461,2140,3550,4871,37.54996671103717,0.0,1321,0,248348,0,1410,0,819,730
12638,1,0,0,0,42,0,300,0,0,1577725,2349305,33.391615714128,1115,2530,2530,1115,52650,474075,493038,2107,3222,2107,3522,4637,37.61648574760805,0.0,1115,0,260910,0,1415,0,992,692
12639,1,0,0,0,42,0,296,0,0,1543097,2325124,33.21144381083123,1073,2532,2502,1103,46800,493272,421600,2078,3211,2138,3507,4640,37.403208418530085,5.531194905403055,1133,0,220600,5220,1399,0,1005,709
12640,1,0,0,0,44,0,225,1,0,1269900,2256240,31.937438845342623,808,2477,2265,1020,28000,387100,353920,2000,3232,2424,3457,4689,35.2845575287547,15.28251067977674,1232,1,163200,30316,1245,0,1192,967
12641,1,0,0,0,46,0,274,0,1,1383087,3079251,36.345563690772494,960,2729,2368,1321,46842,517482,491841,1970,3652,2692,3378,5060,32.357379374726875,19.752473857671298,1682,1,278731,53428,1047,0,1010,1284
12642,1,0,0,0,45,0,588,0,1,1201789,3255262,37.8021163428716,1201,2498,2270,1429,55822,514828,562666,2050,3707,2506,3119,4776,29.0,16.051508547267655,1657,1,352963,22116,841,0,849,1437
12643,1,0,0,0,44,0,612,0,1,1010965,3026110,36.837480912787726,1175,2284,2102,1357,51054,448230,566420,2048,3587,2412,2975,4514,27.294688127912362,14.249103215689319,1539,1,344678,10010,745,0,873,1485
12644,1,0,0,0,44,0,618,0,1,967480,2969440,36.60601043544625,1170,2232,2062,1340,52877,463144,560648,2046,3556,2386,2938,4448,26.870057685088806,13.64605912284091,1510,1,339020,11220,722,0,876,1494
12645,1,0,0,0,43,0,644,0,1,779916,2717086,35.52463933666322,1202,1940,1880,1262,51562,437059,546862,2093,3415,2213,2771,4093,24.859605789312106,8.111420134500735,1322,1,320548,3360,618,0,891,1535
12646,1,0,0,0,42,0,648,0,1,748800,2666976,35.32704346531139,1218,1878,1848,1248,52371,442359,540661,2107,3385,2167,2737,4015,24.49489742783178,5.652706486041966,1278,1,315744,1980,600,0,889,1537
12647,1,0,0,0,45,0,721,0,0,405132,2472288,33.04542328371661,1062,1493,1463,1092,51706,568264,466384,2234,3356,2294,2635,3757,19.261360284258224,5.501408174353464,1122,1,224952,5400,371,0,1172,1893
12648,1,0,0,0,45,0,699,0,0,356022,2382849,32.264531609803356,1041,1383,1383,1041,54390,508158,560805,2289,3330,2289,2631,3672,18.49324200890693,0.0,1041,0,255045,0,342,0,1248,1947
12649,1,0,0,0,42,0,271,1,0,127946,522652,15.716233645501712,97,915,765,247,33150,359720,412620,1966,2363,2266,2634,3031,22.759613353482084,12.865825024943737,397,1,48165,14550,518,0,1869,1598
12650,1,0,0,0,42,0,272,1,0,124388,510378,15.556349186104045,118,880,756,242,32595,335331,432345,1985,2351,2233,2623,2989,22.67156809750927,11.793485665503141,366,1,49610,8680,514,0,1867,1595
12651,1,0,0,0,40,0,250,0,0,138824,543236,16.3707055437449,268,786,786,268,43152,377022,470264,2027,2295,2027,2545,2813,22.759613353482084,0.0,268,1,62176,0,518,0,1759,1509
12652,0,0,0,0,56,1,1013,1,0,1707660,5380560,43.68065933568311,1674,3037,2803,1908,54675,634500,685260,2586,4728,3054,3715,5857,29.916550603303182,15.575439369641607,2142,1,463644,25272,895,0,912,1925
12653,0,0,1,0,55,1,1135,0,0,1625364,5494437,44.30575583375144,1801,2953,2791,1963,54432,626976,680157,2637,4762,2961,3627,5752,28.77498913987632,12.966644717521362,2125,1,477009,17334,828,0,836,1971
12654,1,0,0,0,45,0,64,1,0,39780,389130,13.038404810405298,46,528,404,170,56595,560805,528759,2165,2459,2413,2523,2817,15.297058540778355,11.265233092802442,294,1,39270,17484,234,0,2119,2055
12655,1,0,0,0,43,0,467,0,0,335478,1879020,29.29163703175362,858,1249,1249,858,47515,483990,470850,2190,3048,2190,2581,3439,19.77371993328519,0.0,858,0,184470,0,391,0,1332,1799
12656,1,0,0,0,43,0,507,0,1,362800,1988144,30.116440692751194,907,1307,1307,907,52070,556768,449360,2192,3099,2192,2592,3499,20.0,0.0,907,1,185935,0,400,0,1285,1792
12657,1,0,0,0,43,0,553,0,0,422690,2152770,31.352830813181765,983,1413,1413,983,56608,508080,534360,2190,3173,2190,2620,3603,20.73644135332772,0.0,983,0,239852,0,430,0,1207,1760
12658,1,0,0,0,47,0,638,1,0,918339,3148401,36.45545226711637,1028,2321,2020,1329,30192,525918,322184,2068,3698,2670,3060,4690,26.28687885618983,19.08346215046382,1630,1,180744,66521,691,0,1040,1678
12659,1,0,0,0,43,0,276,0,0,988972,2479282,33.793490497431605,1100,2050,2008,1142,31416,364728,405977,2129,3313,2213,3037,4221,29.427877939124322,6.653712290320142,1184,0,213554,4410,866,0,1029,1305
12660,1,0,0,0,43,0,260,0,0,1033725,2493645,33.98529093593286,1125,2080,2050,1155,37380,384302,453390,2129,3314,2189,3054,4239,29.916550603303182,5.490867587491313,1185,0,242550,2760,895,0,1004,1264
12661,1,0,0,0,43,0,143,0,0,1438490,2761137,35.679125549822544,1243,2433,2403,1273,55125,488025,531405,2139,3442,2199,3299,4602,33.61547262794322,5.684275577662207,1303,1,311885,2730,1130,0,896,1039
12662,1,0,0,0,42,0,113,0,0,1548078,2796696,36.08323710533743,1302,2491,2491,1302,50621,487596,479004,2148,3450,2148,3337,4639,34.48187929913333,0.0,1302,0,290346,0,1189,0,846,959
12663,1,0,0,0,42,0,108,0,0,1879468,2827110,36.30426972134269,1318,2744,2744,1318,36050,441870,375375,2145,3463,2145,3571,4889,37.76241517699841,0.0,1318,0,230650,0,1426,0,827,719
12664,1,0,0,0,42,0,359,0,0,1640922,2375048,33.37663853655727,1114,2587,2587,1114,40850,405080,458380,2132,3246,2132,3605,4719,38.379682124790975,0.0,1114,0,239510,0,1473,0,1018,659
12665,1,0,0,0,42,0,346,0,0,1500240,2258872,32.61901286060018,1034,2504,2474,1064,35588,460691,348172,2093,3187,2153,3533,4627,37.54996671103717,5.5503012171862105,1094,0,174496,5730,1410,0,1059,713
12666,1,0,0,0,46,0,179,1,0,1322552,2449328,32.61901286060018,740,2631,2307,1064,27600,423568,345300,1978,3366,2626,3545,4933,35.25620512760839,19.21444952085864,1388,1,159600,53460,1243,0,1238,1059
12667,1,0,0,0,46,0,173,1,0,1341600,2482175,32.78719262151,733,2665,2323,1075,26741,431783,330187,1967,3384,2651,3557,4974,35.32704346531139,19.706737610150405,1417,1,153725,60192,1248,0,1234,1061
12668,1,0,0,0,46,0,146,0,1,1403640,2935800,35.4964786985977,878,2756,2374,1260,50301,566190,482310,1948,3590,2712,3444,5086,33.37663853655727,20.231360619709847,1642,1,260820,66468,1114,0,1070,1216
12669,1,0,0,0,46,0,367,0,1,1327050,3111750,36.742346141747674,1073,2610,2333,1350,55304,514015,571640,2028,3655,2582,3288,4915,31.352830813181765,17.39759738731192,1627,1,334800,26315,983,0,955,1322
12670,1,0,0,0,44,0,611,0,1,1100226,3128724,37.389838191679836,1236,2347,2185,1398,53424,474456,563976,2076,3636,2400,3025,4585,28.053520278211074,13.441596129072966,1560,1,352296,11340,787,0,840,1451
12671,1,0,0,0,44,0,622,0,1,1014195,3018015,36.945906403822335,1215,2258,2108,1365,51660,453255,557172,2061,3576,2361,2954,4469,27.258026340878022,12.882345016608866,1515,1,343980,10350,743,0,846,1468
12672,1,0,0,0,44,0,622,1,0,632595,2614260,34.132096331752024,1135,1738,1708,1165,32745,415140,397188,2214,3409,2274,2787,3982,23.302360395462088,5.7180036243905645,1195,1,206205,4140,543,0,1079,1701
12673,1,0,0,0,44,0,683,1,0,564828,2618748,34.161381705077446,1167,1651,1651,1167,42112,502656,421872,2244,3411,2244,2728,3895,22.0,0.0,1167,1,219396,0,484,0,1077,1760
12674,1,0,0,0,41,0,168,0,1,584305,1413155,26.1725046566048,685,1538,1538,685,48160,462112,443545,2063,2748,2063,2916,3601,29.206163733020468,0.0,685,1,147275,0,853,0,1378,1210
12675,1,0,0,0,43,0,249,1,0,202122,738378,18.49324200890693,100,1175,933,342,34960,397256,410210,1917,2501,2401,2750,3334,24.310491562286437,16.02581635611341,584,1,64980,30008,591,0,1817,1568
12676,1,0,0,0,43,0,260,1,0,175821,664350,17.578395831246947,117,1070,878,309,36225,376250,445050,1958,2459,2342,2719,3220,23.853720883753127,14.476566939674468,501,1,63963,17472,569,0,1841,1581
12677,0,1,1,0,63,0,618,0,0,11546263,11881153,61.0,3661,6884,6824,3721,52899,731197,737583,3133,6914,3253,6296,10077,55.70457790882182,7.746504550744806,3781,0,859551,7860,3103,1,528,90
12678,1,0,0,0,43,0,597,1,0,401598,2181816,31.606961258558215,969,1431,1401,999,47250,491400,458640,2154,3183,2214,2586,3615,20.049937655763422,5.684275577662207,1029,1,209790,4560,402,0,1185,1782
12679,1,0,0,0,44,0,855,0,0,262800,2440755,33.090784215548595,1065,1365,1335,1095,54520,523815,517128,2199,3324,2259,2469,3594,15.491933384829668,5.514871952411144,1125,1,254040,3420,240,0,1134,1989
12680,1,0,0,0,43,0,162,0,0,1474528,2795892,36.02776706930364,1298,2434,2434,1298,56400,516960,506190,2154,3452,2154,3290,4588,33.704599092705436,0.0,1298,0,305030,0,1136,0,856,1018
12681,1,0,0,0,42,0,390,0,0,1404376,2143786,31.71750305430741,976,2432,2402,1006,48556,519964,424069,2101,3137,2161,3527,4563,37.36308338453881,5.477225575051661,1036,0,200194,5550,1396,0,1125,735
12682,1,0,0,0,46,0,244,1,0,1300725,2370825,32.01562118716424,690,2629,2294,1025,30504,430218,379332,1978,3338,2648,3582,4942,35.62302626111375,19.5996711002731,1360,1,168100,51590,1269,0,1288,1044
12683,1,0,0,0,45,0,415,0,1,1294436,3111284,36.932370625238775,1148,2529,2313,1364,56088,520068,561126,2065,3645,2497,3230,4810,30.805843601498726,15.401035855643228,1580,1,335544,21384,949,0,917,1332
12684,1,0,0,0,43,0,636,0,1,980476,2967230,36.851051545376556,1273,2165,2080,1358,48070,415150,552805,2100,3543,2270,2907,4350,26.870057685088806,9.80698324197389,1443,1,343574,3910,722,0,827,1463
12685,1,0,0,0,45,0,507,1,0,781218,2646288,34.249087579087416,1083,1929,1839,1173,26970,392544,349680,2166,3429,2346,2922,4185,25.80697580112788,10.373767623621715,1263,1,181815,13230,666,0,1083,1590
12686,1,0,0,0,46,0,956,0,1,133920,2509920,32.863353450309965,995,1289,1204,1080,56144,539168,562408,2239,3404,2409,2448,3613,11.135528725660043,9.310388377026886,1165,1,261360,9945,124,0,1244,2200
12687,1,0,0,0,46,0,674,0,1,544152,2681728,33.88214869219483,986,1784,1622,1148,40600,541952,408800,2174,3484,2498,2810,4120,21.77154105707724,13.170380740752039,1310,1,200900,31914,474,0,1188,1862
12688,1,0,0,0,45,0,60,1,0,124416,732564,18.0,294,738,708,324,56364,551684,522291,2231,2585,2291,2645,2999,19.595917942265423,5.490867587491313,354,1,74844,4230,384,0,1937,1877
12689,1,0,0,0,43,0,370,0,0,930099,2534724,34.161381705077446,1137,1994,1964,1167,35802,508248,332316,2142,3339,2202,2969,4166,28.231188426986208,5.652706486041966,1197,0,178551,6570,797,0,1005,1375
12690,1,0,0,0,43,0,282,1,0,1148680,2672514,34.95711658589707,1180,2204,2162,1222,27874,336798,395847,2145,3409,2229,3127,4391,30.659419433511783,7.225062805578423,1264,1,221182,3864,940,0,965,1247
12691,1,0,0,0,43,0,462,1,0,1615903,2284333,32.57299494980466,1001,2644,2584,1061,34138,363857,434906,2093,3214,2213,3676,4797,39.02563260217571,7.9730082341141015,1121,1,214322,5280,1523,0,1092,630
12692,1,0,0,0,42,0,460,1,0,1577829,2246862,32.357379374726875,987,2614,2554,1047,33234,373404,409886,2086,3193,2206,3653,4760,38.82009788756334,7.849311256600636,1107,1,199977,6540,1507,0,1099,639
12693,1,0,0,0,42,0,449,0,0,1417332,2102310,31.416556144810016,987,2423,2423,987,50055,453690,500550,2130,3117,2130,3566,4553,37.89459064299283,0.0,987,0,231945,0,1436,0,1143,694
12694,1,0,0,0,46,0,237,1,0,1448848,2558395,33.03028912982749,603,2907,2419,1091,37200,469000,436170,1857,3436,2833,3673,5252,36.4417343165772,23.28239906382265,1579,1,202926,72224,1328,0,1254,1017
12695,1,0,0,0,46,0,108,0,1,1422720,2664180,33.76388603226827,716,2812,2388,1140,46765,465063,549195,1913,3477,2761,3585,5149,35.32704346531139,21.255294886131228,1564,1,267900,37312,1248,0,1197,1089
12696,1,0,0,0,46,0,158,0,1,1362659,2893933,35.34119409414458,952,2637,2340,1249,56619,563031,539861,2020,3566,2614,3408,4954,33.03028912982749,18.0507537273318,1546,1,291017,39501,1091,0,1068,1226
12697,1,0,0,0,46,0,201,0,1,1348290,2925726,35.58089374931439,989,2608,2331,1266,55822,522286,570817,2034,3577,2588,3376,4919,32.63433774416144,17.40921730865171,1543,1,312702,26869,1065,0,1045,1246
12698,1,0,0,0,46,0,244,0,1,1335360,2953200,35.832945734337834,1029,2579,2324,1284,54467,499100,577300,2045,3584,2555,3340,4879,32.2490309931942,16.68868233948606,1539,1,322284,20655,1040,0,1016,1260
12699,1,0,0,0,45,0,375,0,1,1295406,3048093,36.61966684720111,1149,2499,2307,1341,55552,509152,563704,2081,3614,2465,3239,4772,31.080540535840107,14.561839326296232,1533,1,332568,18048,966,0,932,1307
12700,1,0,0,0,44,0,506,0,1,1253895,3148047,37.429934544425805,1251,2446,2296,1401,55822,507822,555009,2097,3648,2397,3142,4693,29.916550603303182,13.111772778031689,1551,1,346047,14100,895,0,846,1352
12701,1,0,0,0,43,0,644,0,1,994620,2957830,37.013511046643494,1328,2138,2096,1370,49022,416687,548386,2117,3529,2201,2885,4297,26.94438717061496,6.78953034358522,1412,1,347980,1764,726,0,789,1433
12702,1,0,0,0,42,0,654,0,1,895072,2832624,36.4417343165772,1328,2002,2002,1328,46920,490590,435132,2133,3461,2133,2807,4135,25.96150997149434,0.0,1328,1,270912,0,674,0,805,1459
12703,1,0,0,0,45,0,556,1,0,772800,2728800,34.64101615137755,1076,1968,1844,1200,24800,352470,363840,2150,3474,2398,2918,4242,25.37715508089904,12.081486825133021,1324,1,192000,14384,644,0,1074,1630
12704,0,1,1,0,60,0,1937,0,0,6927228,5597964,42.8485705712571,1501,5944,5609,1836,55552,756152,682976,2714,4885,3384,6822,8993,61.424750711744856,18.44331441566398,2171,0,411264,51590,3773,1,1213,724
12705,0,0,1,0,57,1,482,0,0,705795,3212315,33.391615714128,1025,1838,1748,1115,54858,642463,708726,2791,3996,2971,3514,4719,25.15949125081825,9.491514370027666,1205,1,274290,9090,633,0,1766,2248
12706,0,0,1,0,57,1,678,0,0,2072520,5255838,42.638011210655684,1476,3300,2958,1818,54635,644693,708295,2549,4709,3233,4031,6191,33.76388603226827,19.082131035183334,2160,1,445410,35226,1140,0,1073,1751
12707,1,0,0,0,45,0,62,1,0,138168,770868,18.49324200890693,342,746,746,342,55209,538706,520674,2254,2596,2254,2658,3000,20.09975124224178,0.0,342,1,79002,0,404,0,1912,1850
12708,1,0,0,0,45,0,66,1,0,172800,865152,19.595917942265423,384,834,834,384,53703,547479,497913,2253,2637,2253,2703,3087,21.213203435596427,0.0,384,1,84864,0,450,0,1869,1803
12709,1,0,0,0,44,0,415,0,1,267750,1690650,27.65863337187866,765,1115,1115,765,54216,477360,554710,2210,2975,2210,2560,3325,18.708286933869708,0.0,765,1,192015,0,350,0,1445,1860
12710,1,0,0,0,44,0,483,0,0,260338,1780454,28.39013913315678,776,1159,1129,806,31930,455054,342395,2179,3015,2239,2532,3368,17.97220075561143,5.501408174353464,836,0,124930,5610,323,0,1403,1886
12711,1,0,0,0,47,0,691,0,1,1026600,3364416,37.62977544445356,1008,2549,2141,1416,52156,560736,525096,1968,3792,2784,3101,4925,26.92582403567252,21.442743690702624,1824,1,312936,61608,725,0,960,1651
12712,1,0,0,0,46,0,374,1,0,1255527,2219711,30.805843601498726,578,2643,2272,949,35088,477156,402308,1968,3288,2710,3662,4982,36.373066958946424,20.695300402905296,1320,1,163228,62328,1323,0,1390,1016
12713,1,0,0,0,47,0,189,0,1,1415512,2582650,33.15116890850155,675,2811,2387,1099,52140,517000,556950,1926,3449,2774,3638,5161,35.888716889852724,21.338632516170673,1523,1,260463,47488,1288,0,1251,1062
12714,1,0,0,0,45,0,32,0,1,1378020,2733430,34.49637662132068,871,2667,2348,1190,55029,571953,507637,1978,3487,2616,3455,4964,34.02939905434711,18.42379704107894,1509,1,262990,48169,1158,0,1107,1139
12715,1,0,0,0,44,0,551,0,1,1236270,3151778,37.69615364994153,1326,2386,2291,1421,53784,479088,552282,2123,3639,2313,3088,4604,29.49576240750525,10.477236849499048,1516,1,353829,7125,870,0,797,1348
12716,1,0,0,0,46,0,930,1,0,283624,2706148,34.23448553724738,1172,1414,1414,1172,37347,487199,408693,2309,3481,2309,2551,3723,15.556349186104045,0.0,1172,1,207444,0,242,0,1137,2067
12717,1,0,0,0,46,0,953,0,0,246980,2693480,34.132096331752024,1135,1407,1377,1165,40533,529448,409224,2282,3477,2342,2524,3719,14.560219778561036,5.623413251903491,1195,1,206205,5760,212,0,1147,2100
12718,1,0,0,0,46,0,932,0,0,242528,2636920,33.823069050575526,1144,1356,1356,1144,47742,502490,504795,2305,3449,2305,2517,3661,14.560219778561036,0.0,1144,0,250536,0,212,0,1161,2093
12719,1,0,0,0,46,0,904,0,0,277332,2638092,33.85262175962151,1116,1418,1388,1146,43860,494930,469608,2272,3448,2332,2544,3720,15.556349186104045,5.477225575051661,1176,0,233784,4410,242,0,1156,2060
12720,1,0,0,0,41,0,269,0,0,227430,741855,19.0,361,991,991,361,52000,427440,513750,2055,2416,2055,2685,3046,25.099800796022265,0.0,361,1,90250,0,630,0,1694,1425
12721,1,0,0,0,41,0,231,1,0,287512,908001,20.808652046684813,283,1247,1097,433,35532,394236,396333,1947,2530,2247,2761,3344,25.768197453450252,12.865825024943737,583,1,81837,19500,664,0,1664,1433
12722,1,0,0,0,45,0,81,0,1,302512,1151283,22.60530911091463,511,1103,1103,511,52371,570009,466371,2253,2764,2253,2845,3356,24.331050121192877,0.0,511,1,105777,0,592,0,1742,1661
12723,1,0,0,0,44,0,831,1,0,401166,2616963,34.249087579087416,1143,1545,1515,1173,38208,443969,428352,2201,3404,2261,2573,3776,18.49324200890693,5.652706486041966,1203,1,225216,4230,342,0,1058,1889
12724,1,0,0,0,44,0,659,0,0,597870,2589210,34.20526275297414,1170,1681,1681,1170,50996,539972,462517,2213,3383,2213,2724,3894,22.60530911091463,0.0,1170,1,244530,0,511,0,1043,1702
12725,1,0,0,0,43,0,424,0,0,963072,2638720,34.87119154832539,1216,2008,2008,1216,35156,407960,405790,2170,3386,2170,2962,4178,28.142494558940577,0.0,1216,0,227392,0,792,0,954,1378
12726,1,0,0,0,42,0,554,0,0,1334615,1941341,30.18277654557314,881,2406,2376,911,48314,507178,432593,2101,3042,2161,3596,4537,38.27531841800928,5.478746393072713,941,0,184933,5220,1465,0,1220,666
12727,1,0,0,0,42,0,552,0,0,1311508,1929378,30.033314835362415,860,2398,2356,902,40344,526194,350796,2097,3041,2181,3593,4537,38.13135192987524,6.495386533491135,944,0,147928,9156,1454,0,1237,685
12728,1,0,0,0,47,0,315,0,1,1409200,2453360,32.2490309931942,594,2841,2395,1040,53345,554365,535493,1913,3399,2805,3714,5200,36.810324638611924,21.863593851622035,1486,1,236080,63778,1355,0,1319,1004
12729,1,0,0,0,45,0,293,0,1,1299888,2934144,36.0,1146,2449,2299,1296,53750,486760,566000,2114,3560,2414,3267,4713,31.670175244226233,13.056526021193557,1446,1,324000,12600,1003,0,968,1261
12730,1,0,0,0,44,0,424,0,1,1268372,3022908,36.851051545376556,1263,2387,2292,1358,53928,476364,560952,2131,3584,2321,3160,4613,30.56141357987225,10.21168317809702,1453,1,342216,7030,934,0,868,1292
12731,1,0,0,0,44,0,467,0,1,1257648,3054485,37.134889255254286,1294,2376,2291,1379,53212,469580,555965,2130,3594,2300,3127,4591,30.199337741083,9.982202543931885,1464,1,346129,5695,912,0,836,1303
12732,1,0,0,0,44,0,652,1,0,809573,2849543,35.81898937714463,1198,1999,1914,1283,25155,433095,286509,2136,3504,2306,2852,4220,25.11971337416094,9.344583777936014,1368,1,165507,16915,631,0,938,1590
12733,1,0,0,0,46,0,999,1,0,225910,2764425,34.48187929913333,1122,1446,1379,1189,42048,509175,446400,2258,3514,2392,2515,3771,13.784048752090222,8.416522024785497,1256,1,228288,11122,190,0,1136,2135
12734,1,0,0,0,46,0,1046,0,1,158120,2750580,34.351128074635334,1056,1438,1314,1180,47040,571095,447552,2207,3511,2455,2465,3769,11.575836902790225,11.284767849177381,1304,1,226560,23808,134,0,1151,2197
12735,1,0,0,0,46,0,955,0,0,255714,2711976,34.249087579087416,1143,1421,1391,1173,43442,494768,469336,2282,3485,2342,2530,3733,14.7648230602334,5.514871952411144,1203,0,238119,4410,218,0,1139,2094
12736,1,0,0,0,41,0,40,0,1,703521,1702701,28.61817604250837,789,1708,1678,819,52440,474012,478170,2049,2898,2109,2938,3787,29.30870177950569,5.514871952411144,849,1,188370,3930,859,0,1260,1220
12737,1,0,0,0,42,0,206,1,0,580752,1411254,25.80697580112788,542,1662,1538,666,32550,459823,317850,1995,2785,2243,2991,3781,29.5296461204668,11.546879086349044,790,1,99900,25172,872,0,1453,1247
12738,1,0,0,0,42,0,211,1,0,547626,1369386,25.337718918639855,492,1645,1495,642,31275,479925,296487,1983,2775,2283,2986,3778,29.206163733020468,12.865825024943737,792,1,89238,33150,853,0,1491,1280
12739,1,0,0,0,43,0,246,1,0,363096,1080432,22.181073012818835,224,1498,1230,492,49056,480924,491904,1928,2688,2464,2934,3694,27.16615541441225,16.92335870424053,760,1,110208,34304,738,0,1704,1458
12740,0,0,1,0,56,1,287,0,0,1493538,3874680,37.067505985701274,1374,2461,2461,1374,47124,651420,575280,2820,4194,2820,3907,5281,32.96968304366907,0.0,1374,0,280296,0,1087,1,1446,1733
12741,0,0,1,0,56,1,1173,0,0,2038410,5991690,46.151923036857305,2070,3147,3087,2130,35838,556974,509153,2753,4943,2873,3770,5960,30.93541659651604,8.1903625881272,2190,0,385530,9060,957,1,683,1856
12742,1,0,0,0,45,0,104,1,0,93396,584112,16.06237840420901,258,620,620,258,51528,516192,511664,2264,2522,2264,2626,2884,19.026297590440446,0.0,258,1,58308,0,362,0,2006,1902
12743,1,0,0,0,44,0,473,0,0,252648,1747944,28.142494558940577,792,1111,1111,792,51040,512024,485540,2207,2999,2207,2526,3318,17.86057109949175,0.0,792,0,174240,0,319,0,1415,1888
12744,1,0,0,0,44,0,260,1,0,1520700,3024960,37.013511046643494,1250,2600,2480,1370,24272,326784,362112,2088,3578,2328,3318,4808,33.31666249791537,11.436007248781129,1490,1,224680,12240,1110,0,838,1098
12745,1,0,0,0,46,0,311,0,1,1385976,2421072,32.12475680841802,628,2779,2375,1032,53984,525504,565386,1942,3378,2750,3689,5125,36.64696440361739,20.836564304301803,1436,1,248712,44440,1343,0,1314,1003
12746,1,0,0,0,46,0,134,0,1,1371440,2552648,33.25657829663178,787,2665,2346,1106,48804,452368,574692,1989,3414,2627,3548,4973,35.21363372331802,18.529736431604313,1425,1,275394,19459,1240,0,1202,1068
12747,1,0,0,0,45,0,251,0,1,1301006,2873161,35.679125549822544,1146,2422,2295,1273,54216,487512,566507,2130,3530,2384,3279,4679,31.96873472629156,12.022218309728785,1400,1,319523,9779,1022,0,984,1235
12748,1,0,0,0,44,0,338,0,1,1284755,2937710,36.26292872893749,1230,2377,2292,1315,53130,469140,565202,2149,3549,2319,3211,4611,31.25699921617557,9.956213246629972,1400,1,332695,5780,977,0,919,1257
12749,1,0,0,0,43,0,634,0,1,1224312,3160604,38.31448812133603,1468,2302,2302,1468,55695,505955,510261,2153,3621,2153,2987,4455,28.879058156387302,0.0,1468,1,347916,0,834,0,685,1319
12750,1,0,0,0,46,0,663,1,0,826164,3017577,36.0416425818802,1117,2117,1935,1299,32400,418140,418140,2141,3622,2505,2959,4440,25.219040425836983,14.085671765956267,1481,1,233820,23478,636,0,1024,1687
12751,1,0,0,0,46,0,876,1,0,416556,2841594,34.899856733230294,1110,1668,1560,1218,38880,503928,419940,2225,3551,2441,2675,4001,18.49324200890693,10.669676460233537,1326,1,219240,18900,342,0,1115,1991
12752,1,0,0,0,41,0,41,0,1,704340,1793100,29.32575659723036,830,1709,1679,860,53520,464955,500400,2055,2945,2115,2904,3794,28.61817604250837,5.514871952411144,890,1,206400,3360,819,0,1225,1266
12753,1,0,0,0,42,0,215,1,0,579036,1411896,25.709920264364882,499,1699,1537,661,32046,465648,313992,1974,2797,2298,3012,3835,29.597297173897484,13.226055982240474,823,1,97167,33696,876,0,1475,1260
12754,0,1,1,0,59,0,683,0,0,564828,1450548,22.0,3,2132,1651,484,37556,686313,491508,2516,3481,3478,4164,5129,34.161381705077446,22.55024434407732,965,1,79376,98124,1167,0,2513,1830
12755,0,0,0,0,57,1,736,1,0,2236176,5466420,43.68065933568311,1640,3348,3080,1908,53714,613110,719115,2597,4773,3133,4037,6213,34.23448553724738,16.902688914584953,2176,1,478908,21172,1172,0,957,1693
12756,0,0,0,0,56,1,981,1,0,2101840,5666884,44.955533585978046,1894,3188,3061,2021,54312,614076,695392,2677,4825,2931,3844,5992,32.2490309931942,11.539076697242356,2148,1,501208,11811,1040,0,783,1764
12757,1,0,0,0,44,0,134,0,1,344792,1477210,25.65151067676132,658,1182,1182,658,56619,545535,523085,2245,2903,2245,2769,3427,22.891046284519195,0.0,658,1,153314,0,524,0,1587,1721
12758,1,0,0,0,44,0,440,0,0,267444,1731348,27.964262908219126,782,1124,1124,782,56643,524718,529146,2214,2996,2214,2556,3338,18.49324200890693,0.0,782,0,186898,0,342,0,1432,1872
12759,1,0,0,0,46,0,809,1,0,698492,3108556,36.51027252705737,1036,2154,1857,1333,38409,506044,412764,2035,3665,2629,2856,4486,22.891046284519195,18.24087771906589,1630,1,235941,53163,524,0,999,1808
12760,1,0,0,0,47,0,799,0,1,971432,3461458,38.24918299781056,1046,2544,2127,1463,47775,579670,461370,1949,3829,2783,3030,4910,25.768197453450252,21.445709851527415,1880,1,285285,78813,664,0,903,1702
12761,1,0,0,0,45,0,772,1,0,563340,2810550,35.07135583350036,1140,1778,1688,1230,34020,411300,431865,2195,3515,2375,2743,4063,21.400934559032695,10.706736236140928,1320,1,232470,10710,458,0,1055,1827
12762,1,0,0,0,44,0,678,0,0,678960,2717070,35.07135583350036,1230,1782,1782,1230,49494,499234,483771,2209,3439,2209,2761,3991,23.49468024894146,0.0,1230,0,269370,0,552,0,979,1657
12763,1,0,0,0,46,0,307,0,1,1367658,2403918,32.03123475609393,665,2720,2359,1026,52002,501402,569349,1982,3369,2704,3676,5063,36.51027252705737,19.830898668669334,1387,1,249318,34656,1333,0,1317,1010
12764,1,0,0,0,45,0,38,0,1,1329048,2672160,34.23448553724738,980,2498,2306,1172,53676,574560,485640,2088,3452,2472,3414,4778,33.67491648096547,14.697647169827432,1364,1,249636,32064,1134,0,1108,1146
12765,1,0,0,0,45,0,124,0,1,1316357,2748970,34.79942528261063,1061,2448,2298,1211,55029,501670,565230,2120,3481,2420,3357,4718,32.96968304366907,13.168301036937951,1361,1,301539,12600,1087,0,1059,1183
12766,1,0,0,0,44,0,211,0,1,1303332,2813244,35.38361202590826,1144,2401,2293,1252,53965,483105,563997,2139,3499,2355,3288,4648,32.264531609803356,11.093467603198212,1360,1,314252,7992,1041,0,995,1206
12767,1,0,0,0,44,0,297,0,1,1290118,2879150,35.9722114972099,1227,2358,2291,1294,53172,469475,560700,2158,3519,2292,3222,4583,31.575306807693888,8.892463825840219,1361,1,326088,4489,997,0,931,1228
12768,1,0,0,0,43,0,508,0,1,1255685,3026271,37.456641600656084,1403,2298,2298,1403,53592,500424,498267,2157,3560,2157,3052,4455,29.916550603303182,0.0,1403,1,324093,0,895,0,754,1262
12769,1,0,0,0,43,0,664,1,0,998585,3040075,37.21558813185679,1355,2136,2106,1385,38380,417050,443390,2165,3580,2225,2916,4331,26.851443164195103,5.7180036243905645,1415,1,279770,3540,721,0,810,1474
12770,1,0,0,0,46,0,968,1,0,331248,2884824,35.156791662493895,1151,1589,1504,1236,34542,471468,399114,2249,3570,2419,2602,3923,16.3707055437449,9.370214040084857,1321,1,211356,14110,268,0,1098,2066
12771,1,0,0,0,41,0,120,0,1,702000,1879200,30.0,900,1680,1680,900,52899,482328,478152,2088,2988,2088,2868,3768,27.92848008753788,0.0,900,1,206100,0,780,0,1188,1308
12772,1,0,0,0,42,0,215,1,0,645354,1505826,26.514147167125703,553,1771,1621,703,28152,394128,327726,1992,2845,2292,3060,3913,30.298514815086232,12.865825024943737,853,1,107559,24300,918,0,1439,1224
12773,0,0,0,0,56,1,942,1,0,2189968,5681368,44.98888751680797,1897,3233,3106,2024,54780,617540,698943,2680,4831,2934,3889,6040,32.89376840679705,11.552234068076439,2151,1,503976,11303,1082,0,783,1725
12774,1,0,0,0,44,0,18,1,0,368368,1381688,24.819347291981714,616,1214,1214,616,53352,524862,511404,2243,2859,2243,2841,3457,24.454038521274967,0.0,616,1,140448,0,598,0,1627,1645
12775,1,0,0,0,44,0,117,1,0,355978,1473920,25.65151067676132,658,1199,1199,658,52560,537600,490560,2240,2898,2240,2781,3439,23.259406699226016,0.0,658,1,144102,0,541,0,1582,1699
12776,1,0,0,0,45,0,853,1,0,345900,2610392,33.95585369269929,943,1663,1453,1153,28960,409784,362240,2054,3417,2474,2564,3927,17.320508075688775,14.921685106015376,1363,1,184480,31710,300,0,1111,1964
12777,1,0,0,0,46,0,835,1,0,691524,3157016,36.71511950137164,1029,2180,1861,1348,34860,491820,388772,2023,3690,2661,2855,4522,22.64950330581225,18.915016892515798,1667,1,223768,57739,513,0,994,1829
12778,1,0,0,0,47,0,830,1,0,796031,3294645,37.403208418530085,1038,2329,1968,1399,33280,489840,376800,1994,3754,2716,2924,4684,23.853720883753127,20.08449429390723,1760,1,223840,66424,569,0,956,1786
12779,1,0,0,0,45,0,297,1,0,1544200,3173800,37.416573867739416,1250,2653,2503,1400,21024,326448,330982,2117,3667,2417,3370,4920,33.21144381083123,13.130475867068439,1550,1,204400,17250,1103,0,867,1164
12780,1,0,0,0,47,0,579,0,1,1265272,2068384,29.5296461204668,361,2834,2323,872,42705,519468,462540,1861,3244,2883,3823,5206,38.09199390948182,23.24080825333086,1383,1,170040,82782,1451,0,1500,921
12781,1,0,0,0,46,0,258,0,1,1349920,2407600,32.2490309931942,743,2635,2338,1040,50600,463000,585695,2018,3355,2612,3613,4950,36.02776706930364,17.98355945099906,1337,1,263120,16929,1298,0,1275,1017
12782,1,0,0,0,45,0,4,0,1,1324797,2607081,33.896902513356586,979,2472,2302,1149,52961,569519,478759,2099,3418,2439,3422,4741,33.95585369269929,13.852363991743774,1319,1,242439,27880,1153,0,1120,1116
12783,1,0,0,0,45,0,39,0,1,1318672,2647856,34.17601498127012,1018,2447,2297,1168,55920,528211,544080,2117,3435,2417,3396,4714,33.60059523282288,13.1493192969221,1318,1,280320,16200,1129,0,1099,1138
12784,1,0,0,0,44,0,125,0,1,1310556,2717832,34.77067730142742,1101,2401,2293,1209,53320,483320,557504,2140,3457,2356,3332,4649,32.92415526630866,11.227269336102799,1317,1,299832,7668,1084,0,1039,1164
12785,1,0,0,0,43,0,339,0,1,1285732,2872828,36.27671429443411,1316,2293,2293,1316,50292,432234,554482,2183,3499,2183,3160,4476,31.25699921617557,0.0,1316,1,334264,0,977,0,867,1206
12786,1,0,0,0,43,0,423,0,1,1274320,2940320,36.87817782917155,1360,2297,2297,1360,49042,488612,469154,2162,3522,2162,3099,4459,30.610455730027933,0.0,1360,1,295120,0,937,0,802,1225
12787,1,0,0,0,46,0,1025,0,1,331014,3012484,35.81898937714463,1159,1665,1541,1283,48832,511864,525952,2224,3631,2472,2606,4013,16.06237840420901,11.401248222293653,1407,1,287392,15748,258,0,1065,2090
12788,1,0,0,0,41,0,254,0,1,689471,2025865,31.096623610932426,967,1680,1680,967,53680,460900,511180,2095,3062,2095,2808,3775,26.70205984563738,0.0,967,1,235948,0,713,0,1128,1382
12789,1,0,0,0,43,0,220,1,0,680124,1559520,26.870057685088806,560,1826,1664,722,25900,378000,319680,1998,2882,2322,3102,3986,30.692018506445613,13.425198563041231,884,1,106856,25110,942,0,1438,1218
12790,1,0,0,0,41,0,271,1,0,361712,999999,21.93171219946131,481,1233,1233,481,41580,411642,436590,2079,2560,2079,2831,3312,27.422618401604176,0.0,481,1,101010,0,752,0,1598,1327
12791,0,0,1,0,56,1,323,0,0,1717638,4189614,38.49675310984031,1482,2641,2641,1482,50076,661518,604978,2827,4309,2827,3986,5468,34.044089061098404,0.0,1482,0,317148,0,1159,1,1345,1668
12792,0,0,0,0,57,1,666,1,0,2414032,5523828,43.840620433565945,1627,3473,3178,1922,55860,655272,704130,2579,4796,3169,4130,6347,35.4400902933387,17.639976317990524,2217,1,470890,30975,1256,0,952,1618
12793,1,0,0,0,46,0,361,1,0,37910,196690,9.219544457292887,35,651,531,85,56876,546104,557674,2194,2399,2434,2760,2965,21.118712081942874,11.015556749295067,205,1,20485,14280,446,0,2229,1868
12794,1,0,0,0,45,0,169,1,0,108120,581145,15.968719422671311,255,679,679,255,49665,526449,489985,2279,2534,2279,2703,2958,20.591260281974,0.0,255,1,54825,0,424,0,2024,1855
12795,1,0,0,0,44,0,635,0,0,850794,2849772,35.958309192730404,1293,1951,1951,1293,48319,465044,504716,2204,3497,2204,2862,4155,25.65151067676132,0.0,1293,0,296097,0,658,0,911,1546
12796,1,0,0,0,42,0,779,0,0,1232442,1688115,28.053520278211074,787,2353,2353,787,38915,461175,388245,2145,2932,2145,3711,4498,39.57271787481876,0.0,787,0,142447,0,1566,0,1358,579
12797,1,0,0,0,43,0,777,0,0,1212124,1675629,27.910571473905726,749,2365,2335,779,36668,443106,382878,2121,2930,2181,3707,4516,39.44616584663204,5.684275577662207,809,0,138662,4950,1556,0,1372,595
12798,1,0,0,0,47,0,473,0,1,1332930,2215584,30.692018506445613,581,2718,2357,942,52948,510384,573888,1991,3294,2713,3767,5070,37.61648574760805,19.850999416526108,1303,1,229848,35378,1415,0,1410,937
12799,1,0,0,0,46,0,341,0,1,1338660,2321676,31.606961258558215,702,2636,2339,999,52118,478744,587972,2027,3323,2621,3664,4960,36.60601043544625,18.016865855193082,1296,1,252747,18711,1340,0,1325,984
12800,1,0,0,0,44,0,89,0,1,1321670,2487394,33.25657829663178,936,2471,2301,1106,52961,564499,474539,2079,3355,2419,3444,4720,34.56877203488721,13.53128240199624,1276,1,233366,27880,1195,0,1143,1054
12801,1,0,0,0,44,0,127,0,1,1308138,2683980,34.77067730142742,1142,2358,2291,1209,52430,475080,543900,2153,3429,2287,3302,4578,32.89376840679705,8.748575453901612,1276,1,296205,4690,1082,0,1011,1138
12802,1,0,0,0,43,0,297,0,1,1294704,2817504,36.0,1296,2295,2295,1296,54467,471758,545674,2174,3470,2174,3173,4469,31.606961258558215,0.0,1296,1,325296,0,999,0,878,1175
12803,1,0,0,0,46,0,1110,0,1,232200,2996670,35.91656999213594,1290,1470,1470,1290,51192,550551,501768,2323,3613,2323,2503,3793,13.416407864998739,0.0,1290,1,278640,0,180,0,1033,2143
12804,1,0,0,0,46,0,1036,1,0,329205,3032559,35.93048844644336,1206,1631,1546,1291,33936,474498,394632,2264,3640,2434,2604,3980,15.968719422671311,9.548881526149486,1376,1,216888,14365,255,0,1058,2094
12805,1,0,0,0,44,0,239,1,0,594900,1458166,25.709920264364882,378,1844,1561,661,28217,447818,306634,1923,2867,2489,3106,4050,30.0,17.719550885613856,944,1,91879,56034,900,0,1545,1306
12806,1,0,0,0,42,0,267,1,0,401434,1086082,22.67156809750927,429,1380,1295,514,22560,397244,253560,2028,2627,2198,2894,3493,27.94637722496424,9.831014644105558,599,1,61680,16745,781,0,1599,1332
12807,1,0,0,0,45,0,209,1,0,109142,552244,15.556349186104045,242,693,693,242,49728,506604,511168,2282,2524,2282,2733,2975,21.236760581595302,0.0,242,1,54208,0,451,0,2040,1831
12808,1,0,0,0,44,0,606,0,0,958816,2921600,36.4417343165772,1328,2050,2050,1328,51516,534600,466400,2200,3528,2200,2922,4250,26.870057685088806,0.0,1328,0,281536,0,722,0,872,1478
12809,1,0,0,0,45,0,328,1,0,1503273,3195681,37.429934544425805,1293,2582,2474,1401,9396,369522,132298,2173,3682,2389,3354,4863,32.7566787083184,11.883886906268113,1509,1,81258,23544,1073,0,880,1208
12810,1,0,0,0,46,0,56,1,0,1589337,2871657,35.11409973215888,991,2764,2522,1233,22815,393601,314415,2087,3562,2571,3618,5093,35.90264614203248,17.29833376924436,1475,1,166455,38478,1289,0,1096,1040
12811,1,0,0,0,46,0,424,0,1,1321617,2226939,30.93541659651604,657,2638,2338,957,53676,495651,586404,2027,3284,2627,3708,4965,37.16180835212409,18.126405705909097,1257,1,241164,22200,1381,0,1370,946
12812,1,0,0,0,44,0,87,0,1,1314864,2471856,33.2264954516723,977,2422,2295,1104,52858,553033,479146,2112,3343,2366,3430,4661,34.51086785347479,11.81597791836795,1231,1,236256,19177,1191,0,1135,1048
12813,1,0,0,0,43,0,212,0,1,1304373,2724022,35.397740040855716,1253,2294,2294,1253,56350,500020,532630,2174,3427,2174,3215,4468,32.264531609803356,0.0,1253,1,306985,0,1041,0,921,1133
12814,1,0,0,0,44,0,569,1,0,1174580,3135960,37.48332962798263,1281,2365,2241,1405,25110,415152,301320,2108,3637,2356,3068,4597,28.91366458960192,11.137157851700797,1529,1,189675,22444,836,0,827,1396
12815,1,0,0,0,43,0,230,1,0,722939,1633857,27.258026340878022,527,1932,1716,743,25955,393621,318855,1983,2942,2415,3172,4131,31.192947920964443,15.797519287480007,959,1,107735,35208,973,0,1456,1226
12816,1,0,0,0,44,0,253,1,0,560838,1414122,25.15949125081825,375,1777,1519,633,32164,384248,417758,1976,2867,2492,3120,4011,29.765752132274432,16.12004122835068,891,1,118371,28122,886,0,1601,1348
12817,0,1,1,0,58,0,1909,0,0,2184770,2344160,28.372521918222215,763,3561,3519,805,40096,652288,521248,2870,3717,2954,5626,6473,52.09606511052442,6.609134537568676,847,0,144095,7728,2714,1,2107,198
12818,0,0,1,0,58,1,885,0,0,333450,3433950,34.20526275297414,928,1697,1455,1170,52864,692660,657440,2693,4105,3177,3220,4632,16.881943016134134,15.571269388878848,1412,1,262080,35574,285,0,1765,2650
12819,0,0,1,0,56,1,361,0,0,1796676,4347588,39.153543900903784,1533,2705,2705,1533,42966,615412,561528,2836,4369,2836,4008,5541,34.23448553724738,0.0,1533,0,303534,0,1172,1,1303,1664
12820,1,0,0,0,44,0,457,0,0,307188,1843956,28.77498913987632,828,1199,1199,828,50624,498848,503302,2227,3055,2227,2598,3426,19.261360284258224,0.0,828,0,187128,0,371,0,1399,1856
12821,1,0,0,0,44,0,557,1,0,272310,1941840,29.49576240750525,840,1213,1183,870,36676,473184,386136,2202,3102,2262,2545,3445,17.69180601295413,5.684275577662207,900,1,150510,5280,313,0,1362,1919
12822,1,0,0,0,44,0,615,0,0,1008994,2990316,36.851051545376556,1328,2131,2101,1358,49796,519672,464622,2172,3560,2232,2945,4333,27.258026340878022,5.483301264452448,1388,0,286538,4920,743,0,844,1459
12823,1,0,0,0,47,0,759,0,1,1195786,1861754,27.892651361962706,294,2799,2315,778,41140,526460,447491,1909,3171,2877,3930,5192,39.20459156782532,22.85125916832924,1262,1,145486,83248,1537,0,1615,856
12824,1,0,0,0,47,0,640,0,1,1285284,2030886,29.29163703175362,497,2717,2356,858,52750,499437,591750,2006,3225,2728,3865,5084,38.704004960727254,19.975611676981316,1219,1,214500,28519,1498,0,1509,869
12825,1,0,0,0,45,0,384,0,1,1304100,2216970,31.080540535840107,732,2550,2316,966,53172,484245,578340,2061,3261,2529,3645,4845,36.742346141747674,15.97700124035145,1200,1,243432,17082,1350,0,1329,945
12826,1,0,0,0,44,0,215,0,1,1307496,2332881,32.264531609803356,891,2447,2297,1041,47880,425790,564732,2091,3282,2391,3497,4688,35.4400902933387,12.667476048676626,1191,1,262332,7050,1256,0,1200,985
12827,1,0,0,0,44,0,171,0,1,1309446,2365074,32.58834147360065,935,2422,2295,1062,55800,501075,552296,2100,3289,2354,3460,4649,35.11409973215888,11.579381003458169,1189,1,263376,12319,1233,0,1165,994
12828,1,0,0,0,43,0,127,0,1,1312724,2630292,34.79942528261063,1211,2295,2295,1211,55912,503904,523452,2172,3383,2172,3256,4467,32.92415526630866,0.0,1211,1,291851,0,1084,0,961,1088
12829,1,0,0,0,47,0,857,1,0,855768,3424520,38.05259518088089,1147,2340,2039,1448,38502,439890,489555,2064,3813,2666,2956,4705,24.310491562286437,18.011391787344923,1749,1,299736,31906,591,0,917,1774
12830,1,0,0,0,46,0,1099,0,1,346880,3161215,36.810324638611924,1325,1641,1611,1355,54289,543589,543589,2303,3688,2363,2589,3974,16.0,5.483301264452448,1385,1,315715,3990,256,0,978,2077
12831,1,0,0,0,47,0,1083,0,1,414900,3268029,37.1887079635741,1100,1966,1683,1383,47561,470237,564757,2080,3746,2646,2663,4329,17.320508075688775,16.996538735441106,1666,1,330537,23206,300,0,980,2063
12832,1,0,0,0,43,0,265,1,0,485834,1247474,24.020824298928627,443,1553,1419,577,17922,376188,222686,2028,2739,2296,3004,3715,29.017236257093817,12.683189504223728,711,1,59431,26398,842,0,1585,1320
12833,1,0,0,0,43,0,260,1,0,500061,1288143,24.269322199023193,399,1628,1438,589,19470,387099,240570,1997,2776,2377,3036,3815,29.13760456866693,15.080825849763109,779,1,64790,36670,849,0,1598,1338
12834,0,1,1,0,57,0,448,0,0,200825,802469,16.64331697709324,7,1272,1002,277,54145,640237,709765,2627,3174,3167,3622,4169,26.92582403567252,16.8425230770233,547,1,67865,26730,725,0,2620,2172
12835,0,0,1,0,56,1,394,0,0,1775600,4392680,39.293765408777,1502,2736,2694,1544,42848,586070,591760,2803,4389,2887,3995,5581,33.91164991562634,6.553889165207866,1586,1,321152,5502,1150,0,1301,1695
12836,0,0,1,0,57,1,491,0,0,2743680,5543040,43.81780460041329,1664,3605,3349,1920,52640,646688,678445,2631,4807,3143,4316,6492,37.8021163428716,16.000549288119593,2176,1,451200,30464,1429,0,967,1458
12837,0,0,0,0,56,1,871,1,0,2521302,5835846,45.628938186199335,1958,3417,3293,2082,54250,608251,700750,2679,4885,2927,4014,6220,34.79942528261063,11.33917216041645,2206,1,520500,10416,1211,0,721,1592
12838,1,0,0,0,44,0,351,1,0,1471050,3148047,37.429934544425805,1316,2536,2451,1401,14673,451647,164031,2162,3648,2332,3297,4783,32.4037034920393,9.511914438752074,1486,1,102273,20995,1050,0,846,1197
12839,1,0,0,0,47,0,766,0,1,1250435,1906414,28.26658805020514,408,2755,2364,799,53784,515376,594114,1995,3185,2777,3951,5141,39.56008088970496,20.839465388117805,1190,1,198951,33626,1565,0,1587,821
12840,1,0,0,0,46,0,468,0,1,1286208,2125200,30.397368307141328,690,2550,2316,924,52877,480700,581900,2066,3224,2534,3692,4850,37.30951621235526,16.027759703794327,1158,1,233772,16380,1392,0,1376,908
12841,1,0,0,0,43,0,85,0,1,1310364,2425497,33.21144381083123,1061,2333,2291,1103,54656,492576,536556,2157,3302,2241,3387,4532,34.46737587922817,6.7597809605921,1145,1,269132,3738,1188,0,1096,1011
12842,1,0,0,0,45,0,510,1,0,1191616,3109760,37.094473981982816,1346,2272,2242,1376,36456,379680,490420,2230,3636,2290,3126,4532,29.427877939124322,6.198285684332168,1406,1,298592,2070,866,0,884,1394
12843,1,0,0,0,42,0,594,1,0,368767,814471,19.467922333931785,294,1437,1352,379,38304,361032,489972,2064,2528,2234,3122,3586,31.192947920964443,9.239893968762086,464,1,86412,4675,973,0,1770,1176
12844,1,0,0,0,42,0,604,0,0,233696,563872,16.3707055437449,268,1140,1140,268,40660,399760,450256,2104,2372,2104,2976,3244,29.5296461204668,0.0,268,1,57352,0,872,0,1836,1232
12845,0,1,1,0,59,0,1858,0,0,9300303,6765705,47.52893855326458,2259,6376,6376,2259,52200,694840,673875,2995,5254,2995,7112,9371,64.16385275215322,0.0,2259,0,508275,0,4117,1,736,1122
12846,0,1,1,0,60,0,938,0,0,820439,1666775,23.473389188611005,14,2577,2040,551,31590,589875,490050,2488,3576,3562,4514,5602,38.58756276314948,23.83904563483743,1088,1,89262,89679,1489,0,2474,1536
12847,0,0,1,0,57,1,461,0,0,2841972,5595072,43.95452195167182,1690,3645,3403,1932,48124,613952,657392,2654,4828,3138,4367,6541,38.353617821530214,15.558009107250758,2174,1,438564,28072,1471,0,964,1425
12848,0,0,0,0,55,1,910,1,0,2578536,5921712,46.08687448721165,2039,3423,3338,2124,54780,613360,694212,2703,4912,2873,4002,6211,34.84250278036869,9.332611979058527,2209,1,528876,7650,1214,0,664,1574
12849,1,0,0,0,46,0,136,1,0,256497,1031747,21.047565179849187,261,1204,1022,443,46330,526354,477445,2147,2772,2511,2908,3533,24.06241883103193,13.738384613864339,625,1,90815,29120,579,0,1886,1750
12850,1,0,0,0,44,0,560,1,0,294921,2001186,29.8496231131986,849,1264,1222,891,34132,476152,361606,2204,3137,2288,2577,3510,18.193405398660254,6.7040592262067955,933,1,143451,7896,331,0,1355,1915
12851,1,0,0,0,46,0,1035,1,0,181764,2766852,34.46737587922817,828,1701,1341,1188,28545,402917,384285,1969,3517,2689,2482,4030,12.36931687685298,19.512999268313223,1548,1,196020,48600,153,0,1141,2176
12852,1,0,0,0,44,0,836,0,0,815301,3150990,37.589892258425,1413,1990,1990,1413,47940,524050,454920,2230,3643,2230,2807,4220,24.020824298928627,0.0,1413,0,288252,0,577,0,817,1653
12853,1,0,0,0,45,0,736,0,1,950340,3220440,37.54996671103717,1286,2208,2084,1410,49938,463652,561864,2160,3694,2408,2958,4492,25.96150997149434,11.932888170540295,1534,1,346860,9424,674,0,874,1610
12854,1,0,0,0,44,0,650,0,0,1082475,3113000,37.61648574760805,1415,2180,2180,1415,52212,503800,501600,2200,3615,2200,2965,4380,27.65863337187866,0.0,1415,0,322620,0,765,0,785,1435
12855,1,0,0,0,47,0,376,0,0,1266537,2246221,30.870698080866262,658,2577,2282,953,45715,483185,525611,2062,3310,2652,3686,4934,36.45545226711637,18.575774954861963,1248,1,212519,32745,1329,0,1404,1028
12856,1,0,0,0,47,0,807,0,1,1223694,1842120,27.820855486487112,398,2731,2355,774,54780,523600,592620,2004,3154,2756,3961,5111,39.761790704142086,20.44917177477216,1150,1,192726,33464,1581,0,1606,799
12857,1,0,0,0,47,0,720,0,1,1241641,1915582,28.478061731796284,487,2666,2342,811,52208,491296,592862,2038,3173,2686,3893,5028,39.1279950930277,19.068155506358412,1135,1,203561,23652,1531,0,1551,831
12858,1,0,0,0,46,0,593,0,1,1261170,2008530,29.410882339705484,610,2578,2323,865,50904,469044,585144,2067,3187,2577,3780,4900,38.18376618407357,16.851986126960185,1120,1,217980,16320,1458,0,1457,864
12859,1,0,0,0,46,0,552,0,1,1264788,2037420,29.698484809834994,648,2550,2316,882,50148,459690,582120,2076,3192,2544,3744,4860,37.86819245752297,16.160887083353256,1116,1,222264,13806,1434,0,1428,876
12860,1,0,0,0,45,0,469,0,1,1273266,2094876,30.298514815086232,726,2497,2305,918,52624,474656,577346,2090,3200,2474,3669,4779,37.242448899072144,14.53293021104503,1110,1,232254,13056,1387,0,1364,895
12861,1,0,0,0,45,0,1375,1,0,185876,3405728,38.71692136521188,1257,1865,1623,1499,42273,415776,524832,2030,3771,2514,2396,4137,11.135528725660043,16.090297175001925,1741,1,346269,17424,124,0,773,2148
12862,1,0,0,0,44,0,1398,1,0,205288,3442404,39.14077158156185,1320,1878,1666,1532,40205,420189,483105,2035,3779,2459,2381,4125,11.575836902790225,14.910913195537242,1744,1,329380,20776,134,0,715,2113
12863,1,0,0,0,45,0,264,1,0,650065,1548785,26.1725046566048,535,1784,1634,685,34393,368543,477071,2111,2946,2411,3210,4045,30.805843601498726,12.68159626954734,835,1,144535,10200,949,0,1576,1312
12864,1,0,0,0,44,0,691,0,1,1080750,3210548,37.960505792204614,1411,2221,2191,1441,44144,396584,552544,2198,3669,2258,2978,4449,27.386127875258307,5.753771868478424,1471,1,357368,1170,750,0,787,1478
12865,1,0,0,0,44,0,658,0,0,1137215,3183335,38.01315561749642,1445,2232,2232,1445,52182,515502,491269,2203,3648,2203,2990,4435,28.053520278211074,0.0,1445,0,322235,0,787,0,758,1416
12866,1,0,0,0,44,0,516,1,0,1416960,3256056,38.41874542459709,1446,2466,2436,1476,55876,538264,505174,2176,3682,2236,3166,4672,30.983866769659336,6.249099805534655,1506,1,338004,4350,960,0,730,1246
12867,1,0,0,0,43,0,845,1,0,1048050,1495355,26.1725046566048,643,2257,2215,685,25652,462796,264143,2141,2868,2225,3713,4440,39.11521443121589,6.991237203771572,727,1,82885,9366,1530,0,1498,653
12868,1,0,0,0,47,0,927,0,1,1138900,1674400,26.457513110645905,254,2773,2327,700,55876,583648,547768,1946,3092,2838,4019,5165,40.33608806019741,22.062770847550773,1146,1,160300,65116,1627,0,1692,765
12869,1,0,0,0,46,0,635,0,1,1241316,1950279,29.0,607,2551,2317,841,51359,470757,586707,2085,3160,2553,3795,4870,38.41874542459709,16.24481203586954,1075,1,212773,14508,1476,0,1478,843
12870,1,0,0,0,46,0,594,0,1,1245816,1978548,29.29163703175362,646,2522,2310,858,51359,468118,583418,2094,3164,2518,3758,4828,38.1051177665153,15.439557921819016,1070,1,217074,12932,1452,0,1448,854
12871,1,0,0,0,44,0,426,0,1,1270240,2100566,30.56141357987225,800,2428,2294,934,51612,458796,568997,2115,3183,2383,3609,4677,36.87817782917155,12.05117632088489,1068,1,236302,8308,1360,0,1315,889
12872,1,0,0,0,43,0,127,0,1,1312724,2364204,32.92415526630866,1084,2295,2295,1084,51246,510354,477639,2181,3265,2181,3392,4476,34.79942528261063,0.0,1084,1,237396,0,1211,0,1097,970
12873,1,0,0,0,43,0,0,0,1,1329409,2518152,33.95585369269929,1086,2373,2306,1153,42624,484848,419328,2117,3337,2251,3337,4557,33.95585369269929,8.19263674150144,1220,1,221376,11256,1153,0,1031,1031
12874,1,0,0,0,46,0,1089,0,1,525262,3393889,38.09199390948182,1451,1813,1813,1451,54026,556682,530953,2339,3790,2339,2701,4152,19.026297590440446,0.0,1451,1,329377,0,362,0,888,1977
12875,1,0,0,0,42,0,618,0,1,637255,2460480,34.132096331752024,1165,1712,1712,1165,47515,466752,454080,2112,3277,2112,2659,3824,23.388031127053,0.0,1165,1,250475,0,547,0,947,1565
12876,1,0,0,0,44,0,111,1,0,822292,1910720,29.206163733020468,576,2094,1817,853,26445,481600,275520,1963,3093,2517,3204,4334,31.04834939252005,17.78892599201163,1130,1,104919,62325,964,0,1387,1276
12877,1,0,0,0,45,0,253,1,0,782340,1751828,27.694764848252458,577,1977,1787,767,36946,463652,415688,2094,3051,2474,3304,4261,31.937438845342623,14.044701627992035,957,1,139594,29640,1020,0,1517,1264
12878,1,0,0,0,42,0,533,1,0,157940,449652,14.560219778561036,88,1081,957,212,38976,492072,356328,1997,2333,2245,2866,3202,27.294688127912362,11.316469623900245,336,1,35616,25296,745,0,1909,1376
12879,0,1,1,0,61,0,1264,0,0,10984452,8439876,52.364109846344185,2700,6790,6748,2742,41625,569430,692550,3036,5820,3120,7084,9868,63.29296959378664,6.484411467763075,2784,0,616950,3486,4006,1,336,928
12880,0,0,1,0,57,1,535,0,0,1555344,4445383,39.28103868280471,1351,2743,2551,1543,41818,593486,584843,2689,4424,3073,3889,5624,31.74901573277509,13.865793893587346,1735,1,313229,26304,1008,0,1338,1873
12881,1,0,0,0,44,0,500,1,0,348381,1996731,29.8496231131986,861,1312,1282,891,35420,493020,360801,2211,3132,2271,2632,3553,19.77371993328519,5.501408174353464,921,1,143451,5910,391,0,1350,1850
12882,1,0,0,0,44,0,859,0,0,950820,3338335,38.66522985836241,1465,2161,2131,1495,56153,538153,520289,2203,3728,2263,2869,4394,25.219040425836983,5.483301264452448,1525,1,348335,4110,636,0,738,1597
12883,1,0,0,0,45,0,785,0,1,1006950,3379530,38.34057902536163,1308,2317,2155,1470,45264,565554,423016,2137,3769,2461,2984,4616,26.1725046566048,13.226055982240474,1632,1,270480,32562,685,0,829,1614
12884,1,0,0,0,44,0,664,0,0,1196225,3245000,38.40572873934304,1475,2286,2286,1475,55200,528000,506000,2200,3675,2200,3011,4486,28.478061731796284,0.0,1475,0,339250,0,811,0,725,1389
12885,1,0,0,0,44,0,648,0,0,1226740,3261946,38.44476557348217,1448,2338,2308,1478,50546,560578,439193,2177,3685,2237,3037,4545,28.809720581775867,5.501408174353464,1508,0,294122,5610,830,0,729,1377
12886,1,0,0,0,44,0,631,0,0,1258850,3275972,38.48376280978771,1481,2331,2331,1481,54000,553000,477792,2212,3693,2212,3062,4543,29.154759474226502,0.0,1481,1,319896,0,850,0,731,1362
12887,1,0,0,0,48,0,47,0,1,1268450,2653818,33.21144381083123,708,2648,2253,1103,39585,469170,488418,2011,3509,2801,3556,5054,33.91164991562634,21.309472135311417,1498,1,223909,48980,1150,0,1303,1256
12888,1,0,0,0,47,0,165,0,1,1213114,2439514,31.96873472629156,601,2630,2209,1022,43442,510818,484561,1966,3409,2808,3574,5017,34.45286635390443,21.946768986256945,1443,1,207466,61887,1187,0,1365,1200
12889,1,0,0,0,46,0,801,0,1,1197990,1796985,27.65863337187866,470,2626,2331,765,54718,512082,589599,2054,3114,2644,3915,4975,39.57271787481876,18.216939832741396,1060,1,192015,23600,1566,0,1584,783
12890,1,0,0,0,46,0,719,0,1,1212882,1857675,28.26658805020514,557,2559,2317,799,52877,485925,588225,2083,3124,2567,3843,4884,38.961519477556315,16.545885401338353,1041,1,202147,15730,1518,0,1526,807
12891,1,0,0,0,45,0,637,0,1,1226814,1917366,28.879058156387302,642,2497,2305,834,52118,473594,581647,2107,3133,2491,3770,4796,38.353617821530214,14.744899158146904,1026,1,211002,11904,1471,0,1465,828
12892,1,0,0,0,44,0,468,0,1,1258560,2051088,30.199337741083,804,2400,2292,912,51308,454298,571246,2141,3161,2357,3629,4649,37.14835124201342,11.009004714545675,1020,1,231648,6372,1380,0,1337,869
12893,1,0,0,0,43,0,254,0,1,1297187,2228553,31.921779399024736,1019,2292,2292,1019,53724,485514,529254,2187,3206,2187,3460,4479,35.679125549822544,0.0,1019,1,246598,0,1273,0,1168,914
12894,1,0,0,0,43,0,212,0,1,1304373,2271462,32.264531609803356,1041,2294,2294,1041,51736,506224,486586,2182,3223,2182,3435,4476,35.397740040855716,0.0,1041,1,232143,0,1253,0,1141,929
12895,1,0,0,0,47,0,376,1,0,1179060,3046980,35.91656999213594,1230,2264,2204,1290,35032,547984,356662,2302,3652,2422,3276,4626,30.23243291566195,8.038779614196052,1350,1,194790,13080,914,0,1072,1448
12896,1,0,0,0,47,0,1110,1,0,531031,3465676,38.353617821530214,1386,1917,1832,1471,35192,499472,391096,2271,3827,2441,2717,4273,19.0,9.39804606644414,1556,1,244186,15555,361,0,885,1995
12897,1,0,0,0,42,0,747,0,1,595804,2606027,35.08560958569767,1231,1715,1715,1231,51051,489027,467857,2117,3348,2117,2601,3832,22.0,0.0,1231,1,272051,0,484,0,886,1633
12898,1,0,0,0,44,0,266,1,0,669552,1538856,26.38181191654584,546,1808,1658,696,31970,508530,307329,2061,2907,2361,3173,4019,31.016124838541646,13.552624232328649,846,1,96744,33900,962,0,1515,1249
12899,1,0,0,0,45,0,354,1,0,629640,1448172,25.219040425836983,418,1844,1626,636,29736,403029,382536,2059,2913,2495,3267,4121,31.464265445104548,15.045716501099893,854,1,106848,29866,990,0,1641,1287
12900,1,0,0,0,43,0,509,0,0,351900,846124,19.77371993328519,391,1291,1291,391,34476,337584,478244,2164,2555,2164,3064,3455,30.0,0.0,391,1,86411,0,900,0,1773,1264
12901,1,0,0,0,42,0,497,1,0,214398,589179,16.64331697709324,192,1136,1051,277,33831,380733,402003,2042,2404,2212,2901,3263,27.820855486487112,9.290499583346438,362,1,52353,10030,774,0,1850,1353
12902,0,0,1,0,57,1,507,0,0,1775830,4640020,40.124805295477756,1502,2821,2713,1610,52212,657096,659978,2774,4492,2990,3985,5703,33.21144381083123,10.419152549993726,1718,1,368690,14364,1103,0,1272,1779
12903,0,0,1,0,58,1,561,0,0,2615842,5593020,43.840620433565945,1732,3473,3283,1922,50380,666390,640200,2720,4832,3100,4271,6383,36.89173349139343,13.874881522629007,2112,1,422840,27550,1361,0,988,1549
12904,1,0,0,0,43,0,741,0,0,974700,1480860,26.153393661244042,684,2109,2109,684,51480,476300,506610,2165,2849,2165,3590,4274,37.749172176353746,0.0,684,1,160056,0,1425,0,1481,740
12905,1,0,0,0,47,0,1038,0,1,1094863,1547216,25.475478405713993,219,2766,2336,649,55225,560240,560240,1954,3033,2814,4071,5150,41.0731055558257,21.654142992015576,1079,1,152515,56760,1687,0,1735,697
12906,1,0,0,0,46,0,886,0,1,1160976,1695256,26.870057685088806,409,2643,2330,722,55278,521256,584652,2035,3070,2661,3956,4991,40.099875311526844,18.641882512490767,1035,1,179778,27231,1608,0,1626,740
12907,1,0,0,0,45,0,595,0,1,1228250,1924400,29.154759474226502,723,2422,2295,850,52416,470912,570528,2137,3114,2391,3709,4686,38.01315561749642,11.982891688713304,977,1,214200,7874,1445,0,1414,819
12908,1,0,0,0,43,0,339,0,1,1285732,2142561,31.25699921617557,977,2293,2293,977,55388,497811,535092,2193,3170,2193,3509,4486,36.27671429443411,0.0,977,1,238388,0,1316,0,1216,877
12909,1,0,0,0,47,0,306,1,0,1215360,2985228,35.58089374931439,1113,2379,2226,1266,26832,490464,304182,2205,3624,2511,3318,4737,30.983866769659336,12.402996672919196,1419,1,163314,32589,960,0,1092,1398
12910,1,0,0,0,47,0,1092,1,0,612000,3591000,38.72983346207417,1288,2120,1908,1500,34121,548226,356706,2182,3894,2606,2802,4514,20.199009876724155,14.881188412578565,1712,1,223500,46004,408,0,894,1986
12911,1,0,0,0,43,0,1209,0,1,351142,3171886,38.09199390948182,1384,1760,1693,1451,53382,474362,537756,2119,3637,2253,2428,3946,15.556349186104045,8.694308756644029,1518,1,356946,5025,242,0,735,1944
12912,0,0,0,0,56,1,702,1,0,3023875,6013750,46.09772228646444,1935,3738,3548,2125,52118,582980,715990,2640,4955,3020,4253,6568,37.72267222772003,14.016733822252778,2315,1,537625,12160,1423,0,705,1407
12913,1,0,0,0,46,0,143,0,1,421950,1358970,24.124676163629637,348,1541,1307,582,53535,581415,502025,2101,2917,2569,3060,3876,26.92582403567252,15.54251799646276,816,1,125130,39546,725,0,1753,1610
12914,1,0,0,0,47,0,313,0,0,1053990,2107098,29.698484809834994,587,2372,2077,882,52576,506468,592472,2094,3271,2684,3584,4761,34.56877203488721,18.893591126659736,1177,1,218736,25075,1195,0,1507,1194
12915,1,0,0,0,43,0,742,0,0,927383,1433048,25.709920264364882,661,2064,2064,661,47424,494304,450944,2168,2829,2168,3571,4232,37.456641600656084,0.0,661,0,137488,0,1403,0,1507,765
12916,1,0,0,0,47,0,1093,0,1,1071408,1485744,24.979991993593593,200,2765,2341,624,56168,561916,566678,1957,3005,2805,4098,5146,41.43669871020132,21.498916680171057,1048,1,148512,53848,1717,0,1757,664
12917,1,0,0,0,46,0,886,0,1,1147032,1667564,26.758176320519304,439,2595,2318,716,54500,507722,582250,2052,3045,2606,3931,4924,40.024992192379,17.516952028650362,993,1,179000,22160,1602,0,1613,727
12918,1,0,0,0,44,0,509,0,1,1247400,1970001,29.8496231131986,849,2333,2291,891,52920,464310,557172,2169,3102,2253,3611,4544,37.416573867739416,6.73127350780198,933,1,224532,2688,1400,0,1320,811
12919,1,0,0,0,44,0,467,0,1,1257648,2006400,30.199337741083,882,2321,2291,912,55527,490600,547800,2170,3112,2230,3579,4521,37.134889255254286,5.531194905403055,942,1,227088,2760,1379,0,1288,821
12920,1,0,0,0,43,0,295,0,1,1301894,2197573,31.670175244226233,961,2343,2301,1003,46284,499548,444773,2149,3194,2233,3489,4534,36.02776706930364,6.503581472166948,1045,1,203609,6888,1298,0,1188,893
12921,1,0,0,0,46,0,254,1,0,1240512,2909088,35.32704346531139,1188,2302,2242,1248,33810,536130,342657,2271,3579,2391,3325,4633,31.52776554086889,7.994134176674909,1308,1,183456,13140,994,0,1083,1337
12922,1,0,0,0,47,0,264,1,0,1188180,2916330,35.07135583350036,1200,2226,2196,1230,36464,502652,407812,2341,3601,2401,3337,4597,31.080540535840107,5.623413251903491,1260,1,211560,5340,966,0,1141,1405
12923,1,0,0,0,47,0,291,1,0,1154970,2926170,35.07135583350036,1170,2229,2169,1230,33072,504348,371124,2319,3609,2439,3318,4608,30.643106892089126,8.1903625881272,1290,1,191880,11520,939,0,1149,1440
12924,1,0,0,0,47,0,621,0,1,847402,3058852,35.805027579936315,1066,2159,1943,1282,54740,548780,567868,2170,3668,2602,3047,4545,25.709920264364882,14.75401501978566,1498,1,305116,26136,661,0,1104,1725
12925,1,0,0,0,47,0,1106,1,0,648720,3650580,39.11521443121589,1338,2146,1954,1530,43875,536850,465270,2194,3916,2578,2810,4532,20.591260281974,14.152112943504028,1722,1,298350,32448,424,0,856,1962
12926,1,0,0,0,43,0,1115,0,1,424500,3043665,37.61648574760805,1385,1745,1715,1415,55056,477522,533448,2121,3566,2181,2451,3896,17.320508075688775,5.5965095842615735,1445,1,350920,2580,300,0,736,1851
12927,1,0,0,0,42,0,1005,0,1,491400,2912910,36.945906403822335,1365,1725,1725,1365,54731,488686,510026,2134,3499,2134,2494,3859,18.973665961010276,0.0,1365,1,326235,0,360,0,769,1774
12928,1,0,0,0,42,0,895,0,0,552300,2800950,36.26292872893749,1285,1765,1735,1315,42372,455820,421740,2100,3445,2160,2550,3895,20.493901531919196,5.490867587491313,1345,0,260370,4590,420,0,815,1710
12929,1,0,0,0,43,0,362,1,0,779040,2363088,32.89376840679705,929,1955,1802,1082,31228,460824,323232,2031,3266,2337,2904,4139,26.832815729997478,12.651333531125456,1235,1,160136,30447,720,0,1102,1464
12930,1,0,0,0,46,0,130,1,0,907800,2047000,29.832867780352597,715,2085,1910,890,31968,510600,331200,2125,3190,2475,3320,4385,31.937438845342623,13.511562386610331,1065,1,128160,37625,1020,0,1410,1280
12931,1,0,0,0,45,0,266,0,1,847211,1794844,28.231188426986208,730,1927,1860,797,51308,454904,572008,2185,3049,2319,3315,4179,32.60368077380221,8.567952416355485,864,1,202438,3886,1063,0,1455,1189
12932,1,0,0,0,45,0,323,1,0,738668,1629918,26.70205984563738,443,2019,1749,713,25544,470916,283464,2016,2999,2556,3322,4305,32.18695387886216,18.28192997023956,983,1,88412,57780,1036,0,1573,1250
12933,1,0,0,0,44,0,452,0,0,438924,1050384,21.77154105707724,474,1400,1400,474,37835,356776,520760,2216,2690,2216,3142,3616,30.430248109405877,0.0,474,1,111390,0,926,0,1742,1290
12934,1,0,0,0,46,0,19,1,0,13716,248940,10.392304845413264,108,235,235,108,54044,543980,527845,2305,2413,2305,2432,2540,11.269427669584644,0.0,108,1,24732,0,127,0,2197,2178
12935,1,0,0,0,45,0,857,0,1,1149258,3566499,39.786932528155525,1523,2369,2309,1583,29051,470877,313167,2193,3836,2313,2979,4622,26.94438717061496,7.83531632499182,1643,1,220037,12300,726,0,670,1527
12936,1,0,0,0,47,0,1098,0,1,1060488,1462806,24.859605789312106,227,2725,2334,618,53846,516006,584649,1976,2985,2758,4083,5092,41.42463035441596,20.64843410371526,1009,1,152646,36363,1716,0,1749,651
12937,1,0,0,0,44,0,680,0,1,1197716,1804634,28.39013913315678,711,2387,2292,806,50904,452278,564228,2144,3045,2334,3725,4626,38.54867053479276,10.191668715015645,901,1,203112,4940,1486,0,1433,753
12938,1,0,0,0,43,0,466,0,1,1261320,2001660,30.23243291566195,914,2294,2294,914,52650,512460,492750,2190,3104,2190,3570,4484,37.14835124201342,0.0,914,1,205650,0,1380,0,1276,810
12939,1,0,0,0,42,0,696,0,0,669217,2650891,35.17101079013795,1237,1778,1778,1237,39951,413599,443601,2143,3380,2143,2684,3921,23.259406699226016,0.0,1237,0,256059,0,541,0,906,1602
12940,1,0,0,0,43,0,433,1,0,776684,2453692,33.52610922848042,1004,1935,1815,1124,28462,467162,290339,2063,3307,2303,2874,4118,26.28687885618983,11.336427594764531,1244,1,149492,25920,691,0,1059,1492
12941,1,0,0,0,45,0,277,1,0,824460,1765140,27.92848008753788,562,2055,1837,780,22791,482019,242141,2045,3043,2481,3320,4318,32.51153641401772,16.180810842470223,998,1,83460,51230,1057,0,1483,1206
12942,1,0,0,0,43,0,401,1,0,325220,886376,20.09975124224178,319,1294,1209,404,30609,375174,392726,2109,2598,2279,2999,3488,28.372521918222215,9.332611979058527,489,1,72316,9945,805,0,1790,1389
12943,0,1,1,0,60,0,1930,0,0,9540471,6851607,47.65501022977542,2109,6634,6472,2271,39188,585298,609434,2855,5288,3179,7218,9651,64.81512169239521,12.809104356509453,2433,1,458742,19926,4201,0,746,1184
12944,0,0,1,0,58,1,1499,0,0,2970770,7629358,51.273774973177076,2183,4205,3759,2629,40586,647146,528164,2456,5531,3348,4032,7107,33.61547262794322,21.641723003216924,3075,1,478478,80280,1130,0,273,1772
12945,0,0,1,0,57,1,1424,0,0,2886020,7378506,50.53711507397311,2192,4046,3684,2554,46004,626913,612468,2527,5443,3251,4019,6935,33.61547262794322,19.105976922137724,2916,1,541448,51042,1130,0,335,1759
12946,1,0,0,0,47,0,29,1,0,84762,654274,16.64331697709324,127,733,583,277,31073,455866,380282,2212,2639,2512,2668,3095,17.4928556845359,12.72513248597547,427,1,44597,24750,306,0,2085,2056
12947,1,0,0,0,44,0,847,0,0,1266654,3635736,40.32369030731191,1626,2405,2405,1626,53336,505336,527696,2236,3862,2236,3015,4641,27.910571473905726,0.0,1626,0,383736,0,779,0,610,1457
12948,1,0,0,0,45,0,858,0,1,1217815,3646993,40.162171256046406,1528,2453,2368,1613,34050,513247,339150,2176,3874,2346,3016,4714,27.477263328068172,9.476861953055495,1698,1,241950,18190,755,0,648,1506
12949,1,0,0,0,45,0,850,0,1,1200000,3664000,40.0,1505,2445,2350,1600,42966,496930,453420,2195,3890,2385,3040,4735,27.386127875258307,10.550160417734466,1695,1,316800,14915,750,0,690,1540
12950,1,0,0,0,48,0,208,0,1,981200,2163100,29.866369046136157,527,2357,1992,892,43739,463175,555325,2060,3317,2790,3525,4782,33.166247903554,20.86130891196191,1257,1,204268,31390,1100,0,1533,1325
12951,1,0,0,0,46,0,1014,0,1,1079287,1516064,25.475478405713993,349,2612,2312,649,47142,453184,567648,2036,2985,2636,3999,4948,40.779897008207364,18.18343376476695,949,1,157707,20700,1663,0,1687,673
12952,1,0,0,0,45,0,807,0,1,1151650,1680666,27.258026340878022,593,2443,2293,743,50347,450138,572286,2112,3005,2412,3812,4705,39.370039370059054,12.785844799727476,893,1,187979,6900,1550,0,1519,712
12953,1,0,0,0,44,0,636,0,1,1212192,1823256,28.77498913987632,798,2322,2292,828,55278,488844,548298,2172,3030,2232,3666,4524,38.262252939417984,5.514871952411144,858,1,206172,2790,1464,0,1374,738
12954,1,0,0,0,47,0,126,1,0,1234800,2794176,34.292856398964496,1052,2350,2226,1176,37130,558360,375408,2252,3552,2500,3426,4726,32.4037034920393,11.33917216041645,1300,1,185808,26660,1050,0,1200,1326
12955,1,0,0,0,46,0,792,0,0,713673,3120492,36.45545226711637,1329,1866,1866,1329,45571,537692,467252,2348,3677,2348,2885,4214,23.173260452512935,0.0,1329,0,264471,0,537,0,1019,1811
12956,1,0,0,0,47,0,1011,1,0,723580,3580525,38.66522985836241,1267,2207,1979,1495,45652,541270,483790,2167,3890,2623,2879,4602,22.0,15.346337827304712,1723,1,301990,37164,484,0,900,1911
12957,1,0,0,0,44,0,252,1,0,863968,2365272,32.61901286060018,824,2116,1876,1064,30832,417924,364572,1983,3287,2463,3035,4339,28.495613697550013,15.966938683214861,1304,1,174496,37440,812,0,1159,1411
12958,1,0,0,0,46,0,80,1,0,962724,2174136,30.692018506445613,789,2117,1964,942,44103,556228,422364,2155,3250,2461,3330,4425,31.96873472629156,12.819678275901781,1095,1,172386,30294,1022,0,1366,1286
12959,0,0,1,0,57,1,688,0,0,1696073,4888681,41.12177038990418,1606,2779,2694,1691,52668,659148,667821,2806,4582,2976,3894,5670,31.670175244226233,9.231007614073922,1776,1,390621,11050,1003,0,1200,1888
12960,0,0,0,0,56,1,804,1,0,3028192,6167972,46.776062254106,2018,3742,3572,2188,54750,617361,704750,2649,5007,2989,4203,6561,37.20215047547655,13.159533562430733,2358,1,547000,14280,1384,0,631,1435
12961,0,0,0,0,55,1,848,1,0,3205824,6293920,47.58150901348127,2222,3722,3680,2264,53130,642180,639400,2738,5044,2822,4196,6502,37.62977544445356,6.48074069840786,2306,1,520720,5628,1416,0,516,1364
12962,1,0,0,0,46,0,137,0,1,502964,1492148,25.37715508089904,494,1575,1425,644,55440,556080,535227,2167,2961,2467,3098,3892,27.94637722496424,12.480747566911448,794,1,148764,21150,781,0,1673,1536
12963,1,0,0,0,43,0,743,1,0,794178,1305018,24.372115213907882,552,1973,1931,594,27540,448188,296595,2155,2791,2239,3534,4170,36.565010597564445,6.82047017429532,636,1,80190,8526,1337,0,1603,860
12964,1,0,0,0,46,0,1058,0,1,1049568,1458288,24.979991993593593,324,2606,2306,624,48057,451041,581913,2037,2961,2637,4019,4943,41.012193308819754,18.195024241394595,924,1,155376,17400,1682,0,1713,655
12965,1,0,0,0,46,0,1018,0,1,1065720,1490724,25.337718918639855,372,2572,2302,642,46368,427248,585144,2052,2964,2592,3982,4894,40.74309757492672,17.249101742880317,912,1,161784,9720,1660,0,1680,662
12966,1,0,0,0,45,0,892,0,1,1114400,1584800,26.457513110645905,520,2472,2292,700,48260,430160,575056,2084,2964,2444,3856,4736,39.89987468652001,13.858755107602944,880,1,177800,7020,1592,0,1564,672
12967,1,0,0,0,44,0,721,0,1,1182210,1733280,28.0178514522438,725,2351,2291,785,52750,465888,552000,2148,2993,2268,3714,4559,38.80721582386451,7.810249675906654,845,1,196250,4800,1506,0,1423,702
12968,1,0,0,0,44,0,679,0,1,1199202,1775400,28.407745422683583,777,2323,2293,807,53297,490600,525800,2170,3007,2230,3686,4523,38.54867053479276,5.490867587491313,837,1,192873,3390,1486,0,1393,714
12969,1,0,0,0,43,0,1559,0,1,180036,3640728,40.82891132518721,1637,1805,1775,1667,52398,465192,537264,2154,3851,2214,2292,3989,10.392304845413264,5.501408174353464,1697,1,410082,2670,108,0,517,2076
12970,1,0,0,0,43,0,1514,0,1,208407,3577380,40.50925820105819,1641,1768,1768,1641,48837,477420,486140,2180,3821,2180,2307,3948,11.269427669584644,0.0,1641,1,365943,0,127,0,539,2053
12971,1,0,0,0,43,0,729,0,1,697972,2757436,35.7211421989835,1246,1853,1823,1276,43152,401946,501352,2131,3437,2191,2708,4014,23.388031127053,5.830951894845301,1306,1,296032,2220,547,0,885,1614
12972,1,0,0,0,46,0,101,1,0,1004462,2196665,30.870698080866262,833,2127,2007,953,53410,502490,564725,2185,3258,2425,3359,4432,32.46536616149585,11.526037434995047,1073,1,233485,11760,1054,0,1352,1251
12973,1,0,0,0,45,0,361,1,0,473652,1194750,23.043437243605826,441,1513,1423,531,29156,333000,443250,2160,2781,2340,3142,3763,29.866369046136157,9.808573176892017,621,1,104607,5670,892,0,1719,1358
12974,0,1,0,1,65,0,3,0,0,13406580,11949900,60.4979338490167,3660,7323,7323,3660,54988,760745,770540,3265,6925,3265,6928,10588,60.52272300549604,0.0,3660,1,863760,0,3663,0,395,398
12975,0,1,1,0,61,0,1927,0,0,9826788,7063800,48.12483766206386,2088,6787,6559,2316,25857,466650,515450,2822,5366,3278,7293,9837,65.13831437794502,15.388702409555231,2544,1,391404,23712,4243,0,734,1193
12976,1,0,0,0,45,0,317,1,0,336680,1736600,27.568097504180443,636,1327,1203,760,34768,484420,374740,2161,3045,2409,2728,3612,21.047565179849187,11.33917216041645,884,1,124640,22940,443,0,1525,1842
12977,1,0,0,0,47,0,324,1,0,1170592,2993048,35.4400902933387,1000,2444,2188,1256,16896,457536,209704,2127,3639,2639,3315,4827,30.528675044947494,17.23993648765758,1512,1,110528,58624,932,0,1127,1451
12978,1,0,0,0,43,0,615,0,0,799414,1395944,25.25866188063018,638,1891,1891,638,50561,474796,509804,2188,2826,2188,3441,4079,35.397740040855716,0.0,638,1,148654,0,1253,0,1550,935
12979,1,0,0,0,43,0,657,0,0,784168,1347808,24.819347291981714,616,1889,1889,616,43130,496676,415720,2188,2804,2188,3461,4077,35.679125549822544,0.0,616,0,117040,0,1273,0,1572,915
12980,1,0,0,0,47,0,514,0,1,819432,2850042,34.61213659975356,1113,1967,1882,1198,49704,518622,542412,2294,3577,2464,3063,4346,26.153393661244042,9.257905235465769,1283,1,273144,10370,684,0,1181,1695
12981,0,1,1,0,63,0,733,0,0,12549960,10192050,56.52433104425032,3087,7231,7123,3195,39804,682660,593340,3082,6385,3298,7118,10421,62.67375846396959,10.435690064413366,3303,0,594270,17928,3928,1,5,738
12982,0,1,1,0,63,0,1264,0,0,1298385,2130425,25.903667693977237,101,3176,2606,671,35478,514350,695325,2605,3846,3745,5110,6351,43.98863489584554,24.44269614822366,1241,1,146949,32490,1935,0,2504,1240
12983,0,0,0,0,56,1,912,1,0,2833600,6232600,46.9041575982343,2030,3658,3488,2200,55527,631759,705417,2663,5033,3003,4121,6491,35.888716889852724,13.19014343722849,2370,1,547800,15470,1288,0,633,1545
12984,0,0,0,0,55,1,905,1,0,3098550,6346920,47.644516998286385,2185,3720,3635,2270,54502,640284,665448,2711,5066,2881,4161,6516,36.945906403822335,9.251281740554573,2355,1,540260,10285,1365,0,526,1431
12985,0,0,1,0,58,1,1600,0,0,3360000,8198400,52.91502622129181,2182,4618,4000,2800,49056,655872,641232,2310,5728,3546,4128,7546,34.64101615137755,24.979093790441006,3418,1,613200,87756,1200,0,128,1728
12986,1,0,0,0,45,0,75,0,1,465766,1630902,26.851443164195103,721,1367,1367,721,49259,513474,490854,2262,2983,2262,2908,3629,25.41653005427767,0.0,721,1,156457,0,646,0,1541,1616
12987,1,0,0,0,46,0,806,0,1,1468320,3899280,40.98780306383839,1397,2837,2554,1680,43326,577929,403854,2038,4001,2604,3195,5158,29.563490998188964,17.157031228936447,1963,1,292320,59713,874,0,641,1447
12988,1,0,0,0,46,0,788,0,1,1498560,3906000,40.98780306383839,1403,2849,2572,1680,51920,511500,548700,2048,4005,2602,3217,5174,29.866369046136157,17.31829447533829,1957,1,396480,31578,892,0,645,1433
12989,1,0,0,0,43,0,613,0,0,760758,1352802,24.859605789312106,618,1849,1849,618,52182,488147,512226,2189,2807,2189,3420,4038,35.08560958569767,0.0,618,0,144612,0,1231,0,1571,958
12990,1,0,0,0,47,0,1265,0,1,939750,1246350,22.9128784747792,206,2634,2315,525,48412,465304,586378,2055,2899,2693,4164,5008,42.30839160261236,18.763858257952673,844,1,129675,21373,1790,0,1849,584
12991,1,0,0,0,45,0,976,0,1,1075172,1489712,25.65151067676132,478,2472,2292,658,46872,421104,570528,2084,2922,2444,3898,4736,40.422765862815474,13.858755107602944,838,1,165816,7200,1634,0,1606,630
12992,1,0,0,0,43,0,718,0,1,1195920,1741608,28.142494558940577,792,2302,2302,792,49140,514566,461790,2199,2991,2199,3709,4501,38.8587184554509,0.0,792,1,166320,0,1510,0,1407,689
12993,1,0,0,0,43,0,1549,0,1,260406,3737592,41.255302689472536,1672,1885,1855,1702,50007,463356,520452,2166,3898,2226,2349,4081,12.36931687685298,5.572104574801163,1732,1,403374,3030,153,0,494,2043
12994,1,0,0,0,44,0,1011,1,0,597322,3153803,37.8021163428716,1295,1981,1847,1429,29050,386225,366362,2073,3636,2341,2625,4188,20.445048300260872,12.05117632088489,1563,1,237214,18224,418,0,778,1789
12995,1,0,0,0,43,0,756,0,1,736960,2850456,36.27671429443411,1316,1876,1876,1316,44652,396378,528504,2166,3482,2166,2726,4042,23.664319132398465,0.0,1316,1,321104,0,560,0,850,1606
12996,1,0,0,0,46,0,97,0,1,1082370,2283900,31.51190251317746,903,2173,2083,993,34272,351900,515200,2210,3293,2390,3390,4473,33.015148038438355,10.195209251481318,1083,1,222432,3330,1090,0,1307,1210
12997,1,0,0,0,45,0,181,0,1,1114350,2193816,31.12876483254676,939,2149,2119,969,39672,393936,516192,2234,3233,2294,3414,4413,33.91164991562634,5.7180036243905645,999,1,220932,1860,1150,0,1295,1114
12998,1,0,0,0,45,0,270,1,0,1103256,2108568,30.397368307141328,857,2185,2118,924,25752,397068,337736,2215,3206,2349,3476,4467,34.55430508634199,8.892463825840219,991,1,136752,10318,1194,0,1358,1088
12999,1,0,0,0,45,0,272,1,0,1063104,2061120,30.066592756745816,754,2230,2080,904,34400,392160,456000,2130,3184,2430,3456,4510,34.292856398964496,12.68159626954734,1054,1,180800,14400,1176,0,1376,1104
13000,0,0,1,0,59,1,885,0,0,1028536,4583491,39.35733730830886,1264,2498,2213,1549,45368,633226,627308,2674,4508,3244,3623,5457,25.768197453450252,16.909363204997415,1834,1,328388,38760,664,0,1410,2295
13001,0,0,0,0,56,1,965,1,0,2810474,6295729,47.19110085598767,2077,3639,3489,2227,55575,636075,698269,2677,5054,2977,4089,6466,35.52463933666322,12.376180362832391,2377,1,550069,15000,1262,0,600,1565
13002,1,0,0,0,46,0,287,1,0,303738,1653447,26.70205984563738,512,1340,1139,713,32956,496266,357126,2118,3032,2520,2745,3659,20.639767440550294,14.566775612304511,914,1,109802,39597,426,0,1606,1893
13003,1,0,0,0,46,0,498,1,0,1283599,3294242,37.53664875824692,1181,2548,2320,1409,34719,497994,381094,2110,3747,2566,3249,4886,30.18277654557314,16.373041306494688,1637,1,229667,42636,911,0,929,1427
13004,1,0,0,0,47,0,1388,0,1,866285,1117998,21.61018278497431,143,2646,2322,467,50370,524286,550620,2070,2861,2718,4249,5040,43.069710934716056,19.080079852843912,791,1,107410,39528,1855,0,1927,539
13005,1,0,0,0,46,0,1230,0,1,941976,1247958,23.108440016582687,276,2556,2298,534,46482,427671,593598,2079,2871,2595,4101,4893,42.0,16.770851028245673,792,1,135636,7224,1764,0,1803,573
13006,1,0,0,0,44,0,802,0,1,1164000,1653750,27.386127875258307,720,2332,2302,750,48178,480690,487305,2175,2955,2235,3757,4537,39.395431207184416,5.531194905403055,780,1,165750,3930,1552,0,1455,653
13007,1,0,0,0,44,0,1490,0,1,304304,3678400,40.890096600521744,1672,1854,1854,1672,48400,484000,484000,2200,3872,2200,2382,4054,13.490737563232042,0.0,1672,1,367840,0,182,0,528,2018
13008,1,0,0,0,45,0,197,1,0,1168608,2231607,31.416556144810016,987,2171,2171,987,43632,456722,488376,2261,3248,2261,3445,4432,34.40930106817051,0.0,987,1,213192,0,1184,0,1274,1077
13009,1,0,0,0,45,0,270,1,0,1116000,2123190,30.495901363953813,714,2346,2130,930,30615,445185,358431,2067,3213,2499,3483,4629,34.64101615137755,15.176919344261124,1146,1,146010,37368,1200,0,1353,1083
13010,1,0,0,0,46,0,216,0,1,370260,1189320,22.58317958127243,402,1344,1236,510,54612,517704,573672,2224,2842,2440,3058,3676,26.94438717061496,10.816653826391969,618,1,125460,10692,726,0,1822,1606
13011,1,0,0,0,49,0,624,0,1,588240,2832900,33.76388603226827,637,2159,1656,1140,41638,541730,474635,1982,3625,2988,3001,4644,22.715633383201094,22.62504291385172,1643,1,217740,82995,516,0,1345,1969
13012,1,0,0,0,45,0,777,0,1,1509300,3793374,40.95119045888654,1592,2662,2577,1677,49980,554190,461448,2177,3939,2347,3162,4924,30.0,9.321211371972165,1762,1,342108,15215,900,0,585,1362
13013,1,0,0,0,46,0,531,1,0,1269316,3331243,37.72267222772003,1176,2562,2315,1423,31959,470541,372219,2094,3764,2588,3233,4903,29.866369046136157,16.908897813237445,1670,1,226257,43966,892,0,918,1449
13014,1,0,0,0,43,0,697,0,0,657354,1169994,23.108440016582687,534,1765,1765,534,49490,536795,442582,2191,2725,2191,3422,3956,35.08560958569767,0.0,534,0,107868,0,1231,0,1657,960
13015,1,0,0,0,46,0,1201,1,0,473882,723969,17.69180601295413,36,2104,1827,313,41360,407088,543555,2036,2626,2590,3827,4417,38.91015291668744,17.221757782786398,590,1,73555,15235,1514,0,2000,799
13016,1,0,0,0,47,0,1501,0,1,769620,969196,20.09975124224178,65,2648,2309,404,41292,532578,446214,2060,2803,2738,4304,5047,43.64630568559039,19.339390680474487,743,1,75144,59325,1905,0,1995,494
13017,1,0,0,0,44,0,930,0,1,1103976,1518480,26.153393661244042,599,2383,2298,684,47532,452880,517260,2135,2904,2305,3834,4603,40.17461885320133,9.2729914971827,769,1,159372,8330,1614,0,1536,606
13018,1,0,0,0,47,0,386,0,1,835107,2670990,33.57082066318904,1127,1868,1868,1127,55225,556950,556950,2370,3497,2370,3111,4238,27.2213151776324,0.0,1127,1,264845,0,741,0,1243,1629
13019,1,0,0,0,44,0,1428,0,1,343980,3615066,40.47221268969612,1638,1848,1848,1638,52360,485540,525266,2207,3845,2207,2417,4055,14.491376746189438,0.0,1638,1,389844,0,210,0,569,1997
13020,1,0,0,0,45,0,251,1,0,1244256,2264187,31.575306807693888,937,2305,2245,997,46189,560937,424677,2211,3268,2331,3519,4576,35.32704346531139,7.880145860644973,1057,1,186439,11880,1248,0,1274,1023
13021,1,0,0,0,45,0,270,1,0,1231699,2255002,31.352830813181765,863,2356,2236,983,42066,564324,392274,2174,3277,2414,3547,4650,35.397740040855716,11.336427594764531,1103,1,168093,25440,1253,0,1311,1041
13022,1,0,0,0,46,0,288,1,0,1158660,2173194,30.692018506445613,674,2440,2172,942,35700,470628,403725,2039,3249,2575,3537,4747,35.07135583350036,17.065718082977764,1210,1,164850,43952,1230,0,1365,1077
13023,0,1,1,0,59,0,1881,0,0,5625612,4792725,40.13726448077895,1449,5265,5103,1611,51092,630700,716975,2813,4586,3137,6467,8240,59.09314681077663,12.835667595140963,1773,1,388251,15714,3492,0,1364,517
13024,1,0,0,0,46,0,188,1,0,305885,1533355,25.592967784139454,421,1356,1122,655,33620,479905,383924,2107,2996,2575,2808,3697,21.61018278497431,15.78933274275226,889,1,107420,41184,467,0,1686,1874
13025,1,0,0,0,46,0,810,0,1,1699200,4095780,42.07136793592526,1560,2940,2730,1770,29928,536848,298506,2104,4084,2524,3274,5254,30.983866769659336,14.692526380756615,1980,1,228330,49350,960,0,544,1354
13026,1,0,0,0,47,0,1438,0,1,810143,1030973,20.808652046684813,175,2562,2304,433,50038,469057,604774,2123,2814,2639,4252,4943,43.255057507764334,17.132922998494394,691,1,109982,13416,1871,0,1948,510
13027,1,0,0,0,45,0,1103,0,1,1010310,1339940,24.392621835300936,461,2427,2293,595,50096,454904,558496,2118,2847,2386,3950,4679,41.20679555607303,11.727705886231366,729,1,147560,9648,1698,0,1657,554
13028,1,0,0,0,44,0,1059,0,1,1036386,1384938,24.859605789312106,494,2419,2295,618,49405,459405,540081,2117,2859,2365,3918,4660,40.95119045888654,11.295017816300092,742,1,148938,10788,1677,0,1623,564
13029,1,0,0,0,44,0,1015,0,1,1063794,1433586,25.337718918639855,547,2394,2299,642,48822,459998,529221,2138,2875,2328,3890,4627,40.70626487409524,9.924396939761625,737,1,152154,8930,1657,0,1591,576
13030,1,0,0,0,48,0,285,0,1,1241946,2363229,31.32091952673165,896,2332,2247,981,49268,525162,544434,2324,3390,2494,3675,4741,35.58089374931439,9.370214040084857,1066,1,221706,10710,1266,0,1428,1143
13031,1,0,0,0,47,0,497,1,0,824670,2842910,34.49637662132068,1056,2017,1883,1190,32560,525580,353572,2255,3579,2523,3082,4406,26.324893162176366,11.718240104647752,1324,1,176120,28006,693,0,1199,1696
13032,1,0,0,0,43,0,836,0,0,789600,3033800,37.416573867739416,1400,1964,1964,1400,52437,491909,500577,2167,3567,2167,2731,4131,23.748684174075834,0.0,1400,0,323400,0,564,0,767,1603
13033,1,0,0,0,46,0,182,1,0,1096320,2656292,33.793490497431605,914,2330,2102,1142,44352,537306,446592,2098,3468,2554,3286,4656,30.983866769659336,15.232182894810565,1370,1,219264,41040,960,0,1184,1366
13034,1,0,0,0,45,0,150,1,0,1246536,2378232,32.31098884280702,1044,2238,2238,1044,48642,457878,551276,2278,3322,2278,3472,4516,34.55430508634199,0.0,1044,1,252648,0,1194,0,1234,1084
13035,1,0,0,0,45,0,227,1,0,1285578,2326968,32.03123475609393,966,2339,2279,1026,44640,544320,421848,2208,3294,2328,3521,4607,35.397740040855716,7.772191019407321,1086,1,190836,11640,1253,0,1242,1015
13036,1,0,0,0,46,0,298,1,0,1040760,2045358,29.698484809834994,540,2404,2062,882,34440,475395,389592,1977,3201,2661,3499,4723,34.351128074635334,19.194259499691263,1224,1,148176,59166,1180,0,1437,1139
13037,1,0,0,0,45,0,183,0,0,445230,1329288,24.124676163629637,552,1377,1347,582,44880,427108,548160,2254,2866,2314,3049,3661,27.65863337187866,5.753771868478424,612,1,139680,1920,765,0,1702,1519
13038,1,0,0,0,45,0,169,0,0,416010,1284820,23.790754506740637,566,1301,1301,566,44896,417680,553880,2270,2836,2270,3005,3571,27.110883423451916,0.0,566,1,138104,0,735,0,1704,1535
13039,1,0,0,0,44,0,124,1,0,339552,1166948,22.891046284519195,494,1202,1172,524,43092,420903,507756,2197,2751,2257,2875,3429,25.45584412271571,5.684275577662207,554,1,119472,2520,648,0,1703,1579
13040,0,1,0,1,65,0,149,0,0,13948410,11927538,60.50619802962338,3594,7538,7471,3661,52425,759114,733050,3191,6919,3325,7068,10796,61.72519744804386,8.189452396126915,3728,1,823725,9581,3810,0,403,552
13041,0,1,0,1,65,0,408,0,0,13567105,11343675,59.033888572581766,3335,7528,7378,3485,53520,781200,725865,3105,6740,3405,7148,10783,62.39390995922599,12.24744871391589,3635,1,777155,22950,3893,0,230,638
13042,0,0,0,0,57,1,1130,1,0,2393384,6313048,47.031904065219386,2059,3447,3294,2212,56608,662128,696376,2701,5066,3007,3936,6301,32.89376840679705,12.663046086100817,2365,1,539728,16677,1082,0,642,1772
13043,1,0,0,0,47,0,25,1,0,26250,353550,12.24744871391589,42,433,325,150,26167,450187,322909,2249,2507,2465,2532,2790,13.228756555322953,10.669676460233537,258,1,20550,20088,175,0,2207,2182
13044,1,0,0,0,45,0,313,0,1,421064,1168657,22.60530911091463,511,1335,1335,511,54720,521436,548880,2287,2798,2287,3111,3622,28.705400188814647,0.0,511,1,122640,0,824,0,1776,1463
13045,1,0,0,0,45,0,428,1,0,1420725,3263250,37.749172176353746,1340,2507,2422,1425,32175,377850,446550,2205,3715,2375,3287,4797,31.575306807693888,9.905159296613471,1510,1,277875,7735,997,0,865,1293
13046,1,0,0,0,47,0,562,0,1,1168728,3304872,37.389838191679836,1092,2540,2234,1398,33660,468072,401880,2058,3762,2670,3200,4904,28.91366458960192,18.670949634956095,1704,1,237660,49572,836,0,966,1528
13047,1,0,0,0,49,0,75,0,1,742500,2241000,30.0,443,2182,1725,900,55189,570210,600090,2033,3390,2947,3315,4672,28.722813232690143,22.75057449278337,1357,1,216900,53012,825,0,1590,1665
13048,1,0,0,0,44,0,787,0,0,556650,990000,21.213203435596427,450,1687,1687,450,41327,486200,411400,2200,2650,2200,3437,3887,35.17101079013795,0.0,450,0,84150,0,1237,0,1750,963
13049,1,0,0,0,47,0,1483,0,1,771528,969816,20.199009876724155,174,2533,2299,408,46990,439745,603758,2143,2785,2611,4268,4910,43.485629810317796,16.451476130546354,642,1,103632,7488,1891,0,1969,486
13050,1,0,0,0,47,0,1443,0,1,796194,1003230,20.639767440550294,210,2511,2295,426,44528,414480,595815,2139,2781,2571,4224,4866,43.23193264243457,15.628102547800594,642,1,107778,3456,1869,0,1929,486
13051,1,0,0,0,44,0,1099,0,1,1019400,1345800,24.49489742783178,505,2394,2299,600,52974,488974,545049,2148,2843,2338,3942,4637,41.2189276910499,9.874922862703322,695,1,145800,9500,1699,0,1643,544
13052,1,0,0,0,48,0,469,1,0,842766,2853348,34.38022687534217,1007,2070,1895,1182,28034,516596,316234,2239,3596,2589,3127,4484,26.70205984563738,13.543978856984436,1357,1,154842,38150,713,0,1232,1701
13053,1,0,0,0,48,0,1012,0,1,704364,3579774,38.54867053479276,1231,2215,1960,1486,52117,508299,595023,2154,3895,2664,2883,4624,21.77154105707724,17.244667194153394,1741,1,367042,16830,474,0,923,1935
13054,1,0,0,0,44,0,1302,0,1,428128,3487984,39.67366884975475,1574,1846,1846,1574,49059,458712,525192,2216,3790,2216,2488,4062,16.492422502470642,0.0,1574,1,373038,0,272,0,642,1944
13055,1,0,0,0,44,0,1308,0,0,426060,3490536,39.72404813208241,1578,1848,1848,1578,45000,497700,442400,2212,3790,2212,2482,4060,16.431676725154983,0.0,1578,0,315600,0,270,0,634,1942
13056,1,0,0,0,43,0,891,0,0,794542,3134908,37.97367509209505,1442,1993,1993,1442,52538,473932,523934,2174,3616,2174,2725,4167,23.473389188611005,0.0,1442,0,347522,0,551,0,732,1623
13057,1,0,0,0,45,0,129,1,0,1287472,2439872,32.7414110874898,1072,2273,2273,1072,51516,482512,553068,2276,3348,2276,3477,4549,34.655446902326915,0.0,1072,1,260496,0,1201,0,1204,1075
13058,1,0,0,0,47,0,153,0,1,184680,860400,18.973665961010276,63,1170,873,360,50268,509070,564040,2093,2750,2687,2903,3560,22.64950330581225,17.43644470130689,657,1,84960,30888,513,0,2030,1877
13059,1,0,0,0,45,0,484,1,0,1486485,3354615,38.535697735995385,1455,2516,2486,1485,26936,334332,411138,2229,3744,2289,3260,4775,31.63858403911275,5.5503012171862105,1515,1,270270,2430,1001,0,774,1258
13060,1,0,0,0,45,0,648,0,1,1626880,3706400,40.496913462633174,1580,2692,2632,1640,42108,546920,393240,2200,3900,2320,3252,4952,31.496031496047245,7.952707287670506,1700,1,285360,12420,992,0,620,1268
13061,1,0,0,0,45,0,709,0,1,1711710,3902220,41.352146256270665,1586,2835,2711,1710,37620,520296,376530,2158,3992,2406,3283,5117,31.63858403911275,11.193732213226145,1834,1,282150,25048,1001,0,572,1281
13062,1,0,0,0,47,0,1508,0,1,494445,662584,16.64331697709324,85,2424,2062,277,28542,509496,320528,2030,2669,2754,4177,4816,42.24926034855522,19.804817580644276,639,1,37118,77468,1785,0,2115,607
13063,1,0,0,0,47,0,1555,0,1,703086,872910,19.131126469708992,132,2521,2287,366,52371,493695,603405,2151,2751,2619,4306,4906,43.829214001622255,16.575828045818028,600,1,92598,14742,1921,0,2019,464
13064,1,0,0,0,46,0,1443,0,1,791608,986224,20.591260281974,249,2466,2291,424,46736,427984,590804,2151,2750,2501,4193,4792,43.2087954009366,13.948145560734488,599,1,107696,4900,1867,0,1902,459
13065,1,0,0,0,45,0,1271,0,1,910602,1156904,22.60530911091463,403,2401,2293,511,53172,477704,570528,2156,2775,2372,4046,4665,42.21374183841087,10.715687343984417,619,1,128772,7992,1782,0,1753,482
13066,1,0,0,0,44,0,1140,0,1,1002204,1303680,24.124676163629637,515,2371,2304,582,55890,515200,544320,2173,2822,2307,3962,4611,41.49698784249286,8.345174736691893,649,1,141426,7504,1722,0,1658,518
13067,1,0,0,0,44,0,1004,0,1,1095917,1457049,25.67099530598687,629,2352,2322,659,53074,493053,526218,2181,2870,2241,3874,4563,40.779897008207364,5.501408174353464,689,1,156842,3450,1663,0,1552,548
13068,1,0,0,0,44,0,870,1,0,1186704,1647216,27.16615541441225,696,2388,2346,738,29304,495504,294624,2190,2970,2274,3840,4620,40.099875311526844,6.7040592262067955,780,1,97416,9450,1608,0,1494,624
13069,1,0,0,0,46,0,651,1,0,1254772,1971304,29.0,599,2575,2333,841,24881,419576,325816,2102,3185,2586,3836,4919,38.62641583165593,16.82701313365155,1083,1,116899,40898,1492,0,1503,852
13070,1,0,0,0,48,0,339,1,0,1247040,2309760,30.983866769659336,918,2301,2259,960,30368,500448,351276,2364,3366,2448,3705,4707,36.0416425818802,6.852548980306203,1002,1,140160,8274,1299,0,1446,1107
13071,1,0,0,0,47,0,311,1,0,850980,2598762,33.03028912982749,983,1979,1871,1091,41132,538332,433524,2274,3473,2490,3162,4361,27.92848008753788,10.424232425346673,1199,1,198562,19764,780,0,1291,1602
13072,1,0,0,0,48,0,693,0,1,861028,3254258,36.565010597564445,971,2347,1981,1337,43281,557386,460026,2068,3771,2800,3078,4781,25.37715508089904,20.067779664656378,1703,1,252693,65880,644,0,1097,1790
13073,1,0,0,0,43,0,984,0,1,774000,3292500,38.72983346207417,1470,2046,2016,1500,50853,441195,555335,2165,3695,2225,2711,4241,22.715633383201094,5.531194905403055,1530,1,379500,1770,516,0,695,1679
13074,1,0,0,0,45,0,92,1,0,420384,1372288,24.576411454889016,544,1360,1300,604,30192,336256,463488,2212,2876,2332,2968,3632,26.38181191654584,7.748117453886108,664,1,123216,3360,696,0,1668,1576
13075,0,1,0,1,65,0,101,0,0,14654862,12715362,62.281618476080084,3849,7687,7657,3879,50055,770330,698214,3248,7157,3308,7056,10965,61.465437442517235,5.478746393072713,3909,1,826227,4770,3778,0,601,500
13076,0,1,1,0,61,0,1888,0,0,7455185,6008105,44.10215414239989,1639,6084,5778,1945,36660,580732,602355,2783,5034,3395,6922,9173,61.91122676865643,18.11972777303995,2251,1,379275,37332,3833,0,1144,744
13077,0,0,1,0,57,1,1184,0,0,2095632,6209280,46.4327470649756,1955,3329,3128,2156,56880,682560,691200,2679,5036,3081,3852,6209,31.176914536239792,14.483236975101944,2357,1,517440,24321,972,0,724,1908
13078,1,0,0,0,47,0,339,1,0,1031140,2841630,34.62657938636157,820,2438,2059,1199,37518,400530,526140,1991,3569,2749,3230,4808,29.32575659723036,20.000781204227806,1578,1,266178,24256,860,0,1171,1510
13079,1,0,0,0,44,0,723,0,0,495790,952450,20.73644135332772,430,1583,1583,430,45552,485085,460720,2215,2645,2215,3368,3798,33.95585369269929,0.0,430,0,89440,0,1153,0,1785,1062
13080,1,0,0,0,47,0,1559,0,1,610092,773712,18.0,82,2449,2207,324,54180,513420,601776,2146,2712,2630,4271,4837,43.393547907494266,16.82701313365155,566,1,81648,18392,1883,0,2064,505
13081,1,0,0,0,47,0,1539,0,1,685900,851960,19.0,169,2453,2261,361,46552,434240,597080,2168,2721,2552,4260,4813,43.58898943540674,15.029542240585052,553,1,91333,4800,1900,0,1999,460
13082,1,0,0,0,45,0,1400,0,1,823316,1018664,21.118712081942874,322,2416,2292,446,50292,452232,580136,2160,2730,2408,4130,4700,42.96510211788167,11.66442500998483,570,1,113284,6076,1846,0,1838,438
13083,1,0,0,0,44,0,1223,0,1,954324,1210758,23.259406699226016,481,2365,2305,541,55822,505788,552786,2178,2779,2298,4002,4603,42.0,7.83531632499182,601,1,133627,5880,1764,0,1697,474
13084,1,0,0,0,44,0,1178,0,1,987104,1263878,23.790754506740637,524,2352,2310,566,56640,526988,535920,2191,2799,2275,3977,4585,41.7612260356422,6.609134537568676,608,1,135840,5040,1744,0,1667,489
13085,1,0,0,0,46,0,234,1,0,1205127,2851035,34.942810419312295,1011,2418,2208,1221,48076,555730,471670,2125,3556,2545,3322,4753,31.416556144810016,14.70857985441067,1431,1,246642,36750,987,0,1114,1348
13086,1,0,0,0,45,0,49,1,0,1350806,2598054,33.734255586866,1138,2325,2325,1138,54480,518241,547920,2283,3421,2283,3470,4608,34.45286635390443,0.0,1138,1,273120,0,1187,0,1145,1096
13087,1,0,0,0,45,0,124,1,0,1395645,2561485,33.481338085566414,1091,2396,2366,1121,42550,525550,422725,2255,3406,2315,3530,4681,35.2845575287547,5.572104574801163,1151,1,207385,5550,1245,0,1164,1040
13088,1,0,0,0,46,0,271,1,0,1459080,2516400,32.863353450309965,780,2731,2431,1080,36192,484640,405420,2030,3410,2630,3681,5061,36.75595189897821,17.348154625078337,1380,1,187920,51300,1351,0,1250,979
13089,0,1,0,1,64,0,1048,0,0,1758900,2905342,30.033314835362415,253,3501,2852,902,40420,605548,692515,2572,4123,3870,5171,6722,44.15880433163923,25.475538888447133,1551,1,193930,64251,1950,0,2319,1271
13090,1,0,0,0,44,0,614,0,0,478800,1005300,21.213203435596427,450,1514,1514,450,55552,500416,554032,2234,2684,2234,3298,3748,32.61901286060018,0.0,450,1,111600,0,1064,0,1784,1170
13091,1,0,0,0,45,0,1397,0,1,831150,1019250,21.213203435596427,365,2382,2297,450,52877,473385,573045,2180,2715,2350,4112,4647,42.9767378938886,9.628282789709404,535,1,113850,5695,1847,0,1815,418
13092,1,0,0,0,44,0,989,1,0,1146690,1526865,26.1725046566048,643,2401,2359,685,32856,494838,329892,2187,2914,2271,3903,4630,40.91454509095757,6.653712290320142,727,1,101380,8904,1674,0,1544,555
13093,1,0,0,0,47,0,149,1,0,865872,2407104,31.74901573277509,923,1952,1867,1008,39600,525360,429840,2303,3396,2473,3247,4340,29.30870177950569,9.344583777936014,1093,1,181440,15300,859,0,1380,1529
13094,1,0,0,0,48,0,310,1,0,888000,2695080,33.31666249791537,876,2144,1910,1110,36792,531732,407904,2194,3538,2662,3228,4572,28.284271247461902,15.54251799646276,1344,1,186480,44460,800,0,1318,1628
13095,1,0,0,0,44,0,1107,0,0,548338,3312198,38.44476557348217,1478,1849,1849,1478,52900,515430,515430,2241,3719,2241,2612,4090,19.261360284258224,0.0,1478,0,339940,0,371,0,763,1870
13096,1,0,0,0,43,0,889,0,0,797426,3162306,37.97367509209505,1442,1995,1995,1442,50175,493425,489039,2193,3635,2193,2746,4188,23.515952032609693,0.0,1442,0,321566,0,553,0,751,1640
13097,1,0,0,0,45,0,28,1,0,1394565,2658426,34.161381705077446,1167,2362,2362,1167,52899,521662,526218,2278,3445,2278,3473,4640,34.56877203488721,0.0,1167,1,269577,0,1195,0,1111,1083
13098,0,1,0,1,64,0,1068,0,0,1840608,2992836,30.397368307141328,317,3523,2916,924,37962,553869,719058,2632,4163,3846,5231,6762,44.63182720884279,24.641130441605295,1531,1,205128,40669,1992,0,2315,1247
13099,0,0,1,0,59,1,1422,0,0,4186035,8507289,53.637673327615545,2420,4789,4332,2877,44814,683067,573658,2500,5834,3414,4412,7746,38.144462245521304,21.42255633550467,3334,1,558138,81346,1455,0,80,1502
13100,0,0,1,0,58,1,975,0,0,3598066,7208362,49.457052075512955,2026,4337,3917,2446,42188,586453,624764,2527,5393,3367,4418,7284,38.353617821530214,20.590916658091086,2866,1,518552,49560,1471,0,501,1476
13101,1,0,0,0,48,0,9,1,0,74236,649632,16.3707055437449,56,757,545,268,28800,484800,349056,2212,2692,2636,2701,3181,16.64331697709324,15.338238378984531,480,1,38592,40068,277,0,2156,2147
13102,1,0,0,0,50,0,261,0,1,360580,1863990,27.294688127912362,153,1821,1229,745,48108,570456,527922,1910,3247,3094,2986,4323,22.0,24.589486977161943,1337,1,157195,91168,484,0,1757,2018
13103,1,0,0,0,45,0,635,0,0,1693454,3761390,40.70626487409524,1615,2721,2679,1657,51294,565230,467620,2228,3927,2312,3292,4991,31.96873472629156,6.653712290320142,1699,1,341342,6804,1022,0,613,1248
13104,1,0,0,0,47,0,1549,0,1,505802,656213,16.64331697709324,59,2321,2103,277,52920,497490,596988,2151,2646,2587,4195,4690,42.731721238442994,15.8996954831059,495,1,69804,14170,1826,0,2092,543
13105,1,0,0,0,44,0,1391,0,1,846842,1028668,21.400934559032695,416,2349,2307,458,53130,471660,568238,2204,2704,2288,4095,4595,43.0,6.7597809605921,500,1,115874,2898,1849,0,1788,397
13106,1,0,0,0,47,0,71,0,1,877646,2161192,30.033314835362415,872,1905,1875,902,51574,512744,577436,2366,3298,2426,3369,4301,31.192947920964443,5.623413251903491,932,1,217382,2970,973,0,1494,1423
13107,1,0,0,0,48,0,582,0,1,879643,3104847,35.679125549822544,954,2283,1964,1273,53535,524385,607311,2120,3712,2758,3130,4722,26.28687885618983,18.975495718103826,1592,1,316977,27753,691,0,1166,1748
13108,1,0,0,0,45,0,1075,1,0,590000,3340875,38.40572873934304,1325,2025,1875,1475,42098,491505,439410,2115,3740,2415,2665,4290,20.0,12.561867176898298,1625,1,286150,24150,400,0,790,1865
13109,1,0,0,0,44,0,1046,0,1,659627,3345783,38.58756276314948,1404,2017,1932,1489,53500,480858,561750,2162,3736,2332,2690,4264,21.047565179849187,9.460074866898333,1574,1,372250,7140,443,0,758,1804
13110,1,0,0,0,44,0,902,0,1,760923,3152600,37.8549864614954,1433,1964,1964,1433,51948,488400,514800,2200,3633,2200,2731,4164,23.043437243605826,0.0,1433,1,335322,0,531,0,767,1669
13111,1,0,0,0,47,0,222,1,0,1377720,2525820,32.68026927673638,745,2681,2358,1068,33549,499015,376035,2042,3433,2688,3655,5046,35.91656999213594,18.12027404475674,1391,1,169812,60724,1290,0,1297,1075
13112,1,0,0,0,47,0,140,0,1,841500,2035750,29.154759474226502,541,2149,1840,850,39964,493370,464630,2086,3245,2704,3385,4544,31.464265445104548,18.257208619569916,1159,1,164900,45114,990,0,1545,1405
13113,0,0,1,0,56,1,1341,0,0,3082950,7213950,50.49752469181039,2442,3867,3759,2550,38586,616722,500733,2721,5379,2937,4038,6696,34.77067730142742,10.403202108104866,2658,1,451350,19332,1209,0,279,1620
13114,1,0,0,0,48,0,27,0,1,124074,829872,18.411952639521967,27,1071,705,339,49494,536112,553248,2082,2787,2814,2814,3519,19.131126469708992,19.73363194547235,705,1,76614,46482,366,0,2109,2082
13115,1,0,0,0,47,0,226,1,0,308720,1078704,21.307275752662516,304,1284,1134,454,32742,508464,363528,2226,2830,2526,3056,3660,26.076809620810597,13.111772778031689,604,1,69462,29850,680,0,1922,1696
13116,1,0,0,0,45,0,540,0,0,1669500,3587040,39.87480407475377,1590,2640,2640,1590,55104,554976,505344,2256,3846,2256,3306,4896,32.4037034920393,0.0,1590,0,356160,0,1050,0,666,1206
13117,1,0,0,0,45,0,749,1,0,384650,792400,18.708286933869708,283,1516,1449,350,23800,396200,307904,2197,2614,2331,3363,3780,33.15116890850155,8.833574853908106,417,1,47600,11189,1099,0,1914,1165
13118,1,0,0,0,47,0,1232,0,1,207300,355050,12.24744871391589,118,1800,1532,150,48792,506538,539676,2099,2517,2635,3749,4167,37.17526059088221,17.66714970781621,418,1,34200,31356,1382,0,2217,985
13119,1,0,0,0,47,0,1556,0,1,418860,554346,15.297058540778355,8,2266,2024,234,55596,535394,582774,2127,2603,2611,4159,4635,42.30839160261236,16.545885401338353,476,1,57564,22748,1790,0,2135,579
13120,1,0,0,0,44,0,1444,0,1,776037,937833,20.42057785666214,387,2308,2278,417,54216,485784,564499,2219,2666,2279,4110,4557,43.139309220245984,5.572104574801163,447,1,104667,2340,1861,0,1832,388
13121,1,0,0,0,47,0,889,1,0,1163142,1722692,26.870057685088806,466,2589,2333,722,22050,501060,250530,2130,3108,2642,3997,4975,40.13726448077895,17.67408199212543,978,1,75810,59904,1611,0,1664,775
13122,1,0,0,0,47,0,124,0,1,874125,2097375,29.58039891549808,845,1904,1874,875,54740,551310,570486,2367,3272,2427,3396,4301,31.606961258558215,5.652706486041966,905,1,208250,3660,999,0,1522,1398
13123,1,0,0,0,47,0,97,0,1,870938,2118426,29.765752132274432,886,1869,1869,886,51040,526020,554712,2391,3277,2391,3374,4260,31.352830813181765,0.0,886,1,205552,0,983,0,1505,1408
13124,1,0,0,0,48,0,544,0,1,886416,3048620,35.38361202590826,952,2260,1960,1252,50652,489435,613620,2135,3687,2735,3143,4695,26.60826939130014,18.47760878028659,1552,1,315504,18900,708,0,1183,1727
13125,1,0,0,0,44,0,939,0,1,717562,3193798,37.92097045171708,1408,1967,1937,1438,53037,473073,553029,2191,3659,2251,2720,4188,22.338307903688676,5.5965095842615735,1468,1,358062,2550,499,0,783,1722
13126,1,0,0,0,48,0,225,0,1,113014,587576,15.556349186104045,13,964,709,242,52156,536588,573008,2173,2670,2683,2895,3392,21.61018278497431,16.294791930224218,497,1,57112,29070,467,0,2186,1961
13127,1,0,0,0,49,0,35,1,0,303846,1320582,23.108440016582687,114,1523,1103,534,27580,487181,346220,2053,3007,2893,3042,3996,23.853720883753127,21.721683584233134,954,1,74760,80220,569,0,1939,1904
13128,1,0,0,0,45,0,638,0,0,1596048,3651122,40.27406113120453,1622,2606,2606,1622,44036,490718,454702,2251,3873,2251,3235,4857,31.368774282716245,0.0,1622,0,327644,0,984,0,629,1267
13129,1,0,0,0,47,0,1549,0,1,373332,499896,14.560219778561036,28,2213,1973,212,55902,544698,570636,2118,2570,2598,4119,4571,41.96427051671457,16.34013463836819,452,1,51304,24720,1761,0,2146,597
13130,1,0,0,0,46,0,967,1,0,1166900,1640800,26.457513110645905,484,2583,2367,700,22119,513336,236744,2128,3044,2560,4011,4927,40.82891132518721,15.9932207903403,916,1,70700,52704,1667,0,1644,677
13131,1,0,0,0,45,0,938,1,0,631968,3147312,37.30951621235526,1307,1931,1846,1392,37948,479332,404719,2176,3653,2346,2715,4192,21.307275752662516,9.370214040084857,1477,1,249168,14450,454,0,869,1807
13132,1,0,0,0,44,0,857,0,1,756318,3092376,37.389838191679836,1398,1939,1939,1398,51076,499912,499912,2212,3610,2212,2753,4151,23.259406699226016,0.0,1398,1,315948,0,541,0,814,1671
13133,1,0,0,0,46,0,148,1,0,1663788,2839158,34.899856733230294,1133,2669,2584,1218,41912,578088,393939,2246,3549,2416,3697,5000,36.959437225152655,9.412769291411893,1303,1,205842,18275,1366,0,1113,965
13134,1,0,0,0,48,0,61,0,1,758582,2018400,29.0,564,2020,1743,841,41818,494400,487200,2123,3241,2677,3302,4420,30.033314835362415,17.492528744516264,1118,1,170723,37949,902,0,1559,1498
13135,0,1,0,1,65,0,119,0,0,15539766,13174584,63.26136261573884,3875,8012,7885,4002,48160,737408,707780,3165,7294,3419,7175,11304,62.313722405261586,11.270999429035628,4129,1,860430,18415,3883,0,710,591
13136,0,1,0,1,65,0,1274,0,0,2241360,3250170,31.464265445104548,655,3589,3254,990,44840,774788,623770,2948,4273,3618,5547,6872,47.58150901348127,18.631686486055063,1325,1,188100,62310,2264,0,2293,1019
13137,1,0,0,0,49,0,144,1,0,292932,1171254,21.77154105707724,113,1453,1092,474,31758,496671,390418,2110,2945,2832,3089,3924,24.859605789312106,20.399436185173617,835,1,74892,64258,618,0,1997,1853
13138,1,0,0,0,46,0,1513,0,1,408798,543816,15.297058540778355,54,2161,1981,234,51308,469448,590296,2144,2558,2504,4071,4485,41.79712908801273,14.078868216031408,414,1,59436,9720,1747,0,2090,577
13139,1,0,0,0,48,0,257,0,1,860520,1939200,28.42534080710379,808,1873,1873,808,46081,487200,544800,2400,3208,2400,3465,4273,32.63433774416144,0.0,808,1,183416,0,1065,0,1592,1335
13140,1,0,0,0,47,0,175,0,0,861900,2022930,29.068883707497267,803,1907,1865,845,43560,526680,474012,2352,3239,2436,3414,4301,31.937438845342623,6.484411467763075,887,0,167310,6720,1020,0,1549,1374
13141,1,0,0,0,45,0,885,1,0,657046,3107650,36.959437225152655,1239,1974,1847,1366,36550,489125,386750,2148,3641,2402,2756,4249,21.93171219946131,11.489290135793457,1493,1,232220,23241,481,0,909,1794
13142,1,0,0,0,44,0,877,0,1,734124,3134037,37.429934544425805,1341,1985,1925,1401,54587,494377,552539,2177,3638,2297,2761,4222,22.891046284519195,7.914659756013729,1461,1,346047,5760,524,0,836,1713
13143,1,0,0,0,44,0,777,0,0,790938,3012903,36.864617182333525,1317,1983,1941,1359,45600,505476,443400,2175,3576,2259,2799,4200,24.124676163629637,6.503581472166948,1401,0,271800,7014,582,0,858,1635
13144,1,0,0,0,46,0,318,1,0,1186920,2940840,35.4964786985977,930,2532,2202,1260,38976,541488,392112,2004,3594,2664,3276,4866,30.692018506445613,18.273413871518187,1590,1,211680,66990,942,0,1074,1392
13145,1,0,0,0,47,0,266,1,0,1252440,2962260,35.4964786985977,990,2524,2254,1260,39776,531326,413776,2081,3611,2621,3345,4875,31.52776554086889,16.686261417025737,1530,1,221760,51030,994,0,1091,1357
13146,0,1,1,0,62,0,1853,0,0,7595154,6149024,44.50842616853577,1650,6146,5815,1981,42416,546304,748064,2773,5085,3435,6938,9250,61.91930232165088,18.848055822899322,2312,1,477421,15226,3834,0,1123,730
13147,1,0,0,0,46,0,536,1,0,231777,656843,16.822603841260722,283,1102,1102,283,46860,510620,494373,2321,2604,2321,3140,3423,28.61817604250837,0.0,283,1,60279,0,819,0,2038,1502
13148,1,0,0,0,46,0,1533,0,1,289510,396440,13.038404810405298,70,2113,1873,170,56400,548020,559680,2092,2502,2572,4035,4445,41.2674205639267,16.02101568709642,410,1,40800,27120,1703,0,2162,629
13149,1,0,0,0,49,0,441,0,1,864360,1801485,27.110883423451916,611,2035,1911,735,48319,517161,561279,2327,3186,2575,3627,4486,34.292856398964496,11.255953434413934,859,1,168315,13888,1176,0,1716,1275
13150,1,0,0,0,48,0,338,0,1,851283,1857135,27.730849247724095,739,1906,1876,769,47000,483000,567525,2385,3184,2445,3522,4321,33.27160951922825,5.791460926441345,799,1,180715,2670,1107,0,1646,1308
13151,1,0,0,0,45,0,494,1,0,963135,2851635,35.482389998420345,1067,2216,2024,1259,35956,457530,403170,2073,3524,2457,3030,4481,27.65863337187866,14.319779673152123,1451,1,224102,30528,765,0,1006,1500
13152,1,0,0,0,45,0,409,1,0,1036662,2839012,35.25620512760839,975,2345,2077,1243,36036,527604,356304,2016,3527,2552,3118,4629,28.879058156387302,16.933819716368244,1511,1,193908,57084,834,0,1041,1450
13153,1,0,0,0,46,0,22,1,0,1671728,2952446,35.805027579936315,1282,2586,2586,1282,48530,529690,485933,2303,3585,2303,3607,4889,36.11094017053558,0.0,1282,1,270502,0,1304,0,1021,999
13154,1,0,0,0,47,0,164,1,0,1613805,2852445,34.51086785347479,951,2786,2546,1191,33660,526900,366435,2155,3586,2635,3750,5181,36.810324638611924,15.999084394065415,1431,1,182223,48960,1355,0,1204,1040
13155,1,0,0,0,48,0,124,1,0,1304892,2610866,32.89376840679705,692,2678,2288,1082,42966,523621,477774,2023,3495,2803,3619,5091,34.72751070837067,20.10999549270333,1472,1,214236,61230,1206,0,1331,1207
13156,0,1,0,1,66,0,235,0,0,16118466,13646334,64.29618962271404,4010,8157,8033,4134,45173,749327,656899,3177,7435,3425,7200,11458,62.44197306299666,11.150165195519998,4258,1,822666,20708,3899,0,833,598
13157,0,1,1,0,60,0,1749,0,0,4807210,4465430,38.54867053479276,1201,5006,4721,1486,40404,667110,546910,2720,4491,3290,6240,8011,56.87706040223949,17.130983971056178,1771,0,270452,51015,3235,1,1519,230
13158,1,0,0,0,49,0,88,1,0,147060,839268,18.49324200890693,45,1069,772,342,41064,579144,426996,2157,2796,2751,2884,3523,20.73644135332772,17.98355945099906,639,1,59508,59994,430,0,2112,2024
13159,1,0,0,0,48,0,242,0,1,117128,592174,15.556349186104045,35,1003,726,242,53297,545681,584833,2170,2689,2724,2931,3450,22.0,17.021990674332528,519,1,57838,31301,484,0,2205,1963
13160,1,0,0,0,48,0,544,0,1,539105,2567870,32.48076353782343,665,1956,1566,1055,55000,608500,535480,2044,3489,2824,2945,4390,22.60530911091463,20.568888856842072,1445,1,232100,60450,511,0,1379,1923
13161,1,0,0,0,48,0,486,0,1,509467,2433677,31.575306807693888,551,1954,1508,997,48250,610250,471113,1995,3438,2887,2952,4395,22.60530911091463,21.855384401102036,1443,1,192421,86524,511,0,1444,1930
13162,1,0,0,0,44,0,454,0,0,346632,904152,20.09975124224178,404,1262,1262,404,49712,534882,465504,2238,2642,2238,3096,3500,29.29163703175362,0.0,404,0,84032,0,858,0,1834,1380
13163,1,0,0,0,45,0,546,1,0,327427,820914,19.0,301,1328,1268,361,21726,484362,231948,2214,2635,2334,3181,3602,30.116440692751194,8.246211251235321,421,1,36822,14340,907,0,1913,1367
13164,1,0,0,0,46,0,913,1,0,223914,467928,14.177446878757825,11,1527,1315,201,43780,512160,463272,2116,2529,2540,3442,3855,33.37663853655727,15.228432388987814,413,1,39999,33496,1114,0,2127,1214
13165,1,0,0,0,48,0,391,0,1,838812,1791738,27.2213151776324,741,1873,1873,741,50032,512616,570648,2418,3159,2418,3550,4291,33.645207682521445,0.0,741,1,174876,0,1132,0,1677,1286
13166,1,0,0,0,45,0,759,1,0,706986,2977674,36.08323710533743,1152,1995,1845,1302,36400,475696,400225,2137,3589,2437,2830,4282,23.302360395462088,12.384480471957746,1452,1,227850,25500,543,0,985,1744
13167,1,0,0,0,48,0,147,1,0,1644538,2908822,34.79942528261063,971,2809,2569,1211,31780,545254,336280,2162,3613,2642,3760,5211,36.851051545376556,16.077559228392104,1451,1,169540,53280,1358,0,1191,1044
13168,1,0,0,0,48,0,68,0,1,1113980,2483460,31.96873472629156,553,2581,2112,1022,42188,515160,483570,1961,3452,2899,3520,5011,33.015148038438355,22.260752870795972,1491,1,203378,69881,1090,0,1408,1340
13169,0,1,1,0,59,0,1782,0,0,5698423,4919633,40.70626487409524,1562,5191,5096,1657,47840,682870,617552,2874,4626,3064,6408,8160,58.642987645583,9.756499634156611,1752,0,344656,15295,3439,1,1312,470
13170,0,1,0,1,65,0,1139,0,0,2403122,3565190,32.89376840679705,692,3693,3303,1082,49693,754555,715015,2905,4377,3685,5516,6988,47.12748667179272,19.91005125914351,1472,1,234794,58110,2221,0,2213,1074
13171,0,1,1,0,57,0,988,0,0,362805,824790,16.881943016134134,0,1843,1558,285,55404,659832,703242,2609,3179,3179,4167,4737,35.679125549822544,17.237203584011475,570,1,69255,31350,1273,0,2609,1621
13172,0,1,1,0,57,0,985,0,0,276564,657324,15.0996688705415,0,1669,1441,228,56144,668856,697686,2655,3111,3111,4096,4552,34.828149534535996,15.472599544720637,456,1,55176,26676,1213,0,2655,1670
13173,1,0,0,0,50,0,122,1,0,358683,1368730,23.259406699226016,12,1757,1204,541,50268,597080,538890,1977,3071,3083,3193,4287,25.748786379167466,24.824856057076772,1094,1,115233,88480,663,0,1989,1867
13174,1,0,0,0,45,0,827,0,0,1118378,3519328,39.35733730830886,1549,2271,2271,1549,46656,436224,552096,2272,3821,2272,2994,4543,26.870057685088806,0.0,1549,0,376407,0,722,0,723,1550
13175,1,0,0,0,48,0,593,0,1,521268,2609571,32.817678162843876,726,1912,1561,1077,55250,605750,535483,2072,3500,2774,2907,4335,22.0,19.567750329337496,1428,1,238017,54756,484,0,1346,1939
13176,1,0,0,0,49,0,371,0,1,439622,2153536,29.563490998188964,408,1843,1377,874,50882,608608,507584,1998,3338,2930,2967,4307,22.427661492005804,22.61733277864947,1340,1,180044,83414,503,0,1590,1961
13177,1,0,0,0,49,0,843,0,1,1057770,1702920,26.267851073127396,489,2424,2223,690,48364,557768,528152,2267,3158,2669,4001,4892,39.153543900903784,14.555844298125802,891,1,147660,29748,1533,0,1778,935
13178,1,0,0,0,45,0,542,0,1,819584,2777344,34.87119154832539,1174,1932,1890,1216,51660,468220,575568,2242,3500,2326,2958,4216,25.96150997149434,6.609134537568676,1258,1,306432,2814,674,0,1068,1610
13179,1,0,0,0,44,0,697,0,1,812670,2932450,36.26292872893749,1315,1933,1933,1315,51520,499520,512900,2230,3545,2230,2848,4163,24.859605789312106,0.0,1315,1,302450,0,618,0,915,1612
13180,1,0,0,0,45,0,366,1,0,988632,2733066,34.55430508634199,939,2277,2022,1194,32786,444066,386841,2034,3483,2544,3117,4566,28.77498913987632,16.44434083993029,1449,1,201786,40545,828,0,1095,1461
13181,1,0,0,0,47,0,16,1,0,1382912,2822656,34.40930106817051,1034,2502,2352,1184,39644,445808,505408,2234,3568,2534,3552,4886,34.17601498127012,13.130475867068439,1334,1,251008,15300,1168,0,1200,1216
13182,1,0,0,0,48,0,54,0,1,1139895,2536917,32.264531609803356,553,2624,2136,1041,41128,516644,472778,1949,3478,2925,3532,5061,33.090784215548595,22.710875576796255,1529,1,201954,75152,1095,0,1396,1342
13183,1,0,0,0,48,0,20,0,1,705500,2074000,29.154759474226502,508,2022,1680,850,38407,470920,485560,2098,3290,2782,3270,4462,28.809720581775867,19.54281090053729,1192,1,169150,42408,830,0,1590,1610
13184,0,1,0,1,66,0,155,0,0,16343886,13661115,64.19501538281614,3946,8262,8087,4121,42785,712725,659685,3140,7436,3490,7281,11577,62.976185975335156,13.276125050940067,4296,1,820079,26600,3966,0,806,651
13185,1,0,0,0,47,0,330,1,0,1473400,3281790,37.282703764614496,1189,2651,2450,1390,40090,498171,448590,2160,3751,2562,3421,5012,32.55764119219941,15.0436608546514,1591,1,264100,31758,1060,0,971,1301
13186,1,0,0,0,46,0,848,0,1,1142724,3620200,39.67366884975475,1544,2330,2300,1574,40587,374900,572700,2270,3874,2330,3026,4630,26.94438717061496,6.405979164606015,1604,1,391926,300,726,0,726,1574
13187,1,0,0,0,45,0,1297,0,1,723278,948092,20.518284528683193,421,2139,2139,421,48438,466164,526968,2252,2673,2252,3970,4391,41.44876355212541,0.0,421,1,98514,0,1718,0,1831,534
13188,1,0,0,0,45,0,1231,0,1,958652,1235103,23.259406699226016,456,2398,2313,541,33891,541071,326469,2198,2824,2368,4055,4681,42.09513035969837,9.460074866898333,626,1,77363,19380,1772,0,1742,511
13189,1,0,0,0,48,0,999,0,1,1028530,1522603,25.11971337416094,631,2261,2261,631,49704,526034,550164,2413,3044,2413,4043,4674,40.3732584763727,0.0,631,1,143868,0,1630,0,1782,783
13190,1,0,0,0,45,0,655,0,1,786714,2869342,35.679125549822544,1206,1958,1891,1273,50694,480102,536452,2187,3527,2321,2872,4212,24.859605789312106,8.20759886765899,1340,1,302974,6834,618,0,981,1636
13191,1,0,0,0,45,0,483,1,0,889380,2744685,34.85685011586675,1053,2109,1947,1215,34362,467613,374994,2097,3474,2421,2991,4368,27.055498516937366,12.917631945094628,1377,1,201690,28674,732,0,1044,1527
13192,1,0,0,0,46,0,181,1,0,1696140,2807865,34.85685011586675,1185,2641,2611,1215,43890,533841,439090,2281,3526,2341,3707,4952,37.36308338453881,5.514871952411144,1245,1,230850,5430,1396,0,1096,915
13193,1,0,0,0,47,0,151,1,0,1818150,3023025,35.70714214271425,1095,2881,2701,1275,34748,564298,346166,2191,3646,2551,3797,5252,37.76241517699841,13.833892875472413,1455,1,186150,40860,1426,0,1096,945
13194,0,1,1,0,63,0,970,0,0,1750056,2936472,30.397368307141328,258,3484,2818,924,49200,651490,762720,2512,4102,3844,5072,6662,43.520110293977886,25.884141976828893,1590,1,221760,59274,1894,0,2254,1284
13195,1,0,0,0,45,0,1288,0,1,654420,883740,19.748417658131498,360,2098,2068,390,42872,416944,527978,2236,2656,2296,3944,4364,40.963398296528084,5.753771868478424,420,1,90870,2100,1678,0,1876,588
13196,1,0,0,0,45,0,1271,0,1,710220,947100,20.493901531919196,420,2111,2111,420,46060,441980,529925,2255,2675,2255,3946,4366,41.12177038990418,0.0,420,1,98700,0,1691,0,1835,564
13197,1,0,0,0,45,0,409,0,1,852150,2634650,33.91164991562634,1090,1951,1891,1150,49266,474237,545258,2231,3441,2351,3032,4242,27.2213151776324,7.9332512824338455,1210,1,273700,5580,741,0,1141,1550
13198,1,0,0,0,45,0,375,1,0,924264,2664261,34.161381705077446,939,2187,1959,1167,32186,477147,351582,2055,3450,2511,3075,4470,28.142494558940577,15.453125209005169,1395,1,179718,43776,792,0,1116,1491
13199,1,0,0,0,48,0,41,0,1,407262,1607301,25.67099530598687,387,1549,1277,659,51980,560970,551214,2167,3098,2711,3057,3988,24.859605789312106,16.983642189975598,931,1,148934,37536,618,0,1780,1821
13200,0,1,0,1,66,0,416,0,0,17262336,14458080,66.09084656743322,4338,8350,8320,4368,46782,748060,685170,3280,7678,3340,7262,11660,62.864934582006846,5.501408174353464,4398,1,904176,4710,3952,0,1058,642
13201,0,1,0,1,66,0,379,0,0,17182440,14357751,65.87108622149782,4339,8299,8299,4339,45900,744525,675036,3309,7648,3309,7269,11608,62.928530890209096,0.0,4339,1,885156,0,3960,0,1030,651
13202,0,1,0,1,64,0,276,0,0,15901056,12453516,62.0644825967316,3852,7980,7980,3852,52405,720959,759755,3233,7085,3233,7361,11213,64.24951361683604,0.0,3852,1,905220,0,4128,0,619,895
13203,1,0,0,0,47,0,781,0,0,567462,2924040,35.199431813596085,1086,1850,1697,1239,44352,594720,415360,2207,3599,2513,2818,4210,21.400934559032695,13.323203305130646,1392,1,218064,30447,458,0,1121,1902
13204,1,0,0,0,45,0,1279,0,1,590040,823320,18.973665961010276,300,2059,1999,360,44368,429956,539732,2227,2647,2347,3926,4346,40.48456495999432,8.334399795261145,420,1,84960,4260,1639,0,1927,648
13205,1,0,0,0,48,0,577,1,0,786324,1568140,25.37715508089904,577,1932,1865,644,37980,513785,438300,2368,3079,2502,3656,4367,34.942810419312295,8.230562448445415,711,1,115920,11256,1221,0,1791,1214
13206,1,0,0,0,48,0,433,1,0,841434,1777248,26.94438717061496,684,1927,1885,726,40775,570384,428400,2406,3174,2490,3607,4375,34.044089061098404,6.484411467763075,768,1,127050,8274,1159,0,1722,1289
13207,1,0,0,0,45,0,446,1,0,826367,2659905,34.044089061098404,1099,1932,1872,1159,32918,500310,346545,2235,3454,2355,3008,4227,26.70205984563738,8.016064826688304,1219,1,175009,12300,713,0,1136,1582
13208,1,0,0,0,45,0,538,0,1,811239,2733549,34.77067730142742,1142,1947,1880,1209,50500,456722,565250,2194,3470,2328,2932,4208,25.903667693977237,8.2732738280919,1276,1,302250,4623,671,0,1052,1590
13209,1,0,0,0,46,0,135,1,0,1040950,2556050,33.015148038438355,708,2427,2045,1090,29336,452585,356440,1963,3435,2727,3300,4772,30.903074280724887,20.222509109381974,1472,1,165680,66468,955,0,1255,1390
13210,0,1,0,1,66,0,359,0,0,17344172,14417968,65.93936608733814,4348,8337,8337,4348,42946,722888,653252,3316,7664,3316,7305,11653,63.15853069855251,0.0,4348,1,856556,0,3989,0,1032,673
13211,0,0,0,0,57,1,1696,1,0,1453572,6668784,48.187135212627034,2172,3098,2948,2322,55370,649072,703640,2722,5194,3022,3498,5970,25.019992006393608,12.296281753706847,2472,1,568890,15750,626,0,550,2246
13212,1,0,0,0,48,0,1389,1,0,829840,1098185,21.236760581595302,151,2591,2291,451,27552,545440,299505,2135,2886,2735,4275,5026,42.89522117905443,17.322865108115078,751,1,55473,69900,1840,0,1984,595
13213,1,0,0,0,48,0,738,0,1,743683,1388929,23.853720883753127,569,1876,1876,569,51884,532138,580958,2441,3010,2441,3748,4317,36.15245496505044,0.0,569,1,135422,0,1307,0,1872,1134
13214,1,0,0,0,48,0,53,0,1,962640,2428272,31.74901573277509,796,2175,1963,1008,46435,445665,604659,2197,3417,2621,3364,4584,30.903074280724887,14.995850130027382,1220,1,253008,8904,955,0,1401,1454
13215,1,0,0,0,45,0,323,0,1,856578,2520189,33.18132004607411,1071,1909,1879,1101,52192,512736,533337,2259,3390,2319,3067,4198,27.892651361962706,5.531194905403055,1131,1,256533,3690,778,0,1188,1511
13216,1,0,0,0,47,0,37,1,0,1141350,2517900,32.4037034920393,715,2472,2137,1050,38982,525162,426844,2063,3448,2733,3485,4870,32.96968304366907,18.510806767066157,1385,1,186900,60300,1087,0,1348,1311
13217,1,0,0,0,47,0,205,0,1,1380714,2552490,32.817678162843876,969,2467,2359,1077,50250,476370,592500,2262,3447,2478,3652,4837,35.805027579936315,10.799029488658043,1185,1,269250,7128,1282,0,1293,1088
13218,1,0,0,0,47,0,203,1,0,1707108,2894346,34.77067730142742,999,2831,2621,1209,30456,517104,337554,2184,3603,2604,3806,5225,37.57658845611187,15.089492220326534,1419,1,170469,44310,1412,0,1185,982
13219,1,0,0,0,49,0,114,0,1,741520,1977118,28.39013913315678,332,2200,1726,806,54948,591173,559284,1979,3259,2927,3373,4653,30.331501776206203,22.541060306119345,1280,1,183768,69204,920,0,1647,1533
13220,1,0,0,0,48,0,47,0,1,418704,1515696,24.979991993593593,323,1596,1295,624,56876,573244,585389,2128,3053,2730,3100,4025,25.903667693977237,17.6930699777925,925,1,150384,35518,671,0,1805,1758
13221,1,0,0,0,48,0,2,0,1,319224,1360368,23.748684174075834,382,1312,1130,564,56400,578880,566820,2230,2976,2594,2978,3724,23.790754506740637,13.951368915431251,746,1,132540,22932,566,0,1848,1846
13222,0,1,1,0,64,0,985,0,0,2344716,3605796,33.406586176980134,534,3799,3217,1116,48068,636507,788364,2649,4347,3813,5332,7030,45.83666654546336,24.402520305049972,1698,1,272304,41322,2101,0,2115,1130
13223,1,0,0,0,48,0,14,0,1,1067040,2475738,32.03123475609393,666,2426,2066,1026,55189,552577,581533,2053,3439,2773,3453,4839,32.2490309931942,18.992998025667355,1386,1,247266,41760,1040,0,1387,1373
13224,1,0,0,0,46,0,812,0,0,470373,2818629,34.68429039204925,1023,1774,1594,1203,44750,585750,419397,2163,3546,2523,2734,4117,19.77371993328519,13.936984710943394,1383,1,215337,37260,391,0,1140,1952
13225,1,0,0,0,49,0,439,0,1,306440,2017125,28.548204847240395,395,1611,1191,815,46604,603900,472725,2055,3290,2895,2851,4086,19.390719429665317,21.795919370460645,1235,1,155665,80640,376,0,1660,2099
13226,1,0,0,0,45,0,285,0,0,274000,901200,20.0,400,1085,1085,400,51529,511431,511431,2253,2653,2253,2938,3338,26.1725046566048,0.0,400,0,90800,0,685,0,1853,1568
13227,1,0,0,0,46,0,1260,0,1,468000,691200,17.320508075688775,215,1945,1860,300,54250,499968,576000,2219,2604,2389,3864,4249,39.496835316262995,9.476861953055495,385,1,75000,7225,1560,0,2004,744
13228,1,0,0,0,45,0,290,0,0,856944,2476698,32.89376840679705,1082,1874,1874,1082,45200,517314,457800,2289,3371,2289,3081,4163,28.142494558940577,0.0,1082,0,216400,0,792,0,1207,1497
13229,1,0,0,0,46,0,285,0,1,1432924,2488483,32.60368077380221,1021,2453,2411,1063,53424,496292,589932,2299,3404,2383,3689,4794,36.71511950137164,6.678188844436455,1105,1,267876,3192,1348,0,1278,993
13230,1,0,0,0,48,0,207,1,0,1570594,2799604,33.97057550292606,884,2785,2515,1154,31584,543424,342066,2156,3580,2696,3787,5211,36.89173349139343,17.189116732801693,1424,1,162714,59130,1361,0,1272,1065
13231,1,0,0,0,49,0,188,0,1,1185813,2454543,31.606961258558215,549,2636,2186,999,48884,594594,496314,2007,3456,2907,3644,5093,34.45286635390443,21.78666621678477,1449,1,201798,80550,1187,0,1458,1270
13232,1,0,0,0,47,0,23,0,1,249368,1167296,22.090722034374522,380,1107,999,488,55842,542984,588432,2284,2880,2500,2903,3499,22.60530911091463,10.89017689082249,596,1,120048,11232,511,0,1904,1881
13233,0,1,0,1,66,0,245,0,0,17503404,14371488,65.63535632568775,4278,8401,8371,4308,34615,717240,537096,3306,7644,3366,7399,11737,63.74166612193315,5.490867587491313,4338,1,693588,5730,4063,0,972,727
13234,0,0,0,0,57,1,1761,1,0,1390032,6771408,48.49742261192856,2190,3105,2943,2352,54808,636259,713992,2717,5231,3041,3470,5984,24.310491562286437,12.803033322522062,2514,1,583296,15228,591,0,527,2288
13235,1,0,0,0,45,0,909,0,1,888592,3431286,38.742741255621034,1471,2123,2093,1501,56870,553212,537210,2256,3787,2316,2878,4409,24.331050121192877,5.531194905403055,1531,1,352735,3990,592,0,785,1694
13236,1,0,0,0,45,0,900,0,0,779581,3278275,37.960505792204614,1441,1982,1982,1441,48178,502775,495950,2275,3716,2275,2816,4257,23.259406699226016,0.0,1441,0,314138,0,541,0,834,1734
13237,1,0,0,0,47,0,769,1,0,338666,2578406,32.89376840679705,782,1695,1395,1082,46563,593367,445621,2083,3465,2683,2696,4078,17.69180601295413,17.904637500400828,1382,1,202334,59700,313,0,1301,2070
13238,1,0,0,0,45,0,276,0,0,265045,890725,19.87460691435179,395,1066,1066,395,46200,496100,473550,2255,2650,2255,2926,3321,25.903667693977237,0.0,395,0,82950,0,671,0,1860,1584
13239,1,0,0,0,45,0,390,1,0,242875,763800,18.303005217723125,305,1090,1060,335,39120,547200,371640,2250,2615,2310,3005,3370,26.92582403567252,5.684275577662207,365,1,54605,6450,725,0,1945,1555
13240,1,0,0,0,46,0,1232,0,1,459600,690000,17.320508075688775,233,1899,1832,300,53500,492200,575000,2233,2600,2367,3832,4199,39.14077158156185,8.456490803821907,367,1,75000,5494,1532,0,2000,768
13241,1,0,0,0,50,0,1015,0,1,717600,1202880,21.908902300206645,318,2137,1975,480,47080,551320,536284,2344,2986,2668,4001,4643,38.66522985836241,12.79158200857479,642,1,102720,23166,1495,0,2026,1011
13242,1,0,0,0,47,0,43,1,0,1036880,2386818,31.575306807693888,547,2487,2037,997,30458,464436,375858,1944,3391,2844,3434,4881,32.2490309931942,21.333278655795652,1447,1,156529,76950,1040,0,1397,1354
13243,1,0,0,0,48,0,228,1,0,1559520,2771340,33.76388603226827,868,2780,2508,1140,35485,571285,367081,2159,3571,2703,3799,5211,36.98648401781386,17.30166535363801,1412,1,172140,60112,1368,0,1291,1063
13244,1,0,0,0,49,0,195,0,1,903474,2104674,29.29163703175362,281,2488,1911,858,56619,571549,596079,1876,3311,3030,3506,4941,32.449961479175904,24.60334746031052,1435,1,208494,65201,1053,0,1595,1400
13245,1,0,0,0,48,0,153,0,1,564928,1650649,26.057628441590765,220,1970,1511,679,55527,605319,542113,1972,3110,2890,3263,4401,28.844410203711913,21.618501441758234,1138,1,151417,69309,832,0,1752,1599
13246,0,1,0,1,66,0,442,0,0,18158448,14980944,66.9925368977769,4364,8658,8534,4488,39936,694304,640896,3214,7826,3462,7384,11996,63.608175575157006,11.284767849177381,4612,1,861696,18972,4046,0,1150,708
13247,0,0,0,0,57,1,1764,1,0,1394752,6813552,48.53864439804639,2164,3140,2948,2356,53874,633348,711432,2700,5248,3084,3484,6032,24.331050121192877,13.945841795595102,2548,1,579576,18624,592,0,536,2300
13248,1,0,0,0,45,0,929,0,1,984360,3545880,39.496835316262995,1560,2191,2191,1560,56120,554612,522790,2273,3833,2273,2904,4464,25.11971337416094,0.0,1560,1,358800,0,631,0,713,1642
13249,1,0,0,0,45,0,906,1,0,654120,3167100,37.14835124201342,1350,1884,1854,1380,27195,424575,337365,2265,3675,2325,2769,4179,21.77154105707724,6.004624280888846,1410,1,202860,5070,474,0,915,1821
13250,1,0,0,0,45,0,324,0,0,247285,818748,19.0,361,1046,1046,361,38940,498960,401436,2268,2629,2268,2953,3314,26.1725046566048,0.0,361,0,63897,0,685,0,1907,1583
13251,1,0,0,0,47,0,157,0,1,368994,1279464,23.108440016582687,239,1520,1225,534,56643,567852,572644,2101,2930,2691,3087,3916,26.28687885618983,17.31251586689444,829,1,127626,34810,691,0,1862,1705
13252,0,0,1,0,58,1,1458,0,0,262440,4766040,40.24922359499622,1496,1906,1782,1620,51385,703138,632530,2818,4562,3066,3104,4848,12.727922061357855,11.140052311785754,1744,1,348300,19964,162,0,1322,2780
13253,0,0,0,0,57,1,1792,1,0,1381668,6882226,48.72371086031933,2184,3146,2956,2374,52245,623285,704457,2709,5273,3089,3481,6045,24.124676163629637,13.919868588335374,2564,1,576882,18430,582,0,525,2317
13254,1,0,0,0,46,0,695,0,1,1166334,3430830,38.49675310984031,1387,2364,2269,1482,56376,537080,562545,2220,3797,2410,3102,4679,28.053520278211074,9.996498160997929,1577,1,360126,9975,787,0,833,1528
13255,1,0,0,0,45,0,944,0,1,1027140,3615660,39.87480407475377,1590,2236,2236,1590,55221,529842,538938,2274,3864,2274,2920,4510,25.41653005427767,0.0,1590,1,376830,0,646,0,684,1628
13256,1,0,0,0,49,0,1026,0,1,626080,1063390,20.73644135332772,430,1886,1886,430,48357,492127,600939,2473,2903,2473,3929,4359,38.157568056677825,0.0,430,1,104490,0,1456,0,2043,1017
13257,1,0,0,0,49,0,870,1,0,683131,1238518,22.338307903688676,372,1995,1868,499,37948,526184,444278,2355,2981,2609,3851,4477,37.0,11.513609011867374,626,1,89321,21590,1369,0,1983,1113
13258,1,0,0,0,45,0,237,1,0,931714,2497299,33.03028912982749,1001,2035,1945,1091,27777,450933,322749,2199,3380,2379,3143,4324,29.223278392404914,9.903872795307445,1181,1,153831,17100,854,0,1198,1435
13259,1,0,0,0,46,0,436,1,0,1404501,2299710,31.416556144810016,987,2410,2410,987,44268,505610,475320,2330,3317,2330,3753,4740,37.72267222772003,0.0,987,1,201348,0,1423,0,1343,907
13260,0,1,0,1,65,0,113,0,0,15745800,12827448,62.545983084447556,3852,7997,7937,3912,37184,734496,544314,3219,7191,3339,7304,11276,63.4428877022476,7.994134176674909,3972,1,649392,11820,4025,0,633,746
13261,0,1,0,1,65,0,129,0,0,15578596,12751772,62.313722405261586,3793,7985,7895,3883,40480,722480,604256,3194,7167,3374,7296,11269,63.340350488452465,9.756499634156611,3973,1,714472,15660,4012,0,599,728
13262,1,0,0,0,48,0,10,0,1,786744,2139732,29.698484809834994,610,2046,1774,882,52670,557980,555554,2154,3308,2698,3318,4472,29.866369046136157,16.56417852579114,1154,1,201978,36720,892,0,1544,1534
13263,1,0,0,0,45,0,954,0,0,1011240,3610890,39.87480407475377,1590,2226,2226,1590,50718,538227,485994,2271,3861,2271,2907,4497,25.219040425836983,0.0,1590,0,340260,0,636,0,681,1635
13264,1,0,0,0,47,0,521,1,0,1503402,2343480,31.51190251317746,908,2592,2507,993,41536,556960,415360,2275,3353,2445,3874,4952,38.91015291668744,9.300149152818726,1078,1,174768,16915,1514,0,1367,846
13265,1,0,0,0,48,0,415,1,0,1576200,2566650,32.63433774416144,849,2761,2545,1065,38925,542250,416930,2194,3475,2626,3890,5171,38.47076812334269,15.387673282893392,1281,1,184245,41472,1480,0,1345,930
13266,0,1,0,1,67,0,57,0,0,17433988,14213724,64.8382603097893,4084,8471,8351,4204,49368,818202,689724,3261,7585,3501,7528,11852,64.39720490828775,10.986451322313634,4324,1,857616,21120,4147,0,823,766
13267,0,1,0,1,66,0,8,0,0,16540473,13529790,63.74166612193315,3973,8224,8134,4063,38880,539460,799200,3240,7393,3420,7401,11554,63.80438856379708,10.764922770325866,4153,1,975120,2430,4071,0,733,741
13268,1,0,0,0,49,0,1470,1,0,473824,669664,16.492422502470642,0,2286,2014,272,34350,563798,369300,2190,2734,2734,4204,4748,41.737273509418415,16.512504213732733,544,1,40800,58752,1742,0,2190,720
13269,1,0,0,0,49,0,1158,0,1,555895,906295,19.1049731745428,365,1888,1888,365,54480,563641,595920,2483,2848,2483,4006,4371,39.02563260217571,0.0,365,1,87600,0,1523,0,2118,960
13270,1,0,0,0,46,0,124,1,0,912005,2343700,31.921779399024736,989,1944,1914,1019,30049,457700,347300,2270,3319,2330,3195,4244,29.916550603303182,5.91487205010149,1049,1,153869,5460,895,0,1281,1405
13271,1,0,0,0,47,0,26,1,0,932987,2246221,30.870698080866262,683,2202,1932,953,32648,499684,362978,2087,3310,2627,3336,4559,31.28897569432403,17.074764851741445,1223,1,146762,52650,979,0,1404,1378
13272,0,1,0,1,67,0,141,0,0,18112822,14577663,65.77993615077473,4327,8513,8513,4327,48552,801822,687276,3369,7696,3369,7555,11882,64.69930447848725,0.0,4327,1,882708,0,4186,0,958,817
13273,0,1,1,0,61,0,1026,0,0,1257120,2219040,26.832815729997478,250,2936,2466,720,45384,564006,764336,2612,3802,3552,4828,6018,41.78516483155236,21.69134877982182,1190,1,178560,21150,1746,0,2362,1336
13274,0,0,1,0,58,1,1737,0,0,1232398,6713266,47.7283982551269,2116,2981,2819,2278,53312,660128,701386,2785,5225,3109,3488,5928,23.259406699226016,13.009547964816395,2440,1,542164,18792,541,0,669,2406
13275,1,0,0,0,45,0,860,0,0,1040549,3501286,39.20459156782532,1537,2214,2214,1537,45426,514828,457878,2278,3815,2278,2955,4492,26.019223662515376,0.0,1537,0,308937,0,677,0,741,1601
13276,1,0,0,0,46,0,197,0,1,895650,1996873,29.206163733020468,853,1903,1903,853,49735,475223,573545,2341,3194,2341,3391,4244,32.4037034920393,0.0,853,1,208985,0,1050,0,1488,1291
13277,1,0,0,0,48,0,573,1,0,1529548,2360183,31.352830813181765,833,2689,2539,983,35183,559433,362551,2251,3384,2551,3957,5090,39.44616584663204,12.667476048676626,1133,1,148433,33000,1556,0,1418,845
13278,1,0,0,0,48,0,3,0,1,655288,1965864,28.42534080710379,540,1887,1619,808,50609,557157,537693,2165,3241,2701,3244,4320,28.478061731796284,16.475063179409663,1076,1,178568,38592,811,0,1625,1622
13279,1,0,0,0,50,0,1073,0,1,596708,1014444,20.09975124224178,296,1989,1881,404,47952,557442,542376,2403,2915,2619,3988,4500,38.43175770115127,10.429745618880121,512,1,87264,15444,1477,0,2107,1034
13280,1,0,0,0,47,0,45,1,0,854194,2153074,30.033314835362415,668,2083,1849,902,43400,477400,517979,2153,3289,2621,3334,4470,30.773365106858236,15.845242279806376,1136,1,195734,26442,947,0,1485,1440
13281,1,0,0,0,48,0,359,0,1,1198770,2250600,30.495901363953813,480,2669,2219,930,53816,600160,525140,1970,3350,2870,3709,5089,35.90264614203248,21.545660055176604,1380,1,201810,74700,1289,0,1490,1131
13282,1,0,0,0,47,0,153,0,1,1205248,2785959,34.307433596816885,976,2402,2201,1177,56640,558612,568080,2166,3544,2568,3391,4769,32.0,14.70834415446928,1378,1,282480,24120,1024,0,1190,1343
13283,1,0,0,0,45,0,796,1,0,1038432,3428616,38.62641583165593,1450,2230,2188,1492,37664,491772,404448,2256,3790,2340,2994,4528,26.38181191654584,6.7040592262067955,1534,1,262592,7392,696,0,806,1602
13284,1,0,0,0,49,0,720,0,1,130500,2149770,29.49576240750525,585,1305,1020,870,38532,563388,417599,2186,3341,2756,2621,3776,12.24744871391589,17.005340450602812,1155,1,147030,56430,150,0,1601,2321
13285,1,0,0,0,47,0,81,0,0,247860,1290600,23.2379000772445,390,1149,999,540,48945,466050,599890,2240,2930,2540,2849,3539,21.42428528562855,12.514175867137965,690,1,135540,8400,459,0,1850,1931
13286,1,0,0,0,49,0,1361,0,1,440370,672840,16.431676725154983,228,1943,1901,270,50328,538272,580636,2450,2762,2534,4123,4435,40.38564101261734,6.553889165207866,312,1,62910,4746,1631,0,2222,861
13287,1,0,0,0,47,0,327,0,0,880524,1855728,28.089143810376278,789,1905,1905,789,48620,517440,519792,2352,3141,2352,3468,4257,33.406586176980134,0.0,789,0,174369,0,1116,0,1563,1236
13288,1,0,0,0,46,0,53,1,0,902748,2133516,30.397368307141328,924,1901,1901,924,53357,537997,528761,2309,3233,2309,3286,4210,31.25699921617557,0.0,924,1,211596,0,977,0,1385,1332
13289,1,0,0,0,48,0,265,1,0,920436,2018104,28.91366458960192,476,2297,1937,836,32136,497284,376584,2054,3250,2774,3515,4711,33.18132004607411,19.921065175345397,1196,1,130416,66600,1101,0,1578,1313
13290,1,0,0,0,49,0,411,0,1,946800,1945674,28.089143810376278,394,2384,1989,789,36408,547452,404424,2071,3255,2861,3666,4850,34.64101615137755,19.90713647718841,1184,1,129396,77815,1200,0,1677,1266
13291,0,1,0,1,67,0,97,0,0,13580558,12358526,60.30754513325841,3306,7702,7371,3637,29106,672804,499506,3067,7035,3729,7132,11100,61.106464469808756,18.41071085543109,3968,1,534639,60904,3734,0,239,336
13292,1,0,0,0,48,0,893,1,0,64320,2351040,30.983866769659336,660,1327,1027,960,35708,553474,386942,2149,3409,2749,2516,3776,8.18535277187245,17.320508075688775,1260,1,151680,61800,67,0,1489,2382
13293,1,0,0,0,49,0,1433,0,1,401520,599760,15.491933384829668,155,1998,1913,240,50370,547281,574770,2414,2739,2584,4172,4497,40.90232267243512,9.300149152818726,325,1,55200,10285,1673,0,2259,826
13294,1,0,0,0,50,0,1106,0,1,610040,1011616,20.09975124224178,374,1944,1914,404,53820,575920,585936,2474,2908,2534,4014,4448,38.8587184554509,5.531194905403055,434,1,94536,3810,1510,0,2100,994
13295,1,0,0,0,47,0,118,1,0,863280,2068384,29.5296461204668,748,1986,1862,872,42705,462540,519468,2248,3244,2496,3362,4358,31.464265445104548,11.193732213226145,996,1,190968,12896,990,0,1500,1382
13296,0,1,0,1,67,0,283,0,0,17843280,14728896,66.09084656743322,4278,8543,8453,4368,51212,795792,731724,3282,7740,3462,7457,11915,63.914004725099176,9.486832980505138,4458,1,947856,14040,4085,0,996,713
13297,0,1,1,0,64,0,1472,0,0,5348633,5419655,41.12177038990418,1157,5388,4854,1691,25724,698690,378190,2671,4896,3739,6368,8593,56.24055476255546,23.158923026777266,2225,1,199538,123888,3163,0,1514,42
13298,1,0,0,0,50,0,1382,1,0,393008,608630,15.556349186104045,134,1974,1866,242,41216,563360,462760,2407,2757,2623,4139,4489,40.29888335921977,10.613247510664669,350,1,44528,19332,1624,0,2273,891
13299,1,0,0,0,50,0,1221,0,1,528840,851229,18.411952639521967,272,1966,1899,339,51504,557442,582552,2444,2850,2578,4071,4477,39.496835316262995,8.20171446926608,406,1,78648,8107,1560,0,2172,951
13300,1,0,0,0,46,0,172,1,0,885629,2003188,29.30870177950569,829,1920,1890,859,43485,454740,520036,2302,3191,2362,3363,4252,32.109188716004645,5.753771868478424,889,1,191557,2940,1031,0,1473,1301
13301,1,0,0,0,48,0,686,0,1,1044435,1774290,27.110883423451916,585,2306,2156,735,49532,490042,589016,2264,3149,2564,3835,4720,37.69615364994153,12.653555250482114,885,1,179340,12150,1421,0,1679,993
13302,1,0,0,0,48,0,762,0,1,1407355,2081190,29.410882339705484,731,2626,2492,865,50250,601500,483606,2272,3271,2540,4033,5032,40.33608806019741,12.151058826387683,999,1,173865,24924,1627,0,1541,779
13303,1,0,0,0,47,0,476,0,1,427772,1092788,21.400934559032695,67,1783,1392,458,43428,448568,551166,1995,2844,2777,3320,4169,30.56141357987225,20.21652095504626,849,1,105798,30498,934,0,1928,1452
13304,0,1,0,1,65,0,1295,0,0,4636496,5244876,40.01249804748511,1346,4752,4497,1601,48174,710892,727272,3021,4877,3531,6172,8028,53.81449618829484,16.114129483648576,1856,1,355422,33150,2896,0,1675,380
13305,0,0,1,0,58,1,1712,0,0,1207713,6585072,47.4236228055175,2219,2816,2786,2249,51935,647088,688080,2898,5177,2958,3465,5744,23.173260452512935,5.514871952411144,2279,1,528515,3480,537,0,679,2391
13306,1,0,0,0,46,0,900,1,0,963900,3555720,39.11521443121589,1380,2310,2160,1530,40544,520576,420644,2174,3854,2474,2954,4634,25.099800796022265,12.480747566911448,1680,1,276930,27450,630,0,794,1694
13307,1,0,0,0,49,0,1399,1,0,232350,369600,12.24744871391589,120,1969,1699,150,30745,529760,352352,2194,2614,2734,4013,4433,39.35733730830886,17.413290626525438,420,1,21450,56160,1549,0,2314,915
13308,1,0,0,0,48,0,485,0,1,662844,1464691,24.63736998950984,70,2236,1699,607,51051,557403,533273,1876,3020,2950,3505,4649,33.04542328371661,23.363840264637613,1144,1,134147,78402,1092,0,1806,1321
13309,0,1,0,1,67,0,354,0,0,17718040,14807470,66.25707509390978,4240,8576,8426,4390,50995,792655,731941,3223,7763,3523,7409,11949,63.52952069707436,12.24962545775264,4540,1,952630,23250,4036,0,1017,663
13310,0,1,0,1,66,0,213,0,0,15595108,13578779,63.694583757176716,3997,7961,7901,4057,36672,639277,642624,3287,7404,3407,7191,11308,62.0,8.038779614196052,4117,1,778944,7740,3844,0,710,497
13311,0,0,1,0,59,1,902,0,0,296448,3424206,34.02939905434711,1073,1499,1414,1158,50336,715594,615056,2872,4115,3042,3213,4456,16.0,9.239893968762086,1243,1,240864,14620,256,0,1799,2701
13312,1,0,0,0,47,0,992,1,0,437913,3150063,36.373066958946424,1238,1739,1654,1323,38160,571440,378579,2296,3704,2466,2712,4120,18.193405398660254,9.370214040084857,1408,1,210357,18530,331,0,1058,2050
13313,1,0,0,0,48,0,982,1,0,43008,2491392,32.0,747,1343,1066,1024,43400,603384,425775,2156,3457,2710,2475,3776,6.48074069840786,16.651120261358944,1301,1,179200,57893,42,0,1409,2391
13314,1,0,0,0,46,0,141,0,1,245530,1005770,20.73644135332772,430,1001,1001,430,49922,509902,535631,2339,2769,2339,2910,3340,23.895606290697042,0.0,430,1,98470,0,571,0,1909,1768
13315,1,0,0,0,50,0,1036,0,1,707820,1178290,21.6794833886788,346,2100,1976,470,54520,581624,589145,2383,2977,2631,4013,4607,38.80721582386451,11.170846875615652,594,1,110450,15996,1506,0,2037,1001
13316,1,0,0,0,47,0,322,1,0,928608,1942896,28.5657137141714,634,2136,1954,816,30806,502391,347626,2199,3197,2563,3519,4517,33.734255586866,14.030240797340863,998,1,119136,36582,1138,0,1565,1243
13317,1,0,0,0,49,0,508,1,0,870573,1756832,26.70205984563738,378,2269,1934,713,38843,534688,441056,2129,3177,2799,3685,4733,34.942810419312295,18.33959108532256,1048,1,127627,59295,1221,0,1751,1243
13318,1,0,0,0,48,0,503,0,1,758490,1580515,25.592967784139454,79,2389,1813,655,53550,574294,542925,1837,3068,2989,3571,4802,34.02939905434711,24.1549065442883,1231,1,147375,85248,1158,0,1758,1255
13319,0,1,0,1,67,0,357,0,0,17103598,14564614,65.71149062378664,4117,8480,8279,4318,52440,775790,769044,3172,7691,3574,7334,11853,62.93647591023825,14.177446878757825,4519,1,984504,27336,3961,0,945,588
13320,1,0,0,0,46,0,946,1,0,934047,3618464,39.35733730830886,1415,2286,2152,1549,40683,497568,446176,2202,3885,2470,2939,4622,24.55605831561735,11.616877517762624,1683,1,295859,21306,603,0,787,1733
13321,1,0,0,0,47,0,40,0,0,253616,1236116,22.891046284519195,524,1008,1008,524,52185,502467,577955,2359,2883,2359,2843,3367,22.0,0.0,524,1,128380,0,484,0,1835,1875
13322,1,0,0,0,46,0,77,0,1,253038,1094168,21.587033144922902,466,1009,1009,466,45771,490732,514212,2348,2814,2348,2891,3357,23.302360395462088,0.0,466,1,102054,0,543,0,1882,1805
13323,1,0,0,0,49,0,1656,0,1,270900,373350,12.24744871391589,120,2226,1956,150,43200,537624,497800,2219,2639,2759,4295,4715,42.49705872175156,16.54963712788037,420,1,30000,41580,1806,0,2339,683
13324,1,0,0,0,49,0,1664,0,1,356352,477504,13.856406460551018,85,2325,2048,192,42586,532218,494913,2210,2679,2764,4343,4812,43.08131845707603,16.74732262428718,469,1,38208,42104,1856,0,2295,631
13325,1,0,0,0,50,0,1826,0,1,350175,440825,13.228756555322953,186,2537,2176,175,45202,586927,488686,2158,2694,2880,4520,5056,44.73253849269008,19.207115060310446,536,1,33950,64619,2001,0,2344,518
13326,1,0,0,0,48,0,370,1,0,825104,1796382,27.23967694375247,657,1939,1854,742,43200,464832,544725,2336,3163,2506,3533,4360,33.34666400106613,9.300149152818726,827,1,166950,7905,1112,0,1679,1309
13327,1,0,0,0,47,0,357,1,0,839560,1792370,27.477263328068172,755,1867,1867,755,50336,493792,574508,2374,3129,2374,3486,4241,33.34666400106613,0.0,755,1,182710,0,1112,0,1619,1262
13328,1,0,0,0,47,0,331,1,0,941850,1953315,28.61817604250837,685,2103,1969,819,34800,477000,414990,2251,3204,2519,3535,4488,33.91164991562634,12.239957291285208,953,1,142506,21574,1150,0,1566,1235
13329,1,0,0,0,48,0,852,0,1,987085,1579860,25.592967784139454,531,2286,2162,655,51728,511344,588528,2288,3067,2536,3919,4698,38.82009788756334,11.428142902795917,779,1,159820,11408,1507,0,1757,905
13330,1,0,0,0,46,0,990,1,0,840739,3607339,39.20459156782532,1429,2192,2084,1537,36966,474094,429501,2239,3884,2455,2894,4539,23.388031127053,10.498474454302341,1645,1,281271,16632,547,0,810,1800
13331,1,0,0,0,47,0,101,0,0,257040,1326640,23.664319132398465,560,1019,1019,560,47403,490383,542501,2369,2929,2369,2828,3388,21.42428528562855,0.0,560,1,128240,0,459,0,1809,1910
13332,1,0,0,0,49,0,1664,0,1,272100,374250,12.24744871391589,151,2265,1964,150,42411,526445,501495,2194,2645,2796,4309,4760,42.59107887809371,17.477375990374796,451,1,30150,43645,1814,0,2345,681
13333,1,0,0,0,50,0,1448,0,1,393588,588042,15.297058540778355,192,1958,1916,234,51067,575477,560399,2471,2747,2555,4195,4471,41.012193308819754,6.481658975540136,276,1,52182,5922,1682,0,2279,831
13334,1,0,0,0,48,0,849,0,1,875556,1476747,24.55605831561735,411,2247,2055,603,53628,533882,602454,2257,3052,2641,3901,4696,38.1051177665153,14.094608812369348,795,1,148338,18432,1452,0,1846,997
13335,1,0,0,0,47,0,774,1,0,1143000,1791750,27.386127875258307,630,2394,2274,750,34604,504079,391796,2269,3139,2509,3913,4783,39.03844259188627,11.100602434372421,870,1,123000,22200,1524,0,1639,865
13336,1,0,0,0,48,0,536,0,1,924180,1769520,27.018512172212592,112,2614,1996,730,48384,523584,542976,1806,3154,3042,3690,5038,35.58089374931439,24.996207136938686,1348,1,163520,76632,1266,0,1694,1158
13337,0,1,1,0,61,0,1297,0,0,6711018,6219672,44.96665431183423,1927,5436,5341,2022,34875,692100,476780,2981,5098,3171,6395,8512,57.61076288333631,9.76859066112806,2117,1,313410,19665,3319,0,1054,243
13338,0,1,1,0,63,0,1105,0,0,2409000,3466770,33.090784215548595,903,3487,3295,1095,54780,696520,788334,2974,4261,3358,5366,6653,46.9041575982343,14.193561620765193,1287,1,272655,17664,2200,0,2071,966
13339,0,0,0,0,58,1,1873,1,0,930648,6681049,47.75981574503821,2186,2784,2689,2281,44688,574084,667812,2834,5210,3024,3337,5713,20.199009876724155,9.74706432789427,2376,1,520068,8835,408,0,648,2521
13340,1,0,0,0,47,0,192,0,1,257040,987840,20.493901531919196,335,1117,1032,420,50328,508032,548016,2267,2772,2437,2964,3469,24.73863375370596,9.224644470006377,505,1,97860,9605,612,0,1932,1740
13341,1,0,0,0,48,0,479,1,0,808470,1661855,26.28687885618983,691,1861,1861,691,44506,449735,572390,2405,3096,2405,3575,4266,34.20526275297414,0.0,691,1,164458,0,1170,0,1714,1235
13342,1,0,0,0,47,0,831,0,1,949900,1528212,25.37715508089904,644,2119,2119,644,48792,541044,507822,2373,3017,2373,3848,4492,38.40572873934304,0.0,644,1,137816,0,1475,0,1729,898
13343,1,0,0,0,48,0,612,1,0,1348765,2176640,29.916550603303182,534,2763,2402,895,38055,522880,430464,2071,3327,2793,3939,5195,38.82009788756334,19.276176726200813,1256,1,158415,63175,1507,0,1537,925
13344,1,0,0,0,46,0,386,0,1,1120527,2947887,35.62302626111375,1209,2212,2152,1269,47871,457631,564489,2263,3592,2383,3206,4535,29.715315916207253,8.52469877450791,1329,1,308367,4440,883,0,1054,1440
13345,1,0,0,0,45,0,504,0,0,1094272,3041120,36.4417343165772,1328,2152,2152,1328,48265,451130,561050,2290,3618,2290,3114,4442,28.705400188814647,0.0,1328,0,325360,0,824,0,962,1466
13346,1,0,0,0,46,0,742,1,0,1022288,3382528,38.05259518088089,1358,2244,2154,1448,28520,537280,289664,2246,3784,2426,3042,4580,26.570660511172846,10.270107864508772,1538,1,179552,21330,706,0,888,1630
13347,1,0,0,0,47,0,982,1,0,746955,3532815,38.535697735995385,1400,2073,1988,1485,31428,461526,385398,2294,3864,2464,2882,4452,22.427661492005804,9.370214040084857,1570,1,240570,14110,503,0,894,1876
13348,1,0,0,0,48,0,960,1,0,314244,2943906,34.899856733230294,1151,1543,1476,1218,38394,572829,391554,2350,3635,2484,2675,3960,16.06237840420901,8.239962426314323,1285,1,197316,14271,258,0,1199,2159
13349,1,0,0,0,48,0,531,1,0,904666,1754460,26.870057685088806,488,2209,1975,722,31200,505440,364500,2196,3152,2664,3683,4639,35.397740040855716,15.97700124035145,956,1,108300,45396,1253,0,1708,1177
13350,1,0,0,0,47,0,827,0,1,893010,1469604,24.859605789312106,618,2063,2063,618,46350,535050,489868,2378,2996,2378,3823,4441,38.01315561749642,0.0,618,1,127308,0,1445,0,1760,933
13351,1,0,0,0,47,0,967,1,0,935870,3716875,39.56008088970496,1390,2338,2163,1565,39471,529625,420375,2200,3940,2550,2973,4713,24.454038521274967,13.398254763593743,1740,1,277005,32550,598,0,810,1777
13352,1,0,0,0,48,0,684,1,0,1157677,1913984,28.053520278211074,502,2543,2258,787,40260,535040,445056,2147,3219,2717,3903,4975,38.353617821530214,17.22904594733818,1072,1,144021,50160,1471,0,1645,961
13353,1,0,0,0,47,0,647,0,1,642708,1291367,23.259406699226016,124,2146,1729,541,55632,544236,582428,1970,2928,2804,3575,4533,34.46737587922817,20.551111833209788,958,1,132004,45036,1188,0,1846,1199
13354,0,1,1,0,62,0,1154,0,0,6747992,6472904,45.65084884205331,1964,5442,5322,2084,26474,674002,378932,2986,5190,3226,6344,8548,56.90342696182718,11.232917923179112,2204,1,254248,27240,3238,0,1022,132
13355,1,0,0,0,47,0,46,0,1,829392,2211712,30.56141357987225,772,1984,1822,934,55575,532800,584896,2206,3302,2530,3256,4352,29.79932885150268,13.28445058508805,1096,1,230698,14904,888,0,1434,1480
13356,1,0,0,0,45,0,486,0,1,1107351,3032316,36.373066958946424,1293,2190,2160,1323,44103,419436,552372,2262,3615,2322,3129,4482,28.930952282978865,5.623413251903491,1353,1,318843,1710,837,0,969,1455
13357,1,0,0,0,47,0,897,1,0,974988,3640875,39.153543900903784,1383,2319,2169,1533,43680,570000,432250,2225,3908,2525,3011,4694,25.219040425836983,12.740029376818088,1683,1,279006,29700,636,0,842,1739
13358,1,0,0,0,48,0,956,1,0,526677,3247617,36.701498607005135,1305,1780,1738,1347,38064,501488,441213,2369,3758,2453,2802,4191,19.77371993328519,6.538739683827756,1389,1,246501,6762,391,0,1064,2020
13359,1,0,0,0,48,0,952,1,0,482388,3180334,36.30426972134269,1288,1714,1684,1318,37467,499491,436753,2383,3731,2443,2779,4127,19.131126469708992,5.623413251903491,1348,1,238558,4860,366,0,1095,2047
13360,1,0,0,0,50,0,1763,0,1,166770,227880,9.486832980505138,219,2252,1943,90,45248,567168,511464,2223,2622,2841,4385,4784,43.04648650006177,17.614369557179575,399,1,18180,49131,1853,0,2442,679
13361,1,0,0,0,49,0,909,0,1,729486,1264545,22.64950330581225,379,2069,1935,513,54720,562020,591600,2331,2978,2599,3887,4534,37.70941526992961,11.64626725886957,647,1,123120,15678,1422,0,1952,1043
13362,0,0,0,0,58,1,1794,1,0,1356291,1678317,23.93741840717165,573,2940,2940,573,55448,679528,700031,2929,3502,2929,5296,5869,48.65182422068057,0.0,573,1,136947,0,2367,0,2356,562
13363,1,0,0,0,48,0,952,1,0,645780,3409380,37.54996671103717,1302,1976,1868,1410,41109,515034,466674,2310,3828,2526,2876,4394,21.400934559032695,10.587221077960752,1518,1,272130,16956,458,0,1008,1960
13364,1,0,0,0,46,0,341,0,1,253422,844740,19.0,151,1273,1063,361,48930,491400,545220,2130,2701,2550,3042,3613,26.49528259898354,14.517920541282885,571,1,84113,22050,702,0,1979,1638
13365,1,0,0,0,48,0,674,1,0,848792,1572004,25.37715508089904,410,2196,1962,644,33400,488200,407647,2207,3085,2675,3759,4637,36.30426972134269,15.66595306375429,878,1,107548,39078,1318,0,1797,1123
13366,1,0,0,0,48,0,907,0,1,612458,1095028,21.236760581595302,391,1869,1809,451,56120,592432,558440,2368,2879,2488,3786,4297,36.851051545376556,7.746504550744806,511,1,103730,8640,1358,0,1977,1070
13367,1,0,0,0,47,0,841,1,0,689010,1219410,22.58317958127243,510,1861,1861,510,43026,509283,482982,2391,2901,2391,3742,4252,36.75595189897821,0.0,510,1,103020,0,1351,0,1881,1040
13368,1,0,0,0,47,0,828,1,0,710325,1255800,22.9128784747792,495,1908,1878,525,41202,521456,452088,2362,2917,2422,3745,4300,36.78314831549904,5.572104574801163,555,1,99225,5040,1353,0,1867,1039
13369,1,0,0,0,49,0,634,1,0,1144967,1961545,28.26658805020514,437,2594,2232,799,40762,562195,436990,2093,3254,2817,3888,5049,37.8549864614954,19.421642878217533,1161,1,142222,69142,1433,0,1656,1022
13370,1,0,0,0,46,0,768,1,0,363769,770899,18.193405398660254,119,1642,1430,331,42816,447168,519367,2117,2660,2541,3428,3971,33.15116890850155,14.576068100328353,543,1,73813,20140,1099,0,1998,1230
13371,1,0,0,0,47,0,52,0,1,663549,1992329,29.0,651,1820,1630,841,55104,530656,582774,2179,3210,2559,3158,4189,28.089143810376278,14.229707211083644,1031,1,206886,19380,789,0,1528,1580
13372,1,0,0,0,45,0,114,0,0,1169640,2620860,33.76388603226827,1140,2166,2166,1140,56069,567853,521873,2299,3439,2299,3325,4465,32.03123475609393,0.0,1140,0,258780,0,1026,0,1159,1273
13373,1,0,0,0,48,0,104,0,0,300897,1460466,24.55605831561735,469,1236,1102,603,48659,477134,598234,2288,3025,2556,2921,3658,22.338307903688676,11.575836902790225,737,1,148941,8844,499,0,1819,1923
13374,1,0,0,0,48,0,863,0,1,603240,1098628,21.37755832643195,457,1777,1777,457,45771,502436,526476,2404,2861,2404,3724,4181,36.3318042491699,0.0,457,1,100083,0,1320,0,1947,1084
13375,1,0,0,0,45,0,223,0,0,1172400,2755200,34.64101615137755,1200,2177,2177,1200,50561,534968,498232,2296,3496,2296,3273,4473,31.25699921617557,0.0,1200,0,260400,0,977,0,1096,1319
13376,1,0,0,0,47,0,785,1,0,976976,3434704,38.157568056677825,1371,2212,2127,1456,42336,594468,396312,2274,3815,2444,3030,4571,25.903667693977237,9.511914438752074,1541,1,244608,18190,671,0,903,1688
13377,1,0,0,0,49,0,621,0,1,292342,2317254,30.56141357987225,764,1417,1247,934,43442,530934,503643,2311,3415,2651,2794,3898,17.69180601295413,13.14546904636285,1104,1,189602,24990,313,0,1547,2168
13378,1,0,0,0,48,0,917,0,1,518240,961430,19.87460691435179,395,1707,1707,395,51302,550084,552518,2434,2829,2434,3746,4141,36.22154055254967,0.0,395,1,89665,0,1312,0,2039,1122
13379,1,0,0,0,48,0,690,1,0,855144,1554282,25.337718918639855,400,2216,1974,642,48954,595566,481779,2179,3063,2663,3753,4637,36.49657518178932,15.71977451973018,884,1,127758,44770,1332,0,1779,1089
13380,1,0,0,0,48,0,657,1,0,931468,1683967,26.28687885618983,396,2334,2039,691,43966,601939,433786,2142,3128,2732,3785,4771,36.71511950137164,17.41239095345354,986,1,122998,60770,1348,0,1746,1089
13381,1,0,0,0,48,0,641,1,0,971612,1750620,26.758176320519304,393,2396,2073,716,42834,591690,432765,2122,3161,2768,3802,4841,36.837480912787726,18.248328731643245,1039,1,126732,65892,1357,0,1729,1088
13382,1,0,0,0,49,0,660,0,1,1134325,1937380,28.0178514522438,276,2739,2230,785,49887,510876,594788,1959,3253,2977,3913,5207,38.01315561749642,22.904248798382877,1294,1,189185,45810,1445,0,1683,1023
13383,0,0,1,0,59,1,1167,0,0,4139100,8094600,51.96152422706632,2296,4637,4233,2700,50976,647568,707528,2594,5698,3402,4531,7635,39.153543900903784,20.12559326445287,3104,1,637200,43632,1533,0,298,1465
13384,1,0,0,0,48,0,916,0,1,460997,879396,19.0,331,1668,1638,361,44099,509124,513996,2406,2797,2466,3713,4104,35.73513677041127,5.483301264452448,391,1,76171,3930,1277,0,2075,1159
13385,1,0,0,0,48,0,797,1,0,593754,1134042,21.656407827707714,361,1843,1735,469,38407,481182,466674,2310,2887,2526,3684,4261,35.58089374931439,10.539713118296461,577,1,90517,15120,1266,0,1949,1152
13386,1,0,0,0,49,0,612,1,0,971388,1783782,26.94438717061496,364,2426,2064,726,37600,577395,393120,2095,3183,2819,3795,4883,36.578682316343766,19.332751162765454,1088,1,116160,77106,1338,0,1731,1119
13387,1,0,0,0,48,0,736,1,0,767076,1400292,24.124676163629637,220,2262,1900,582,41856,461952,524508,2044,2988,2768,3724,4668,36.30426972134269,19.21684550450282,944,1,126876,36924,1318,0,1824,1088
13388,1,0,0,0,47,0,745,1,0,717794,1326094,23.515952032609693,203,2201,1851,553,40734,446028,525162,2048,2951,2748,3696,4599,36.02776706930364,18.882386696959433,903,1,121107,31850,1298,0,1845,1100
13389,1,0,0,0,45,0,922,0,0,164475,351747,12.36931687685298,153,1228,1228,153,46367,457501,535667,2299,2452,2299,3374,3527,32.78719262151,0.0,153,0,35649,0,1075,0,2146,1224
13390,1,0,0,0,47,0,61,0,1,609812,1921192,28.495613697550013,685,1690,1563,812,55029,522886,589134,2239,3178,2493,3117,4056,27.40437921208944,11.86971052873884,939,1,202188,11557,751,0,1554,1615
13391,1,0,0,0,47,0,770,1,0,692664,1275204,23.065125189341593,223,2143,1834,532,44522,472209,541722,2088,2929,2706,3699,4540,36.08323710533743,17.78146024076311,841,1,120232,30282,1302,0,1865,1095
13392,1,0,0,0,49,0,836,0,1,653376,1222620,22.181073012818835,425,1887,1820,492,54502,569065,591430,2418,2977,2552,3813,4372,36.4417343165772,8.2143728690235,559,1,117096,8040,1328,0,1993,1157
13393,1,0,0,0,49,0,878,0,1,517928,997072,20.09975124224178,404,1686,1686,404,52640,552832,579980,2468,2872,2468,3750,4154,35.805027579936315,0.0,404,1,94940,0,1282,0,2064,1186
13394,1,0,0,0,48,0,817,1,0,461184,936960,19.595917942265423,257,1712,1585,384,36672,468480,466040,2313,2824,2567,3641,4152,34.655446902326915,11.403946263829544,511,1,73344,16891,1201,0,2056,1239
13395,1,0,0,0,49,0,584,1,0,894836,1713590,26.419689627245813,307,2371,1980,698,44856,618660,436990,2064,3153,2846,3737,4826,35.805027579936315,19.98764480590276,1089,1,124244,80937,1282,0,1757,1173
13396,1,0,0,0,46,0,956,0,0,197925,403025,13.228756555322953,175,1306,1306,175,50830,508963,529690,2303,2478,2303,3434,3609,33.63034344160047,0.0,175,0,40250,0,1131,0,2128,1172
13397,0,1,1,0,61,0,1206,0,0,1733095,2599220,29.068883707497267,750,2991,2896,845,51260,676720,716708,2981,3921,3171,5127,6067,45.28796749689701,9.764028217990806,940,1,196885,11115,2051,0,2231,1025
13398,0,0,0,0,57,1,1370,0,0,2312999,2822193,31.352830813181765,983,3336,3336,983,54516,677556,663201,2871,3854,2871,5224,6207,48.507731342539614,0.0,983,0,227073,0,2353,0,1888,518
13399,1,0,0,0,46,0,57,0,0,861300,2203971,30.93541659651604,957,1857,1857,957,48300,529690,483630,2303,3260,2303,3203,4160,30.0,0.0,957,0,200970,0,900,0,1346,1403
13400,0,1,1,0,60,0,1224,0,0,1271545,2039169,25.903667693977237,581,2656,2566,671,50976,656424,717204,2949,3710,3129,4934,5695,43.53159771935783,9.488003977624334,761,1,158356,9810,1895,0,2368,1144
13401,0,0,1,0,57,1,1621,0,0,2097030,2457006,29.13760456866693,725,3443,3319,849,53352,659832,677196,2770,3743,3018,5364,6337,49.699094559156705,11.135528725660043,973,1,198666,15500,2470,0,2045,424
13402,1,0,0,0,47,0,499,1,0,1037102,3073664,36.02776706930364,1256,2139,2097,1298,35908,445184,452288,2326,3666,2410,3167,4507,28.26658805020514,6.7597809605921,1340,1,247918,5334,799,0,1070,1569
13403,1,0,0,0,49,0,773,1,0,654330,3204934,35.81898937714463,1073,2003,1793,1283,40592,589528,429656,2288,3781,2708,3008,4501,22.58317958127243,14.846855792793013,1493,1,220676,42840,510,0,1215,1988
13404,1,0,0,0,49,0,888,1,0,292864,627968,16.0,106,1550,1400,256,40586,547019,446446,2303,2709,2603,3597,4003,33.823069050575526,12.296281753706847,406,1,46592,27000,1144,0,2197,1309
13405,1,0,0,0,48,0,803,0,0,819888,1415367,24.269322199023193,347,2223,1981,589,54918,543078,583929,2161,2992,2645,3795,4626,37.30951621235526,15.84624764074158,831,1,143127,26378,1392,0,1814,1011
13406,1,0,0,0,46,0,81,0,0,277672,1320080,23.853720883753127,569,1057,1057,569,44919,480240,503440,2320,2889,2320,2808,3377,22.090722034374522,0.0,569,0,123473,0,488,0,1751,1832
13407,1,0,0,0,46,0,260,1,0,1033725,2700390,33.98529093593286,1095,2110,2050,1155,45549,441882,563458,2278,3493,2398,3233,4448,29.916550603303182,7.9332512824338455,1215,1,278355,3960,895,0,1183,1443
13408,1,0,0,0,47,0,294,0,1,364032,1113900,21.77154105707724,389,1327,1242,474,52875,528750,552250,2265,2824,2435,3118,3677,27.712812921102035,9.231007614073922,559,1,111390,10200,768,0,1876,1582
13409,1,0,0,0,49,0,856,1,0,409716,847134,18.49324200890693,275,1607,1540,342,43430,532555,500354,2410,2819,2544,3675,4084,34.61213659975356,8.18535277187245,409,1,69084,10050,1198,0,2135,1279
13410,1,0,0,0,49,0,666,1,0,533920,1153850,21.6794833886788,170,1906,1606,470,41778,518005,486090,2155,2925,2755,3591,4361,33.704599092705436,17.474752997463312,770,1,93060,45000,1136,0,1985,1319
13411,1,0,0,0,47,0,818,0,0,846768,1434602,24.454038521274967,382,2230,2014,598,54934,544573,580558,2183,2997,2615,3815,4629,37.62977544445356,14.954982936743432,814,1,144716,23976,1416,0,1801,983
13412,1,0,0,0,47,0,876,0,0,609181,1081262,21.37755832643195,307,1940,1790,457,56316,539448,584402,2216,2823,2516,3699,4306,36.51027252705737,12.420125667085228,607,1,112879,15000,1333,0,1909,1033
13413,1,0,0,0,46,0,989,1,0,260280,499824,14.696938456699069,121,1516,1421,216,46368,478998,518336,2219,2530,2409,3519,3830,34.713109915419565,9.746794344808963,311,1,48384,10830,1205,0,2098,1109
13414,1,0,0,0,46,0,63,0,1,340648,1428504,24.819347291981714,616,1169,1169,616,51294,577431,477714,2319,2935,2319,2872,3488,23.515952032609693,0.0,616,1,126896,0,553,0,1703,1766
13415,1,0,0,0,46,0,19,0,0,637512,1861632,28.42534080710379,808,1597,1597,808,54026,548352,523008,2304,3112,2304,3093,3901,28.089143810376278,0.0,808,0,183416,0,789,0,1496,1515
13416,1,0,0,0,47,0,247,1,0,938300,2599300,33.166247903554,980,2073,1953,1100,47499,503319,526949,2243,3463,2483,3216,4436,29.206163733020468,11.305412972083932,1220,1,245300,14640,853,0,1263,1510
13417,1,0,0,0,47,0,620,1,0,966861,3210354,36.61966684720111,1311,2092,2062,1341,41990,591318,406980,2364,3735,2424,3115,4486,26.851443164195103,5.5965095842615735,1371,1,227970,6390,721,0,1053,1673
13418,1,0,0,0,46,0,35,0,0,333200,1378615,24.392621835300936,595,1155,1155,595,54044,546812,530593,2317,2912,2317,2877,3472,23.664319132398465,0.0,595,0,136255,0,560,0,1722,1757
13419,1,0,0,0,47,0,494,1,0,1004015,3060647,35.76310948449533,1249,2094,2064,1279,36270,466635,445098,2363,3672,2423,3178,4487,28.0178514522438,5.652706486041966,1309,1,237894,4260,785,0,1114,1608
13420,0,0,1,0,62,1,228,0,0,429229,1730691,23.473389188611005,209,1672,1330,551,54531,782109,687879,2799,3692,3483,3920,4813,27.910571473905726,18.869041523282117,893,1,120669,55746,779,0,2590,2362
13421,1,0,0,0,46,0,16,0,0,538692,1674156,26.94438717061496,726,1468,1468,726,54522,537298,539604,2306,3032,2306,3048,3774,27.23967694375247,0.0,726,0,169884,0,742,0,1580,1564
13422,0,1,1,0,62,0,203,0,0,7228488,8137227,50.882216932834204,2276,5694,5381,2589,31520,619171,502880,2830,5732,3456,5935,8837,52.839379254491625,17.722246352702786,2902,1,414240,53523,2792,0,554,351
13423,0,0,1,0,57,1,1430,0,0,2793899,3150168,33.21144381083123,953,3786,3636,1103,51984,651168,651168,2706,3959,3006,5389,6642,50.32891812864648,12.247584794411392,1253,1,251484,19950,2533,0,1753,323
13424,1,0,0,0,48,0,360,0,1,1057536,2105568,29.393876913398138,541,2411,2088,864,55671,562947,587317,2114,3301,2760,3661,4848,34.9857113690718,18.248328731643245,1187,1,208224,38114,1224,0,1573,1213
13425,1,0,0,0,46,0,993,0,0,539370,908700,19.748417658131498,390,1773,1773,390,48530,535900,491630,2330,2720,2330,3713,4103,37.1887079635741,0.0,390,0,82290,0,1383,0,1940,947
13426,0,0,1,0,61,1,335,0,0,472500,1656720,23.2379000772445,420,1535,1415,540,48312,748592,607464,2948,3608,3188,3943,4603,29.58039891549808,10.991537949000206,660,0,106920,22200,875,1,2528,2193
13427,0,0,0,0,56,1,1511,0,0,2372160,2718720,30.983866769659336,900,3491,3431,960,52212,645696,648528,2772,3792,2892,5303,6323,49.70915408654627,7.754559014766193,1020,0,219840,7980,2471,0,1872,361
13428,1,0,0,0,46,0,48,1,0,291024,1197636,22.715633383201094,486,1110,1080,516,52080,487410,575608,2291,2837,2351,2885,3431,23.748684174075834,5.514871952411144,546,1,127968,2490,564,0,1805,1757
13429,1,0,0,0,47,0,285,1,0,830700,2529375,32.63433774416144,1023,1887,1845,1065,30456,384750,446500,2333,3440,2417,3155,4262,27.92848008753788,6.991237203771572,1107,1,200220,3990,780,0,1310,1595
13430,1,0,0,0,48,0,634,1,0,987360,3303440,36.87817782917155,1318,2128,2086,1360,41236,592676,410501,2387,3789,2471,3155,4557,26.94438717061496,6.484411467763075,1402,1,229840,8904,726,0,1069,1703
13431,1,0,0,0,47,0,284,0,1,481100,1334628,23.790754506740637,566,1416,1416,566,50175,525834,530550,2358,2924,2358,3208,3774,29.154759474226502,0.0,566,1,127350,0,850,0,1792,1508
13432,1,0,0,0,46,0,992,0,0,662193,1067552,21.37755832643195,457,1906,1906,457,51903,553632,511584,2336,2793,2336,3785,4242,38.06573262134856,0.0,457,1,100083,0,1449,0,1879,887
13433,0,1,1,0,61,0,143,0,0,7681644,8679888,53.32916650389353,2724,5665,5545,2844,39444,695856,527996,2932,5896,3172,5753,8717,51.97114584074513,11.037374824906587,2964,0,492012,23280,2701,1,208,351
13434,0,0,1,0,59,1,1398,0,0,1539175,2139475,26.92582403567252,275,3298,2848,725,56640,708240,696436,2501,3676,3401,5074,6249,46.07602413403309,21.539983850044322,1175,1,171100,57600,2123,0,2226,828
13435,1,0,0,0,46,0,1091,1,0,477710,783900,18.303005217723125,268,1828,1761,335,50525,549900,503100,2273,2675,2407,3766,4168,37.76241517699841,8.20759886765899,402,1,72025,10586,1426,0,2005,914
13436,1,0,0,0,46,0,107,0,0,378444,1306224,23.748684174075834,564,1235,1235,564,55920,555840,539628,2316,2880,2316,2987,3551,25.903667693977237,0.0,564,0,131412,0,671,0,1752,1645
13437,1,0,0,0,46,0,107,1,0,448050,1432524,24.859605789312106,588,1373,1343,618,34992,500688,375516,2288,2936,2348,3043,3691,26.92582403567252,5.483301264452448,648,1,100116,5760,725,0,1700,1593
13438,1,0,0,0,48,0,351,1,0,1037322,2946333,34.77067730142742,1124,2152,2067,1209,34220,575132,353365,2352,3646,2522,3295,4589,29.29163703175362,9.2729914971827,1294,1,175305,19210,858,0,1228,1579
13439,1,0,0,0,49,0,193,0,0,658994,2283172,30.23243291566195,739,1810,1635,914,50904,504596,629496,2323,3412,2673,3219,4308,26.851443164195103,13.31865546831378,1089,1,230328,11375,721,0,1584,1777
13440,0,0,1,0,60,1,2278,0,0,2166000,9027000,54.772255750516614,2661,4061,3722,3000,48306,749241,583746,2670,6009,3348,3731,7070,26.870057685088806,18.436935183464257,3339,1,582000,65427,722,0,9,2287
13441,1,0,0,0,46,0,136,0,0,314601,1150058,22.293496809607955,467,1160,1130,497,46440,499824,497510,2284,2811,2344,2947,3474,25.15949125081825,5.477225575051661,527,0,106855,4110,633,0,1817,1681
13442,1,0,0,0,49,0,605,1,0,1056606,3399276,37.067505985701274,1254,2263,2143,1374,30962,559124,338938,2354,3848,2594,3243,4737,27.730849247724095,11.35235258913941,1494,1,188238,26880,769,0,1100,1705
13443,0,1,0,1,66,0,1030,0,0,5461224,6225570,43.3358973600409,1716,4948,4786,1878,52250,692835,828750,3153,5193,3477,6223,8263,53.925875050851054,12.857952745342404,2040,1,469500,12636,2908,0,1437,407
13444,0,1,1,0,63,0,1233,0,0,3742858,4471068,37.603191353926334,1414,4061,4061,1414,54900,711450,771528,3162,4576,3162,5809,7223,51.44900387762624,0.0,1414,1,345016,0,2647,0,1748,515
13445,0,0,1,0,58,1,1383,0,0,1842880,2436096,28.844410203711913,472,3407,3047,832,51408,737856,597312,2568,3760,3288,5143,6335,47.06378650300037,19.263424054554513,1192,1,169728,65880,2215,0,2096,713
13446,1,0,0,0,46,0,80,1,0,396561,1383531,24.310491562286437,524,1329,1262,591,23280,454154,280920,2274,2932,2408,3012,3670,25.903667693977237,8.456490803821907,658,1,70920,13735,671,0,1750,1670
13447,1,0,0,0,48,0,180,1,0,477709,1895883,28.053520278211074,575,1606,1394,787,39277,522753,436029,2197,3196,2621,3016,4015,24.63736998950984,15.310171951475196,999,1,142447,36888,607,0,1622,1802
13448,1,0,0,0,48,0,280,1,0,582576,2225880,30.265491900843113,724,1744,1552,916,34354,468990,432540,2238,3346,2622,3066,4174,25.219040425836983,14.422205101855956,1108,1,163048,28416,636,0,1514,1794
13449,1,0,0,0,48,0,317,1,0,907068,2704344,33.52610922848042,1082,1973,1931,1124,28470,526914,312780,2364,3530,2448,3213,4379,28.407745422683583,6.852548980306203,1166,1,146120,9366,807,0,1282,1599
13450,1,0,0,0,50,0,461,0,1,371322,1057131,20.518284528683193,120,1844,1303,421,50394,569997,557442,1970,2932,3052,3393,4355,29.698484809834994,23.398342244891513,962,1,93462,75740,882,0,2090,1629
13451,0,0,1,0,60,1,518,0,0,657120,3354420,33.31666249791537,768,2044,1702,1110,48777,692038,643686,2680,4132,3364,3614,5066,24.331050121192877,18.49324200890693,1452,1,236430,52326,592,0,1912,2430
13452,0,0,1,0,60,1,2251,0,0,2557230,9304620,55.50675634551167,2750,4242,3911,3081,49440,724800,622120,2689,6101,3351,3850,7262,28.809720581775867,18.208373589048605,3412,1,634686,57263,830,0,61,2190
13453,0,0,1,0,61,1,82,0,0,285615,1522125,22.24859546128699,410,1157,1072,495,51600,661125,738000,2990,3570,3160,3652,4232,24.020824298928627,9.321211371972165,580,1,118800,8670,577,0,2580,2498
13454,0,0,1,0,61,1,387,0,0,760900,2165100,26.457513110645905,365,2122,1787,700,54216,776343,668088,2758,3793,3428,4180,5215,32.96968304366907,18.364708247999342,1035,1,151200,55945,1087,0,2393,2006
13455,0,0,1,0,58,1,1322,0,0,1771275,2406525,28.722813232690143,495,3302,2972,825,56619,708831,679661,2587,3742,3247,5064,6219,46.33573135281238,18.420758090526704,1155,1,192225,43890,2147,0,2092,770
13456,0,0,0,0,53,1,768,1,0,49680,161760,7.745966692414834,0,948,888,60,53820,630864,620080,2636,2756,2756,3524,3644,28.77498913987632,7.746504550744806,120,1,13800,8280,828,0,2636,1868
13457,1,0,0,0,46,0,196,1,0,313020,1097450,21.6794833886788,440,1166,1136,470,31622,380605,452990,2305,2805,2365,3001,3501,25.80697580112788,5.684275577662207,500,1,91180,2700,666,0,1865,1669
13458,1,0,0,0,48,0,35,0,0,707816,2008088,28.705400188814647,794,1713,1683,824,42770,443534,572695,2407,3261,2467,3296,4150,29.30870177950569,5.514871952411144,854,1,193640,1920,859,0,1613,1578
13459,1,0,0,0,48,0,112,0,0,685764,1869984,27.820855486487112,774,1660,1660,774,42488,454208,546016,2416,3190,2416,3302,4076,29.765752132274432,0.0,774,1,174924,0,886,0,1642,1530
13460,1,0,0,0,47,0,144,1,0,595441,1678061,26.514147167125703,661,1592,1550,703,45248,482174,534688,2345,3090,2429,3234,3979,29.103264421710495,6.488991180673202,745,1,157472,4452,847,0,1684,1540
13461,0,0,1,0,58,1,1369,0,0,2038932,2621484,29.9833287011299,599,3467,3167,899,54216,731916,629856,2616,3815,3216,5184,6383,47.62352359916263,17.60608396191918,1199,1,194184,48600,2268,0,2017,648
13462,0,0,1,0,58,1,1383,0,0,2093040,2660304,30.199337741083,611,3508,3207,912,55000,729250,641740,2616,3829,3218,5212,6425,47.90615826801394,17.640705001746127,1213,1,200640,47558,2295,0,2005,622
13463,1,0,0,0,47,0,236,1,0,256476,956358,20.049937655763422,317,1125,1040,402,28812,349713,466284,2294,2781,2464,3017,3504,25.25866188063018,10.089053347107663,487,1,78792,5355,638,0,1977,1741
13464,1,0,0,0,48,0,319,1,0,789066,2549862,32.58834147360065,1062,1805,1805,1062,46632,557032,482601,2401,3463,2401,3144,4206,27.258026340878022,0.0,1062,1,213462,0,743,0,1339,1658
13465,1,0,0,0,48,0,83,0,0,733584,1984512,28.5657137141714,816,1715,1715,816,43052,457216,556928,2432,3248,2432,3331,4147,29.9833287011299,0.0,816,1,186864,0,899,0,1616,1533
13466,0,0,0,0,54,1,681,0,0,21330,81480,5.477225575051661,305,1076,741,30,49268,613816,592088,2381,2746,3051,3427,3792,26.664583251946766,18.314777256180623,365,0,6540,48240,711,0,2686,2005
13467,0,0,0,0,54,1,690,0,0,50719,181704,8.18535277187245,180,1071,824,67,48825,610200,588504,2465,2779,2959,3469,3783,27.51363298439521,15.727106176144607,314,0,14539,35815,757,0,2645,1955
13468,0,0,0,0,54,1,684,1,0,102997,343789,11.269427669584644,35,1100,938,127,49283,603661,598247,2545,2834,2869,3518,3807,28.478061731796284,12.735674720387733,289,1,28067,22194,811,0,2580,1896
13469,0,0,0,0,54,1,726,1,0,105400,334800,11.135528725660043,16,1082,974,124,49725,596700,607500,2592,2824,2808,3550,3782,29.154759474226502,10.403202108104866,232,1,27900,14040,850,0,2576,1850
13470,1,0,0,0,47,0,32,1,0,331520,1324400,23.664319132398465,530,1182,1152,560,38445,551045,390225,2335,2925,2395,2957,3547,24.331050121192877,5.531194905403055,590,1,92400,6210,592,0,1805,1773
13471,0,1,1,0,61,0,610,0,0,7730184,9492120,55.695601262577284,3072,5624,5594,3102,42075,688500,572220,3030,6162,3090,5552,8684,49.91993589739474,5.490867587491313,3132,0,580074,5340,2492,1,42,568
13472,0,0,1,0,57,1,1295,0,0,2037800,2659720,30.331501776206203,680,3375,3135,920,55552,716968,647584,2651,3811,3131,5106,6266,47.06378650300037,15.67744954089078,1160,1,206080,36480,2215,0,1971,676
13473,0,0,0,0,54,1,696,0,0,30996,114240,6.48074069840786,300,1122,780,42,47925,612000,579360,2378,2762,3062,3458,3842,27.16615541441225,18.510649104167545,384,0,8946,50958,738,0,2678,1982
13474,0,0,0,0,53,1,762,1,0,136800,404400,12.24744871391589,65,1147,1062,150,49283,595816,601208,2611,2846,2781,3608,3843,30.199337741083,9.235136611923052,235,1,33450,11305,912,0,2546,1784
13475,0,0,0,0,61,1,223,1,0,836730,2472120,28.460498941515414,630,2023,1843,810,51308,775208,616504,2872,3862,3232,4085,5075,32.14031735997639,13.502634751615815,990,1,163620,31860,1033,0,2242,2019
13476,0,0,0,0,54,1,691,1,0,126150,407400,12.24744871391589,66,1207,991,150,50398,613816,605668,2500,2866,2932,3557,3923,29.0,14.731545485687572,366,1,33450,29808,841,0,2566,1875
13477,0,0,0,0,54,1,688,1,0,145860,461210,13.038404810405298,22,1220,1028,170,51076,613138,613138,2521,2883,2905,3571,3933,29.29163703175362,13.893842384028202,362,1,38420,25728,858,0,2543,1855
13478,0,0,0,0,54,1,713,1,0,162890,492674,13.490737563232042,32,1227,1077,182,50850,609075,611782,2557,2889,2857,3602,3934,29.916550603303182,12.282138241571156,332,1,41132,19950,895,0,2525,1812
13479,0,0,0,0,54,1,754,1,0,168120,486000,13.416407864998739,72,1222,1114,180,50398,602100,610200,2592,2880,2808,3634,3922,30.56141357987225,10.419152549993726,288,1,40680,14256,934,0,2520,1766
13480,1,0,0,0,47,0,4,1,0,290517,1276449,23.173260452512935,537,1078,1078,537,43665,487285,506301,2377,2914,2377,2918,3455,23.259406699226016,0.0,537,1,114381,0,541,0,1840,1836
13481,1,0,0,0,49,0,7,1,0,893958,2341812,30.692018506445613,912,1921,1891,942,39960,459910,536976,2456,3428,2516,3435,4407,30.805843601498726,5.5965095842615735,972,1,203472,2850,949,0,1544,1537
13482,0,0,0,0,54,1,662,0,0,43320,164640,7.745966692414834,451,1293,782,60,47742,598192,600936,2233,2804,3255,3466,4037,26.870057685088806,22.62225780818879,571,0,13140,68474,722,0,2684,2022
13483,0,0,0,0,54,1,706,1,0,194616,574096,14.560219778561036,42,1300,1130,212,51984,617424,617424,2538,2920,2878,3626,4008,30.298514815086232,13.078932278133562,382,1,48336,22780,918,0,2496,1790
13484,1,0,0,0,49,0,286,1,0,326472,1826340,27.055498516937366,431,1479,1178,732,39798,494010,501495,2194,3227,2796,2941,3974,21.118712081942874,17.560372002467933,1033,1,147132,39130,446,0,1763,2049
13485,0,1,0,1,65,0,463,0,0,7061964,9433346,53.842362503887216,2749,5485,5335,2899,23780,667070,377464,3104,6153,3404,5690,8739,49.35585071701227,12.36812780528175,3049,1,336284,33000,2436,0,355,818
13486,0,0,0,0,54,1,691,1,0,195912,586224,14.696938456699069,18,1357,1123,216,51300,618792,610650,2480,2930,2948,3621,4071,30.116440692751194,15.333871817609987,450,1,48600,32292,907,0,2498,1807
13487,1,0,0,0,49,0,324,1,0,836797,2710044,33.03028912982749,1024,1925,1858,1091,42074,541512,479412,2417,3575,2551,3251,4409,27.694764848252458,8.397588990243326,1158,1,210563,10921,767,0,1393,1717
13488,1,0,0,0,48,0,315,1,0,192816,745617,17.578395831246947,97,1145,933,309,40250,603250,388493,2201,2722,2625,3037,3558,24.979991993593593,14.790851390782576,521,1,49749,46428,624,0,2104,1789
13489,1,0,0,0,50,0,310,1,0,321719,1865673,27.258026340878022,533,1386,1176,743,47424,522288,572508,2301,3254,2721,2944,3897,20.808652046684813,15.026890566248307,953,1,169404,23100,433,0,1768,2078
13490,1,0,0,0,49,0,217,1,0,184920,1359576,23.49468024894146,351,1088,887,552,40424,610824,401469,2262,3015,2664,2798,3551,18.303005217723125,14.37539151437394,753,1,89976,44019,335,0,1911,2128
13491,1,0,0,0,50,0,272,1,0,203345,1523570,24.63736998950984,307,1242,942,607,42385,614950,434230,2210,3117,2810,2845,3752,18.303005217723125,17.73928915010946,907,1,105011,62700,335,0,1903,2175
13492,0,0,1,0,60,1,1969,0,0,2742162,8817419,53.95368384086484,2803,3961,3853,2911,45756,745134,563394,2921,5940,3137,3971,6990,30.692018506445613,10.551011889467135,3019,1,541446,21492,942,0,118,2087
13493,0,0,0,0,55,1,668,1,0,184380,584430,14.491376746189438,327,1625,1088,210,49729,620609,620609,2246,2993,3320,3661,4408,29.631064780058107,23.22134651200843,747,1,46830,71958,878,0,2573,1905
13494,0,0,0,0,55,1,665,1,0,183750,580650,14.491376746189438,434,1729,1085,210,43665,588945,566825,2121,2975,3409,3640,4494,29.58039891549808,25.44352871750395,854,1,43050,92736,875,0,2555,1890
13495,1,0,0,0,48,0,113,1,0,171114,881562,19.0,241,955,835,361,47304,527472,534798,2322,2803,2562,2916,3397,21.77154105707724,11.436007248781129,481,1,79059,15720,474,0,2081,1968
13496,1,0,0,0,48,0,4,1,0,164832,985728,20.199009876724155,378,842,812,408,45825,471120,567760,2386,2824,2446,2820,3258,20.09975124224178,5.753771868478424,438,1,95880,2520,404,0,2008,2012
13497,1,0,0,0,50,0,35,0,1,1076100,2562240,31.937438845342623,953,2142,2075,1020,46930,620464,477280,2445,3532,2579,3567,4654,32.48076353782343,8.19672545160342,1087,1,193800,13065,1055,0,1492,1457
13498,1,0,0,0,51,0,175,0,1,918750,2233000,29.58039891549808,657,2143,1925,875,42768,505296,551232,2334,3427,2770,3602,4695,32.4037034920393,15.183565749303918,1093,1,189000,24416,1050,0,1677,1502
13499,0,0,0,0,55,1,672,1,0,218880,669360,15.491933384829668,311,1703,1152,240,50850,627525,630314,2238,3029,3340,3701,4492,30.199337741083,23.531642639050833,791,1,54240,73283,912,0,2549,1877
13500,1,0,0,0,48,0,29,1,0,416460,1531437,25.11971337416094,397,1525,1291,631,40020,422298,558210,2193,3058,2661,3087,3952,25.69046515733026,15.575439369641607,865,1,145130,13806,660,0,1796,1767
13501,0,1,1,0,61,0,1323,0,0,8285580,11108895,60.124870062229654,3585,5937,5907,3615,53815,703717,722155,3043,6688,3103,5365,9010,47.8748368143433,5.478746393072713,3645,0,849525,3750,2292,1,542,781
13502,0,1,1,0,60,0,973,0,0,881624,1740979,23.895606290697042,40,2646,2115,571,42872,561016,710417,2518,3620,3580,4593,5695,39.293765408777,23.07445074374598,1102,1,133043,37170,1544,0,2478,1505
13503,0,0,1,0,56,1,1062,0,0,2530368,3258078,33.85262175962151,1116,3384,3354,1146,56619,690849,662419,2813,3989,2873,5051,6227,46.98936049788292,5.478746393072713,1176,0,267018,4080,2208,0,1697,635
13504,1,0,0,0,48,0,266,1,0,135192,627198,16.06237840420901,46,994,782,258,34692,573716,357357,2219,2689,2643,2955,3425,22.891046284519195,14.735922616710878,470,1,37926,47700,524,0,2173,1907
13505,0,1,1,0,61,0,968,0,0,882993,1749942,23.93741840717165,21,2666,2114,573,41678,555828,699366,2502,3627,3606,4595,5720,39.25557285278104,23.531911237731663,1125,1,131217,40296,1541,0,2481,1513
13506,0,0,0,0,56,1,1309,0,1,3450560,3718820,36.26292872893749,1255,3999,3939,1315,47498,718312,528836,2768,4143,2888,5452,6827,51.22499389946279,7.849311256600636,1375,1,245905,11520,2624,0,1513,204
13507,0,0,0,0,56,1,1334,0,1,3591192,3815306,36.6333181680284,1234,4126,4018,1342,49140,716436,554385,2735,4185,2951,5519,6969,51.73006862551025,10.640744280253392,1450,1,261690,19116,2676,0,1501,167
13508,0,0,0,0,57,1,2108,1,0,2715020,2577916,30.033314835362415,684,4130,3912,902,56876,688778,674488,2640,3760,3076,5868,6988,54.86346689738081,15.194338669790927,1120,1,212872,28340,3010,0,1956,152
13509,1,0,0,0,48,0,368,1,0,114369,482601,14.177446878757825,9,980,770,201,34602,569037,350546,2191,2602,2611,2970,3381,23.853720883753127,14.89966442575134,411,1,29346,47670,569,0,2200,1832
13510,0,0,1,0,61,1,1829,0,0,4423832,9890264,56.639209034025185,2878,4917,4587,3208,50310,721422,662845,2753,6291,3413,4462,8000,37.134889255254286,18.194028081620004,3538,1,689720,51480,1379,0,125,1704
13511,0,0,0,0,57,1,1647,0,1,3416400,3439200,34.64101615137755,1038,4209,4047,1200,54064,710768,624788,2704,4066,3028,5713,7075,53.3572862878164,13.269603124809358,1362,1,261600,24300,2847,0,1666,19
13512,0,0,0,0,57,1,2099,0,1,2936640,2740800,30.983866769659336,780,4199,4019,960,56133,693765,659505,2675,3815,3035,5914,7054,55.308227236099334,13.923574722636502,1140,1,221760,24120,3059,0,1895,204
13513,0,0,0,0,55,1,2207,1,0,927048,1001053,19.0,301,2989,2929,361,56628,648882,671066,2713,3134,2833,5341,5762,50.67543783727971,7.9730082341141015,421,1,87362,6840,2568,0,2412,205
13514,0,0,0,0,54,1,712,1,0,516468,1212674,21.118712081942874,70,1980,1604,446,51504,603618,630808,2343,3165,3095,3877,4699,34.02939905434711,19.437491937702344,822,1,103472,45872,1158,0,2273,1561
13515,1,0,0,0,49,0,113,0,1,108030,679758,16.64331697709324,153,791,667,277,45426,493254,554604,2330,2731,2578,2844,3245,19.748417658131498,11.500318471195635,401,1,62602,12772,390,0,2177,2064
13516,0,1,0,1,68,0,808,0,0,6416009,10139135,54.48853090330111,2939,5160,5130,2969,25752,758130,396140,3385,6384,3445,5576,8575,46.486557196677836,6.099356562415133,2999,1,344404,7110,2161,0,446,1254
13517,1,0,0,0,47,0,785,0,1,78750,212400,9.486832980505138,5,1050,965,90,48500,457840,590000,2275,2450,2445,3235,3410,29.58039891549808,9.344583777936014,175,1,22500,4760,875,0,2270,1485
13518,0,0,1,0,58,1,661,0,0,2516790,3759060,35.91656999213594,1166,3365,3241,1290,38190,553660,585714,2790,4204,3038,4865,6279,44.170125650715555,11.470617839819623,1414,1,259290,14756,1951,0,1624,963
13519,0,0,0,0,56,1,2195,0,1,2914364,2628240,30.528675044947494,837,4154,4059,932,54858,693720,628860,2725,3752,2915,5947,6974,55.91958512006326,10.152715924344653,1027,1,207836,13585,3127,0,1888,307
13520,0,0,0,1,65,1,474,0,0,759240,2195136,25.80697580112788,135,2337,1806,666,51012,718528,771264,2765,3962,3827,4436,5633,33.76388603226827,23.282438681198837,1197,1,155844,61065,1140,0,2630,2156
13521,1,0,0,0,48,0,271,1,0,63150,365400,12.24744871391589,84,805,571,150,42588,613872,411684,2202,2586,2670,2857,3241,20.518284528683193,15.333871817609987,384,1,25350,49842,421,0,2286,2015
13522,1,0,0,0,49,0,149,0,1,60242,448994,13.490737563232042,20,675,513,182,50049,614283,495867,2305,2649,2629,2798,3142,18.193405398660254,13.020774002346478,344,1,36582,30132,331,0,2285,2136
13523,0,0,1,0,60,1,863,0,0,2401080,6124080,45.16635916254486,1828,3429,3217,2040,50112,696464,648432,2790,5042,3214,4179,6431,34.307433596816885,14.583569918441016,2252,1,440640,32648,1177,0,962,1825
13524,0,0,0,1,65,1,230,0,0,700800,2375420,27.018512172212592,339,2081,1690,730,51120,693102,780960,2863,3984,3645,4214,5335,30.983866769659336,20.01404769274308,1121,1,175200,39100,960,0,2524,2294
13525,0,0,0,0,59,1,1067,1,0,833684,1550516,22.891046284519195,184,2823,2115,524,55056,733832,656898,2251,3483,3667,4550,5782,39.88734135035826,27.413691450967644,1232,1,116328,112572,1591,0,2435,1368
13526,0,0,0,0,59,1,1033,1,0,843090,1589520,23.173260452512935,189,2833,2107,537,54808,734080,654160,2234,3497,3686,4530,5793,39.6232255123179,27.75150608593105,1263,1,118677,116160,1570,0,2423,1390
13527,0,0,0,0,59,1,1028,0,1,897888,1664928,23.748684174075834,139,2859,2156,564,55000,738000,649440,2249,3516,3655,4544,5811,39.89987468652001,27.30314271218914,1267,1,124080,111074,1592,0,2388,1360
13528,0,1,1,0,63,0,1579,0,0,6887030,11186570,59.413803110051795,3318,5693,5481,3530,37018,706687,526054,2957,6699,3381,5120,8862,44.170125650715555,14.56540043043163,3742,1,585980,41552,1951,0,361,1218
13529,0,0,0,1,64,1,26,0,0,687072,2627520,28.5657137141714,539,1935,1658,816,50578,672980,779240,2943,4036,3497,4062,5155,29.017236257093817,16.84152879264993,1093,1,197472,24930,842,0,2404,2378
13530,0,0,0,0,57,1,793,1,0,790490,1671569,24.020824298928627,82,2442,1947,577,53261,640237,698177,2402,3474,3392,4267,5339,37.013511046643494,22.343890365257895,1072,1,139057,52965,1370,0,2320,1527
13531,0,0,0,0,54,1,601,1,0,548900,1357779,22.338307903688676,49,2049,1599,499,44660,552363,598620,2271,3220,3171,3821,4770,33.166247903554,21.303785983550323,949,1,109780,50850,1100,0,2222,1621
13532,1,0,0,0,48,0,442,1,0,20328,101178,6.48074069840786,243,811,526,42,36852,534798,399894,2124,2451,2694,2893,3220,22.0,17.197282142295823,327,1,6972,55290,484,0,2367,1925
13533,0,1,1,0,63,0,897,0,0,1471990,2698930,29.068883707497267,360,3072,2587,845,33975,482294,718650,2709,4039,3679,4936,6266,41.737273509418415,22.17470176828994,1330,1,190125,0,1742,0,2349,1452
13534,0,0,1,0,59,1,703,0,0,5438970,5966811,44.799553569204235,1977,4747,4717,2007,48832,665952,648114,2943,4980,3003,5683,7720,52.05766033928148,5.477225575051661,2037,0,437526,4260,2710,1,966,263
13535,0,0,0,0,58,1,889,0,1,1046760,1967372,25.903667693977237,55,2847,2231,671,56105,718340,671428,2316,3603,3548,4492,5779,39.496835316262995,24.981274972904437,1287,1,153659,86856,1560,0,2261,1372
13536,0,0,0,0,58,1,857,0,1,1056270,2007050,26.1725046566048,90,2822,2227,685,56364,714920,676830,2335,3615,3525,4472,5752,39.26830783214372,24.55639597986418,1280,1,158235,82110,1542,0,2245,1388
13537,1,0,0,0,48,0,675,0,1,533314,1135744,21.61018278497431,347,1729,1609,467,52000,608000,505856,2312,2899,2552,3574,4161,33.793490497431605,11.82974410020298,587,1,97136,19440,1142,0,1965,1290
13538,0,0,0,0,58,1,1184,0,1,1016097,1680801,24.020824298928627,36,2879,2338,577,52118,736989,600078,2372,3490,3454,4674,5792,41.96427051671457,24.060193451463537,1118,1,118862,92511,1761,0,2336,1152
13539,0,0,0,0,58,1,1081,0,1,1049982,1803324,24.859605789312106,23,2912,2317,618,54587,720746,644878,2323,3536,3513,4617,5830,41.2189276910499,25.145854614094812,1213,1,136578,87465,1699,0,2300,1219
13540,0,0,0,0,58,1,917,0,1,1097370,2001570,26.1725046566048,69,2903,2287,685,55304,724656,651606,2306,3607,3538,4524,5825,40.024992192379,24.950750661190106,1301,1,152755,91784,1602,0,2237,1320
13541,1,0,0,0,46,0,636,1,0,94240,290656,11.135528725660043,94,914,884,124,47970,576624,457080,2314,2468,2374,3104,3258,27.568097504180443,5.478746393072713,154,1,24180,5700,760,0,2220,1584
13542,0,1,1,0,63,0,911,0,0,3362730,4542912,37.86819245752297,1344,3869,3779,1434,45732,703296,652608,3078,4602,3258,5513,7037,48.425200051213004,9.552038418812673,1524,1,295404,13770,2345,0,1734,823
13543,0,0,0,0,58,1,808,1,0,1020528,1991124,26.153393661244042,241,2619,2176,684,55671,701551,672441,2468,3595,3354,4403,5530,38.62641583165593,21.212941539346005,1127,1,158004,62906,1492,0,2227,1419
13544,1,0,0,0,48,0,656,0,1,630297,1279179,23.043437243605826,464,1785,1718,531,49848,597432,484209,2342,2940,2476,3596,4194,34.45286635390443,9.015051363864515,598,1,106731,10921,1187,0,1878,1222
13545,0,0,0,1,64,1,0,0,0,842724,2973402,30.298514815086232,706,2048,1836,918,52080,680190,803272,3027,4157,3451,4157,5287,30.298514815086232,14.774444774483948,1130,1,227664,17172,918,0,2321,2321
13546,0,0,1,0,61,1,939,0,0,588670,4241162,37.0,1168,2000,1799,1369,42174,659874,613404,2897,4467,3299,3528,5098,20.73644135332772,14.1782363787959,1570,1,271062,30753,430,0,1729,2668
13547,0,0,0,0,58,1,805,1,0,1082334,2072691,26.70205984563738,296,2648,2231,713,54412,709308,648261,2490,3620,3324,4425,5555,38.961519477556315,20.58375391141587,1130,1,158999,65052,1518,0,2194,1389
13548,0,0,0,0,56,1,663,1,0,873180,1875060,25.69046515733026,56,2699,1983,660,53580,667635,647748,2125,3501,3557,4164,5540,36.373066958946424,26.76111181675494,1376,1,150480,100956,1323,0,2181,1518
13549,1,0,0,0,47,0,642,0,1,633123,1283430,23.173260452512935,447,1806,1716,537,51700,561650,525800,2300,2927,2480,3569,4196,34.336569426778794,9.756499634156611,627,1,118140,10890,1179,0,1853,1211
13550,0,1,0,1,70,0,1003,0,0,5559008,10261888,53.96295025292817,2612,5121,4821,2912,50718,835188,754136,3224,6436,3824,5433,8645,43.69210454990696,17.87542744029941,3212,1,623168,48300,1909,0,612,1615
13551,0,0,1,0,60,1,1208,0,0,3348513,7699302,50.309044912421065,2246,4139,3854,2531,35139,672282,483678,2757,5573,3327,4365,7181,36.373066958946424,17.078228970268245,2816,1,402429,57000,1323,0,511,1719
13552,0,0,0,0,57,1,1236,0,1,1178077,1806553,25.11971337416094,198,2931,2498,631,48829,724339,552559,2430,3494,3296,4730,5794,43.2087954009366,21.48524239990887,1064,1,121783,78373,1867,0,2232,996
13553,0,0,0,0,57,1,1168,0,1,1201508,1890434,25.65151067676132,189,2953,2484,658,52000,718250,597584,2404,3531,3342,4699,5826,42.731721238442994,22.327557166754858,1127,1,136864,75509,1826,0,2215,1047
13554,1,0,0,0,47,0,831,0,1,606166,1105856,21.61018278497431,437,1795,1765,467,56350,544640,580160,2338,2835,2398,3666,4163,36.02776706930364,5.572104574801163,497,1,114415,3090,1298,0,1901,1070
13555,1,0,0,0,47,0,530,1,0,146931,476571,14.177446878757825,106,1027,932,201,40527,561927,405441,2276,2572,2466,3102,3398,27.03701166919155,10.06192246325636,296,1,34371,19475,731,0,2170,1640
13556,0,0,0,0,56,1,1193,0,1,1319918,1983716,26.419689627245813,294,2993,2589,698,51612,719026,579768,2438,3540,3246,4733,5835,43.485629810317796,20.685704058977965,1102,1,142392,69892,1891,0,2144,951
13557,0,0,0,0,57,1,904,0,1,1411137,2343978,28.61817604250837,294,3067,2542,819,51359,724086,580986,2337,3681,3387,4585,5929,41.50903516103452,22.931560005563142,1344,1,166257,90825,1723,0,2043,1139
13558,0,0,0,0,57,1,821,0,1,1385252,2411024,28.91366458960192,410,2919,2493,836,49500,721000,571032,2458,3720,3310,4541,5803,40.70626487409524,20.71622489944482,1262,1,165528,80088,1657,0,2048,1227
13559,0,1,0,1,69,0,868,0,0,5124669,9559110,52.3354564325181,2205,5144,4610,2739,47328,711960,809680,2956,6229,4024,5361,8634,43.255057507764334,23.17171337242411,3273,1,635448,52866,1871,0,751,1619
13560,0,0,0,1,66,1,216,0,0,1198336,3296416,31.496031496047245,673,2519,2200,992,53100,747675,784228,3004,4315,3642,4531,5842,34.75629439396553,18.026902931800603,1311,1,234112,38280,1208,0,2331,2115
13561,0,0,0,0,56,1,963,0,1,1459458,2325960,28.61817604250837,322,3098,2601,819,51865,718520,582200,2343,3659,3337,4622,5938,42.21374183841087,22.747325510309057,1316,1,167895,85484,1782,0,2021,1058
13562,0,0,0,0,57,1,677,1,0,1181600,2310400,28.284271247461902,481,2596,2277,800,48600,649800,623808,2569,3688,3207,4365,5484,38.43175770115127,17.99661255554811,1119,1,172800,46255,1477,0,2088,1411
13563,1,0,0,0,47,0,611,0,1,357582,862296,19.131126469708992,336,1373,1343,366,55822,581932,532456,2326,2722,2386,3333,3729,31.25699921617557,5.478746393072713,396,1,82716,4320,977,0,1990,1379
13564,0,1,0,1,65,0,489,0,0,4247920,5959905,42.790185790669334,1651,4331,4151,1831,48111,660765,771435,3075,5086,3435,5575,7586,48.16637831516918,13.57906068717044,2011,1,433947,16200,2320,0,1424,935
13565,0,0,1,0,57,1,1330,0,0,4284051,4341393,38.84584919911006,1167,4690,4348,1509,46782,595539,650202,2535,4386,3219,5716,7567,53.28226721902888,18.798689279054418,1851,1,341034,37962,2839,0,1368,38
13566,0,0,0,0,57,1,676,1,0,1236000,2379712,28.705400188814647,505,2643,2324,824,50175,649800,644024,2569,3712,3207,4388,5531,38.72983346207417,17.99661255554811,1143,1,183752,43703,1500,0,2064,1388
13567,1,0,0,0,47,0,817,0,0,734678,1278924,23.259406699226016,541,1899,1899,541,49416,548448,503532,2364,2905,2364,3722,4263,36.851051545376556,0.0,541,0,115233,0,1358,0,1823,1006
13568,0,0,0,1,66,1,172,0,0,1287648,3487380,32.43454948045371,775,2553,2276,1052,55144,749190,808860,3038,4367,3592,4539,5868,34.9857113690718,16.799239788186497,1329,1,256688,29639,1224,0,2263,2091
13569,0,0,0,0,54,1,1985,0,0,1206824,1332240,22.090722034374522,488,2961,2961,488,52668,622440,630630,2730,3218,2730,5203,5691,49.72926703662542,0.0,488,0,112728,0,2473,0,2242,257
13570,0,0,0,0,56,1,959,0,1,1596632,2461656,29.5296461204668,429,3146,2703,872,49588,714219,553308,2380,3695,3266,4654,5969,42.790185790669334,21.473738823360563,1315,1,170912,84170,1831,0,1951,992
13571,0,0,0,0,57,1,675,1,0,1293876,2451912,29.13760456866693,530,2692,2373,849,49283,638248,644024,2569,3737,3207,4412,5580,39.03844259188627,18.026902931800603,1168,1,189327,42108,1524,0,2039,1364
13572,1,0,0,0,47,0,552,0,0,367380,918840,19.748417658131498,360,1362,1332,390,40950,494760,459420,2326,2746,2386,3298,3718,30.692018506445613,5.623413251903491,420,0,76050,4530,942,0,1966,1414
13573,0,0,0,0,54,1,1917,0,0,1249534,1403220,22.67156809750927,484,2975,2945,514,48614,608790,595140,2700,3244,2760,5161,5705,49.3051721424842,5.477225575051661,544,0,112052,4200,2431,0,2216,299
13574,0,0,0,0,56,1,987,0,1,1659478,2490546,29.765752132274432,484,3161,2759,886,50094,711183,556578,2409,3697,3213,4684,5972,43.278170016764804,20.45487034517113,1288,1,175428,75978,1873,0,1925,938
13575,1,0,0,0,47,0,774,0,1,654840,1218390,22.58317958127243,480,1824,1794,510,54587,527969,590083,2359,2899,2419,3673,4213,35.832945734337834,5.514871952411144,540,1,125970,2490,1284,0,1879,1105
13576,1,0,0,0,49,0,481,0,1,15330,74880,5.477225575051661,162,733,541,30,42822,584064,456768,2304,2526,2688,3007,3229,22.60530911091463,13.93476779920133,222,1,5490,36672,511,0,2466,1985
13577,0,0,1,0,60,1,500,0,0,2002469,5118358,41.0731055558257,1507,3054,2874,1687,46398,634106,673548,2854,4721,3214,4221,6088,34.45286635390443,13.418995158121604,1867,1,374514,21240,1187,0,1347,1847
13578,0,0,0,0,57,1,814,0,1,1777587,2829729,31.416556144810016,608,3167,2788,987,39360,688080,470188,2488,3854,3246,4668,6034,42.43819034784589,19.509296860822754,1366,1,161868,81106,1801,0,1880,1066
13579,0,0,0,0,55,1,1044,0,1,1783872,2542656,30.199337741083,589,3191,2868,912,50148,702576,554812,2465,3700,3111,4744,5979,44.22668877499196,18.33363034590017,1235,1,181488,60724,1956,0,1876,832
13580,0,1,1,0,58,0,886,0,0,479435,1117671,19.467922333931785,337,1686,1644,379,54240,666474,707760,2907,3328,2991,4214,4635,35.566838487557476,6.488991180673202,421,1,90960,4788,1265,0,2570,1684
13581,0,1,1,0,58,0,886,0,0,390507,948328,17.97220075561143,263,1592,1532,323,51972,625368,716384,2876,3259,2996,4145,4528,34.77067730142742,7.789174875971784,383,1,78812,5580,1209,0,2613,1727
13582,0,0,0,0,55,1,1866,1,0,2230632,2317572,28.77498913987632,678,3672,3522,828,52170,621378,657765,2649,3627,2949,5493,6471,51.90375708944392,12.338422017092807,978,1,194580,17850,2694,0,1971,105
13583,0,0,0,0,55,1,1838,0,0,1683539,1851289,25.903667693977237,671,3180,3180,671,50624,623534,618016,2759,3430,2759,5268,5939,50.08991914547278,0.0,671,0,150304,0,2509,0,2088,250
13584,0,1,0,1,66,0,8,0,0,4255953,6893532,45.37620521815371,1669,4516,4126,2059,36417,612684,666252,2958,5407,3738,5415,7864,45.46427168667722,20.299128257920547,2449,1,409741,43680,2067,0,1289,1281
13585,0,0,0,0,55,1,1801,0,0,1834602,2006664,26.94438717061496,726,3253,3253,726,51246,646776,605316,2764,3490,2764,5291,6017,50.269274910227224,0.0,726,0,158994,0,2527,0,2038,237
13586,0,0,0,0,54,1,1109,0,1,1736000,2404500,29.58039891549808,705,3029,2859,875,53965,689748,590820,2578,3623,2918,4732,5777,44.54211490264017,13.311665991403686,1045,1,188125,27370,1984,0,1873,764
13587,0,0,0,0,53,1,346,0,1,76347,1337819,22.338307903688676,190,961,652,499,55460,632716,630035,2372,3180,2990,2834,3642,12.36931687685298,17.818695391551277,808,1,117265,40479,153,0,2182,2528
13588,1,0,0,0,49,0,520,1,0,126000,445320,13.416407864998739,62,1122,880,180,43011,601182,437898,2232,2654,2716,3174,3596,26.457513110645905,15.790094819097714,422,1,31860,49610,700,0,2294,1774
13589,0,0,0,0,55,1,987,0,1,1808514,2583189,30.643106892089126,749,3055,2865,939,48132,693252,525441,2561,3690,2941,4677,5806,43.88621651498338,14.074117791100516,1129,1,179349,37240,1926,0,1812,825
13590,0,0,0,0,56,1,198,1,0,1269360,2894760,32.12475680841802,719,2575,2262,1032,47742,614295,611490,2492,3837,3118,4035,5380,35.07135583350036,17.70483892550094,1345,1,224976,42568,1230,0,1773,1575
13591,0,0,0,0,54,1,361,0,1,259560,1969051,26.851443164195103,350,1452,1081,721,53460,600820,663633,2360,3452,3102,3091,4183,18.973665961010276,19.264857809485118,1092,1,175203,37842,360,0,2010,2371
13592,0,0,0,0,53,1,491,0,1,120780,1811029,25.903667693977237,241,1281,851,671,56168,642362,636964,2269,3370,3129,2879,3980,13.416407864998739,20.752572048743716,1101,1,158356,55900,180,0,2028,2519
13593,1,0,0,0,50,0,480,0,1,32400,152220,7.745966692414834,264,924,600,60,43485,565751,494715,2213,2597,2861,3077,3461,23.2379000772445,18.195024241394595,384,1,11700,53784,540,0,2477,1997
13594,0,1,0,1,69,0,614,0,0,4370520,8409500,49.193495504995376,1670,4976,4226,2420,36575,608125,726275,2725,5895,4225,5281,8451,42.49705872175156,28.17425038751955,3170,1,505780,66750,1806,0,1055,1669
13595,0,0,1,0,61,1,816,0,0,1858465,5633987,42.790185790669334,1563,3114,2846,1831,47436,618477,726172,2809,4908,3345,4092,6191,31.85906464414798,16.37076252546435,2099,1,432116,24120,1015,0,1246,2062
13596,0,0,1,0,58,1,654,0,0,4852600,5568900,43.58898943540674,1550,4804,4454,1900,49268,638958,662406,2581,4831,3281,5485,7735,50.53711507397311,18.83111931185242,2250,1,429400,44100,2554,0,1031,377
13597,0,0,0,0,55,1,1726,0,0,2158847,2336298,29.0,811,3438,3408,841,51246,608382,650052,2748,3619,2808,5345,6216,50.665570163573605,5.514871952411144,871,0,196794,3450,2567,0,1937,211
13598,0,0,0,0,56,1,725,0,1,2007500,3118500,33.166247903554,791,3234,2925,1100,49530,720090,552825,2526,3935,3144,4660,6069,42.720018726587654,18.545120724108482,1409,1,214500,58401,1825,0,1735,1010
13599,0,0,0,0,54,1,361,0,1,294032,2058976,27.422618401604176,417,1478,1143,752,52538,596884,659858,2403,3490,3073,3129,4216,19.77371993328519,18.303372163798578,1087,1,181232,34840,391,0,1986,2347
13600,0,0,0,0,54,1,483,0,1,175450,1962575,26.92582403567252,346,1346,967,725,51700,595540,636145,2328,3432,3086,2949,4053,15.556349186104045,19.477707126614654,1104,1,170375,43585,242,0,1982,2465
13601,0,0,0,0,53,1,516,0,1,127036,1881110,26.419689627245813,296,1282,880,698,54502,617155,641410,2293,3393,3097,2877,3977,13.490737563232042,20.0725109580806,1100,1,166124,47838,182,0,1997,2513
13602,0,0,0,0,53,1,550,0,1,83576,1809690,25.96150997149434,244,1228,798,674,55692,628290,639030,2255,3359,3115,2809,3913,11.135528725660043,20.770702133587328,1104,1,160412,53750,124,0,2011,2561
13603,1,0,0,0,48,0,522,1,0,253368,745416,17.4928556845359,198,1242,1134,306,37191,562716,392196,2328,2742,2544,3264,3678,28.77498913987632,10.498474454302341,414,1,49266,22464,828,0,2130,1608
13604,0,0,0,1,66,1,267,0,0,2017080,4317327,35.958309192730404,1159,2987,2853,1293,55216,794682,774648,3205,4632,3473,4899,6326,39.496835316262995,11.602978935530418,1427,1,299976,18492,1560,0,2046,1779
13605,0,0,1,0,62,1,1046,0,0,1222200,5496408,41.78516483155236,1584,2608,2446,1746,46225,676820,676820,2986,4894,3310,3848,5756,26.457513110645905,12.748363342157862,1908,1,375390,21870,700,0,1402,2448
13606,0,0,0,0,56,1,706,0,1,1986600,3095400,33.166247903554,844,3162,2906,1100,51562,714756,571242,2558,3914,3070,4620,5976,42.49705872175156,16.891651238640204,1356,1,223300,45568,1806,0,1714,1008
13607,0,0,0,0,56,1,291,1,0,1505290,3080340,33.015148038438355,751,2810,2471,1090,47686,596286,638676,2487,3916,3165,4207,5636,37.16180835212409,18.469519347287758,1429,1,246340,39324,1381,0,1736,1445
13608,0,1,1,0,65,0,2486,0,0,5398176,12638402,62.27358990776106,3728,5420,5270,3878,40698,775642,557289,3109,7137,3409,4651,8679,37.30951621235526,12.439392632724381,4028,1,663138,30900,1392,0,619,1867
13609,0,0,1,0,61,1,835,0,0,4484816,7939232,50.75431016179808,2257,4636,4317,2576,44454,736598,573252,2763,5658,3401,4823,7718,41.72529209005013,18.115229658601585,2895,1,479136,61248,1741,0,506,1341
13610,0,0,0,0,55,1,1640,0,0,2310129,2527809,30.116440692751194,907,3454,3454,907,50844,621501,635436,2787,3694,2787,5334,6241,50.46781152378217,0.0,907,0,206796,0,2547,0,1880,240
13611,0,0,0,0,54,1,1354,0,0,1606640,2076320,27.568097504180443,760,2874,2874,760,50175,609236,614700,2732,3492,2732,4846,5606,45.9782557302906,0.0,760,0,171000,0,2114,0,1972,618
13612,0,0,0,0,54,1,1332,0,0,1604205,2087685,27.65863337187866,765,2862,2862,765,48399,597651,603109,2729,3494,2729,4826,5591,45.79301256742124,0.0,765,0,169065,0,2097,0,1964,632
13613,0,0,0,0,54,1,864,0,1,1855417,2711840,31.575306807693888,907,2948,2858,997,50292,690880,538560,2630,3717,2810,4581,5668,43.139309220245984,9.664766342822109,1087,1,197406,16830,1861,0,1723,859
13614,0,0,0,0,56,1,631,0,1,2018940,3198840,33.76388603226827,898,3153,2911,1140,50904,707112,566812,2564,3946,3048,4577,5959,42.08325082500163,16.476181186431486,1382,1,230280,41624,1771,0,1666,1035
13615,0,0,0,0,56,1,95,0,1,794300,2637640,30.659419433511783,693,2032,1785,940,52658,653798,634156,2559,3746,3053,3651,4838,29.068883707497267,15.750191710457472,1187,1,212440,35321,845,0,1866,1961
13616,0,0,0,0,54,1,537,1,0,174420,2070090,27.65863337187866,430,1328,993,765,46690,549318,622380,2371,3471,3041,2934,4034,15.0996688705415,18.312172256238316,1100,1,175950,33835,228,0,1941,2478
13617,0,0,0,0,53,1,581,1,0,109650,1964928,27.03701166919155,355,1257,881,731,48590,577920,607488,2312,3419,3064,2838,3945,12.24744871391589,19.41754649322966,1107,1,165206,45872,150,0,1957,2538
13618,0,0,0,0,52,1,398,0,1,100275,1517877,23.93741840717165,197,1124,748,573,55930,630462,622515,2273,3222,3025,2824,3773,13.228756555322953,19.459785326212117,949,1,134655,50008,175,0,2076,2474
13619,0,1,0,1,64,0,2868,0,0,6812128,14197816,66.42288762166245,4073,6295,5956,4412,30195,588894,530970,2879,7630,3557,4762,9513,39.293765408777,18.749006587720018,4751,1,727980,50511,1544,0,1194,1674
13620,0,0,1,0,58,1,106,0,0,4253160,5865180,44.83302354291979,1980,4156,4126,2010,48399,639042,644878,2888,4928,2948,5034,7074,46.0,5.5965095842615735,2040,0,444210,3990,2116,1,908,802
13621,0,0,0,0,54,1,871,0,1,1825320,2658768,31.368774282716245,942,2881,2839,984,52118,683606,556612,2660,3686,2744,4557,5583,43.069710934716056,6.5252844928085345,1026,1,202704,7518,1855,0,1718,847
13622,0,1,0,1,64,0,2771,0,0,5867280,13442544,64.62197768561404,4068,5689,5581,4176,39919,614829,672771,3111,7395,3327,4624,8908,37.48332962798263,10.748049169056976,4284,1,872784,11880,1405,0,957,1814
13623,0,0,1,0,61,1,324,0,0,5018272,7450352,49.07137658554119,2196,4704,4492,2408,47460,699244,649740,2882,5502,3306,5178,7798,45.65084884205331,14.64762860497819,2620,1,505680,32648,2084,0,686,1010
13624,0,0,1,0,60,1,1117,0,0,6132060,5969700,44.49719092257398,1950,5107,5077,1980,47686,681390,636165,2985,4995,3045,6112,8122,55.65069631190611,5.477225575051661,2010,1,417780,4590,3097,0,1035,82
13625,0,0,1,0,59,1,468,0,0,5066413,5993666,45.044422518220834,1694,4861,4526,2029,49506,655788,658742,2619,4983,3289,5451,7815,49.969990994595946,18.516519329174788,2364,1,452467,44555,2497,0,925,457
13626,0,0,0,0,55,1,1561,1,0,2525490,2769030,31.464265445104548,960,3571,3541,990,52664,634919,648904,2767,3787,2827,5348,6368,50.50742519669756,5.501408174353464,1020,1,229680,3840,2551,0,1807,246
13627,1,0,0,0,50,0,492,1,0,1198368,2207520,29.597297173897484,456,2664,2244,876,45126,521640,549360,2100,3396,2940,3888,5184,36.98648401781386,21.15049097876389,1296,1,190968,51240,1368,0,1644,1152
13628,1,0,0,0,49,0,518,1,0,618503,1404292,23.853720883753127,435,1790,1656,569,33003,422028,476324,2334,3037,2602,3555,4258,32.96968304366907,12.431722618206066,703,1,109817,13668,1087,0,1899,1381
13629,1,0,0,0,49,0,564,1,0,319900,858200,18.708286933869708,260,1354,1264,350,27090,514920,316308,2362,2802,2542,3366,3806,30.23243291566195,9.883997062654284,440,1,45150,19350,914,0,2102,1538
13630,0,0,1,0,58,1,65,0,0,4419450,6054750,45.4972526643093,2070,4205,4205,2070,46330,661050,599625,2925,4995,2925,5060,7130,46.20606020859169,0.0,2070,0,424350,0,2135,1,855,790
13631,0,0,0,0,58,1,566,1,0,2119200,3502800,34.64101615137755,746,3420,2966,1200,53820,683046,671370,2465,4119,3373,4685,6339,42.02380277890139,21.78325673221013,1654,1,276000,62198,1766,0,1719,1153
13632,0,0,0,0,54,1,548,1,0,282528,2383176,29.5296461204668,644,1424,1196,872,50140,595794,628590,2505,3605,2961,3057,4157,18.0,15.110114860095715,1100,1,200560,27360,324,0,1861,2409
13633,0,1,0,1,64,0,2702,0,0,5112755,12939295,63.12685640834652,3955,5298,5268,3985,36348,756551,506532,3217,7232,3277,4530,8545,35.81898937714463,5.652706486041966,4015,1,621660,6450,1283,0,738,1964
13634,0,1,1,0,61,0,974,0,0,880080,1749330,23.874672772626646,358,2326,2114,570,45933,561627,770319,2857,3639,3281,4613,5395,39.293765408777,14.707715565889083,782,1,143070,8268,1544,0,2499,1525
13635,0,0,1,0,62,1,731,0,0,4949180,8124620,51.18593556827891,2244,4885,4509,2620,53586,725634,710129,2725,5721,3477,4990,7986,43.46262762420146,19.41043994499176,2996,1,599980,51888,1889,0,481,1212
13636,0,0,0,0,55,1,367,0,1,2093550,3525375,35.70714214271425,1105,3087,2917,1275,49896,696780,547470,2595,4040,2935,4407,5852,40.52159917870962,13.738384613864339,1445,1,252450,29920,1642,0,1490,1123
13637,0,0,0,0,54,1,255,0,1,2102224,3637392,36.4417343165772,1201,3038,2911,1328,49644,690228,539583,2612,4067,2866,4322,5777,39.786932528155525,11.81597791836795,1455,1,261616,22352,1583,0,1411,1156
13638,1,0,0,0,50,0,275,1,0,1245594,2505993,31.416556144810016,499,2737,2249,987,47080,558580,543346,2051,3526,3027,3801,5276,35.52463933666322,22.725203943000377,1475,1,211218,69784,1262,0,1552,1277
13639,0,0,0,0,55,1,1171,0,0,2082996,2701188,31.176914536239792,972,3115,3115,972,49725,625275,614159,2779,3751,2779,4922,5894,46.292547996410825,0.0,972,0,214812,0,2143,0,1807,636
13640,0,0,0,0,55,1,209,0,1,1098942,3207660,34.02939905434711,1128,2137,2107,1158,56105,678650,634330,2740,3928,2800,3719,4907,30.805843601498726,5.514871952411144,1188,1,265182,4380,949,0,1612,1821
13641,0,1,0,1,66,0,1458,0,0,9523800,12920700,62.44997998398398,3718,6524,6342,3900,54934,801746,752051,3131,7213,3495,5755,9837,49.416596402423345,13.520067743263182,4082,1,885300,27118,2442,0,587,871
13642,0,1,1,0,61,0,950,0,0,1138599,2137905,26.324893162176366,387,2642,2336,693,55200,709550,740400,2779,3778,3391,4728,5727,40.53393639902249,17.595125361206108,999,1,166320,36108,1643,0,2392,1442
13643,0,0,0,0,54,1,381,1,0,776412,2985528,33.04542328371661,1062,1833,1803,1092,55696,645224,645224,2704,3826,2764,3445,4567,26.664583251946766,5.478746393072713,1122,1,257712,3900,711,0,1642,2023
13644,0,0,1,0,61,1,315,0,0,4751604,7185981,48.40454524112379,2193,4521,4371,2343,52360,729946,674740,2917,5410,3217,5095,7588,45.033320996790806,12.247584794411392,2493,1,515460,23250,2028,0,724,1039
13645,0,0,0,0,55,1,265,1,0,1136994,3330113,34.741905532080416,1207,2149,2149,1207,54747,653883,637329,2759,3966,2759,3701,4908,30.692018506445613,0.0,1207,1,278817,0,942,0,1552,1817
13646,0,0,0,0,53,1,192,0,1,310009,1756277,25.709920264364882,203,1588,1130,661,56364,613767,648308,2199,3318,3115,3126,4245,21.656407827707714,21.521348375156006,1119,1,161284,50380,469,0,1996,2188
13647,0,0,1,0,59,1,147,0,0,4863240,6726000,47.74934554525329,2250,4443,4413,2280,43884,610650,625400,2920,5230,2980,5083,7393,46.184412955021955,5.5965095842615735,2310,0,483360,3870,2133,1,670,817
13648,0,0,0,0,58,1,214,1,0,2289840,4090410,37.54996671103717,892,3552,3034,1410,55632,707844,661428,2383,4311,3419,4525,6453,40.29888335921977,23.025682274526826,1928,1,321480,76664,1624,0,1491,1277
13649,0,0,0,0,55,1,172,1,0,1447040,3595636,35.94440151122286,1232,2472,2412,1292,47952,601128,617826,2723,4075,2843,3903,5255,33.46640106136302,7.748117453886108,1352,1,286824,7680,1120,0,1491,1663
13650,0,1,0,1,66,0,1485,0,0,8999884,12671898,61.91122676865643,3748,6266,6181,3833,52664,766992,750462,3221,7139,3391,5654,9572,48.45616575834287,9.224644470006377,3918,1,870091,11900,2348,0,527,958
13651,0,1,1,0,63,0,815,0,0,1903226,3281673,32.109188716004645,605,3303,2877,1031,44929,569757,798933,2757,4214,3609,5029,6486,42.96510211788167,21.111302896254227,1457,1,258781,13632,1846,0,2152,1337
13652,0,0,0,0,57,1,1286,1,0,4391415,4462669,39.35733730830886,1333,4600,4384,1549,43780,633820,573319,2665,4430,3097,5716,7481,53.24471804789655,14.697253452969017,1765,1,308251,34128,2835,0,1332,46
13653,0,1,0,1,65,0,1729,0,0,8327796,12735945,62.26556030423239,3877,6025,6025,3877,49713,719415,745695,3285,7162,3285,5433,9310,46.34652090502587,0.0,3877,1,880079,0,2148,0,592,1137
13654,0,0,0,0,51,1,895,0,0,405806,844712,18.193405398660254,301,1587,1557,331,48168,569096,551232,2522,2883,2582,3778,4139,35.014282800023196,5.478746393072713,361,0,71496,4320,1226,0,2221,1326
13655,0,0,0,0,50,1,1126,0,0,283656,538692,14.560219778561036,212,1550,1550,212,53590,584430,592053,2541,2753,2541,3879,4091,36.578682316343766,0.0,212,0,49396,0,1338,0,2329,1203
13656,0,1,0,1,68,0,919,0,0,9993690,12423600,60.44832503882965,3587,6456,6389,3654,46728,673200,802400,3333,7054,3467,6135,9856,52.29722745997153,8.2143728690235,3721,1,862344,5695,2735,0,254,665
13657,0,1,0,1,64,0,2137,0,0,7364280,12891475,63.12685640834652,3955,5863,5833,3985,47304,698760,708465,3205,7220,3265,5083,9098,42.988370520409354,5.477225575051661,4015,1,872715,3930,1848,0,750,1387
13658,0,1,1,0,64,0,2601,0,0,6468292,13310714,64.47480127925948,4157,5713,5713,4157,49473,765278,662814,3202,7359,3202,4758,8915,39.44616584663204,0.0,4157,0,860499,0,1556,1,955,1646
13659,0,0,0,0,53,1,36,1,0,2050300,3878750,38.07886552931954,1450,2864,2864,1450,52864,599200,631300,2675,4125,2675,4089,5539,37.603191353926334,0.0,1450,1,342200,0,1414,0,1225,1261
13660,0,0,0,0,51,1,280,0,0,374784,1260504,22.090722034374522,126,1618,1256,488,49896,596673,557928,2221,3071,2945,3351,4201,27.712812921102035,19.04384131825279,850,0,105408,55024,768,0,2095,1815
13661,0,1,0,1,64,0,2783,0,0,5872958,13571012,64.69930447848725,4036,5739,5589,4186,34400,697030,518720,3092,7428,3392,4645,8981,37.456641600656084,12.459604606992961,4336,1,669760,28950,1403,0,944,1839
13662,0,0,0,0,53,1,567,0,1,663534,3075864,33.85262175962151,1146,1725,1725,1146,53105,662948,577060,2684,3830,2684,3263,4409,24.06241883103193,0.0,1146,1,246390,0,579,0,1538,2105
13663,0,0,0,0,50,1,1332,1,0,222300,380850,12.24744871391589,90,1692,1632,150,47742,553502,556041,2479,2689,2599,4021,4231,38.49675310984031,7.754559014766193,210,1,32850,8040,1482,0,2389,1057
13664,0,1,0,1,66,0,1221,0,0,8829412,12156384,60.36555309114628,3644,6067,6067,3644,43780,663864,733920,3336,6980,3336,5759,9403,49.22397789695587,0.0,3644,1,801680,0,2423,0,308,913
13665,0,1,0,1,66,0,1258,0,0,8748935,12164490,60.440052945046304,3653,6048,6048,3653,42016,672660,692640,3330,6983,3330,5725,9378,48.938737212968626,0.0,3653,1,759824,0,2395,0,323,935
13666,0,0,1,0,62,1,389,0,0,4910570,6333600,45.05552130427524,1721,4758,4449,2030,45000,702000,624000,2811,5150,3429,5539,7878,49.18333050943175,17.674987570472922,2339,1,406000,50367,2419,0,1090,701
13667,0,0,0,0,54,1,58,0,1,1992903,3900787,37.960505792204614,1411,2854,2824,1441,54612,600954,665922,2677,4148,2737,4090,5561,37.1887079635741,5.572104574801163,1471,1,354486,2970,1383,0,1266,1324
13668,0,0,0,0,53,1,223,1,0,2033898,4146438,39.26830783214372,1475,2928,2861,1542,40400,543178,537800,2622,4231,2756,4008,5617,36.318039594669756,8.20759886765899,1609,1,308400,9045,1319,0,1147,1370
13669,0,1,0,1,67,0,109,0,0,3436200,6051600,42.42640687119285,1259,4250,3709,1800,53823,783346,776622,2821,5162,3903,5271,7612,43.69210454990696,23.37631694045105,2341,1,415800,73576,1909,0,1562,1453
13670,0,0,0,0,54,1,29,0,1,1989300,3813872,37.36308338453881,1354,2863,2821,1396,56144,633824,661144,2690,4128,2774,4157,5595,37.749172176353746,6.678188844436455,1438,1,337832,4452,1425,0,1336,1307
13671,0,0,0,0,51,1,965,1,0,460250,906850,18.708286933869708,197,1818,1665,350,37810,492290,515609,2438,2941,2744,3906,4409,36.26292872893749,12.60665128010484,503,1,69650,18513,1315,0,2241,1276
13672,0,0,0,0,51,1,1261,1,0,319032,552312,14.696938456699069,121,1788,1693,216,42552,503729,552312,2462,2773,2652,4034,4345,38.43175770115127,9.898721770111106,311,1,46656,10450,1477,0,2341,1080
13673,0,1,0,1,67,0,1074,0,0,8850160,11982960,59.665735560705194,3518,6088,6046,3560,46367,669834,784278,3324,6926,3408,5852,9454,49.85980344927164,6.5252844928085345,3602,1,829480,3864,2486,0,194,880
13674,0,0,0,0,52,1,2,0,0,550563,1935515,27.258026340878022,284,1943,1484,743,50398,588730,580915,2146,3348,3064,3346,4548,27.2213151776324,21.45361360244819,1202,0,165689,63342,741,0,1862,1864
13675,0,0,0,0,51,1,1013,1,0,463410,888858,18.49324200890693,162,1877,1697,342,36630,480815,514602,2419,2941,2779,3954,4476,36.810324638611924,13.677921696369898,522,1,67716,20880,1355,0,2257,1244
13676,0,1,0,1,68,0,2737,0,0,3066714,12281220,59.924953066314536,3161,4875,4445,3591,46046,865260,622440,2990,7011,3850,4274,8295,29.223278392404914,21.067672401654697,4021,1,653562,84280,854,0,171,2566
13677,0,1,0,1,66,0,514,0,0,3304847,5223332,39.736632972611055,1184,4067,3672,1579,52948,717836,807152,2913,4887,3703,5401,7375,45.749316934791494,19.891431663643996,1974,1,385276,38710,2093,0,1729,1215
13678,0,0,1,0,62,1,1477,0,0,4496888,4677728,38.82009788756334,1373,4625,4491,1507,55458,735648,726336,2970,4611,3238,6088,7729,54.62600113499065,11.66016950172314,1641,0,352638,17956,2984,1,1597,120
13679,0,0,0,0,52,1,69,0,0,595566,2109498,28.407745422683583,412,1940,1545,807,50160,575080,595992,2219,3421,3009,3352,4554,27.16615541441225,19.894480353687705,1202,0,183996,48980,738,0,1807,1876
13680,0,0,0,0,52,1,398,1,0,565683,1523928,24.06241883103193,197,1938,1556,579,42432,581672,505344,2250,3211,3014,3609,4570,31.25699921617557,19.720866780635053,961,1,111168,63794,977,0,2053,1655
13681,0,1,0,1,67,0,2988,0,0,2961805,12658415,61.424750711744856,3476,4855,4558,3773,52250,838750,701195,3058,7128,3652,4140,8210,28.0178514522438,17.303788837718695,4070,1,788557,52272,785,0,418,2570
13682,0,0,0,0,54,1,353,1,0,1966830,4347060,39.87480407475377,1482,2935,2827,1590,37080,563204,492120,2626,4324,2842,3971,5669,35.17101079013795,10.562698776726089,1698,1,286200,17496,1237,0,1144,1497
13683,0,0,0,0,52,1,290,0,1,693000,2606670,31.464265445104548,808,1872,1690,990,54747,624021,608223,2451,3623,2815,3333,4505,26.457513110645905,13.494401588860493,1172,1,228690,25116,700,0,1643,1933
13684,0,1,0,1,67,0,1167,0,0,8223930,11832210,59.2452529743945,3425,5938,5853,3510,46800,758475,701168,3286,6881,3456,5714,9309,48.40454524112379,9.300149152818726,3595,1,730080,13175,2343,0,139,1028
13685,0,0,0,0,52,1,218,0,0,712320,2526720,30.983866769659336,720,1942,1702,960,49842,615888,560616,2392,3592,2872,3374,4574,27.23967694375247,15.495227059715251,1200,0,204480,38160,742,0,1672,1890
13686,0,0,0,0,52,1,499,0,1,671342,1604908,24.63736998950984,245,2075,1713,607,46800,594900,549952,2282,3251,3006,3750,4719,33.25657829663178,19.32000626596122,969,1,126256,55748,1106,0,2037,1538
13687,0,1,1,0,57,0,689,0,0,146030,487390,13.038404810405298,50,1149,1029,170,43510,544730,656543,2747,3037,2987,3726,4016,29.30870177950569,10.955211796648204,290,1,38930,10080,859,0,2697,2008
13688,0,0,0,0,55,1,272,0,0,2371620,3895830,37.54996671103717,1410,3092,3092,1410,53820,635490,646542,2763,4173,2763,4445,5855,41.012193308819754,0.0,1410,0,329940,0,1682,0,1353,1081
13689,0,0,0,0,54,1,262,1,0,1979408,4210488,39.293765408777,1477,2893,2826,1544,44642,602667,550854,2660,4271,2794,4009,5620,35.805027579936315,8.222029866439447,1611,1,311888,10452,1282,0,1183,1445
13690,0,0,0,0,54,1,320,1,0,1962500,4289240,39.6232255123179,1475,2915,2820,1570,39820,601040,494492,2637,4302,2827,3982,5647,35.35533905932738,9.815189597405173,1665,1,284170,16910,1250,0,1162,1482
13691,0,0,0,0,51,1,1262,1,0,534995,861955,18.303005217723125,227,2040,1932,335,42136,473432,589217,2465,2908,2681,4170,4613,39.96248240537617,10.684669642126707,443,1,76715,8100,1597,0,2238,976
13692,0,0,0,0,51,1,1293,1,0,537544,848022,18.193405398660254,246,2040,1955,331,43010,479094,589260,2477,2893,2647,4186,4602,40.29888335921977,9.428020440933057,416,1,76130,6715,1624,0,2231,938
13693,0,0,0,0,50,1,1337,1,0,552108,841733,18.193405398660254,289,2041,1999,331,46864,513686,589976,2501,2874,2585,4211,4584,40.84115571332428,6.570697549716149,373,1,76792,4032,1668,0,2212,875
13694,0,1,1,0,59,0,680,0,0,497489,1317925,21.047565179849187,323,1686,1566,443,39162,544425,636650,2855,3418,3095,4098,4661,33.51119216023208,10.95616238207774,563,1,94802,11280,1123,0,2532,1852
13695,0,0,0,0,52,1,228,0,0,811468,2693992,31.96873472629156,812,2026,1816,1022,48880,619460,548288,2426,3658,2846,3430,4662,28.178005607210743,14.492116045569249,1232,0,212576,35070,794,0,1614,1842
13696,0,0,0,0,52,1,339,0,1,730782,1858896,26.49528259898354,214,2231,1743,702,47840,609040,550784,2160,3350,3136,3689,4879,32.264531609803356,22.27216632260941,1190,1,146016,78568,1041,0,1946,1607
13697,0,0,0,0,52,1,1023,0,1,630448,1145718,20.808652046684813,150,2172,1889,433,47475,558306,595350,2363,3079,2929,4102,4818,38.157568056677825,17.424879201536484,716,1,97425,33394,1456,0,2213,1190
13698,0,0,0,0,51,1,1277,1,0,591318,927409,19.0,253,2107,1999,361,42136,472696,588301,2461,2930,2677,4207,4676,40.47221268969612,10.62681426149494,469,1,82669,8316,1638,0,2208,931
13699,0,0,1,0,62,1,1627,0,0,3890040,4105200,36.3318042491699,1128,4459,4267,1320,52658,724630,702860,2918,4430,3302,6057,7569,54.286278192559855,14.01173814462286,1512,1,298320,27456,2947,0,1790,163
13700,0,0,0,0,54,1,368,1,0,1968369,4376463,39.98749804626441,1475,2954,2830,1599,44823,610351,550137,2613,4336,2861,3968,5691,35.08560958569767,11.15359010904883,1723,1,321399,19964,1231,0,1138,1506
13701,0,0,0,0,52,1,416,0,1,1003265,3228913,35.08560958569767,1231,2046,2046,1231,56376,637389,608536,2623,3854,2623,3438,4669,28.548204847240395,0.0,1231,1,285592,0,815,0,1392,1808
13702,0,0,0,0,51,1,1261,1,0,645932,1007216,19.77371993328519,264,2170,2043,391,41768,473984,584752,2449,2967,2703,4228,4746,40.64480286580315,11.579381003458169,518,1,88757,9906,1652,0,2185,924
13703,0,0,0,0,51,1,1250,1,0,639600,1000740,19.748417658131498,282,2138,2030,390,41400,472144,577350,2458,2956,2674,4206,4704,40.496913462633174,10.62681426149494,498,1,87750,8748,1640,0,2176,926
13704,0,1,0,1,67,0,1127,0,0,7762274,11519092,58.360945845659494,3256,5835,5685,3406,48760,777860,716984,3232,6788,3532,5661,9217,47.738873049120045,12.270382205646603,3556,1,722072,23400,2279,0,24,1103
13705,0,1,0,1,73,0,1484,0,0,2950077,9579258,51.11751167652823,1619,4736,3742,2613,52290,769860,912834,2672,6279,4660,4795,8402,33.60059523282288,32.796636358992465,3607,1,650637,80514,1129,0,1053,2537
13706,0,0,0,1,66,1,1069,0,0,3589302,8269912,50.02999100539596,2161,4279,3937,2503,49268,720272,746704,2962,5807,3646,4738,7583,37.86819245752297,18.572770987153813,2845,1,565678,42750,1434,0,801,1870
13707,0,0,0,0,55,1,780,1,0,1875676,5001198,42.59107887809371,1531,3131,2848,1814,40420,518316,592755,2474,4571,3040,3791,5888,32.155870381627054,17.250465531565574,2097,1,390010,28017,1034,0,943,1723
13708,0,0,0,0,50,1,1116,1,0,440325,778062,17.578395831246947,189,1854,1734,309,42387,536334,501082,2398,2827,2638,3943,4372,37.749172176353746,10.969823458961839,429,1,61491,18120,1425,0,2209,1093
13709,0,0,0,0,49,1,1236,1,0,37980,73920,5.477225575051661,30,1296,1296,30,52156,581504,544544,2464,2494,2464,3730,3760,35.58089374931439,0.0,30,1,6630,0,1266,0,2434,1198
13710,0,1,0,1,67,0,1146,0,0,7595896,11461604,58.20652884342099,3198,5820,5630,3388,49680,778090,730728,3193,6771,3573,5625,9203,47.34976240700686,13.802720429891991,3578,1,731808,28880,2242,0,5,1141
13711,0,1,0,1,69,0,578,0,0,3272703,7321692,46.05431575867782,1523,4262,3664,2121,46320,666236,828480,2854,5573,4050,4995,7714,39.28103868280471,24.917480328555392,2719,1,509040,43654,1543,0,1331,1909
13712,0,0,0,0,55,1,415,1,0,1988994,4490750,40.4103947023535,1453,3031,2851,1633,42848,566500,572000,2570,4383,2930,3968,5781,34.899856733230294,13.439639827089282,1813,1,339664,23760,1218,0,1117,1532
13713,0,0,0,0,55,1,727,1,0,1860200,4946925,42.13074886588179,1480,3118,2823,1775,41412,565761,568548,2492,4562,3082,3835,5905,32.37282811247729,17.439603507543996,2070,1,362100,38940,1048,0,1012,1739
13714,0,0,0,0,53,1,748,0,1,840224,1632400,24.819347291981714,170,2426,1980,616,54036,628050,604200,2204,3266,3096,4014,5076,36.932370625238775,21.389600909685395,1062,1,140448,63778,1364,0,2034,1286
13715,0,0,1,0,61,1,167,0,0,6781658,8274053,51.85556864985669,2389,5511,5211,2689,26400,507705,492320,2777,5766,3377,5599,8588,50.21951811795888,17.697717233228598,2989,1,430240,38700,2522,0,388,555
13716,0,0,1,0,60,1,758,0,0,6762743,6794229,47.4236228055175,1949,5556,5256,2249,24150,486381,453150,2721,5270,3321,6028,8577,54.83611948342078,17.332811765262047,2549,1,337350,40200,3007,0,772,14
13717,0,0,0,0,55,1,524,1,0,1947756,4655776,41.012193308819754,1470,3052,2840,1682,36540,581280,481632,2556,4450,2980,3926,5820,34.02939905434711,14.658435386318777,1894,1,292668,36888,1158,0,1086,1610
13718,0,0,0,0,54,1,364,0,1,2562197,4887718,42.34383071948026,1463,3552,3222,1793,48006,692404,515214,2396,4519,3056,4155,6278,37.8021163428716,18.720645060853272,2123,1,338877,63030,1429,0,933,1297
13719,0,0,0,0,52,1,457,0,1,1276044,3622363,37.16180835212409,1261,2425,2305,1381,54054,613782,605913,2503,4004,2743,3547,5048,30.397368307141328,10.954451150103322,1501,1,319011,13560,924,0,1242,1699
13720,0,0,0,0,52,1,380,0,1,1160736,3338400,35.832945734337834,1284,2188,2188,1284,53599,642200,564200,2600,3884,2600,3504,4788,30.066592756745816,0.0,1284,1,278628,0,904,0,1316,1696
13721,0,0,0,0,53,1,659,0,1,908502,1802745,26.057628441590765,236,2460,2017,679,55125,650475,597375,2212,3334,3098,3993,5115,36.578682316343766,21.467297833845354,1122,1,152775,67779,1338,0,1976,1317
13722,0,0,0,0,49,1,1079,1,0,219450,434525,13.228756555322953,85,1519,1429,175,52405,553709,583505,2393,2658,2573,3737,4002,35.41186241925155,9.488003977624334,265,1,41125,10710,1254,0,2308,1229
13723,0,1,0,1,68,0,796,0,0,8009760,11203896,57.06137047074842,3226,5746,5716,3256,44128,677877,770784,3411,6697,3471,5901,9187,49.59838707054898,5.478746393072713,3286,1,729344,3030,2460,0,185,981
13724,0,1,0,1,68,0,872,0,0,7858473,11203479,57.21013896155121,3183,5764,5674,3273,38191,619563,722253,3333,6696,3513,5824,9187,49.0,9.488003977624334,3363,1,690603,8550,2401,0,150,1022
13725,0,0,0,0,55,1,105,0,0,2704914,4438098,39.91240408695021,1563,3321,3291,1593,49728,624064,618492,2756,4379,2816,4484,6107,41.20679555607303,5.501408174353464,1623,0,353646,4110,1698,0,1193,1088
13726,0,0,0,0,55,1,82,0,0,2661743,4432526,39.88734135035826,1549,3306,3264,1591,49220,640780,596204,2744,4377,2828,4459,6092,40.90232267243512,6.48074069840786,1633,0,340474,6468,1673,0,1195,1113
13727,0,0,0,0,55,1,634,1,0,1904567,4816007,41.6293165929973,1477,3088,2832,1733,41400,639170,500220,2523,4512,3035,3878,5867,33.15116890850155,16.116877164043522,1989,1,311940,48640,1099,0,1046,1680
13728,0,0,0,0,51,1,408,0,1,1271700,3496500,36.742346141747674,1290,2352,2292,1350,54056,600880,603470,2530,3940,2650,3532,4942,30.692018506445613,7.952707287670506,1410,1,314550,6420,942,0,1240,1648
13729,0,1,0,1,69,0,623,0,0,8211774,11089568,56.515484603779164,3152,5807,5765,3194,42419,586768,871472,3430,6666,3514,6043,9279,50.70502933634887,6.78953034358522,3236,1,801694,0,2571,0,278,901
13730,0,0,0,1,65,1,1062,0,0,4280535,8689086,51.64300533470143,2517,4422,4272,2667,52864,729792,768888,3108,5925,3408,4863,7680,40.06245124802026,12.296281753706847,2817,1,629412,17700,1605,0,591,1653
13731,0,0,0,0,56,1,887,1,0,1789998,5192106,43.04648650006177,1477,3195,2819,1853,44457,568806,613638,2426,4655,3178,3768,5997,31.080540535840107,19.639494276149154,2229,1,405807,43240,966,0,949,1836
13732,0,0,0,0,52,1,483,0,1,1497934,3878845,38.58756276314948,1299,2685,2495,1489,55596,588730,640830,2415,4094,2795,3611,5290,31.71750305430741,13.949435170761742,1679,1,366294,19380,1006,0,1116,1599
13733,0,0,0,0,49,1,1005,1,0,177174,379134,12.36931687685298,33,1431,1311,153,46830,552594,520380,2358,2631,2598,3636,3909,34.02939905434711,11.002816348706927,273,1,32130,18120,1158,0,2325,1320
13734,0,1,1,0,62,0,361,0,0,1160976,2861856,30.199337741083,788,2309,2185,912,40775,549150,731154,3014,4050,3262,4411,5447,35.679125549822544,11.170846875615652,1036,1,212496,7068,1273,0,2226,1865
13735,0,0,0,1,67,1,1026,0,0,3939331,8603991,50.62608023538856,2228,4435,4100,2563,49951,701613,802323,3022,5920,3692,4894,7792,39.20459156782532,18.358569931971438,2898,1,612557,32160,1537,0,794,1820
13736,0,0,0,0,55,1,620,1,0,1965996,4846896,41.78516483155236,1451,3167,2872,1746,41976,588512,549648,2481,4522,3071,3902,5943,33.555923471125034,17.235690167505883,2041,1,345708,44545,1126,0,1030,1650
13737,0,0,0,0,56,1,738,1,0,1877400,5006400,42.28474902373195,1475,3151,2838,1788,34440,588000,459200,2487,4588,3113,3850,5951,32.4037034920393,17.879540345223443,2101,1,293232,56966,1050,0,1012,1750
13738,0,0,0,0,56,1,768,1,0,1857600,5047200,42.42640687119285,1477,3155,2832,1800,37170,588840,496308,2481,4604,3127,3836,5959,32.12475680841802,18.185470972928353,2123,1,318600,54587,1032,0,1004,1772
13739,0,1,0,1,68,0,766,0,0,7665336,10957744,56.37375275782161,3148,5620,5590,3178,50268,813728,734424,3418,6626,3478,5860,9068,49.1121166312347,5.490867587491313,3208,1,676914,4800,2412,0,270,1036
13740,0,1,0,1,70,0,1122,0,0,3004963,8359564,48.815980989835694,1572,4455,3644,2383,52961,740188,880508,2697,5891,4319,4769,7963,35.510561809129406,29.00173218314695,3194,1,598133,62447,1261,0,1125,2247
13741,0,0,0,1,66,1,1071,0,0,4277872,8838976,51.69139193328034,2460,4485,4273,2672,52890,711220,813768,3096,5980,3520,4909,7793,40.01249804748511,14.602876145096486,2884,1,657312,19504,1601,0,636,1707
13742,0,0,0,0,56,1,174,0,0,3250456,4865376,41.44876355212541,1688,3640,3610,1718,52658,659856,640032,2802,4550,2862,4724,6472,43.497126341863094,5.483301264452448,1748,0,388268,4260,1892,0,1114,940
13743,0,0,0,0,51,1,905,0,1,905106,1561999,24.515301344262525,306,2402,2107,601,50576,566582,602968,2304,3200,2894,4105,5001,38.80721582386451,17.419064154957447,896,1,139432,34515,1506,0,1998,1093
13744,0,0,0,1,65,1,1068,0,0,4532869,8942933,52.23983154643591,2605,4514,4390,2729,52297,711109,789757,3153,6006,3401,4938,7791,40.755367744629666,11.147098121756736,2853,1,657689,12772,1661,0,548,1616
13745,0,0,0,0,53,1,554,0,1,2353752,4878252,42.8485705712571,1674,3280,3118,1836,54978,632366,613767,2495,4493,2819,3939,5937,35.805027579936315,13.329963566490761,1998,1,424116,19602,1282,0,821,1375
13746,0,0,0,0,51,1,47,0,1,1263948,2833974,33.18132004607411,891,2459,2249,1101,56882,615186,612612,2364,3675,2784,3722,5033,33.88214869219483,14.596690407581317,1311,1,262038,25830,1148,0,1473,1426
13747,0,0,0,0,51,1,244,0,1,1257500,2612582,31.71750305430741,824,2438,2256,1006,48006,659638,490833,2415,3603,2779,3847,5035,35.35533905932738,13.951368915431251,1188,1,190134,34398,1250,0,1591,1347
13748,0,0,0,0,52,1,572,0,1,1215525,2223771,29.206163733020468,595,2536,2278,853,46990,662178,482295,2349,3460,2865,4032,5143,37.749172176353746,16.408694078727795,1111,1,157805,51600,1425,0,1754,1182
13749,0,0,0,0,56,1,912,1,0,1845553,5340203,43.46262762420146,1465,3290,2866,1889,36188,616286,469282,2403,4716,3251,3804,6117,31.25699921617557,20.790398594045072,2313,1,313574,80984,977,0,938,1850
13750,0,0,0,0,56,1,1034,1,0,1740600,5482890,43.977266854592045,1477,3291,2834,1934,46010,609525,606690,2378,4769,3292,3735,6126,30.0,21.624066607128444,2391,1,413876,62152,900,0,901,1935
13751,0,1,1,0,59,0,305,0,0,376800,1425600,21.908902300206645,288,1457,1265,480,52858,635580,733590,2778,3450,3162,3755,4427,28.0178514522438,14.01927502583177,672,1,118560,17088,785,0,2490,2185
13752,0,0,0,1,67,1,653,0,0,1432238,5280790,39.585350825778974,1417,2631,2481,1567,49887,812170,697590,3220,4937,3520,4284,6001,30.23243291566195,12.261034368426225,1717,1,324369,25950,914,0,1803,2456
13753,0,0,0,1,67,1,702,0,0,1429315,5386681,39.96248240537617,1435,2654,2492,1597,49086,819639,681346,3211,4970,3535,4268,6027,29.916550603303182,12.737731642481698,1759,1,322594,28998,895,0,1776,2478
13754,0,0,0,0,51,1,43,0,1,1423980,3139560,34.85685011586675,1040,2562,2387,1215,55800,640832,581400,2409,3799,2759,3756,5146,34.23448553724738,13.4515702780965,1390,1,273375,26600,1172,0,1369,1412
13755,0,0,0,0,50,1,647,0,1,591738,1301006,22.60530911091463,135,2045,1669,511,46762,524476,577942,2170,3057,2922,3704,4591,34.02939905434711,19.512999268313223,887,1,115997,40608,1158,0,2035,1388
13756,0,0,1,0,63,1,1156,0,0,2960141,3939845,35.17101079013795,511,4356,3630,1237,50838,707070,729365,2459,4422,3911,5578,7541,48.91829923454004,27.081565833355207,1963,1,283273,91476,2393,0,1948,792
13757,0,0,0,0,52,1,786,0,1,1237951,2051709,28.053520278211074,405,2742,2360,787,51455,654357,534435,2225,3394,2989,4180,5349,39.66106403010388,19.828205394392814,1169,1,161335,69142,1573,0,1820,1034
13758,0,0,1,0,58,1,191,0,0,358722,2048436,26.49528259898354,41,1874,1213,702,48108,665304,615698,2257,3620,3579,3429,4792,22.60530911091463,26.84432510811805,1363,1,148122,101794,511,0,2216,2407
13759,0,0,0,1,67,1,551,0,0,1386990,4998510,38.535697735995385,1335,2569,2419,1485,49350,791010,706860,3216,4851,3516,4300,5935,30.56141357987225,12.26699777646566,1635,1,311850,24450,934,0,1881,2432
13760,0,0,0,1,67,1,1041,0,0,1320462,6048108,42.21374183841087,1463,2842,2523,1782,46886,807772,668618,3075,5176,3713,4135,6236,27.2213151776324,17.89487307450726,2101,1,351054,57739,741,0,1612,2653
13761,0,0,0,1,66,1,1070,0,0,5151999,9472568,53.54437412091022,2837,4694,4664,2867,48564,703752,753312,3274,6171,3334,5101,7998,42.391036788453285,5.5503012171862105,2897,1,653676,3480,1797,0,437,1507
13762,0,0,0,0,51,1,520,0,1,2454144,4777080,42.988370520409354,1818,3206,3176,1848,55176,625570,589380,2555,4433,2615,3913,5791,36.4417343165772,5.623413251903491,1878,1,421344,3930,1328,0,737,1257
13763,0,0,0,0,51,1,496,0,1,2347200,4642200,42.42640687119285,1800,3104,3104,1800,55209,616381,595749,2579,4379,2579,3883,5683,36.11094017053558,0.0,1800,1,415800,0,1304,0,779,1275
13764,0,0,0,0,52,1,675,0,1,1417500,2341800,30.0,666,2709,2475,900,46736,660908,478768,2368,3502,2836,4177,5311,39.68626966596886,15.833855784025385,1134,1,165600,46566,1575,0,1702,1027
13765,0,0,0,1,68,1,1406,0,0,1250832,6924104,44.98888751680797,1499,3167,2642,2024,40992,766304,626043,2896,5445,3946,4039,6588,24.859605789312106,22.968869211159312,2549,1,370392,94500,618,0,1397,2803
13766,0,0,0,0,56,1,1361,1,0,1532076,5906446,45.749316934791494,1763,3155,2825,2093,54988,657526,665992,2492,4915,3152,3554,5977,27.055498516937366,18.295294246874324,2423,1,493948,42240,732,0,729,2090
13767,0,0,0,1,65,1,1063,0,0,5712660,9750560,54.589376255824725,2853,5024,4897,2980,49896,706752,755832,3145,6252,3399,5189,8296,43.78355855797927,11.270126310527191,3107,1,688380,14732,1917,0,292,1355
13768,0,0,1,0,64,1,1006,0,0,6285240,9819540,55.31726674375732,2792,5382,5114,3060,52080,696353,770160,2941,6269,3477,5263,8591,45.32107677449864,16.479924852628645,3328,1,734400,27872,2054,0,149,1155
13769,0,0,0,0,53,1,1611,0,1,1540090,6121515,47.80167361086848,2255,2989,2959,2285,53297,597417,640281,2649,4964,2709,3353,5668,25.96150997149434,5.531194905403055,2315,1,546115,3390,674,0,394,2005
13770,0,0,0,0,51,1,872,1,0,2827073,5645454,46.61544808322666,2143,3504,3474,2173,47742,566364,568962,2568,4771,2628,3899,6102,36.069377593742864,5.478746393072713,2203,1,475887,3990,1301,0,425,1297
13771,0,0,0,0,51,1,112,0,0,1752489,3535360,37.16180835212409,1351,2680,2650,1381,49000,640000,501760,2530,3941,2590,3829,5240,35.62302626111375,5.652706486041966,1411,0,270676,5730,1269,0,1179,1291
13772,0,1,0,1,70,0,1393,0,0,2789178,8783530,50.05996404313531,1604,4521,3619,2506,49848,704505,869240,2603,6011,4407,4618,8026,33.36165463522455,30.47034140314815,3408,1,621488,64042,1113,0,999,2392
13773,0,0,0,1,67,1,1033,0,0,1220408,5893720,41.66533331199932,1386,2789,2439,1736,47736,794430,692580,3045,5131,3745,4098,6184,26.514147167125703,18.75488327714228,2086,1,354144,59150,703,0,1659,2692
13774,0,0,0,1,68,1,1321,0,0,3662340,9190755,51.81698563212646,2204,4530,4049,2685,52212,780444,783867,2942,6108,3904,4787,7953,36.932370625238775,22.06034945790158,3166,1,614865,63492,1364,0,738,2059
13775,0,0,0,0,56,1,1108,1,0,1877568,5781040,45.077710678338576,1450,3538,2956,2032,45248,637280,574690,2263,4877,3427,3769,6383,30.397368307141328,24.24351965835115,2614,1,410464,93120,924,0,813,1921
13776,0,1,1,0,60,0,145,0,0,513864,1966680,25.45584412271571,606,1483,1441,648,53424,643420,764820,2993,3683,3077,3828,4518,28.160255680657446,6.484411467763075,690,1,163296,3066,793,0,2387,2242
13777,0,0,1,0,54,1,1846,0,0,1241880,6429810,48.68264577855234,2370,2894,2894,2370,52212,621277,618564,2713,5083,2713,3237,5607,22.891046284519195,0.0,2370,1,540360,0,524,0,343,2189
13778,0,0,1,0,54,1,1822,0,0,1278383,6396641,48.61069841094653,2363,2904,2904,2363,53820,622610,633438,2707,5070,2707,3248,5611,23.259406699226016,0.0,2363,1,552942,0,541,0,344,2166
13779,0,0,0,0,51,1,103,0,0,1900368,3650481,37.82856063875548,1431,2759,2759,1431,53628,627546,556118,2551,3982,2551,3879,5310,36.4417343165772,0.0,1431,0,311958,0,1328,0,1120,1223
13780,0,0,0,1,67,1,1294,0,0,4536467,9696375,53.600373133029585,2749,4576,4452,2873,48760,715500,776250,3251,6248,3499,4954,7951,39.736632972611055,11.255953434413934,2997,1,660790,14012,1579,0,502,1796
13781,0,0,0,0,57,1,1300,1,0,1726656,6072920,46.0,1534,3514,2932,2116,43290,637140,559650,2288,4986,3452,3686,6384,28.5657137141714,24.314997008631234,2698,1,412620,96612,816,0,754,2054
13782,0,0,1,0,53,1,1831,0,0,1312482,6421872,48.80573736764972,2322,2993,2933,2382,48614,587728,601208,2636,5078,2756,3247,5689,23.473389188611005,7.765259411425052,2442,1,531186,7740,551,0,314,2145
13783,0,0,0,0,50,1,143,1,0,1875900,3299400,36.05551275463989,1258,2785,2743,1300,42387,540594,505062,2496,3838,2580,3981,5323,37.986839826445156,6.495386533491135,1342,1,258700,6342,1443,0,1238,1095
13784,0,1,0,1,69,0,1322,0,0,2857304,8618956,49.759421218498915,1601,4505,3630,2476,50960,724048,852845,2606,5957,4356,4635,7986,33.97057550292606,29.944671198369193,3351,1,606620,74375,1154,0,1005,2327
13785,0,1,0,1,65,0,79,0,0,2896946,5472933,40.779897008207364,1363,3705,3405,1663,46116,621999,803004,2991,4954,3591,5033,6996,41.737273509418415,17.32743212587264,1963,1,405772,18600,1742,0,1628,1549
13786,0,0,0,1,67,1,1384,0,0,4186736,9691096,53.40411969127476,2605,4567,4320,2852,49450,730570,781540,3151,6250,3645,4866,7965,38.31448812133603,15.868630154934264,3099,1,655960,28899,1468,0,546,1930
13787,0,0,0,0,56,1,1614,1,0,1373680,6348810,47.22287581247038,1868,3208,2846,2230,38745,538083,583635,2485,5077,3209,3463,6055,24.819347291981714,19.26010070863936,2592,1,457150,41268,616,0,617,2231
13788,0,0,0,0,51,1,312,0,1,1080265,2284935,29.916550603303182,576,2421,2102,895,55418,584637,617826,2234,3448,2872,3760,4974,34.741905532080416,18.001457299008262,1214,1,216590,36366,1207,0,1658,1346
13789,0,0,0,0,51,1,289,0,1,705876,1806108,26.60826939130014,389,2024,1705,708,55860,624995,581628,2232,3259,2870,3548,4575,31.575306807693888,18.259837210818738,1027,1,161424,47212,997,0,1843,1554
13790,0,0,0,1,68,1,1246,0,0,1042287,6208247,42.649736224272246,1335,2876,2392,1819,41132,771338,621166,2929,5232,3897,3986,6289,23.93741840717165,22.06814627630503,2303,1,331058,88572,573,0,1594,2840
13791,0,0,0,1,67,1,1328,0,0,4978688,10056112,54.699177324709375,2902,4746,4656,2992,44197,648673,769669,3271,6353,3451,5025,8107,40.792156108742276,9.52871847115494,3082,1,685168,8010,1664,0,369,1697
13792,0,0,0,1,66,1,1217,0,0,5762780,10199010,55.54277630799526,2923,5115,4953,3085,49665,710790,763686,3144,6391,3468,5174,8421,43.22036556994862,12.748363342157862,3247,1,712635,18468,1868,0,221,1438
13793,0,0,0,1,65,1,1142,0,0,6145895,10223430,55.812185049503306,2881,5322,5088,3115,51840,708912,787680,3048,6397,3516,5255,8604,44.41846462902562,15.33075055979848,3349,1,747600,24102,1973,0,167,1309
13794,0,0,0,0,57,1,1253,1,0,1895154,6134652,46.24932431938871,1443,3721,3025,2139,46200,630960,602280,2172,5007,3564,3754,6589,29.765752132274432,26.501302153527266,2835,1,449190,101616,886,0,729,1982
13795,0,0,0,0,52,1,248,1,0,2353145,4340430,40.779897008207364,1451,3290,3078,1663,41829,498510,571590,2398,4273,2822,4025,5900,37.61648574760805,14.910913195537242,1875,1,364197,20988,1415,0,947,1195
13796,0,0,0,0,50,1,310,1,0,1978200,3211740,35.4964786985977,1140,2950,2830,1260,37185,471565,512349,2429,3809,2669,4119,5499,39.6232255123179,11.111005581829925,1380,1,253260,13440,1570,0,1289,979
13797,0,0,0,0,50,1,468,1,0,1924893,2955960,34.249087579087416,1143,2844,2814,1173,44075,516600,541800,2490,3693,2550,4161,5364,40.50925820105819,5.501408174353464,1203,1,252195,3630,1641,0,1347,879
13798,0,0,0,0,50,1,520,0,1,1685376,2700432,32.61901286060018,956,2756,2648,1064,50546,644652,505062,2430,3602,2646,4122,5294,39.7994974842648,10.640744280253392,1172,1,211736,19440,1584,0,1474,954
13799,0,1,0,1,69,0,1292,0,0,2902368,8566428,49.678969393496885,1596,4516,3644,2468,51240,728910,846924,2599,5939,4343,4647,7987,34.292856398964496,29.859948250000876,3340,1,602192,77608,1176,0,1003,2295
13800,0,0,0,1,67,1,1455,0,0,4326156,9956607,54.13871073455665,2715,4623,4407,2931,48608,737149,760928,3181,6328,3613,4873,8020,38.41874542459709,14.875115696189704,3147,1,656544,27216,1476,0,466,1921
13801,0,0,0,1,67,1,1348,0,0,5172108,10204100,55.190578906186516,2922,4868,4744,3046,49060,737000,747050,3226,6396,3474,5048,8218,41.20679555607303,11.135709774976435,3170,1,679258,16368,1698,0,304,1652
13802,0,0,0,0,57,1,1434,1,0,1688167,6354287,46.9148164229596,1594,3575,2968,2201,42784,646688,551417,2280,5088,3494,3654,6462,27.694764848252458,24.878557972228833,2808,1,420391,104404,767,0,686,2120
13803,0,0,0,0,57,1,1469,1,0,1637610,6382480,47.01063709417264,1631,3530,2951,2210,44457,632472,586264,2309,5098,3467,3629,6418,27.2213151776324,24.325164195971247,2789,1,448630,88587,741,0,678,2147
13804,0,0,1,0,54,1,2035,0,0,1097754,6727770,49.77951385861457,2358,3041,2921,2478,42021,562005,551145,2595,5193,2835,3158,5756,21.047565179849187,10.955211796648204,2598,1,503034,16560,443,0,237,2272
13805,0,0,0,0,51,1,251,1,0,2076612,3394970,36.345563690772494,1171,3043,2893,1321,34216,467740,483160,2420,3891,2720,4142,5613,39.64845520319802,12.459604606992961,1471,1,248348,18450,1572,0,1249,998
13806,0,0,0,0,50,1,200,0,1,724449,1920509,27.51363298439521,480,1991,1714,757,56619,616491,591121,2260,3294,2814,3494,4528,30.93541659651604,16.996538735441106,1034,1,176381,37672,957,0,1780,1580
13807,0,0,0,1,67,1,1378,0,0,5270888,10338100,55.5517776493246,2924,4956,4794,3086,51980,757100,770500,3188,6436,3512,5058,8306,41.32795663954365,12.728043305644134,3248,1,709780,20736,1708,0,264,1642
13808,0,0,1,0,54,1,2141,0,0,955080,6889680,50.19960159204453,2370,3049,2899,2520,45305,560470,604214,2584,5254,2884,3113,5783,19.467922333931785,12.30702509692623,2670,1,556920,17250,379,0,214,2355
13809,0,0,0,0,53,1,1300,1,0,2675100,6386500,49.09175083453431,2302,3628,3520,2410,50190,556500,633350,2542,5060,2758,3760,6278,33.31666249791537,10.551011889467135,2518,1,575990,10368,1110,0,240,1540
13810,0,0,0,0,52,1,678,1,0,3537000,5915250,47.43416490252569,2060,4012,3822,2250,39528,567864,481107,2439,4879,2819,4201,6641,39.64845520319802,13.886846184065407,2440,1,411750,32300,1572,0,379,1057
13811,0,1,0,1,68,0,1088,0,0,3071289,8198034,48.774993593028796,1580,4469,3670,2379,53799,816702,782242,2647,5825,4245,4737,7915,35.93048844644336,28.549247048390054,3178,1,540033,115855,1291,0,1067,2155
13812,0,0,0,1,68,1,1279,0,0,968142,6222216,42.579337712087536,1261,2899,2347,1813,34821,751608,545688,2880,5245,3984,3966,6331,23.108440016582687,23.61407261733835,2365,1,288267,109296,534,0,1619,2898
13813,0,0,0,0,57,1,1379,1,0,1885422,6415332,47.18050444834179,1485,3814,3073,2226,43357,654214,550462,2141,5108,3623,3729,6696,29.103264421710495,27.386578213808498,2967,1,425166,130416,847,0,656,2035
13814,0,0,0,0,55,1,2215,1,0,854250,7015050,50.49752469181039,2360,3075,2885,2550,45938,566706,613473,2561,5301,2941,3086,5826,18.303005217723125,13.919868588335374,2740,1,568650,21660,335,0,201,2416
13815,0,0,0,0,51,1,259,1,0,2225736,3548592,36.98648401781386,1158,3205,2995,1368,38808,508424,513612,2384,3962,2804,4221,5799,40.33608806019741,14.769248280398969,1578,1,270864,27510,1627,0,1226,967
13816,0,1,0,1,68,0,511,0,0,3340590,7179117,45.83666654546336,1506,4286,3691,2101,51067,761991,782493,2822,5518,4012,5007,7703,39.87480407475377,24.714241762089088,2696,1,481129,75565,1590,0,1316,1827
13817,0,0,0,1,67,1,646,0,0,1238952,4998786,38.49675310984031,1106,2694,2318,1482,44969,785909,650989,2997,4855,3749,4209,6067,28.91366458960192,19.44266430755012,1858,1,286026,67680,836,0,1891,2537
13818,0,0,0,1,67,1,814,0,0,1177632,5300910,39.57271787481876,1140,2744,2318,1566,43968,775165,649920,2959,4951,3811,4137,6129,27.422618401604176,20.71048612983299,1992,1,300672,75402,752,0,1819,2633
13819,0,0,0,1,66,1,1422,0,0,5590440,10583040,56.39148871948674,2924,5194,4938,3180,51146,712192,795392,3072,6508,3584,5086,8522,41.92851058647326,16.024358381266456,3436,1,760020,26368,1758,0,148,1570
13820,0,0,0,0,57,1,1491,1,0,1771380,6579087,47.65501022977542,1573,3749,3051,2271,37840,622855,509872,2199,5168,3595,3677,6646,27.92848008753788,26.64932635544011,2969,1,399696,124244,780,0,626,2117
13821,0,0,0,0,58,1,1527,1,0,1713808,6611379,47.738873049120045,1608,3702,3031,2279,39096,626616,525081,2230,5180,3572,3653,6603,27.422618401604176,26.16191432563746,2950,1,412499,116083,752,0,622,2149
13822,0,0,0,0,58,1,1598,1,0,1602608,6672176,47.916594202843754,1678,3612,2994,2296,43143,636414,572482,2288,5202,3524,3604,6518,26.419689627245813,25.172588551929152,2914,1,452312,98880,698,0,610,2208
13823,0,0,0,0,50,1,361,0,0,1810226,2950739,34.307433596816885,1147,2745,2715,1177,50508,611708,518949,2477,3684,2537,4045,5252,39.21734310225516,5.490867587491313,1207,0,243639,5280,1538,0,1330,969
13824,0,0,0,0,50,1,262,0,1,1588128,2861584,33.704599092705436,1076,2594,2534,1136,53928,634788,539066,2459,3655,2579,3917,5113,37.389838191679836,7.994134176674909,1196,1,243104,9900,1398,0,1383,1121
13825,0,0,0,0,50,1,124,0,1,1075677,2463994,31.25699921617557,735,2320,2078,977,55902,582582,610324,2280,3499,2764,3623,4842,33.18132004607411,15.641708141339256,1219,1,236434,27830,1101,0,1545,1421
13826,0,0,0,0,52,1,241,1,0,2477142,3824334,38.18376618407357,1163,3452,3157,1458,43215,563945,527223,2328,4081,2918,4322,6075,41.2189276910499,17.52940394318896,1753,1,293058,44545,1699,0,1165,924
13827,0,0,0,0,49,1,108,0,1,565600,1984448,28.42534080710379,778,1538,1508,808,54054,574704,567336,2426,3264,2486,3156,3994,26.457513110645905,5.483301264452448,838,1,186648,4110,700,0,1648,1756
13828,0,0,1,0,64,1,1032,0,0,1704960,2847816,29.79932885150268,330,3366,2808,888,49200,769680,657435,2649,4095,3765,5127,6573,43.81780460041329,23.632050549476407,1446,1,182040,97092,1920,0,2319,1287
13829,0,0,0,1,68,1,1710,0,0,4349491,10629671,55.758407437802596,2774,4843,4508,3109,43956,676962,759018,3084,6528,3754,4818,8262,37.403208418530085,18.4996026760834,3444,1,690198,34840,1399,0,310,2020
13830,0,0,0,0,52,1,301,0,1,2532552,3803896,38.05259518088089,1151,3494,3197,1448,47952,583194,567432,2330,4075,2924,4376,6121,41.82104733265297,17.806309616952312,1745,1,312768,42174,1749,0,1179,878
13831,0,0,0,0,49,1,142,0,0,1671984,3058776,34.9857113690718,1194,2620,2590,1224,51528,569772,564774,2469,3723,2529,3865,5119,36.959437225152655,5.478746393072713,1254,0,276624,4080,1366,0,1275,1133
13832,0,0,0,0,50,1,104,0,0,1700321,3132500,35.397740040855716,1193,2670,2610,1253,46842,527500,555000,2440,3753,2560,3857,5170,36.837480912787726,7.750803389552748,1313,0,278166,7320,1357,0,1247,1143
13833,0,0,0,0,50,1,13,0,1,1328214,2871876,33.85262175962151,1061,2390,2305,1146,55000,626500,551320,2421,3652,2591,3665,4896,34.044089061098404,9.344583777936014,1231,1,252120,13515,1159,0,1360,1347
13834,0,0,0,1,68,1,805,0,0,1201050,5341140,39.6232255123179,1054,2851,2335,1570,38763,745038,602154,2886,4972,3918,4167,6253,27.65863337187866,22.83783856045723,2086,1,277890,93396,765,0,1832,2637
13835,0,0,0,1,68,1,1810,0,0,4234479,10836861,56.15158056546583,2751,4898,4496,3153,47520,742392,756140,3035,6590,3839,4780,8335,36.64696440361739,20.285934458574264,3555,1,693660,51858,1343,0,284,2094
13836,0,0,1,0,53,1,1547,0,0,2767088,6921632,51.068581339214816,2608,3669,3669,2608,49476,575918,605112,2654,5262,2654,3715,6323,32.57299494980466,0.0,2608,0,594624,0,1061,0,46,1593
13837,0,0,1,0,53,1,253,0,0,3309150,5200650,44.15880433163923,1908,3689,3647,1950,54056,621411,618744,2625,4617,2709,4364,6356,41.19465984809196,6.484411467763075,1992,1,452400,5586,1697,0,717,970
13838,0,0,0,0,52,1,362,0,1,2679848,3848250,38.28837943815329,1166,3594,3294,1466,51959,585375,611625,2325,4091,2925,4453,6219,42.7551166528639,17.83749006715356,1766,1,341578,36300,1828,0,1159,797
13839,0,0,0,0,51,1,283,1,0,2304078,3572289,37.1887079635741,1191,3241,3049,1383,48138,550179,583758,2391,3966,2775,4249,5824,40.8166632639171,14.369918301307246,1575,1,312558,22848,1666,0,1200,917
13840,0,0,0,1,67,1,543,0,0,1317508,4908733,38.09199390948182,993,2817,2359,1451,37518,751026,571727,2925,4834,3841,4291,6200,30.133038346638727,21.539258372745223,1909,1,245219,87936,908,0,1932,2475
13841,0,0,1,0,64,1,1261,0,0,7899750,11389684,59.253691868102194,3361,5911,5761,3511,44084,668264,694216,3094,6755,3394,5494,9155,47.43416490252569,12.449381359612769,3661,1,751354,18600,2250,0,267,994
13842,0,0,1,0,53,1,337,0,0,3721640,5656135,45.880278987817846,1985,3993,3873,2105,54502,639506,615323,2567,4792,2807,4455,6680,42.04759208325728,10.969823458961839,2225,1,482045,17160,1768,0,582,919
13843,0,1,1,0,64,0,5,0,0,1670550,4155655,35.98610843089316,972,2908,2585,1295,42781,574411,766951,2886,4504,3532,4499,6117,35.91656999213594,18.040713851564195,1618,1,309505,17765,1290,0,1914,1919
13844,0,0,0,1,65,1,1412,0,0,7363980,11516310,59.2452529743945,3210,5908,5608,3510,45333,679167,718539,2981,6791,3581,5379,9189,45.803929962395145,17.934485436933898,3810,1,768690,35700,2098,0,229,1183
13845,0,0,1,0,65,1,1356,0,0,7731360,11547480,59.49789912257407,3330,5934,5724,3540,43143,642614,714378,3052,6802,3472,5446,9196,46.73328578219169,14.857157716059705,3750,1,775260,22260,2184,0,278,1078
13846,0,1,1,0,63,0,12,0,0,1605253,4071054,35.679125549822544,988,2819,2534,1273,48360,623610,793104,2913,4471,3483,4459,6017,35.510561809129406,16.92547308304612,1558,1,315704,17670,1261,0,1925,1937
13847,0,0,1,0,54,1,755,0,0,3851496,6434208,48.744230427815765,1925,4448,3997,2376,50151,620132,593052,2257,5084,3159,4329,7156,40.26164427839479,21.26021357850731,2827,1,520344,66297,1621,0,332,1087
13848,0,0,1,0,54,1,652,0,0,3921773,6308432,48.30113870293329,1942,4405,4014,2333,51726,630032,600288,2313,5037,3095,4385,7109,41.0,19.795542342693437,2724,1,517926,57086,1681,0,371,1023
13849,0,0,0,0,51,1,146,0,1,2292927,3731598,37.986839826445156,1227,3248,3032,1443,42846,499098,574092,2370,4029,2802,4175,5834,39.8622628559895,15.132096632713768,1659,1,320346,20952,1589,0,1143,997
13850,0,0,0,0,49,1,88,0,1,1565568,3224448,36.0,1266,2534,2504,1296,48070,519992,572240,2458,3784,2518,3696,5022,34.75629439396553,5.490867587491313,1326,1,298080,3270,1208,0,1192,1280
13851,0,1,1,0,64,0,14,0,0,1932051,4538853,37.376463182061514,1078,3099,2780,1397,51092,688788,783009,2930,4646,3568,4632,6348,37.1887079635741,18.135004741653518,1716,1,336677,30943,1383,0,1852,1866
13852,0,0,0,0,56,1,457,1,0,942794,3485518,35.014282800023196,920,2301,1995,1226,41924,534484,633989,2537,4069,3149,3612,5144,27.730849247724095,18.722664278748045,1532,1,273398,27234,769,0,1617,2074
13853,0,0,1,0,65,1,1140,0,0,8856000,11746800,60.0,3492,6168,6060,3600,42460,717860,629759,3155,6863,3371,5723,9431,49.59838707054898,10.60004836173973,3708,1,694800,17928,2460,0,337,803
13854,0,0,0,0,52,1,249,0,1,2859220,4117591,39.63584236521283,1209,3753,3391,1571,54692,592346,634282,2259,4192,2983,4441,6374,42.661458015403085,19.232573309194525,1933,1,380182,40182,1820,0,1050,801
13855,0,0,0,0,50,1,192,1,0,409393,1863444,27.258026340878022,635,1402,1294,743,23664,511632,290928,2400,3251,2616,3059,3910,23.473389188611005,10.96830808063325,851,1,86188,23652,551,0,1765,1957
13856,0,1,0,1,68,0,464,0,0,3458052,7215156,45.89117562233506,1338,4516,3748,2106,54492,781128,818814,2658,5532,4194,5068,7942,40.52159917870962,28.140351988050863,2874,1,503334,90624,1642,0,1320,1784
13857,0,1,0,1,65,0,15,0,0,2379250,5093300,39.370039370059054,1142,3493,3085,1550,53040,726206,788640,2878,4836,3694,4821,6779,39.179076048319466,20.62234427799285,1958,1,372000,44880,1535,0,1736,1751
13858,0,0,1,0,57,1,456,0,0,756217,3234490,33.57082066318904,719,2206,1798,1127,39690,602700,542430,2462,3997,3278,3541,5076,25.903667693977237,21.295688285113627,1535,1,213003,64056,671,0,1743,2199
13859,0,0,0,0,57,1,457,1,0,964860,3525450,35.17101079013795,942,2312,2017,1237,41528,510150,661200,2555,4087,3145,3630,5162,27.92848008753788,18.561835162882343,1532,1,286984,18585,780,0,1613,2070
13860,0,0,0,0,55,1,524,1,0,2637381,5309088,43.669211121796096,1594,3603,3290,1907,29140,654240,345216,2471,4691,3097,4167,6387,37.1887079635741,18.462730300468674,2220,1,236468,74807,1383,0,877,1401
13861,0,0,0,1,68,1,669,0,0,1338930,5240295,39.230090491866065,962,2986,2409,1539,43497,827415,609495,2828,4944,3982,4275,6391,29.49576240750525,24.23616496362775,2116,1,275481,116554,870,0,1866,2535
13862,0,0,0,0,52,1,79,0,1,2365422,3900398,38.71692136521188,1231,3345,3077,1499,49006,556828,595858,2334,4101,2870,4180,5947,39.72404813208241,16.833044049570994,1767,1,343271,31088,1578,0,1103,1024
13863,0,0,0,0,49,1,145,0,1,944394,2587137,32.357379374726875,1017,1979,1949,1047,53966,597982,551033,2441,3518,2501,3373,4450,30.033314835362415,5.490867587491313,1077,1,233481,4650,902,0,1424,1569
13864,0,0,0,0,49,1,167,0,0,566834,2074747,29.0,841,1515,1515,841,47532,574811,503268,2467,3308,2467,3141,3982,25.96150997149434,0.0,841,0,171564,0,674,0,1626,1793
13865,0,0,0,0,57,1,457,1,0,989208,3567144,35.34119409414458,964,2326,2041,1249,42240,502656,685440,2571,4105,3141,3648,5182,28.142494558940577,18.418357856183633,1534,1,299760,13395,792,0,1607,2064
13866,0,0,0,1,67,1,522,0,0,1422720,5019534,38.49675310984031,913,3011,2442,1482,46215,802719,660465,2818,4869,3956,4347,6398,30.983866769659336,24.032233903265443,2051,1,288990,103558,960,0,1905,2427
13867,0,0,0,1,68,1,1939,0,0,4967400,11617800,58.309518948453004,2860,5401,4861,3400,43164,676566,744906,2877,6817,3957,4878,8818,38.22302970723278,23.329480095189204,3940,1,741200,59400,1461,0,17,1956
13868,0,0,1,0,54,1,418,0,0,4237080,6152878,47.7283982551269,2036,4380,4138,2278,46221,586117,575313,2459,4979,2943,4561,7081,43.12771730569565,15.59136036785464,2520,1,485214,33638,1860,0,423,841
13869,0,0,0,0,53,1,41,0,1,3558462,5097411,43.669211121796096,1787,3893,3773,1907,55144,652212,604098,2553,4580,2793,4539,6566,43.197222132910355,11.080810612286749,2027,1,430982,18120,1866,0,766,807
13870,0,0,0,0,53,1,52,1,0,3470093,4869887,42.86023798347368,1609,3954,3726,1837,46662,535502,612381,2423,4488,2879,4540,6605,43.46262762420146,15.110114860095715,2065,1,424347,22572,1889,0,814,762
13871,0,1,0,1,68,0,438,0,0,3448939,7138113,45.70557952810576,1386,4443,3740,2089,54273,782493,809829,2714,5506,4120,5068,7860,40.63249930782009,26.957017829498692,2792,1,495093,86469,1651,0,1328,1766
13872,0,0,0,0,56,1,457,1,0,1189898,3777859,36.64696440361739,1153,2419,2229,1343,45682,511966,706063,2623,4156,3003,3699,5232,29.765752132274432,15.381906354258097,1533,1,337093,6840,886,0,1470,1927
13873,0,0,0,1,67,1,538,0,0,1443000,5085000,38.72983346207417,947,3015,2462,1500,44969,789870,654270,2837,4890,3943,4352,6405,31.016124838541646,23.56579594526109,2053,1,289500,99540,962,0,1890,2428
13874,0,0,1,0,53,1,278,0,0,4261440,5950560,46.98936049788292,2046,4300,4138,2208,47523,590205,584815,2533,4903,2857,4625,6995,43.93176527297759,12.758848143974324,2370,1,479136,22194,1930,0,487,765
13875,0,0,0,0,53,1,203,1,0,4003710,5641400,45.880278987817846,1985,4127,4007,2105,46655,576200,581560,2560,4785,2800,4582,6807,43.61192497471305,10.969823458961839,2225,1,456785,15840,1902,0,575,778
13876,0,0,0,0,52,1,178,1,0,3455400,4624920,42.09513035969837,1475,4019,3722,1772,54288,610740,605520,2313,4382,2907,4560,6629,44.15880433163923,17.23959494577348,2069,1,411104,40095,1950,0,838,660
13877,0,0,0,0,52,1,159,0,1,2984850,4314750,40.620192023179804,1367,3742,3459,1650,54044,598835,617140,2332,4265,2898,4424,6357,42.532340636273474,17.074212406068007,1933,1,389400,34809,1809,0,965,806
13878,0,0,0,0,51,1,91,0,1,2702310,4151004,39.98749804626441,1357,3531,3289,1599,53714,651596,555544,2354,4195,2838,4286,6127,41.10960958218893,15.726270627932008,1841,1,342186,40898,1690,0,997,906
13879,0,0,0,0,52,1,34,0,1,2505600,4074732,39.57271787481876,1326,3406,3166,1566,55161,632286,590654,2362,4168,2842,4202,6008,40.0,15.905414575341013,1806,1,355482,35760,1600,0,1036,1002
13880,0,1,0,1,69,0,992,0,0,3337433,8299386,48.877397639399746,1482,4693,3786,2389,54054,812916,802494,2567,5863,4381,4871,8167,37.376463182061514,30.634493020339917,3296,1,551859,123352,1397,0,1085,2077
13881,0,1,0,1,67,0,33,0,0,3198460,6077435,42.485291572496,1273,4109,3577,1805,53500,720538,841750,2835,5172,3899,5139,7476,42.09513035969837,23.422562660938883,2337,1,451250,44688,1772,0,1562,1595
13882,0,0,0,0,53,1,8,0,1,3744209,5179069,44.034077712607996,1831,3978,3870,1939,49646,643711,550226,2563,4610,2779,4602,6649,43.94314508543966,10.562698776726089,2047,1,399434,18684,1931,0,732,740
13883,0,0,0,0,49,1,125,0,0,890064,2492784,31.74901573277509,966,1933,1891,1008,49060,544060,551479,2431,3481,2515,3356,4406,29.715315916207253,6.488991180673202,1050,0,224784,5502,883,0,1465,1590
13884,0,0,1,0,57,1,434,0,0,808536,3301522,33.793490497431605,722,2270,1850,1142,39424,647584,508816,2471,4033,3311,3599,5161,26.60826939130014,21.763906013675356,1562,1,200992,78540,708,0,1749,2183
13885,0,0,1,0,54,1,1032,0,0,3940345,7023312,50.665570163573605,2064,4605,4102,2567,47080,601920,585504,2233,5303,3239,4271,7341,39.179076048319466,22.681794429277964,3070,1,549338,70923,1535,0,169,1201
13886,0,0,0,0,52,1,162,1,0,3679839,4803468,42.883563284783136,1605,4074,3840,1839,51788,558968,632104,2378,4451,2846,4613,6686,44.73253849269008,15.302712601452019,2073,1,445038,22932,2001,0,773,611
13887,0,0,0,0,51,1,154,1,0,321255,1659493,25.475478405713993,457,1336,1144,649,32100,547198,383550,2365,3206,2749,3052,3893,22.24859546128699,14.57647171859062,841,1,97350,38592,495,0,1908,2062
13888,0,1,0,1,69,0,872,0,0,3446553,8102094,48.40454524112379,1519,4638,3814,2343,56160,829920,809172,2634,5801,4282,4929,8096,38.353617821530214,29.22613292121345,3167,1,548262,112888,1471,0,1115,1987
13889,0,1,0,1,68,0,705,0,0,3385746,7652988,47.18050444834179,1500,4473,3747,2226,50218,725418,818244,2712,5664,4164,4959,7911,39.0,27.46612151890108,2952,1,529788,72600,1521,0,1212,1917
13890,0,1,0,1,68,0,455,0,0,3277044,6985008,45.2990066116245,1457,4244,3649,2052,54273,806748,779516,2809,5456,3999,5001,7648,39.96248240537617,24.881414919709286,2647,1,469908,84490,1597,0,1352,1807
13891,0,1,1,0,64,0,49,0,0,1963602,4597424,37.76241517699841,1251,2978,2803,1426,45198,599664,783432,3049,4650,3399,4601,6202,37.107950630558946,13.57796224751577,1601,1,346518,10150,1377,0,1798,1847
13892,0,0,1,0,61,1,670,0,0,3551171,6947161,47.4236228055175,1791,4286,3828,2249,55104,759894,691936,2631,5338,3547,4668,7375,39.736632972611055,21.501457270676152,2707,1,503776,70532,1579,0,840,1510
13893,0,0,0,1,68,1,584,0,0,1512432,5295068,39.44616584663204,1090,2994,2528,1556,45120,799705,653376,2937,4959,3869,4375,6397,31.176914536239792,21.688114695078472,2022,1,298752,85278,972,0,1847,2431
13894,0,0,0,1,68,1,690,0,0,1461024,5470830,40.024992192379,1148,2968,2514,1602,42897,809355,618115,2961,5017,3869,4327,6383,30.199337741083,21.455005986548535,2056,1,289962,88984,912,0,1813,2503
13895,0,0,0,1,69,1,2211,0,0,4204440,11950365,58.60887304837041,2751,5343,4659,3435,51528,786254,793212,2795,6914,4163,4703,8822,34.9857113690718,26.386439889264818,4119,1,783180,89604,1224,0,44,2255
13896,0,0,1,0,54,1,1204,0,0,3840096,7279740,51.49757275833493,2222,4530,4100,2652,48972,634095,581940,2315,5397,3175,4193,7275,38.05259518088089,21.00062085574041,3082,1,562224,67080,1448,0,93,1297
13897,0,0,1,0,53,1,191,0,0,4344362,5882672,46.71188285650665,1972,4383,4173,2182,46224,582336,576944,2486,4878,2906,4687,7079,44.62062303464621,14.542450268973452,2392,1,466948,28770,1991,0,514,705
13898,0,0,0,0,52,1,121,0,1,3828146,5019462,43.55456348076513,1727,4085,3915,1897,45201,484218,653562,2476,4543,2816,4664,6731,44.9221548904324,13.102891263230726,2067,1,468559,7990,2018,0,749,628
13899,0,0,0,0,57,1,433,1,0,1019184,3604614,35.34119409414458,919,2395,2065,1249,45318,525252,718614,2556,4135,3216,3702,5281,28.5657137141714,19.832148744518605,1579,1,311001,13860,816,0,1637,2070
13900,0,0,1,0,63,1,717,0,0,1495828,2888148,30.265491900843113,826,2639,2549,916,52704,769332,681048,3063,4069,3243,4786,5792,40.4103947023535,9.580310602724222,1006,0,197856,14850,1633,1,2237,1520
13901,0,0,0,1,69,1,2247,0,0,4211008,12051240,58.84725991921799,2750,5392,4679,3463,51302,786480,789960,2767,6943,4193,4696,8872,34.87119154832539,26.924607328575885,4176,1,786101,94829,1216,0,17,2264
13902,0,0,1,0,54,1,1375,0,0,3727794,7510328,52.316345438113316,2375,4461,4099,2737,49115,644840,573496,2382,5481,3106,4106,7205,36.90528417449187,19.29527580699211,3099,1,572033,59368,1362,0,7,1382
13903,0,0,1,0,54,1,1120,0,0,3975441,7229988,51.29327441292864,2134,4639,4142,2631,46631,607308,579828,2251,5379,3245,4259,7387,38.87158345115362,22.56163788754017,3128,1,555141,72562,1511,0,117,1237
13904,0,0,0,0,53,1,148,1,0,4354268,5826590,46.49731175025068,2000,4338,4176,2162,48180,590205,592900,2533,4857,2857,4709,7033,44.87761134463375,12.927016270999431,2324,1,475640,21546,2014,0,533,681
13905,0,0,0,0,50,1,97,1,0,1275678,2989944,34.336569426778794,1071,2369,2261,1179,47268,593424,512272,2428,3715,2644,3618,4905,32.89376840679705,10.60004836173973,1287,1,238158,18576,1082,0,1357,1454
13906,0,0,0,1,69,1,2196,0,0,4660480,12203840,59.329587896765304,2798,5566,4844,3520,52170,769674,814745,2745,6987,4189,4791,9033,36.38681079732051,27.04771920092268,4242,1,827200,85196,1324,0,53,2143
13907,0,0,1,0,54,1,170,0,0,4542464,5995254,47.095647357266465,1990,4494,4266,2218,47742,589254,591957,2475,4921,2931,4751,7197,45.254833995939045,15.271081087865298,2446,1,485742,30552,2048,0,485,655
13908,0,0,1,0,57,1,413,0,0,1031690,3602214,35.25620512760839,883,2433,2073,1243,48954,576702,712908,2538,4141,3258,3728,5331,28.809720581775867,20.616983187782438,1603,1,305778,25560,830,0,1655,2068
13909,0,0,0,1,69,1,2212,0,0,4512789,12137967,59.16924876994806,2746,5545,4790,3501,55680,832080,804344,2712,6968,4222,4756,9012,35.90264614203248,27.643544598660146,4256,1,812232,104945,1289,0,34,2178
13910,0,0,0,0,53,1,78,1,0,4446360,5698644,46.34652090502587,2063,4303,4218,2148,51429,575701,628761,2568,4801,2738,4723,6956,45.4972526643093,9.235136611923052,2233,1,509076,9180,2070,0,505,583
13911,0,0,0,0,51,1,37,0,1,2884560,4385218,41.43669871020132,1650,3464,3397,1717,55902,618068,589974,2487,4271,2621,4234,6018,40.98780306383839,8.222029866439447,1784,1,396627,9447,1680,0,837,874
13912,0,0,0,0,50,1,81,0,0,1768590,3454920,37.027017163147235,1329,2703,2661,1371,43095,556920,491400,2478,3891,2562,3810,5223,35.91656999213594,6.495386533491135,1413,0,267345,6888,1290,0,1149,1230
13913,0,1,0,1,67,0,463,0,0,3081078,6740734,44.74371464239419,1556,3987,3541,2002,55000,740740,841750,2921,5369,3813,4906,7354,39.230090491866065,21.579971716270332,2448,1,500500,38802,1539,0,1365,1828
13914,0,0,0,1,68,1,1714,0,0,911640,7335920,46.26013402488151,1588,3118,2566,2140,56635,826148,805580,2876,5568,3980,3854,6546,20.639767440550294,23.79491217214831,2692,1,502900,73968,426,0,1288,3002
13915,0,0,0,1,68,1,2406,0,0,1311712,9771968,53.51635264103861,2689,3497,3322,2864,53874,839352,747228,3237,6276,3587,3870,6909,21.400934559032695,13.267569739724314,3039,1,627216,28350,458,0,548,2954
13916,0,0,1,0,55,1,1525,0,0,3747074,7835308,53.319789947073126,2482,4522,4161,2843,40128,576004,529152,2395,5599,3117,4074,7278,36.30426972134269,19.18619393981722,3204,1,545856,54872,1318,0,87,1438
13917,0,0,0,0,52,1,9,1,0,4462636,5531721,46.010868281309364,2087,4255,4225,2117,48618,572247,580086,2583,4730,2643,4721,6868,45.91296113299599,5.501408174353464,2147,1,469974,3930,2108,0,496,505
13918,0,0,0,0,52,1,74,0,0,4341687,5377469,45.24378410345447,2017,4198,4168,2047,50800,667258,525400,2597,4674,2657,4748,6825,46.05431575867782,5.514871952411144,2077,0,409400,5490,2121,0,580,506
13919,0,1,0,1,66,0,408,0,0,3027888,6523260,44.22668877499196,1572,3888,3504,1956,52250,697015,833750,2951,5291,3719,4883,7223,39.344631145812,19.932786938796074,2340,1,489000,23808,1548,0,1379,1787
13920,0,1,1,0,65,0,66,0,0,2530192,5307232,40.29888335921977,1339,3467,3182,1624,55687,761444,781052,2983,4892,3553,4826,6735,39.4715087119811,17.130983971056178,1909,1,388136,34770,1558,0,1644,1710
13921,0,0,0,1,67,1,443,0,0,2069418,4159814,35.12833614050059,474,3671,2911,1234,42336,728136,660716,2611,4605,4131,5048,7042,40.95119045888654,27.686652305207865,1994,1,241864,119320,1677,0,2137,1694
13922,0,0,0,1,67,1,2142,0,0,732600,8295474,49.416596402423345,2202,2982,2742,2442,55125,832265,764325,3157,5839,3637,3697,6379,17.320508075688775,15.491933384829668,2682,1,549450,36720,300,0,955,3097
13923,0,0,0,1,67,1,2287,0,0,1149464,9211978,52.06726418777925,2711,3135,3135,2711,54366,835908,750958,3398,6109,3398,3822,6533,20.591260281974,0.0,2711,1,599131,0,424,0,687,2974
13924,0,0,1,0,66,1,891,0,0,7779330,10902180,57.18391382198319,2875,6044,5649,3270,42021,690138,676802,2939,6604,3729,5713,9378,48.774993593028796,20.15597830211765,3665,1,663810,54905,2379,0,64,955
13925,0,0,1,0,55,1,1388,0,0,3953600,7747600,52.91502622129181,2350,4662,4212,2800,43780,608740,550633,2317,5567,3217,4179,7429,37.57658845611187,21.42222575325334,3250,1,557200,71550,1412,0,33,1355
13926,0,0,0,0,52,1,65,0,1,4033016,5153408,44.45222154178574,1881,4112,4017,1976,51700,573760,612880,2513,4584,2703,4649,6720,45.17742799230607,9.799287634083276,2071,1,464360,10925,2041,0,632,567
13927,0,0,0,0,50,1,57,1,0,1740268,3421224,36.71511950137164,1253,2734,2639,1348,34068,517752,423846,2443,3886,2633,3829,5272,35.93048844644336,9.799287634083276,1443,1,225116,16530,1291,0,1190,1247
13928,0,0,0,0,51,1,72,1,0,1528873,3247423,35.679125549822544,1123,2624,2474,1273,40232,545914,479588,2401,3824,2701,3752,5175,34.655446902326915,12.410850817228189,1423,1,239324,24600,1201,0,1278,1350
13929,0,0,0,0,51,1,110,0,1,57000,771000,17.320508075688775,17,773,490,300,55056,570540,637360,2287,2870,2853,2760,3343,13.784048752090222,17.695236144641566,583,1,74400,26885,190,0,2270,2380
13930,0,0,0,0,56,1,2741,1,0,1421402,9076576,56.45352070508977,3025,3795,3633,3187,38356,635104,489856,2686,6035,3010,3294,6643,21.118712081942874,13.020774002346478,3349,1,548164,30780,446,0,339,2402
13931,0,0,1,0,55,1,1353,0,0,4055848,7767173,52.92447448959697,2309,4741,4249,2801,45066,615606,562919,2281,5574,3265,4221,7514,38.05259518088089,22.389246655055864,3293,1,568603,77244,1448,0,28,1325
13932,0,0,0,0,50,1,16,0,0,2193297,3771637,38.58756276314948,1459,2992,2962,1489,52884,592722,572458,2503,4022,2563,4006,5525,38.379682124790975,5.490867587491313,1519,0,336514,4290,1473,0,1044,1060
13933,0,0,0,1,67,1,710,0,0,2276475,4029540,34.56877203488721,321,3974,3100,1195,39618,718236,627192,2498,4567,4246,5277,7346,43.64630568559039,29.661700189504238,2069,1,222270,144210,1905,0,2177,1467
13934,0,0,0,1,67,1,315,0,0,2143450,4452590,36.26292872893749,528,3732,2945,1315,41925,727990,660270,2599,4701,4173,5016,7118,40.3732584763727,28.078500345115835,2102,1,256425,124346,1630,0,2071,1756
13935,0,0,1,0,67,1,865,0,0,7527450,10756710,56.65686189686118,2759,6006,5555,3210,44310,707061,703710,2900,6561,3802,5696,9357,48.425200051213004,21.556874244631672,3661,1,674100,60885,2345,0,141,1006
13936,0,0,0,0,50,1,4,1,0,2093805,3671766,38.06573262134856,1382,2961,2894,1449,45113,580286,499198,2467,3983,2601,3979,5495,38.01315561749642,8.187175587434018,1516,1,285453,11457,1445,0,1085,1089
13937,0,0,0,0,51,1,59,0,1,448700,1799700,26.457513110645905,365,1676,1341,700,42823,588759,480777,2236,3271,2906,3212,4247,25.317977802344327,18.70546096049085,1035,1,130900,60970,641,0,1871,1930
13938,0,1,1,0,62,0,110,0,0,1363536,3838464,34.9857113690718,1008,2554,2338,1224,52056,677376,755776,2920,4360,3352,4250,5690,33.37663853655727,14.776924748515805,1440,1,294984,21816,1114,0,1912,2022
13939,0,0,1,0,60,1,1835,0,0,3084536,8821657,53.842362503887216,1681,5181,3963,2899,46200,639030,669460,1825,5942,4261,4107,8224,32.61901286060018,35.24764495055457,4117,1,637780,148596,1064,0,144,1979
13940,0,0,1,0,55,1,1630,0,0,3889731,8198220,54.30469592954186,2525,4692,4268,2949,48530,639400,586580,2356,5729,3204,4099,7472,36.318039594669756,20.72240842835788,3373,1,622239,66144,1319,0,169,1461
13941,0,1,0,1,67,0,731,0,0,2916672,7102656,45.95650117230423,1710,3895,3493,2112,50853,675963,850839,2961,5475,3765,4744,7258,37.16180835212409,20.5547400195117,2514,1,534336,20100,1381,0,1251,1982
13942,0,0,0,1,68,1,260,0,0,2028000,5322720,39.496835316262995,1130,3290,2860,1560,45938,760876,702872,2982,4972,3842,4712,6702,36.05551275463989,20.884264321902126,1990,1,321360,66650,1300,0,1852,2112
13943,0,0,0,1,68,1,643,0,0,1846850,5856662,41.44876355212541,1484,3027,2793,1718,52392,804524,756798,3175,5127,3643,4484,6436,32.78719262151,15.628364529118596,1952,1,381396,35100,1075,0,1691,2334
13944,0,0,0,1,67,1,1890,0,0,1072579,7939901,48.4458460551573,1957,3194,2804,2347,56133,822069,781473,2993,5730,3773,3840,6577,21.37755832643195,19.760125156972677,2737,1,542157,55380,457,0,1036,2926
13945,0,0,0,1,67,1,1961,0,0,1047926,8110036,48.96937818678118,2036,3197,2835,2398,54834,835354,750804,3020,5780,3744,3819,6579,20.904544960366874,19.038047104140688,2760,1,532356,56834,437,0,984,2945
13946,0,0,1,0,61,1,1583,0,0,3865808,9009545,53.95368384086484,1593,5557,4239,2911,46081,628285,702565,1777,6006,4413,4423,8652,36.4417343165772,36.56823697206357,4229,1,660797,138390,1328,0,184,1767
13947,0,0,1,0,57,1,2720,0,0,1809969,9403329,57.21013896155121,3005,4094,3826,3273,46945,657917,588965,2605,6146,3141,3426,6967,23.515952032609693,16.682224203116405,3541,1,670965,43684,553,0,400,2320
13948,0,0,1,0,56,1,2513,0,0,2475390,9208320,57.18391382198319,3150,4147,4027,3270,47560,577280,653312,2696,6086,2936,3573,6963,27.51363298439521,11.206010841342998,3390,1,758640,12000,757,0,454,2059
13949,0,0,0,0,51,1,53,0,1,3176604,4493604,41.90465367951393,1714,3607,3565,1756,55224,598806,603924,2517,4315,2601,4368,6166,42.532340636273474,6.503581472166948,1798,1,414416,5376,1809,0,803,750
13950,0,0,0,1,67,1,2487,0,0,1234264,9862468,53.95368384086484,2777,3469,3335,2911,53900,830060,745360,3254,6299,3522,3812,6857,20.591260281974,11.5784147532791,3045,1,640420,21440,424,0,477,2964
13951,0,0,0,1,68,1,2242,0,0,3729648,11487450,57.91372894228103,2364,5456,4466,3354,56088,842550,780900,2435,6779,4415,4537,8881,33.34666400106613,31.510520249759203,4344,1,764712,145530,1112,0,71,2313
13952,0,0,0,1,67,1,870,0,0,7025371,10542738,55.86591089385369,2578,5915,5372,3121,45126,699246,736404,2835,6499,3921,5629,9293,47.44470465710583,23.675064889540526,3664,1,680378,65703,2251,0,257,1127
13953,0,1,1,0,64,0,2152,0,0,2231505,9456914,54.00925846556311,2747,3852,3682,2917,55692,771596,758628,3072,6159,3412,4007,7094,27.65863337187866,13.038855942866585,3087,0,682578,22950,765,1,325,2477
13954,0,1,0,1,65,0,574,0,0,2848575,6562717,44.710177812216315,1757,3666,3424,1999,52030,705845,794486,3041,5282,3525,4708,6949,37.749172176353746,15.71977451973018,2241,1,483758,23958,1425,0,1284,1858
13955,0,0,1,0,64,1,860,0,0,464736,1209216,19.390719429665317,99,1889,1612,376,48256,746112,668928,2939,3592,3493,4452,5105,35.156791662493895,16.70935173845662,653,0,78208,45151,1236,1,2840,1980
13956,0,0,0,1,67,1,1590,0,0,1364544,7467456,46.98936049788292,1842,3192,2826,2208,56120,825208,777860,3016,5590,3748,4000,6574,24.859605789312106,19.691039187488602,2574,1,507840,52704,618,0,1174,2764
13957,0,0,0,1,68,1,1895,0,0,4380750,11114125,56.96490147450446,2255,5585,4595,3245,53500,856250,732950,2435,6670,4415,4775,9010,36.742346141747674,31.510520249759203,4235,1,694430,168300,1350,0,180,2075
13958,0,0,0,0,51,1,87,0,0,3920488,4993586,44.01136216933077,1907,3991,3961,1937,55125,580050,631610,2548,4515,2608,4602,6569,44.98888751680797,5.531194905403055,1967,0,474565,3150,2024,0,641,554
13959,0,0,0,0,51,1,72,0,1,2565108,4007394,39.57271787481876,1458,3312,3204,1566,48279,591129,534831,2451,4125,2667,4197,5871,40.47221268969612,10.424232425346673,1674,1,327294,17280,1638,0,993,921
13960,0,1,0,1,66,0,748,0,0,2815085,6938295,45.749316934791494,1780,3751,3438,2093,50141,672945,818805,3002,5408,3628,4660,7066,36.6742416417845,17.987856372244348,2406,1,516971,23475,1345,0,1222,1970
13961,0,0,1,0,64,1,1087,0,0,185550,485250,12.24744871391589,25,1562,1387,150,50794,753755,705230,3060,3385,3410,4472,4797,35.17101079013795,13.241804011448092,325,1,32700,26775,1237,0,3085,1998
13962,0,0,0,1,68,1,199,0,0,2308106,4853853,37.72267222772003,608,3860,3045,1423,43008,764064,654912,2596,4834,4226,5033,7271,40.27406113120453,28.60374427995568,2238,1,273216,139365,1622,0,1988,1789
13963,0,0,0,1,68,1,377,0,0,2100450,5651250,40.620192023179804,1279,3294,2923,1650,47064,760350,726100,3054,5075,3796,4698,6719,35.679125549822544,19.515051513497582,2021,1,349800,54166,1273,0,1775,2152
13964,0,0,1,0,57,1,2739,0,0,2098512,9702255,57.99137866959192,3012,4338,3987,3363,47740,634700,626045,2534,6248,3236,3509,7223,24.979991993593593,19.016344257698428,3714,1,729771,48438,624,0,478,2261
13965,0,0,1,0,56,1,2064,0,0,3652560,9003240,56.60388679233962,2921,4627,4344,3204,47520,618200,606960,2527,6014,3093,3950,7437,33.76388603226827,16.942308248920387,3487,1,692064,39620,1140,0,394,1670
13966,0,0,0,1,68,1,466,0,0,2357520,4494600,36.3318042491699,298,4128,3106,1320,42098,738885,660570,2383,4725,4427,5191,7533,42.261093218230876,32.002013970019746,2342,1,256080,164542,1786,0,2085,1619
13967,0,0,0,1,67,1,2177,0,0,1635888,9333696,52.61178575186362,2738,3389,3359,2768,53946,819396,748584,3342,6140,3402,3963,6761,24.310491562286437,5.477225575051661,2798,1,614496,4680,591,0,604,2781
13968,0,0,0,1,67,1,2250,0,0,1610791,9515233,53.113086899558006,2821,3392,3392,2821,53655,826385,738687,3373,6194,3373,3944,6765,23.895606290697042,0.0,2821,1,617799,0,571,0,552,2802
13969,0,0,0,0,51,1,19,0,1,473942,1758610,26.057628441590765,176,1880,1377,679,53192,631960,564620,2087,3269,3093,3288,4470,26.419689627245813,22.74018560029439,1182,1,148022,81989,698,0,1911,1892
13970,0,1,0,1,65,0,633,0,0,2774548,6579240,44.85532298401161,1830,3573,3391,2012,50225,670350,801150,3088,5282,3452,4649,6843,37.134889255254286,13.628019367742883,2194,1,492940,14924,1379,0,1258,1891
13971,0,0,0,1,68,1,386,0,0,2371455,4638267,36.864617182333525,369,4094,3104,1359,42510,744034,665535,2423,4772,4403,5158,7507,41.773197148410844,31.5081228298549,2349,1,265005,159390,1745,0,2054,1668
13972,0,0,0,1,68,1,585,0,0,2044584,6007608,41.8568990729127,1480,3191,2919,1752,46652,747522,733806,3157,5181,3701,4596,6620,34.161381705077446,16.926401096657948,2024,1,374928,38080,1167,0,1677,2262
13973,0,0,0,1,67,1,895,0,0,1938650,6398500,43.70354676682432,1868,2967,2925,1910,53463,713550,840850,3308,5260,3392,4365,6317,31.85906464414798,6.589126398255297,1952,1,479410,3276,1015,0,1440,2335
13974,0,0,0,1,67,1,2034,0,0,1487455,8763220,51.03920062069938,2443,3338,3176,2605,52460,820816,723260,3202,5969,3526,3935,6702,23.895606290697042,12.727922061357855,2767,1,560075,26730,571,0,759,2793
13975,0,0,0,1,67,1,2374,0,0,1484432,9738336,53.74011537017761,2821,3469,3402,2888,53628,829512,735096,3305,6260,3439,3886,6841,22.67156809750927,8.189452396126915,2955,1,629584,10988,514,0,484,2858
13976,0,0,0,1,68,1,2298,0,0,3263680,11199160,57.358521598799946,2152,5420,4282,3290,55912,820364,789728,2266,6694,4542,4396,8824,31.496031496047245,33.75393770942869,4428,1,763280,159320,992,0,114,2412
13977,0,0,1,0,63,1,449,0,0,8339312,9896691,55.86591089385369,2164,6750,5793,3121,56643,751527,757869,2214,6292,4128,5843,9921,51.69139193328034,30.939139932999183,4078,1,745919,117711,2672,0,50,499
13978,0,0,0,0,51,1,119,0,1,2925692,4227468,40.64480286580315,1567,3508,3423,1652,48175,601365,524595,2474,4211,2644,4330,6067,42.08325082500163,9.222414255489701,1737,1,338660,14450,1771,0,907,788
13979,0,1,1,0,63,0,1688,0,0,2399360,8332560,51.068581339214816,2608,3528,3528,2608,51980,734850,722070,3195,5803,3195,4115,6723,30.331501776206203,0.0,2608,0,589408,0,920,1,587,2275
13980,0,0,0,1,67,1,2273,0,0,1644450,9598800,53.38539126015655,2820,3457,3427,2850,53724,815056,747696,3338,6218,3398,3945,6825,24.020824298928627,5.478746393072713,2880,1,632700,4680,577,0,518,2791
13981,0,0,1,0,64,1,64,0,0,9161705,9682835,54.72659317004851,2337,6712,6054,2995,56404,762988,772687,2575,6228,3891,6292,9945,55.308227236099334,25.656855983399602,3653,1,715805,81592,3059,0,238,174
13982,0,1,0,1,65,0,656,0,0,2735012,6569668,44.87761134463375,1861,3525,3372,2014,49532,662186,795928,3109,5276,3415,4620,6787,36.851051545376556,12.478946871590342,2167,1,491416,12393,1358,0,1248,1904
13983,0,0,1,0,61,1,182,0,0,2523000,4609500,38.72983346207417,1440,3242,3182,1500,46848,749812,590016,3013,4573,3133,4755,6315,41.012193308819754,7.880145860644973,1560,0,288000,11520,1682,1,1573,1391
13984,0,0,0,1,66,1,1307,0,0,1791548,7112617,46.292547996410825,2035,3087,2979,2143,44073,826431,587463,3211,5462,3427,4155,6406,28.91366458960192,10.655033166942168,2251,1,379311,20196,836,0,1176,2483
13985,0,0,0,1,66,1,1372,0,0,1785408,7305732,46.776062254106,2026,3166,3004,2188,48132,841428,637749,3177,5527,3501,4155,6505,28.5657137141714,13.52572907573559,2350,1,417908,29484,816,0,1151,2523
13986,0,0,1,0,67,1,3299,0,0,517350,11681763,58.728187440104094,2885,4163,3599,3449,53072,839976,724818,2823,6836,3951,3537,7550,12.24744871391589,24.00869391489559,4013,1,738086,95316,150,0,62,3237
13987,0,0,0,1,68,1,1708,0,0,4283805,10528572,55.614746245937326,1953,5618,4478,3093,52858,840788,728456,2264,6497,4544,4789,9022,37.21558813185679,33.78351644266453,4233,1,661902,192660,1385,0,311,2019
13988,0,0,0,0,51,1,147,0,1,3889300,4911500,43.58898943540674,1870,3977,3947,1900,46656,558360,558360,2555,4485,2615,4632,6562,45.24378410345447,5.490867587491313,1930,1,410400,4020,2047,0,685,538
13989,0,0,0,0,51,1,146,0,1,2918771,4197268,40.45985664828782,1503,3554,3420,1637,47174,587156,528184,2430,4201,2698,4347,6118,42.22558466143482,11.576481526871955,1771,1,337222,21708,1783,0,927,781
13990,0,0,0,0,50,1,131,0,1,177612,913330,19.0,22,1192,853,361,55890,581900,614790,2191,2891,2869,3022,3722,22.181073012818835,18.633232414702057,700,1,87723,38307,492,0,2169,2038
13991,0,0,0,1,68,1,254,0,0,2386371,4883736,37.72267222772003,461,4062,3100,1423,45854,779064,693264,2470,4855,4394,5109,7494,40.95119045888654,31.08833974277568,2385,1,287446,156806,1677,0,2009,1755
13992,0,0,0,1,68,1,403,0,0,2183970,5837464,41.14608122288197,1179,3497,2983,1693,47880,786144,724080,2934,5141,3962,4738,6945,35.91656999213594,22.92226646406418,2207,1,355530,79670,1290,0,1755,2158
13993,0,0,0,1,68,1,442,0,0,2162328,5889184,41.32795663954365,1224,3458,2974,1708,47880,786144,724080,2964,5156,3932,4714,6906,35.58089374931439,22.273795384084337,2192,1,358680,75020,1266,0,1740,2182
13994,0,0,0,1,68,1,561,0,0,2098420,6052932,41.90465367951393,1361,3346,2951,1756,48351,782469,734211,3052,5203,3842,4642,6793,34.56877203488721,20.23606863364595,2151,1,374028,59645,1195,0,1691,2252
13995,0,0,0,1,67,1,2207,0,0,3211208,10878328,56.639209034025185,2124,5293,4209,3208,55671,817231,783321,2307,6599,4475,4392,8684,31.63858403911275,33.17157103812785,4292,1,741048,153928,1001,0,183,2390
13996,0,0,0,1,68,1,1637,0,0,4331990,10396165,55.27205442174191,1885,5643,4473,3055,53628,837138,741854,2233,6458,4573,4821,9046,37.656340767525464,34.433257023740815,4225,1,665990,190710,1418,0,348,1985
13997,0,0,1,0,66,1,362,0,0,7447464,9748188,54.0,2129,6257,5470,2916,55842,758861,822378,2556,6259,4130,5897,9600,50.53711507397311,28.175200510573685,3703,1,717336,82635,2554,0,427,789
13998,0,0,0,0,51,1,159,1,0,3774760,4824755,43.18564576337837,1798,3956,3889,1865,45368,548444,553618,2520,4452,2654,4611,6543,44.98888751680797,8.19672545160342,1932,1,399110,8844,2024,0,722,563
13999,0,0,0,0,51,1,160,1,0,3331529,4505513,41.79712908801273,1597,3804,3654,1747,46872,557064,559643,2429,4326,2729,4486,6383,43.669211121796096,12.254111330655777,1897,1,379099,19950,1907,0,832,672
14000,0,0,0,0,51,1,161,0,1,2008500,3445247,36.59234892706397,978,3200,2839,1339,52884,602082,581498,2212,3912,2934,4073,5773,38.72983346207417,19.024591376718707,1700,1,302614,51623,1500,0,1234,1073
14001,0,0,0,0,57,1,1740,1,0,1838421,7145280,49.80963762164909,2186,3517,3222,2481,30114,688320,362880,2585,5361,3175,3621,6397,27.2213151776324,17.94357958926427,2776,1,312606,69915,741,0,399,2139
14002,0,0,1,0,59,1,763,0,0,2705490,6193440,45.4972526643093,2070,3377,3377,2070,48755,733040,595408,2992,5062,2992,4299,6369,36.15245496505044,0.0,2070,0,411930,0,1307,0,922,1685
14003,0,0,0,1,69,1,251,0,0,2308350,5697450,40.620192023179804,984,3715,3049,1650,47443,783831,721677,2787,5103,4119,4852,7168,37.403208418530085,25.993966949160146,2316,1,344850,103896,1399,0,1803,2054
14004,0,0,0,1,67,1,1981,0,0,1846352,8972576,51.69139193328034,2612,3423,3363,2672,51336,832784,695106,3298,6030,3418,4049,6781,26.28687885618983,7.772191019407321,2732,1,553104,10680,691,0,686,2667
14005,0,0,0,1,68,1,750,0,0,6174544,9836528,53.74011537017761,2088,5826,5026,2888,56105,834470,779974,2606,6294,4206,5544,9232,46.238512086787566,28.58749309362631,3688,1,661352,117600,2138,0,518,1268
14006,0,0,0,0,58,1,2462,1,0,2581215,9566445,57.05260730238365,2468,4835,4048,3255,48805,631885,667153,2152,6194,3726,3732,7774,28.160255680657446,28.275981195890854,4042,1,738885,95227,793,0,316,2146
14007,0,0,0,1,69,1,371,0,0,2271432,5890728,41.27953488110059,1092,3649,3037,1704,47475,777825,729427,2845,5161,4069,4790,7106,36.51027252705737,24.96541630423749,2316,1,359544,92412,1333,0,1753,2124
14008,0,0,0,0,51,1,190,0,1,2353344,3716034,37.97367509209505,1123,3393,3074,1442,50600,592710,566940,2258,4019,2896,4209,5970,40.39801975344831,17.8837378312632,1761,1,317240,46893,1632,0,1135,945
14009,0,0,1,0,56,1,1087,0,0,1395908,5242492,42.941821107167776,1588,2857,2601,1844,41630,514583,653890,2587,4687,3099,3600,5700,27.51363298439521,16.82722301351531,2100,1,424120,17920,757,0,999,2086
14010,0,0,0,1,65,1,1324,0,0,1696277,7003777,46.07602413403309,2063,2982,2922,2123,46872,613614,831348,3239,5422,3359,4098,6281,28.26658805020514,7.759379671981613,2183,1,534996,2460,799,0,1176,2500
14011,0,0,0,1,65,1,1568,0,0,1593540,7416090,47.644516998286385,2162,3080,2972,2270,45933,820017,597861,3159,5537,3375,3969,6347,26.49528259898354,10.539713118296461,2378,1,415410,20196,702,0,997,2565
14012,0,0,0,1,65,1,1686,0,0,1581547,7773386,48.54894437575342,2195,3190,3028,2357,48070,834394,626620,3136,5655,3460,3969,6488,25.903667693977237,12.89950058566656,2519,1,447830,30294,671,0,941,2627
14013,0,0,0,1,66,1,2041,0,0,1719162,8971290,51.78802950489621,2652,3353,3323,2682,50400,842940,669000,3315,6027,3375,3986,6698,25.317977802344327,5.514871952411144,2712,1,536400,5610,641,0,663,2704
14014,0,0,0,1,67,1,2150,0,0,3108600,10606920,56.0357029044876,2148,5122,4130,3140,56394,814098,790452,2386,6518,4370,4368,8500,31.464265445104548,31.74101345974313,4132,1,734760,135904,990,0,238,2388
14015,0,0,0,0,53,1,245,1,0,5838974,6142178,47.92702786528704,2135,5001,4839,2297,51204,545496,671174,2512,4971,2836,5216,7675,50.41825066382212,12.87391722223528,2459,1,576547,11016,2542,0,377,132
14016,0,0,0,0,52,1,190,1,0,4883919,5555008,46.010868281309364,2087,4454,4424,2117,43524,614016,488064,2594,4741,2654,4931,7078,48.03123983409131,5.652706486041966,2147,1,393762,5670,2307,0,507,317
14017,0,0,0,0,51,1,207,0,1,2181168,3547152,37.107950630558946,995,3343,2961,1377,51260,600208,566720,2194,3953,2958,4160,5919,39.7994974842648,19.56407892490962,1759,1,302940,57300,1584,0,1199,992
14018,0,1,1,0,63,0,1441,0,0,2325162,7642225,49.06118628814432,2322,3458,3373,2407,55920,762000,739775,3090,5582,3260,4141,6633,31.080540535840107,9.224644470006377,2492,0,560831,11645,966,1,768,2209
14019,0,0,1,0,56,1,1123,0,0,1357860,5279330,43.069710934716056,1608,2834,2587,1855,44160,523664,683040,2599,4701,3093,3578,5680,27.055498516937366,16.6246312392797,2102,1,445200,14573,732,0,991,2114
14020,0,0,0,1,65,1,1445,0,0,1619826,7126360,46.75467891024384,2156,2957,2927,2186,48829,629180,824780,3230,5446,3290,4001,6217,27.2213151776324,5.483301264452448,2216,1,553058,1500,741,0,1074,2519
14021,0,0,0,1,66,1,2367,0,0,1794484,9937995,54.506880299646575,2821,3725,3575,2971,54948,806145,762660,3195,6316,3495,3949,7070,24.576411454889016,12.30152264982736,3121,1,677388,21900,604,0,374,2741
14022,0,0,1,0,64,1,520,0,0,9192249,8997439,52.754146756439916,2206,6663,6086,2783,55671,746823,779153,2656,6016,3810,6536,9896,57.47173218200405,24.264021270038565,3360,1,670703,67509,3303,0,450,70
14023,0,0,0,0,55,1,511,1,0,5483100,7224637,51.09794516416487,2383,4939,4711,2611,55209,661313,639177,2539,5378,2995,4867,7706,45.8257569495584,15.198114466394223,2839,1,603141,31920,2100,0,156,667
14024,0,0,1,0,64,1,1599,0,0,1523170,7347990,47.644516998286385,2240,2971,2941,2270,54340,799539,712140,3207,5507,3267,3908,6208,25.903667693977237,5.490867587491313,2300,0,499400,4800,671,1,967,2566
14025,0,0,0,0,52,1,218,1,0,3794520,4816830,42.91852746774987,1630,4114,3902,1842,46655,567455,562225,2403,4457,2827,4675,6729,45.387222871640866,14.570009798918585,2054,1,396030,29044,2060,0,773,555
14026,0,0,0,0,51,1,239,0,1,2192430,3521548,36.959437225152655,942,3395,2971,1366,51290,592940,574894,2154,3944,3002,4183,5973,40.06245124802026,20.605105461539555,1790,1,304618,60632,1605,0,1212,973
14027,0,0,0,0,56,1,1285,1,0,1255166,5459682,43.977266854592045,1754,2763,2583,1934,49949,561777,708573,2643,4757,3003,3472,5586,25.475478405713993,14.366631369225079,2114,1,485434,11160,649,0,889,2174
14028,0,0,0,1,66,1,2079,0,0,1417420,8680060,51.18593556827891,2560,3221,3161,2620,52164,834876,685791,3253,5933,3373,3854,6534,23.259406699226016,7.759379671981613,2680,1,542340,10740,541,0,693,2772
14029,0,0,0,1,66,1,2146,0,0,1460127,8930169,51.85556864985669,2689,3232,3232,2689,52961,833571,700731,3321,6010,3321,3864,6553,23.302360395462088,0.0,2689,1,567379,0,543,0,632,2778
14030,0,0,0,0,57,1,1185,1,0,1268200,5335765,43.18564576337837,1595,2815,2545,1865,52080,600810,709528,2591,4726,3131,3541,5676,26.076809620810597,17.42639110525688,2135,1,462520,22140,680,0,996,2181
14031,0,0,0,1,66,1,1431,0,0,1615282,7239420,46.62617290749907,2012,3079,2917,2174,44250,589410,832500,3168,5504,3492,4073,6409,27.258026340878022,13.240404067118192,2336,1,543500,0,743,0,1156,2587
14032,0,0,0,0,59,1,2152,1,0,2660340,9020310,55.04543577809154,2334,4604,3908,3030,40755,622193,580515,2281,6007,3673,3855,7581,29.631064780058107,26.807637489085852,3726,1,590850,104400,878,0,53,2099
14033,0,0,0,0,57,1,1267,1,0,1215390,5429250,43.64630568559039,1665,2783,2543,1905,50000,570000,712500,2610,4755,3090,3488,5633,25.25866188063018,16.492422502470642,2145,1,476250,15600,638,0,945,2212
14034,0,0,0,0,56,1,1314,1,0,1193976,5479152,43.95452195167182,1722,2760,2550,1932,48112,550184,703328,2626,4768,3046,3454,5596,24.859605789312106,15.457933012562789,2142,1,479136,12810,618,0,904,2218
14035,0,0,0,1,65,1,2066,0,0,1292207,8449441,50.68530358989675,2569,3072,3072,2569,45612,828828,595309,3289,5858,3289,3792,6361,22.427661492005804,0.0,2569,1,464989,0,503,0,720,2786
14036,0,0,0,1,67,1,813,0,0,5154700,9099402,52.08646657242167,1626,5700,4613,2713,55842,825084,761358,2267,6067,4441,5254,9054,43.58898943540674,33.06155364144172,3800,1,615851,163050,1900,0,641,1454
14037,0,0,0,0,51,1,284,1,0,2220845,3504030,36.810324638611924,863,3486,2994,1355,48399,566334,571506,2094,3941,3078,4225,6072,40.48456495999432,22.19215231324491,1847,1,299455,64944,1639,0,1231,947
14038,0,1,1,0,62,0,1443,0,0,1335844,6516668,45.65084884205331,1902,2907,2725,2084,55029,778623,691067,2945,5211,3309,3768,6034,25.317977802344327,13.494401588860493,2266,0,460564,28756,641,1,1043,2486
14039,0,0,0,1,65,1,1679,0,0,1419546,7479032,47.92702786528704,2202,3010,2915,2297,47750,621896,814000,3161,5553,3351,3874,6266,24.859605789312106,9.815189597405173,2392,1,574250,5035,618,0,959,2638
14040,0,0,0,1,67,1,1251,0,0,4250620,9363040,52.72570530585627,1790,5299,4309,2780,54656,821792,754432,2378,6148,4358,4897,8667,39.102429592034305,31.683129597965383,3770,1,622720,151470,1529,0,588,1839
14041,0,0,1,0,64,1,101,0,0,7187892,8532333,51.29327441292864,2073,5921,5363,2631,53965,697245,813993,2685,5874,3801,5975,9164,52.26853738148792,23.922166313942018,3189,1,660381,45198,2732,0,612,511
14042,0,0,0,0,54,1,252,1,0,5464405,6749712,49.66890375275057,2400,4749,4682,2467,56406,651168,648432,2669,5203,2803,4951,7485,47.06378650300037,8.20171446926608,2534,1,584679,8710,2215,0,269,521
14043,0,0,0,0,53,1,377,1,0,5033720,5479328,45.42025979670306,2021,4545,4503,2063,37881,549792,486048,2614,4719,2698,5096,7201,49.39635614091387,6.553889165207866,2105,1,377529,6720,2440,0,593,216
14044,0,0,0,0,52,1,270,1,0,3504904,4588428,41.737273509418415,1391,4105,3754,1742,43470,553140,545238,2283,4376,2985,4646,6739,44.85532298401161,18.760640864258956,2093,1,360594,48438,2012,0,892,622
14045,0,1,1,0,64,0,1081,0,0,2105712,6707779,45.70557952810576,1601,3585,3097,2089,49530,815594,626145,2723,5300,3699,4219,6796,31.74901573277509,22.100941954408,2577,1,407355,89792,1008,0,1122,2203
14046,0,0,1,0,66,1,1810,0,0,3261375,9763650,54.08326913195984,2136,4829,4040,2925,55328,824486,747712,2549,6263,4127,4453,8167,33.391615714128,28.295500926622005,3714,1,655200,121506,1115,0,413,2223
14047,0,0,1,0,63,1,543,0,0,8057340,8196660,50.79370039680118,2274,6009,5703,2580,55552,787896,711648,2871,5757,3483,6300,9186,55.883808030591474,17.66411143074631,2886,1,577920,46818,3123,0,597,54
14048,0,0,0,0,54,1,320,1,0,5417289,6833313,49.92995093127971,2398,4761,4666,2493,53100,616725,646876,2646,5234,2836,4914,7502,46.61544808322666,9.779300676839927,2588,1,588348,11400,2173,0,248,568
14049,0,0,0,0,56,1,1374,1,0,1115631,5523639,44.12482294582042,1705,2762,2520,1947,53535,609955,706413,2595,4784,3079,3410,5599,23.93741840717165,16.408411135572948,2189,1,484803,21054,573,0,890,2264
14050,0,0,0,0,53,1,455,1,0,5176326,5495471,45.37620521815371,2017,4615,4573,2059,38247,557821,488427,2627,4728,2711,5183,7284,50.1398045468867,6.589126398255297,2101,1,376797,6846,2514,0,610,155
14051,0,0,0,0,50,1,365,0,0,1485750,2673300,32.4037034920393,584,2931,2465,1050,52658,575396,593218,2080,3596,3012,3961,5477,37.61648574760805,21.63283847335924,1516,0,244650,58250,1415,0,1496,1131
14052,0,0,0,0,53,1,367,0,1,3857084,4746217,42.2965719651132,1428,4306,3945,1789,53110,599578,623455,2292,4442,3014,4809,6959,46.4327470649756,19.04706206206517,2150,1,420415,44042,2156,0,864,497
14053,0,0,0,0,52,1,333,0,1,3603208,4597916,41.701318923986086,1309,4241,3811,1739,53823,616052,610764,2214,4383,3074,4716,6885,45.51922670696417,20.75998067242139,2169,1,401709,58480,2072,0,905,572
14054,0,0,0,1,66,1,2567,0,0,1926618,10512288,56.3382640840131,2897,4058,3781,3174,53250,828000,705456,3035,6486,3589,3919,7370,24.63736998950984,16.74732262428718,3451,1,676062,47367,607,0,138,2705
14055,0,0,0,1,66,1,628,0,0,4968405,8533755,50.6458290484024,1459,5608,4502,2565,56350,815115,765210,2221,5892,4433,5264,8935,44.01136216933077,33.39856998805539,3671,1,589950,160370,1937,0,762,1390
14056,0,0,0,0,55,1,1623,1,0,922774,5780786,45.48626166217664,1945,2639,2515,2069,53424,592328,704088,2670,4863,2918,3240,5433,21.118712081942874,12.038156742151878,2193,1,521388,9052,446,0,725,2348
14057,0,0,1,0,60,1,436,0,0,2609376,5568024,42.988370520409354,1753,3355,3260,1848,46116,735172,569457,2918,4861,3108,4425,6368,37.57658845611187,9.799287634083276,1943,0,349272,18430,1412,1,1165,1601
14058,0,0,1,0,62,1,88,0,0,1304513,3716497,34.45286635390443,699,2774,2286,1187,51385,748309,673165,2643,4318,3619,4230,5905,33.15116890850155,22.194096346076076,1675,0,255205,78568,1099,1,1944,2032
14059,0,0,1,0,66,1,556,0,0,4994220,8397070,50.299105359837164,1426,5608,4504,2530,56069,819793,753413,2215,5849,4423,5293,8927,44.429719783046124,33.368869881518194,3634,1,574310,164496,1974,0,789,1345
14060,0,0,0,0,53,1,477,0,1,4151770,4847962,42.579337712087536,1516,4400,4103,1813,52200,620368,601650,2377,4487,2971,4964,7074,47.853944456021594,17.303788837718695,2110,1,407925,42174,2290,0,861,384
14061,0,1,1,0,57,0,75,0,0,509104,2156736,27.422618401604176,599,1582,1429,752,36895,450276,673980,2715,3620,3021,3545,4450,26.019223662515376,12.939497000677182,905,1,176720,4131,677,0,2116,2191
14062,0,0,1,0,66,1,384,0,0,5207236,8215420,49.8196748283246,1332,5730,4580,2482,55081,817570,738130,2160,5792,4460,5408,9040,45.803929962395145,34.15038340971216,3632,1,553486,179400,2098,0,828,1212
14063,0,0,1,0,66,1,320,0,0,5333625,8192250,49.749371855331,1385,5720,4630,2475,55370,810950,748060,2220,5785,4400,5465,9030,46.42197755374064,33.27355739984391,3565,1,559350,165680,2155,0,835,1155
14064,0,0,1,0,57,1,1279,0,0,1172346,5480433,43.55456348076513,1562,2850,2515,1897,40664,531576,638469,2554,4786,3224,3507,5739,24.859605789312106,19.312930279614452,2232,1,419237,28810,618,0,992,2271
14065,0,0,1,0,61,1,947,0,0,8211918,7519083,49.3051721424842,2154,6086,5809,2431,55575,763971,695925,2816,5524,3370,6471,9179,58.12056434688156,16.664965739633967,2708,1,546975,40442,3378,0,662,285
14066,0,0,0,0,51,1,404,0,1,2275680,3425400,36.3318042491699,960,3404,3044,1320,49729,578685,578685,2235,3915,2955,4319,5999,41.52107898405339,19.087417876065437,1680,1,294360,48600,1724,0,1275,871
14067,0,0,0,0,56,1,1598,1,0,939135,5815650,45.332107826572546,1875,2692,2512,2055,43077,489590,704670,2650,4885,3010,3287,5522,21.37755832643195,14.435603895983952,2235,1,511695,5040,457,0,775,2373
14068,0,0,0,1,68,1,1798,0,0,1459835,8217885,49.040799340956916,2063,3354,3012,2405,28080,410040,799578,3075,5822,3759,4024,6771,24.63736998950984,19.730866091994038,2747,1,562770,0,607,0,1012,2810
14069,0,0,1,0,64,1,2760,0,0,841249,9852028,55.10898293381942,2779,3572,3314,3037,55209,775316,749364,2986,6281,3502,3521,6816,16.64331697709324,16.17791848681554,3295,0,701547,36120,277,1,207,2967
14070,0,0,1,0,64,1,265,0,0,6280034,7651563,48.75448697299562,1774,5622,5019,2377,55224,753246,759684,2616,5596,3822,5861,8841,51.40038910358559,24.73324892023849,2980,1,560972,77184,2642,0,842,577
14071,0,0,1,0,61,1,752,0,0,7693025,7443456,49.22397789695587,2092,5929,5598,2423,55104,755712,688128,2741,5495,3403,6247,9001,56.34713834792323,18.262793019703505,2754,1,542752,47333,3175,0,649,103
14072,0,1,1,0,60,0,367,0,0,2740218,5628356,43.0,1458,3722,3331,1849,56404,718384,727516,2653,4893,3435,4526,6766,38.49675310984031,19.90082729351363,2240,1,441911,45356,1482,0,1195,1562
14073,0,0,0,0,58,1,1308,1,0,1190268,5650884,43.88621651498338,1566,2904,2544,1926,37349,495846,648414,2574,4860,3294,3552,5838,24.859605789312106,20.402704351339132,2286,1,425646,23760,618,0,1008,2316
14074,0,0,1,0,64,1,2774,0,0,1334256,10319736,56.49778756730214,2826,3976,3610,3192,54750,808250,708027,2867,6425,3599,3651,7209,20.445048300260872,19.169890285517887,3558,0,699048,58926,418,1,41,2815
14075,0,0,0,1,66,1,1828,0,0,2897228,9403184,53.34791467339656,2305,4405,3864,2846,56088,812784,753312,2763,6150,3845,4322,7709,31.906112267087632,23.46340898743039,3387,1,648888,77904,1018,0,458,2286
14076,0,0,1,0,60,1,187,0,0,7048250,7778705,50.62608023538856,2143,5733,5313,2563,55876,695015,740540,2615,5598,3455,5785,8768,52.44044240850758,20.62690361683963,2983,1,625372,46200,2750,0,472,285
14077,0,0,0,0,56,1,921,1,0,5223832,7898568,52.839379254491625,2118,5337,4663,2792,54500,707250,616722,2155,5621,3503,4700,8166,43.255057507764334,26.100420920715663,3466,1,608656,109862,1871,0,37,958
14078,0,0,0,0,58,1,1332,1,0,1189728,5717304,44.090815370097204,1584,2916,2556,1944,45384,538203,729368,2581,4885,3301,3553,5857,24.73863375370596,20.489717822089734,2304,1,482112,15840,612,0,997,2329
14079,0,0,0,0,56,1,1652,1,0,912893,5905603,45.70557952810576,1909,2706,2526,2089,41168,469282,701096,2647,4916,3007,3264,5533,20.904544960366874,14.383715646341178,2269,1,518072,3060,437,0,738,2390
14080,0,0,0,0,56,1,789,0,1,5275600,7689950,52.20153254455275,2094,5292,4661,2725,56870,682924,663170,2191,5547,3453,4758,8114,44.0,25.252159225435854,3356,1,640375,82661,1936,0,97,886
14081,0,0,0,0,53,1,729,0,1,4656672,4886496,42.708313008125245,1529,4672,4377,1824,54044,613491,632244,2384,4503,2974,5232,7351,50.52722038663912,17.191528214751017,2119,1,430464,36580,2553,0,855,126
14082,0,0,0,0,53,1,716,0,1,4451436,4754376,42.21374183841087,1458,4604,4280,1782,55632,608304,650992,2344,4450,2992,5166,7272,49.9799959983992,18.018874612645277,2106,1,434808,35640,2498,0,886,170
14083,0,0,0,0,57,1,1570,1,0,1004304,5898228,45.36518488885502,1818,2786,2546,2058,42828,492952,713634,2626,4924,3106,3354,5652,22.090722034374522,16.683947106195433,2298,1,512442,6000,488,0,808,2378
14084,0,0,1,0,56,1,2416,0,0,453425,7280710,50.90186637049765,2291,3066,2766,2591,35953,643490,441170,2510,5401,3110,2985,5876,13.228756555322953,17.382527994752092,2891,1,406787,63000,175,0,219,2635
14085,0,0,1,0,64,1,293,0,0,395208,2550240,28.142494558940577,341,1742,1291,792,53436,785680,705180,2769,4012,3671,3719,4962,22.338307903688676,21.37079943289485,1243,1,173448,72160,499,0,2428,2721
14086,0,0,0,1,68,1,1113,0,0,2197780,7363740,46.26013402488151,1351,3956,3167,2140,50049,856809,691641,2652,5581,4230,4468,7397,32.046840717924134,28.72257057591289,2929,1,430140,145965,1027,0,1301,2414
14087,0,0,0,0,51,1,627,0,1,2944998,3687687,37.82856063875548,1175,3745,3489,1431,55304,639096,574671,2321,4008,2833,4635,6322,45.36518488885502,16.10659602217231,1687,1,319113,37888,2058,0,1146,519
14088,0,0,1,0,62,1,374,0,0,1696887,4665312,38.768543949960254,1353,2782,2632,1503,50200,779104,620800,2954,4607,3254,4233,5886,33.60059523282288,12.459604606992961,1653,0,300600,27900,1129,1,1601,1975
14089,0,0,1,0,58,1,1228,0,0,3496028,7534276,50.813384063650005,1576,4942,3936,2582,52164,735336,604026,1912,5500,3924,4272,7860,36.796738985948195,31.835381101076877,3588,1,534474,180074,1354,0,336,1564
14090,0,0,0,0,54,1,674,0,1,5287407,5398679,44.57577817604534,1687,4948,4648,1987,56153,633061,654797,2417,4704,3017,5378,7665,51.58488150611572,17.322239866749324,2287,1,478867,36000,2661,0,730,56
14091,0,1,1,0,63,0,1459,0,0,480872,5470136,41.66533331199932,1676,2073,2013,1736,46872,680616,683767,3091,4887,3211,3428,5224,16.64331697709324,7.745966692414834,1796,0,376712,7980,277,1,1415,2874
14092,0,0,1,0,56,1,2464,0,0,481572,7501410,51.43928459844674,2327,3147,2828,2646,30030,654885,368550,2516,5481,3154,3017,5982,13.490737563232042,17.885791773215054,2965,1,343980,74327,182,0,189,2653
14093,0,0,1,0,65,1,19,0,0,408870,2055060,25.099800796022265,11,1920,1279,630,49735,799190,662186,2621,3892,3903,3911,5182,25.475478405713993,25.33004644722397,1271,1,127890,115380,649,0,2632,2613
14094,0,0,1,0,66,1,360,0,0,885364,2592296,27.892651361962706,28,2666,1916,778,50481,789684,709716,2582,4110,4082,4470,5998,33.734255586866,27.589550365299587,1528,1,165714,122250,1138,0,2554,2194
14095,0,0,1,0,58,1,873,0,0,4748974,7764280,51.56549233741495,2017,5087,4445,2659,54500,730000,636560,2278,5579,3562,4706,8007,42.261093218230876,25.426025873652936,3301,1,579662,105288,1786,0,261,1134
14096,0,0,1,0,59,1,1191,0,0,3683470,7778530,51.03920062069938,1674,4950,4019,2605,56640,716640,704696,2055,5591,3917,4400,7936,37.603191353926334,30.821916330243837,3536,1,614780,120099,1414,0,381,1572
14097,0,0,0,0,53,1,843,0,1,4887088,4903549,42.76680956068619,1528,4802,4501,1829,55200,643440,616630,2380,4510,2982,5353,7483,51.69139193328034,17.77465288304594,2130,1,420670,42742,2672,0,852,9
14098,0,0,0,0,51,1,640,0,1,2441625,3286950,35.70714214271425,1125,3340,3190,1275,56350,631610,592940,2428,3853,2728,4493,5918,43.76071297408213,12.449381359612769,1425,1,293250,21150,1915,0,1303,663
14099,0,1,1,0,64,0,1181,0,0,1584800,6388725,44.50842616853577,1681,3081,2781,1981,45927,609525,783675,2925,5206,3525,4025,6306,28.284271247461902,17.34168682176524,2281,0,481383,18600,800,1,1244,2425
14100,0,0,0,0,60,1,1108,1,0,1472640,5677216,43.45112196480086,1430,3126,2668,1888,52948,652519,733708,2549,4895,3465,3787,6133,27.92848008753788,22.970498890030495,2346,1,460672,45342,780,0,1119,2227
14101,0,0,1,0,66,1,932,0,0,1191813,2395883,26.851443164195103,196,2899,2374,721,45114,727737,684538,2798,4044,3848,4976,6222,40.65710270051225,23.075752977961024,1246,1,148526,78750,1653,0,2602,1670
14102,0,0,0,1,68,1,789,0,0,2386800,6788457,44.598206241955516,1210,3968,3189,1989,54780,849837,750860,2634,5402,4192,4613,7381,34.64101615137755,28.390729086502883,2768,1,437580,126198,1200,0,1424,2213
14103,0,0,1,0,58,1,770,0,0,4842531,7634385,51.176166327695945,2037,5050,4468,2619,56105,714175,667535,2333,5534,3497,4764,7965,43.0,24.213937347762414,3201,1,599751,84390,1849,0,296,1066
14104,0,0,0,0,58,1,1335,1,0,1319356,5874228,44.67661580737735,1654,2999,2657,1996,42312,506196,723978,2601,4939,3285,3604,5942,25.709920264364882,19.891781063824254,2338,1,491016,10944,661,0,947,2282
14105,0,0,0,0,57,1,1492,1,0,1177973,5960007,45.42025979670306,1786,2911,2634,2063,48576,554688,730917,2612,4952,3166,3460,5800,23.895606290697042,17.721707357674177,2340,1,521939,12742,571,0,826,2318
14106,0,0,0,0,57,1,1598,1,0,1077699,6035958,45.92385001282014,1881,2848,2620,2109,50292,566676,726948,2634,4971,3090,3373,5710,22.60530911091463,16.051508547267655,2337,1,535686,11628,511,0,753,2351
14107,0,0,1,0,65,1,29,0,0,504600,2287056,26.38181191654584,38,2079,1421,696,47970,768924,673630,2628,3982,3944,4011,5365,26.92582403567252,25.786937866927,1354,1,142680,110544,725,0,2590,2561
14108,0,0,1,0,67,1,1142,0,0,2295120,3537000,32.37282811247729,208,4078,3238,1048,46116,823500,637875,2535,4423,4215,5565,7453,46.79743582719036,29.124690648324567,1888,1,198072,163800,2190,0,2327,1185
14109,0,0,1,0,58,1,1055,0,0,3577076,7223900,49.90991885387112,1409,5009,3927,2491,51706,727900,597400,1818,5391,3982,4336,7909,37.89459064299283,33.27181993396417,3573,1,513146,195842,1436,0,409,1464
14110,0,0,0,0,50,1,662,0,1,1816983,2668925,32.51153641401772,972,2861,2776,1057,56643,598425,603475,2440,3582,2610,4244,5386,41.46082488325576,9.300149152818726,1142,1,252623,10455,1719,0,1468,806
14111,0,0,1,0,66,1,453,0,0,1272348,3084312,30.397368307141328,321,2904,2301,924,52580,797782,734360,2735,4262,3941,4715,6242,37.107950630558946,24.58721666528819,1527,1,203280,94068,1377,0,2414,1961
14112,0,0,0,0,56,1,778,1,0,4969848,7523724,51.49757275833493,2014,5164,4526,2652,52539,598607,706413,2199,5489,3475,4711,8001,43.289721643826724,25.90463131617872,3290,1,660348,51678,1874,0,185,963
14113,0,0,0,0,55,1,538,1,0,5440743,7199367,51.15662224971465,2160,5153,4696,2617,56105,629979,673995,2294,5368,3208,4830,7904,45.59605246071199,21.719561109806076,3074,1,641165,48899,2079,0,134,672
14114,0,0,0,0,50,1,754,0,1,2241807,2965347,34.161381705077446,1107,3148,3088,1167,55278,632709,564102,2481,3708,2601,4462,5689,43.829214001622255,7.748117453886108,1227,1,259074,9360,1921,0,1374,620
14115,0,0,1,0,66,1,317,0,0,1239378,3221610,31.080540535840107,377,2838,2249,966,53410,817075,727030,2746,4301,3924,4618,6173,35.81898937714463,24.297256467590245,1555,1,210588,96007,1283,0,2369,2052
14116,0,0,0,0,57,1,967,1,0,3582390,7028308,49.36598018878993,1470,4874,3907,2437,56120,663320,703696,1917,5321,3851,4354,7758,38.34057902536163,31.19137452882987,3404,1,594628,98634,1470,0,447,1414
14117,0,0,0,0,53,1,974,0,1,4884000,4711728,42.14261501141095,1596,4706,4526,1776,52858,655291,567742,2473,4429,2833,5403,7359,52.44044240850758,13.871417214289645,1956,1,380064,26820,2750,0,877,97
14118,0,0,0,0,53,1,968,0,1,4663113,4593953,41.58124577258358,1547,4608,4426,1729,53874,653622,581883,2475,4386,2839,5354,7265,51.93264869039514,14.00336977441059,1911,1,378651,26026,2697,0,928,40
14119,0,0,0,0,56,1,1643,1,0,1135508,6152113,46.551047249229526,1997,2861,2691,2167,48006,536571,721106,2669,5006,3009,3363,5700,22.891046284519195,13.955050015729233,2337,1,550418,6120,524,0,672,2315
14120,0,0,0,1,66,1,2354,0,0,1101600,9151542,52.478567053607705,2601,3307,3154,2754,25650,378822,747675,3170,6077,3476,3723,6630,20.0,14.011101947662597,2907,1,619650,0,400,0,569,2923
14121,0,0,0,0,55,1,632,1,0,5441460,7406580,51.67204273105525,2201,5177,4708,2670,55890,638020,674082,2305,5444,3243,4812,7951,45.14421336118285,22.156336545636123,3139,1,648810,52528,2038,0,104,736
14122,0,1,1,0,63,0,1293,0,0,537544,5188680,40.29888335921977,1474,2105,1955,1624,37830,623025,619830,3045,4819,3345,3526,5300,18.193405398660254,12.30152264982736,1774,0,315056,19950,331,1,1571,2864
14123,0,0,0,0,57,1,1504,1,0,1311396,6149556,46.06517122512408,1894,2968,2740,2122,44176,510048,727398,2670,5020,3126,3516,5866,24.859605789312106,16.570390997525028,2350,1,532622,2964,618,0,776,2280
14124,0,0,0,0,57,1,1514,1,0,1339640,6167480,46.26013402488151,1924,2982,2766,2140,47120,547580,714736,2666,5022,3098,3508,5864,25.019992006393608,15.9932207903403,2356,1,530720,6696,626,0,742,2256
14125,0,0,1,0,61,1,614,0,0,2462552,5847608,43.657759905886145,1821,3283,3198,1906,50328,714844,662688,2983,4974,3153,4360,6351,35.94440151122286,9.224644470006377,1991,0,411696,13090,1292,1,1162,1776
14126,0,0,1,0,67,1,816,0,0,1393537,2819873,29.0,361,2978,2498,841,47959,808073,667247,2873,4194,3833,5010,6331,40.70626487409524,21.95071744408215,1321,1,167359,86880,1657,0,2512,1696
14127,0,0,1,0,68,1,1409,0,0,2116752,7893721,48.176757881783615,1655,3899,3233,2321,54216,853651,734616,2735,5722,4067,4313,7300,30.199337741083,26.37556028738493,2987,1,501336,110556,912,0,1080,2489
14128,0,0,0,0,58,1,1091,1,0,1613736,5672176,43.9089968002003,1552,3141,2765,1928,54934,667834,711964,2566,4870,3318,3779,6083,28.930952282978865,20.53608913329811,2304,1,466576,36096,837,0,1014,2105
14129,0,0,1,0,57,1,101,0,0,5382170,6859303,48.692915295759406,2137,4875,4641,2371,53424,729036,613316,2659,5264,3127,5163,7768,47.644516998286385,15.37716437725175,2605,1,502652,40248,2270,0,522,623
14130,0,0,1,0,57,1,330,0,0,4954599,6891375,48.95916665957459,2036,4825,4464,2397,56168,684250,678500,2514,5272,3236,4942,7700,45.46427168667722,19.039568597447047,2758,1,565692,47291,2067,0,478,808
14131,0,0,0,0,57,1,731,1,0,3709970,6689576,48.228622207149975,1507,4740,3921,2326,53130,603960,727628,2057,5202,3695,4471,7616,39.93745109543172,28.720069797808502,3145,1,588478,54054,1595,0,550,1281
14132,0,0,0,0,57,1,1431,1,0,1418770,6037140,45.880278987817846,1893,2991,2779,2105,53172,605148,722736,2656,4973,3080,3542,5859,25.96150997149434,15.65560409590837,2317,1,530460,14204,674,0,763,2194
14133,0,0,0,0,57,1,1489,1,0,1379210,6097560,46.20606020859169,1945,2971,2781,2135,51308,576912,725424,2666,4991,3046,3502,5827,25.41653005427767,14.817050448756712,2325,1,542290,10070,646,0,721,2210
14134,0,0,1,0,66,1,1442,0,0,1644000,2511000,27.386127875258307,234,3458,2942,750,47053,746604,706428,2832,4098,3864,5540,6806,46.8187996428785,22.723329151154964,1266,1,158250,77400,2192,0,2598,1156
14135,0,0,0,0,58,1,616,1,0,3833460,6689090,47.853944456021594,1453,4801,3964,2290,39852,718566,473202,2084,5211,3758,4595,7722,40.91454509095757,29.58009948487277,3127,1,370980,183303,1674,0,631,1247
14136,0,0,0,0,56,1,481,1,0,4877222,6992080,49.61854492022111,1904,5001,4443,2462,51204,579360,712840,2282,5302,3398,4821,7841,44.50842616853577,24.39585953036203,3020,1,617962,37944,1981,0,378,859
14137,0,0,0,0,53,1,4,0,1,5541312,6277488,48.49742261192856,2140,4920,4708,2352,55632,608532,651236,2457,5021,2881,5025,7589,48.53864439804639,14.658435386318777,2564,1,573888,22896,2356,0,317,313
14138,0,0,0,0,53,1,53,0,1,5524148,6188812,48.2078831727758,2114,4911,4701,2324,56640,628468,639120,2453,4987,2873,5040,7574,48.75448697299562,14.55997679978325,2534,1,557760,24990,2377,0,339,286
14139,0,0,0,0,51,1,1091,0,0,3009372,3251242,35.679125549822544,1273,3637,3637,1273,49275,574650,559326,2554,3827,2554,4918,6191,48.620983124572874,0.0,1273,0,278787,0,2364,0,1281,190
14140,0,0,1,0,60,1,2050,0,0,1873475,8215940,52.29722745997153,2523,3632,3420,2735,47940,705940,612816,2792,5739,3216,3689,6636,26.1725046566048,14.599262058563324,2947,1,557940,36040,685,0,269,2319
14141,0,0,1,0,60,1,1484,0,0,6782700,5917660,44.339598554790726,1858,5524,5416,1966,49266,623070,716380,2902,4976,3118,6460,8534,58.73670062235365,10.435690064413366,2074,1,467908,10152,3450,0,1044,440
14142,0,0,0,0,56,1,596,0,0,3721500,6403500,47.43416490252569,1391,4763,3904,2250,50882,702962,586276,1987,5096,3705,4500,7609,40.66939881532551,29.376871504196654,3109,0,463500,152902,1654,0,596,1192
14143,0,0,0,0,57,1,583,1,0,3750750,6453000,47.43416490252569,1391,4776,3917,2250,43845,679716,530580,2009,5118,3727,4535,7644,40.82891132518721,29.65353491454547,3109,1,416250,164928,1667,0,618,1201
14144,0,0,0,0,57,1,553,1,0,3778880,6401920,47.32863826479693,1514,4653,3927,2240,55278,634476,711642,2132,5098,3584,4545,7511,41.0731055558257,27.023796191240795,2966,1,557760,62436,1687,0,618,1171
14145,0,0,0,0,56,1,551,1,0,3755906,6335021,47.25462940284264,1476,4672,3915,2233,56069,643999,700739,2080,5070,3594,4519,7509,41.012193308819754,27.55532119781682,2990,1,551551,75700,1682,0,604,1155
14146,0,0,0,0,56,1,533,0,0,3745140,6324780,47.11687595755899,1375,4752,3907,2220,46494,700854,538461,2004,5069,3694,4536,7601,41.0731055558257,29.140433831211347,3065,0,419580,165620,1687,0,629,1162
14147,0,0,0,0,55,1,361,1,0,5086326,6837957,49.42671342502959,1993,4975,4525,2443,51294,576594,696951,2349,5242,3249,4881,7774,45.628938186199335,21.900719915423547,2893,1,608307,33300,2082,0,356,717
14148,0,0,0,0,53,1,768,0,1,5276785,5156195,44.10215414239989,1855,4748,4658,1945,54064,657448,577918,2561,4596,2741,5364,7399,52.08646657242167,10.008987875452021,2035,1,424010,13500,2713,0,706,62
14149,0,0,0,0,57,1,1219,1,0,1592712,5789669,44.844174649557324,1764,3050,2803,2011,56635,676565,693839,2632,4890,3126,3671,5929,28.142494558940577,16.67920783761053,2258,1,484651,29393,792,0,868,2087
14150,0,0,0,0,57,1,1390,1,0,1493811,5998355,45.83666654546336,1939,2974,2812,2101,49949,568145,716605,2693,4956,3017,3566,5829,26.664583251946766,13.993435617774107,2263,1,527351,10044,711,0,754,2144
14151,0,0,1,0,60,1,1640,0,0,6682544,5738436,43.497126341863094,1712,5604,5424,1892,45084,618732,670293,2853,4925,3213,6565,8637,59.430631832414505,13.446226071745194,2072,1,418132,20340,3532,0,1141,499
14152,0,0,0,0,58,1,412,0,1,4029888,6502976,47.15930449020638,1544,4716,4036,2224,53536,698836,654976,2244,5148,3604,4736,7640,42.567593307585526,26.968483701493412,2904,1,498176,85680,1812,0,700,1112
14153,0,0,0,0,53,1,95,1,0,5674050,6502680,49.29503017546495,2255,4940,4765,2430,56643,639564,634212,2501,5106,2851,5011,7616,48.321837713398274,13.461112333209106,2605,1,575910,21525,2335,0,246,341
14154,0,0,0,0,52,1,850,0,1,5248275,5015865,43.64630568559039,1845,4720,4660,1905,54755,618755,613489,2573,4538,2693,5388,7353,52.48809388804284,8.086478275311649,1965,1,443865,6840,2755,0,728,122
14155,0,0,0,0,57,1,1205,1,0,1618050,5772720,44.83302354291979,1768,3057,2815,2010,56876,692152,677792,2630,4882,3114,3677,5929,28.372521918222215,16.448836593433427,2252,1,474360,31460,805,0,862,2067
14156,0,0,0,0,57,1,1262,1,0,1587120,5846640,45.16635916254486,1828,3030,2818,2040,56635,673510,690706,2654,4906,3078,3644,5896,27.892651361962706,15.530051626164838,2252,1,491640,24804,778,0,826,2088
14157,0,0,1,0,67,1,1132,0,0,1764780,2945690,29.631064780058107,555,3211,2888,878,51120,805200,714615,3032,4233,3678,5365,6566,44.83302354291979,18.008310429515394,1201,1,187014,53618,2010,0,2477,1345
14158,0,0,1,0,65,1,496,0,0,4382160,6067320,43.12771730569565,1055,5021,4216,1860,51972,795928,694806,2457,5122,4067,5618,8283,48.53864439804639,28.558525127512524,2665,1,396180,136045,2356,0,1402,906
14159,0,0,0,0,56,1,436,1,0,3821565,6220695,46.74398357008097,1526,4593,3934,2185,54750,623493,711750,2188,5032,3506,4596,7440,41.82104733265297,25.741065341385244,2844,1,546250,55356,1749,0,662,1098
14160,0,0,0,0,56,1,425,0,0,3767100,6116125,46.52956049652737,1434,4636,3905,2165,52576,700600,598900,2094,4990,3556,4565,7461,41.71330722922842,27.072473515442198,2896,0,458980,125732,1740,0,660,1085
14161,0,0,0,0,56,1,421,0,0,3764042,6120622,46.49731175025068,1410,4655,3903,2162,51168,696426,588848,2079,4993,3583,4572,7486,41.72529209005013,27.47527471324383,2914,0,449696,132352,1741,0,669,1090
14162,0,0,0,0,52,1,182,0,1,5608619,6002886,47.738873049120045,2189,4830,4740,2279,55890,605820,640062,2544,4913,2724,5095,7464,49.60846701924985,9.486832980505138,2369,1,553797,10080,2461,0,355,173
14163,0,1,1,0,63,0,917,0,0,394284,3935424,35.156791662493895,886,1905,1555,1236,38088,585856,659088,2834,4420,3534,3503,5089,17.86057109949175,19.25236289351405,1586,0,255852,36400,319,1,1948,2865
14164,0,0,1,0,66,1,802,0,0,1716099,3242274,31.12876483254676,699,3010,2740,969,53599,826462,726082,3076,4315,3616,5117,6356,42.08325082500163,16.50027477956775,1239,1,210273,44550,1771,0,2377,1575
14165,0,0,1,0,57,1,491,0,0,5969210,6373640,47.01063709417264,2180,4941,4911,2210,48618,640248,631596,2854,5094,2914,5585,7825,51.97114584074513,5.490867587491313,2240,1,483990,4170,2701,0,674,183
14166,0,0,0,0,52,1,67,0,1,5694260,6230744,48.507731342539614,2258,4868,4773,2353,56364,611688,646112,2553,5001,2743,5068,7516,49.193495504995376,9.842833472037558,2448,1,574132,10260,2420,0,295,228
14167,0,0,0,0,52,1,611,0,1,5431520,5351765,45.221676218380054,1960,4786,4701,2045,55388,594059,638548,2532,4662,2702,5273,7403,51.536394906900505,9.2729914971827,2130,1,498980,9095,2656,0,572,39
14168,0,0,1,0,60,1,2465,0,0,1479036,8963136,54.4426303552648,2412,4015,3463,2964,30740,641088,438480,2472,5988,3576,3523,7039,22.338307903688676,23.599535114003253,3516,1,429780,111504,499,0,60,2525
14169,0,0,1,0,67,1,1040,0,0,1867044,3156642,30.692018506445613,686,3180,2924,942,52216,817644,717114,3095,4293,3607,5333,6531,44.51965857910413,16.032190321965594,1198,1,201588,42752,1982,0,2409,1369
14170,0,0,1,0,67,1,1074,0,0,1887256,3145114,30.62678566222711,670,3218,2950,938,51484,818132,707483,3085,4291,3621,5365,6571,44.85532298401161,16.40342893853216,1206,1,197918,45560,2012,0,2415,1341
14171,0,0,0,0,56,1,315,1,0,3830526,5991825,46.05431575867782,1497,4551,3927,2121,56105,646925,692125,2201,4946,3449,4631,7376,42.49705872175156,25.016862930820366,2745,1,519645,66144,1806,0,704,1019
14172,0,0,0,0,57,1,231,0,1,4117716,6164760,46.34652090502587,1575,4638,4065,2148,52836,683060,637140,2297,5018,3443,4787,7508,43.78355855797927,24.662340554539774,2721,1,476856,71625,1917,0,722,953
14173,0,0,0,0,52,1,294,0,0,5628520,5853750,47.22287581247038,2200,4784,4754,2230,51975,590625,606375,2595,4855,2655,5149,7409,50.23942674832188,5.572104574801163,2260,0,515130,3780,2524,0,395,101
14174,0,0,0,0,51,1,1247,1,0,4780050,4280100,40.620192023179804,1565,4632,4547,1650,36594,555116,443574,2509,4244,2679,5491,7226,53.823786563191554,9.231007614073922,1735,1,282150,15470,2897,0,944,303
14175,0,0,0,0,52,1,1317,1,0,4537048,4109736,39.63584236521283,1451,4579,4459,1571,40994,538896,520584,2496,4187,2736,5504,7195,53.74011537017761,11.15593165433301,1691,1,312629,17040,2888,0,1045,272
14176,0,0,1,0,67,1,1080,0,0,1970416,3234220,31.04834939252005,706,3266,3008,964,51062,811910,707905,3097,4319,3613,5399,6621,45.21061822182926,16.088916690483718,1222,1,203404,43860,2044,0,2391,1311
14177,0,0,0,0,56,1,259,1,0,3870042,5954234,45.83666654546336,1535,4509,3943,2101,54969,620646,711334,2268,4935,3400,4676,7343,42.91852746774987,23.848764564787327,2667,1,527351,46978,1842,0,733,992
14178,0,0,1,0,62,1,1439,0,0,3528452,8487948,52.25897052181568,2664,4090,4023,2731,43769,786324,537684,3041,5839,3175,4400,7198,35.94440151122286,8.47749576439433,2798,1,472463,14070,1292,0,377,1816
14179,0,0,1,0,62,1,1801,0,0,5853242,5258168,41.0,1196,5648,5163,1681,50838,694416,716312,2643,4809,3613,6610,8776,59.00847396772772,22.26229380566442,2166,1,384949,60625,3482,0,1447,354
14180,0,0,0,0,56,1,186,0,0,3805560,5755398,45.232731511594565,1428,4524,3906,2046,48906,694811,556974,2195,4859,3431,4673,7337,43.12771730569565,24.91048032041512,2664,0,405108,115566,1860,0,767,953
14181,0,0,0,0,58,1,165,1,0,3825000,5926200,45.16635916254486,1385,4570,3915,2040,35805,671055,450275,2250,4945,3560,4780,7475,43.30127018922193,26.192227817613617,2695,1,316200,140170,1875,0,865,1030
14182,0,0,1,0,63,1,1157,0,0,200430,4165800,36.193922141707716,1220,1553,1463,1310,43650,715500,616920,3090,4490,3270,3333,4733,12.36931687685298,9.535934250532243,1400,0,254140,15300,153,1,1870,3027
14183,0,0,1,0,65,1,237,0,0,1250458,4062124,35.25620512760839,1033,2459,2249,1243,54612,803928,725496,3058,4511,3478,4274,5727,31.71750305430741,14.621066420214344,1453,0,275946,33180,1006,0,2025,2262
14184,0,0,1,0,66,1,490,0,0,1858200,3785940,33.76388603226827,990,2920,2770,1140,52117,820287,700731,3171,4461,3471,4951,6241,40.3732584763727,12.261034368426225,1290,0,240540,25800,1630,0,2181,1691
14185,0,0,1,0,66,1,1619,0,0,2608152,3335962,31.575306807693888,647,3963,3613,997,51520,749504,769580,2996,4343,3696,5962,7309,51.146847410177685,18.730240044732902,1347,1,229310,44450,2616,0,2349,730
14186,0,0,1,0,61,1,1562,0,0,3402048,8566368,52.76362383309168,2784,4006,4006,2784,52118,778481,633862,3077,5861,3077,4299,7083,34.95711658589707,0.0,2784,0,573504,0,1222,1,293,1855
14187,0,0,1,0,58,1,758,0,0,6061440,6129024,45.95650117230423,1932,5162,4982,2112,53550,652950,690676,2722,5014,3082,5772,8064,53.5723809439155,13.439639827089282,2292,1,502656,21060,2870,0,790,32
14188,0,0,0,0,56,1,357,0,0,5046400,5884700,45.552167895721496,2075,4507,4507,2075,55304,703328,632428,2836,4911,2836,5268,7343,49.31531202375181,0.0,2075,0,462725,0,2432,0,761,404
14189,0,0,0,0,56,1,124,0,0,3806460,5679480,44.87761134463375,1410,4508,3904,2014,41140,682440,479400,2216,4834,3424,4710,7328,43.474130238568314,24.63482862033772,2618,0,342380,126840,1890,0,806,930
14190,0,0,0,0,52,1,487,0,0,5640864,5608704,46.3033476111609,2114,4805,4775,2144,52614,580752,619992,2586,4760,2646,5247,7421,51.29327441292864,5.477225575051661,2174,0,508128,3450,2631,0,472,15
14191,0,0,0,0,57,1,54,1,0,3813480,5692500,44.49719092257398,1362,4524,3906,1980,29700,646875,379500,2257,4855,3493,4801,7399,43.88621651498338,25.33827217414362,2598,1,261360,140286,1926,0,895,949
14192,0,0,0,1,66,1,608,0,0,2015888,3821692,33.88214869219483,1058,2994,2904,1148,50787,808947,695761,3239,4477,3419,5085,6323,41.90465367951393,9.522065445080457,1238,1,239932,15480,1756,0,2181,1573
14193,0,0,1,0,66,1,904,0,0,2173460,3644960,33.015148038438355,963,3211,3084,1090,49680,802560,692208,3217,4434,3471,5338,6555,44.654227123532216,11.273792045560366,1217,1,225630,21844,1994,0,2254,1350
14194,0,0,0,0,52,1,781,1,0,5080166,4989110,43.55456348076513,1802,4670,4575,1897,31465,533890,407650,2535,4527,2725,5308,7300,51.749396131742444,9.863740202967753,1992,1,294035,17480,2678,0,733,48
14195,0,0,0,0,53,1,1128,1,0,4434304,4292096,40.19950248448356,1426,4550,4360,1616,33034,528544,440896,2466,4272,2846,5400,7206,52.38320341483518,14.044701627992035,1806,1,268256,31920,2744,0,1040,88
14196,0,0,1,0,63,1,1164,0,0,257260,4323322,36.796738985948195,1204,1694,1544,1354,50838,731197,708846,3043,4547,3343,3383,4887,13.784048752090222,12.254111330655777,1504,0,300588,21450,190,1,1839,3003
14197,0,0,0,0,56,1,59,1,0,3807482,5456558,43.840620433565945,1381,4444,3903,1922,28990,633097,369070,2298,4761,3380,4820,7283,44.50842616853577,23.401639705691508,2463,1,249860,123348,1981,0,917,858
14198,0,0,0,0,55,1,130,1,0,4347171,5606254,44.955533585978046,1702,4491,4172,2021,54282,690726,604732,2455,4795,3093,4925,7265,46.37887450122092,18.351737857243336,2340,1,440578,48807,2151,0,753,623
14199,0,0,1,0,52,1,628,0,0,5269893,5253869,44.75488800120049,1913,4724,4634,2003,40018,561322,490501,2533,4626,2713,5254,7347,51.29327441292864,9.52871847115494,2093,1,374561,14850,2631,0,620,8
14200,0,0,1,0,52,1,694,0,0,5132855,5115350,44.10215414239989,1850,4679,4584,1945,34569,544410,439210,2535,4575,2725,5269,7309,51.37119815616529,9.842833472037558,2040,1,324815,16720,2639,0,685,9
14201,0,1,1,0,65,0,553,0,0,474854,3329073,31.921779399024736,403,2101,1485,1019,44091,676269,695871,2651,4286,3883,3733,5368,21.587033144922902,25.498415808534528,1635,0,217047,77616,466,1,2248,2801
14202,0,1,1,0,64,0,321,0,0,680680,3205202,31.63858403911275,611,2071,1681,1001,46440,691632,688430,2812,4203,3592,3882,5273,26.076809620810597,20.25234028213656,1391,0,215215,53430,680,1,2201,2522
14203,0,0,0,1,66,1,357,0,0,2040298,4175171,35.510561809129406,1231,2909,2879,1261,49776,807884,675444,3281,4572,3341,4929,6220,40.22437072223753,5.477225575051661,1291,1,257244,5370,1618,0,2050,1693
14204,0,0,1,0,56,1,355,0,0,4714356,5620809,44.73253849269008,1971,4387,4357,2001,56376,682587,651688,2779,4810,2839,5165,7196,48.53864439804639,5.501408174353464,2031,1,464232,4170,2356,0,808,453
14205,0,0,0,0,55,1,102,0,0,3858624,5349630,43.749285708454714,1484,4360,3930,1914,55125,684775,628875,2365,4709,3225,4811,7155,44.8998886412873,20.776809290145852,2344,0,430650,65790,2016,0,881,779
14206,0,0,0,0,54,1,206,0,1,4931120,5806680,46.04345773288535,1910,4656,4446,2120,56169,649143,649143,2529,4859,2949,5065,7395,48.228622207149975,14.910611547535398,2330,1,502440,24780,2326,0,619,413
14207,0,0,0,0,54,1,211,0,1,5198676,5921440,46.65833258915282,1987,4755,4565,2177,55860,620160,666400,2530,4897,2910,5108,7475,48.86716689148246,14.254285148303317,2367,1,533365,18620,2388,0,543,332
14208,0,0,1,0,52,1,542,0,0,5322888,5388552,45.2990066116245,1932,4766,4646,2052,42074,572468,506818,2506,4678,2746,5220,7392,50.93132631298737,10.996993508431213,2172,1,396036,19680,2594,0,574,32
14209,0,0,0,0,55,1,343,0,0,4659978,5579212,44.654227123532216,1994,4331,4331,1994,54253,668722,635146,2798,4792,2798,5135,7129,48.342527861087284,0.0,1994,0,452638,0,2337,0,804,461
14210,0,0,1,0,52,1,617,0,0,5041850,5180868,44.24929377967517,1808,4683,4533,1958,30888,523908,412776,2496,4604,2796,5221,7329,50.7444578254611,12.410850817228189,2108,1,305448,26400,2575,0,688,71
14211,0,0,0,0,55,1,373,0,0,4521308,5446608,44.13615298142782,1948,4269,4269,1948,52080,671040,606732,2796,4744,2796,5117,7065,48.176757881783615,0.0,1948,0,422716,0,2321,0,848,475
14212,0,0,1,0,54,1,1006,0,0,2060432,5561952,44.98888751680797,2024,3042,3042,2024,46428,601812,582576,2748,4772,2748,3766,5790,31.906112267087632,0.0,2024,0,429088,0,1018,1,724,1730
14213,0,0,1,0,55,1,1351,0,0,1969506,6142983,47.25462940284264,2203,3145,3115,2233,39405,585963,508935,2721,4984,2781,3633,5896,29.698484809834994,5.5503012171862105,2263,0,413105,4980,882,1,518,1869
14214,0,0,1,0,63,1,2071,0,0,2977896,9625584,55.20869496736904,2808,4265,4025,3048,53325,710550,748446,2918,6206,3398,4135,7423,31.25699921617557,15.494353432296254,3288,1,722376,28320,977,0,110,2181
14215,0,0,1,0,56,1,607,0,0,4714944,5315646,43.46262762420146,1829,4445,4385,1889,50140,647220,613452,2754,4703,2874,5310,7259,49.95998398718719,7.748117453886108,1949,1,411802,8880,2496,0,925,318
14216,0,0,0,0,52,1,278,0,0,5521995,5860890,47.06378650300037,2215,4708,4708,2215,53823,616518,611226,2646,4861,2646,5139,7354,49.92995093127971,0.0,2215,0,511665,0,2493,0,431,153
14217,0,0,0,0,53,1,316,1,0,5427261,5773404,46.65833258915282,2015,4832,4670,2177,47085,570180,580788,2490,4829,2814,5145,7484,49.92995093127971,12.771467890036456,2339,1,476763,20898,2493,0,475,159
14218,0,0,1,0,53,1,442,0,0,5154120,5465180,45.387222871640866,1848,4774,4562,2060,35292,541212,458969,2441,4713,2865,5155,7427,50.0199960015992,14.701031829420534,2272,1,356380,35192,2502,0,593,151
14219,0,0,0,0,54,1,710,1,0,4630736,4948460,42.731721238442994,1584,4604,4362,1826,25993,506770,376690,2468,4536,2952,5246,7314,50.35871324805669,16.169941716904972,2068,1,253814,43318,2536,0,884,174
14220,0,0,0,0,54,1,780,1,0,4504864,4812496,42.04759208325728,1500,4584,4316,1768,31816,528068,446408,2454,4490,2990,5270,7306,50.47771785649585,17.0316639184496,2036,1,289952,43684,2548,0,954,174
14221,0,0,1,0,64,1,2509,0,0,2725632,10716160,57.688820407423826,3081,4394,4147,3328,51146,689080,769580,2973,6548,3467,4039,7614,28.61817604250837,15.989552760408257,3575,1,795392,25441,819,0,108,2401
14222,0,0,1,0,56,1,370,0,0,4147800,5211720,43.12771730569565,1740,4210,4090,1860,49022,711708,540786,2682,4662,2922,5032,7012,47.22287581247038,11.06238981080611,1980,1,358980,22920,2230,0,942,572
14223,0,0,0,0,57,1,356,1,0,3778620,5057674,42.118879377305376,1384,4294,3904,1774,44022,721303,496074,2461,4625,3241,4981,7145,46.151923036857305,20.103444669102547,2164,1,308676,81510,2130,0,1077,721
14224,0,0,0,0,54,1,406,1,0,4140816,5054448,42.91852746774987,1565,4367,4090,1842,55029,606424,683256,2467,4586,3021,4992,7111,47.41307836451879,16.861120351761624,2119,1,458658,25207,2248,0,902,496
14225,0,0,0,0,54,1,687,1,0,4558414,4954956,42.649736224272246,1551,4593,4325,1819,27648,523008,392256,2456,4543,2992,5230,7317,50.05996404313531,17.054288550044582,2087,1,261936,48240,2506,0,905,218
14226,0,0,1,0,66,1,699,0,0,2605302,4359096,36.08323710533743,1168,3437,3303,1302,45458,796824,639468,3214,4650,3482,5349,6785,44.73253849269008,11.607297633161403,1436,1,248682,25058,2001,0,2046,1347
14227,0,0,1,0,63,1,2043,0,0,3055138,9631452,55.190578906186516,2751,4344,4049,3046,54093,692478,781014,2867,6208,3457,4165,7506,31.670175244226233,17.178720983821375,3341,1,752362,28025,1003,0,116,2159
14228,0,0,1,0,66,1,1679,0,0,4464042,4750842,37.86819245752297,520,5461,4547,1434,49440,682478,795120,2399,4747,4227,6426,8774,55.794264938253285,30.708054699321515,2348,1,344160,83174,3113,0,1879,200
14229,0,0,0,0,55,1,526,0,0,4395600,5159650,43.01162633521314,1850,4226,4226,1850,54044,638681,658204,2789,4639,2789,5165,7015,48.744230427815765,0.0,1850,0,436600,0,2376,0,939,413
14230,0,0,0,0,53,1,209,1,0,5397030,5938954,47.12748667179272,2136,4736,4651,2221,31310,540148,414470,2589,4895,2759,5104,7410,49.29503017546495,9.494144610579708,2306,1,344255,15555,2430,0,453,244
14231,0,0,0,0,53,1,242,1,0,5326080,5845110,46.79743582719036,2020,4792,4622,2190,42525,504441,600525,2499,4859,2839,5101,7461,49.31531202375181,13.19014343722849,2360,1,492750,14960,2432,0,479,237
14232,0,0,0,0,54,1,561,1,0,4675900,5156600,43.58898943540674,1628,4633,4361,1900,31408,564512,409814,2442,4614,2986,5175,7347,49.60846701924985,17.054288550044582,2172,1,286900,52496,2461,0,814,253
14233,0,0,1,0,60,1,1289,0,0,3562650,8009365,51.37119815616529,2609,4019,3989,2639,54253,725365,688945,3005,5674,3065,4385,7054,36.742346141747674,5.477225575051661,2669,0,599053,4410,1350,1,396,1685
14234,0,0,0,0,56,1,471,1,0,3764610,4844142,41.46082488325576,1406,4222,3909,1719,42250,704500,476242,2505,4537,3131,5008,7040,46.79743582719036,17.927634038761152,2032,1,290511,66982,2190,0,1099,628
14235,0,0,1,0,65,1,345,0,0,3624076,5653489,41.701318923986086,1654,3908,3823,1739,55216,773738,754232,3166,4990,3336,5335,7159,45.65084884205331,9.224644470006377,1824,1,403448,11730,2084,0,1512,1167
14236,0,0,0,0,55,1,521,0,0,3783546,4721348,41.255302689472536,1460,4167,3925,1702,43152,687952,482676,2532,4476,3016,4997,6941,47.148700936505136,15.588391269727603,1944,0,296148,51062,2223,0,1072,551
14237,0,0,0,0,52,1,355,0,0,4841550,5377470,45.05552130427524,2030,4415,4415,2030,50429,633111,558939,2649,4679,2649,5034,7064,48.83646178829912,0.0,2030,0,428330,0,2385,0,619,264
14238,0,0,1,0,64,1,257,0,0,3595388,6527293,45.044422518220834,1921,3909,3801,2029,39360,617664,659485,3109,5246,3325,4989,7126,42.09513035969837,10.403202108104866,2137,1,415945,12636,1772,0,1188,1445
14239,0,0,1,0,55,1,690,0,0,4295176,4888704,41.90465367951393,1696,4262,4202,1756,50140,606912,640320,2724,4540,2844,5230,7046,49.457052075512955,7.745966692414834,1816,1,403880,7260,2446,0,1028,338
14240,0,0,0,0,54,1,209,1,0,4991012,5760664,46.17358552246078,2005,4600,4473,2132,33760,570122,432320,2575,4834,2829,5043,7302,48.38388161361178,11.781273911446958,2259,1,341120,23876,2341,0,570,361
14241,0,0,0,0,55,1,708,0,0,4143040,4755936,41.376321731154405,1682,4162,4132,1712,50310,650052,597270,2748,4490,2808,5198,6940,49.193495504995376,5.478746393072713,1742,0,368080,4680,2420,0,1066,358
14242,0,0,0,0,54,1,167,1,0,4959240,5804370,46.314144707637645,1890,4712,4457,2145,40953,506022,592614,2451,4851,2961,5018,7418,48.08326112068523,16.199661663980073,2400,1,469755,23460,2312,0,561,394
14243,0,0,0,0,54,1,508,1,0,4320320,5058160,42.89522117905443,1479,4549,4188,1840,39100,632270,467330,2388,4589,3110,5097,7298,48.45616575834287,19.105403371455346,2201,1,312800,71839,2348,0,909,401
14244,0,0,1,0,61,1,1776,0,0,3279745,8866060,53.898051912847464,2406,4533,4034,2905,44180,717220,573776,2553,5957,3551,4181,7585,33.60059523282288,22.473526702475525,3404,0,546140,93812,1129,1,147,1923
14245,0,0,1,0,63,1,948,0,0,3632620,7747964,49.37610758251404,2343,4023,3928,2438,39162,581574,680092,3083,5616,3273,4668,7201,38.600518131237564,9.898721770111106,2533,1,521732,8930,1490,0,740,1688
14246,0,0,1,0,59,1,1220,0,0,4867421,5030284,40.97560249709576,1008,5249,4578,1679,48231,620172,698068,2325,4675,3667,5895,8245,53.842362503887216,26.09182577551602,2350,1,391207,68442,2899,0,1317,97
14247,0,0,0,0,54,1,816,0,0,3702625,4282573,39.48417404479927,1451,4042,3934,1559,45287,694991,491713,2639,4306,2855,5122,6789,48.73397172404482,10.406531168715494,1667,0,279061,22248,2375,0,1188,372
14248,0,0,0,0,53,1,286,1,0,4335120,5244912,44.090815370097204,1782,4336,4174,1944,37570,596258,458660,2536,4642,2860,4928,7034,47.22287581247038,13.032196985029728,2106,1,330480,30618,2230,0,754,468
14249,0,0,0,0,55,1,259,1,0,4407942,5438370,44.429719783046124,1550,4631,4207,1974,35700,578550,468350,2331,4729,3179,4988,7386,47.25462940284264,20.959932987892294,2398,1,335580,75048,2233,0,781,522
14250,0,0,1,0,62,1,1879,0,0,3334202,9335167,54.70831746635972,2908,4192,4107,2993,50702,782869,630038,3034,6112,3204,4233,7311,33.37663853655727,9.383858473517451,3078,1,604586,14365,1114,0,126,2005
14251,0,0,0,0,54,1,236,1,0,4300005,5326521,44.26059195266146,1743,4370,4154,1959,37887,595461,470387,2503,4678,2935,4914,7089,46.850827100489916,15.099741486923206,2175,1,338907,39960,2195,0,760,524
14252,0,0,1,0,65,1,865,0,0,1444950,5625900,41.352146256270665,1387,2878,2555,1710,41255,733670,608650,2967,5000,3613,4135,6168,29.068883707497267,18.135507721016413,2033,1,316350,57171,845,0,1580,2445
14253,0,0,1,0,56,1,1052,0,0,4221965,4515445,39.93745109543172,1339,4498,4242,1595,45126,586017,617158,2575,4426,3087,5478,7329,51.44900387762624,16.18806442001474,1851,1,347710,31232,2647,0,1236,184
14254,0,0,0,0,53,1,696,0,0,3565296,4223964,39.64845520319802,1512,3900,3840,1572,44121,620697,513217,2627,4259,2747,4955,6587,47.62352359916263,7.748117453886108,1632,0,300252,10740,2268,0,1115,419
14255,0,0,0,0,55,1,115,1,0,4291950,5545280,44.88875137492688,1680,4480,4145,2015,42372,588928,544896,2417,4767,3087,4882,7232,46.151923036857305,18.69777853458177,2350,1,398970,51590,2130,0,737,622
14256,0,0,0,0,55,1,198,1,0,4168135,5381815,44.10215414239989,1491,4542,4088,1945,51684,653012,605973,2313,4712,3221,4910,7309,46.292547996410825,21.440004603134955,2399,1,425955,70370,2143,0,822,624
14257,0,0,1,0,59,1,1239,0,0,4232272,4573239,39.102429592034305,769,5057,4297,1529,45333,619137,655029,2231,4520,3751,5759,8048,52.61178575186362,27.850402025395628,2289,1,334851,90440,2768,0,1462,223
14258,0,1,1,0,65,0,605,0,0,682014,1891983,24.020824298928627,217,2553,1759,577,52800,721380,786960,2485,3856,4073,4461,5832,34.38022687534217,28.627600403177897,1371,0,138480,84958,1182,1,2702,2097
14259,0,0,1,0,62,1,1970,0,0,1599384,8043504,50.872389367907616,2279,3515,3206,2588,49053,773892,612276,2799,5696,3417,3726,6623,24.859605789312106,17.61967352074504,2897,1,509836,58710,618,0,520,2490
14260,0,1,1,0,64,0,86,0,0,1275051,3520793,32.96968304366907,1057,2290,2260,1087,56120,790316,744970,3209,4326,3269,4412,5529,34.249087579087416,5.483301264452448,1117,0,250010,4320,1173,1,2152,2066
14261,0,0,1,0,61,1,2038,0,0,2144295,8672482,52.94336596779619,2234,4137,3568,2803,43281,708526,584766,2525,5897,3663,3859,7231,27.65863337187866,23.85556259403448,3372,0,529767,102420,765,1,291,2329
14262,0,0,1,0,64,1,1461,0,0,1083082,6472466,44.74371464239419,1223,3322,2543,2002,44064,698328,659532,2454,5235,4012,3774,6555,23.259406699226016,27.931807590786228,2781,0,408408,116071,541,1,1231,2692
14263,0,0,0,0,56,1,763,1,0,3063930,6171320,46.61544808322666,2053,3703,3583,2173,22523,633320,286840,2720,5013,2960,4250,6543,37.54996671103717,11.765341641478667,2293,1,219473,29520,1410,0,667,1430
14264,0,0,1,0,61,1,424,0,0,3927105,5483699,42.20189569201838,1484,4283,3986,1781,55250,680459,769750,2782,4860,3376,5284,7362,46.95742752749558,17.54557963638612,2078,1,445250,25839,2205,0,1298,874
14265,0,0,0,0,54,1,644,1,0,3082541,3988138,38.24918299781056,1253,3780,3570,1463,39144,635158,457968,2516,4189,2936,4833,6506,45.902069670114,14.555357889997133,1673,1,245784,42840,2107,0,1263,619
14266,0,0,0,0,54,1,447,1,0,3238830,4359780,39.87480407475377,1271,3946,3627,1590,44719,622434,540174,2423,4332,3061,4779,6688,45.13313638558703,18.026902931800603,1909,1,313230,53911,2037,0,1152,705
14267,0,0,0,0,54,1,422,1,0,3264240,4413960,40.099875311526844,1266,3980,3638,1608,44038,623115,532530,2403,4353,3087,4775,6725,45.05552130427524,18.673368975059056,1950,1,311952,59166,2030,0,1137,715
14268,0,0,1,0,65,1,1411,0,0,1224926,6576662,44.9221548904324,1240,3403,2625,2018,46945,746311,668095,2481,5277,4037,3866,6662,24.63736998950984,27.922567967566025,2796,1,413690,126036,607,0,1241,2652
14269,0,0,1,0,65,1,1316,0,0,1370685,6551274,44.73253849269008,1270,3417,2686,2001,47952,726828,707184,2543,5275,4005,3959,6691,26.1725046566048,27.066108481289398,2732,1,432216,103802,685,0,1273,2589
14270,0,0,0,0,57,1,1512,1,0,3614580,3676500,35.91656999213594,870,4512,4092,1290,40723,601350,550050,2430,4140,3270,5652,7362,52.933921071464184,20.720188616349954,1710,1,248970,65100,2802,0,1560,48
14271,0,0,0,0,54,1,740,0,0,2655341,3530914,36.069377593742864,1024,3619,3342,1301,44719,616078,534658,2437,4015,2991,4755,6333,45.17742799230607,16.66285869514053,1578,0,256297,46813,2041,0,1413,673
14272,0,0,0,0,54,1,610,1,0,2726016,3768882,37.067505985701274,1043,3689,3358,1374,46995,661063,534885,2412,4117,3074,4727,6432,44.54211490264017,18.26619863064172,1705,1,267930,61235,1984,0,1369,759
14273,0,0,1,0,67,1,316,0,0,4206285,6443307,43.57751713900185,1602,4411,4114,1899,54366,834678,749853,3096,5292,3690,5608,7804,47.06378650300037,17.336123515451035,2196,1,419679,47520,2215,0,1494,1178
14274,0,0,1,0,60,1,386,0,0,3978767,5498196,42.555845661906424,1476,4343,4008,1811,54225,731676,683100,2701,4847,3371,5233,7379,46.87216658103186,18.534096587088996,2146,1,407475,43550,2197,0,1225,839
14275,0,0,0,0,54,1,1072,0,0,2555300,3148700,33.91164991562634,1150,3372,3372,1150,48168,610574,591408,2738,3888,2738,4960,6110,47.138094997570704,0.0,1150,0,248400,0,2222,0,1588,516
14276,0,0,0,0,54,1,713,1,0,2577288,3508512,35.888716889852724,975,3602,3289,1288,42823,623796,509388,2411,4012,3037,4725,6326,44.73253849269008,17.729652552337875,1601,1,240856,56653,2001,0,1436,723
14277,0,0,0,0,54,1,634,1,0,2622011,3652420,36.51027252705737,982,3651,3300,1333,46320,657600,528820,2389,4073,3091,4707,6391,44.35087372307337,18.814925257001708,1684,1,257269,65637,1967,0,1407,773
14278,0,0,0,0,55,1,554,1,0,2672235,3797750,37.16180835212409,1010,3687,3316,1381,49440,660000,566500,2379,4131,3121,4685,6437,43.98863489584554,19.344814791810816,1752,1,284486,64183,1935,0,1369,815
14279,0,0,0,0,55,1,387,1,0,2723140,4050212,38.31448812133603,994,3797,3323,1468,49059,653883,571113,2285,4227,3233,4614,6556,43.069710934716056,21.885973238959636,1942,1,303876,80106,1855,0,1291,904
14280,0,0,0,0,57,1,698,1,0,3614688,6505982,47.77028364998475,2120,4028,3866,2282,34364,689942,404842,2689,5133,3013,4435,6879,39.7994974842648,13.28445058508805,2444,1,324044,37422,1584,0,569,1267
14281,0,0,1,0,57,1,82,0,0,3532719,5290803,42.883563284783136,1839,3760,3760,1839,51067,658833,641571,2877,4716,2877,4798,6637,43.829214001622255,0.0,1839,0,410097,0,1921,1,1038,956
14282,0,0,1,0,60,1,1397,0,0,4735608,8987808,54.62600113499065,2954,4601,4571,2984,54285,707820,695772,2982,5996,3042,4599,7613,39.83716857408418,5.478746393072713,3014,0,689304,4110,1587,1,28,1425
14283,0,0,1,0,61,1,1485,0,0,3379000,3798120,35.21363372331802,1028,4177,3965,1240,48000,765750,588096,2851,4303,3275,5788,7240,52.20153254455275,14.72865131070837,1452,1,238080,41340,2725,0,1823,338
14284,0,0,0,0,55,1,1223,0,0,2190870,2722500,31.464265445104548,990,3203,3203,990,49028,654500,566500,2750,3740,2750,4963,5953,47.042533945356304,0.0,990,0,203940,0,2213,0,1760,537
14285,0,0,1,0,67,1,1213,0,0,2277660,7491715,47.25462940284264,1361,4125,3253,2233,39375,754875,587125,2483,5588,4227,4375,7480,31.937438845342623,29.568105125425404,3105,1,390775,164808,1020,0,1122,2335
14286,0,0,1,0,66,1,25,0,0,4487886,7050888,45.89117562233506,2076,4267,4237,2106,47232,823608,642816,3318,5454,3378,5479,7615,46.16275555033516,5.572104574801163,2136,1,404352,5760,2131,0,1242,1217
14287,0,0,1,0,63,1,1636,0,0,5284476,10396278,57.07889277132134,2882,5256,4880,3258,40804,644582,644582,2815,6449,3567,4813,8447,40.27406113120453,19.85904818241984,3634,1,658116,50008,1622,0,67,1569
14288,0,0,0,0,55,1,1323,0,0,2013208,2492328,30.066592756745816,874,3161,3131,904,51040,639624,606540,2727,3661,2787,4984,5918,47.19110085598767,5.478746393072713,934,0,198880,4470,2227,0,1853,530
14289,0,0,0,0,58,1,747,1,0,4310488,7213115,49.82971001320397,2308,4394,4219,2483,32319,705915,386365,2730,5388,3080,4641,7299,41.66533331199932,14.64508235363062,2658,1,330239,40250,1736,0,422,1169
14290,0,0,0,0,55,1,1349,0,0,1955306,2422402,29.631064780058107,878,3105,3105,878,51230,648365,601462,2759,3637,2759,4986,5864,47.19110085598767,0.0,878,0,191404,0,2227,0,1881,532
14291,0,0,0,0,58,1,1103,1,0,3786354,4318856,38.353617821530214,1471,4045,4045,1471,47244,745744,546096,2936,4407,2936,5510,6981,50.73460357586329,0.0,1471,1,273606,0,2574,0,1465,362
14292,0,0,0,1,67,1,267,0,0,5525848,7518085,47.12748667179272,2011,4919,4709,2221,46127,809015,653305,3175,5606,3595,5873,8304,49.879855653359705,14.596690407581317,2431,1,428653,39060,2488,0,1164,897
14293,0,1,1,0,65,0,688,0,0,1671908,3245410,31.52776554086889,738,2932,2676,994,46420,688915,718300,3009,4259,3521,4947,6197,41.012193308819754,16.404844797070098,1250,0,218680,31488,1682,1,2271,1583
14294,0,0,1,0,60,1,1045,0,0,4864016,8467404,52.81098370604357,2278,5044,4533,2789,42273,701316,555588,2525,5825,3547,4780,8080,41.7612260356422,22.782438357947235,3300,1,510387,96068,1744,0,247,1292
14295,0,0,0,1,68,1,405,0,0,5973750,7672500,47.43416490252569,1888,5267,4905,2250,47096,791120,692230,3048,5660,3772,6065,8677,51.526692111953004,19.07579542641156,2612,1,456750,60816,2655,0,1160,755
14296,0,1,1,0,62,0,1268,0,0,513893,1017127,17.97220075561143,293,1944,1914,323,49235,721121,677035,3119,3472,3179,4740,5093,39.88734135035826,5.483301264452448,353,0,69445,4500,1591,1,2826,1558
14297,0,0,0,1,67,1,110,0,0,5496000,7698980,47.853944456021594,2230,4750,4690,2290,40869,803518,574902,3302,5652,3422,5762,8112,48.98979485566356,7.83531632499182,2350,1,391590,12420,2400,0,1072,962
14298,0,0,0,1,67,1,266,0,0,5804880,7745160,47.74934554525329,2064,5042,4826,2280,44694,794898,648827,3181,5677,3613,5943,8439,50.457903246171455,14.742090873254648,2496,1,435480,39528,2546,0,1117,851
14299,0,0,0,1,68,1,378,0,0,6209280,7893270,48.062459362791664,1968,5340,4998,2310,45080,785910,669732,3075,5727,3759,6105,8757,51.84592558726288,18.56929705162081,2652,1,452760,59166,2688,0,1107,729
14300,0,0,1,0,63,1,1791,0,0,6302970,11348907,59.67411499134277,3111,5781,5331,3561,43600,694766,637400,2737,6748,3637,4957,8968,42.07136793592526,21.772146668954463,4011,1,712200,70200,1770,0,374,1417
14301,0,0,1,0,67,1,1330,0,0,3148800,8693760,50.59644256269407,2035,4315,3790,2560,44576,760704,675804,2871,5956,3921,4626,7711,35.07135583350036,23.134429560463524,3085,1,509440,86100,1230,0,836,2166
14302,0,0,0,1,68,1,154,0,0,6289152,8271232,49.31531202375181,2312,5138,5018,2432,45458,809438,649591,3281,5833,3521,5987,8539,50.85272854036448,11.100602434372421,2552,1,464512,22440,2586,0,969,815
14303,0,0,1,0,65,1,1716,0,0,7137472,11984944,60.530983801686226,3023,6253,5612,3664,39520,621490,680368,2630,6935,3912,5219,9524,44.13615298142782,26.014127080009928,4305,1,762112,71151,1948,0,393,1323
14304,0,0,0,0,57,1,1206,0,0,4012855,4268963,38.58756276314948,1422,4251,4184,1489,53020,690947,630740,2800,4356,2934,5562,7118,51.91338940966964,8.185808589931957,1556,0,327580,10519,2695,0,1378,172
14305,0,0,1,0,61,1,2307,0,0,1747708,8901388,53.925875050851054,2728,3689,3509,2908,46366,731579,593834,2881,5969,3241,3662,6750,24.515301344262525,13.42674807141325,3088,0,564152,33120,601,1,153,2460
14306,0,0,0,1,67,1,7,0,0,6277518,8451756,50.0199960015992,2435,5078,5011,2502,40809,753294,618174,3311,5880,3445,5887,8456,50.08991914547278,8.187175587434018,2569,1,457866,11993,2509,0,876,869
14307,0,0,1,0,60,1,1880,0,0,2509364,8482318,52.744667976962376,2697,3769,3684,2782,51040,707368,670780,2964,5831,3134,3951,6818,30.033314835362415,9.220820253968727,2867,0,612040,12665,902,1,267,2147
14308,0,0,0,1,67,1,28,0,0,6350204,8569988,50.33885179461288,2426,5148,5040,2534,42653,747422,652726,3274,5916,3490,5888,8530,50.05996404313531,10.400314334861214,2642,1,489062,17928,2506,0,848,876
14309,0,1,1,0,64,0,1143,0,0,1425040,2441744,27.422618401604176,570,2829,2647,752,52210,746810,737069,3065,3999,3429,5142,6076,43.53159771935783,13.495723976045436,934,0,170704,24934,1895,1,2495,1352
14310,0,0,1,0,65,1,2326,0,0,1675031,9510228,53.879495172096775,2795,3588,3480,2903,48443,822276,632268,3168,6179,3384,3853,6864,24.020824298928627,10.392527581411793,3011,0,560279,20952,577,1,373,2699
14311,0,0,0,1,68,1,1084,0,0,4363200,9312300,51.96152422706632,2153,4863,4316,2700,56394,831209,807066,2902,6149,3996,5065,8312,40.19950248448356,23.512106213561296,3247,1,631800,74392,1616,0,749,1833
14312,0,0,1,0,65,1,2159,0,0,2108970,9510588,53.749418601506754,2829,3679,3619,2889,54145,806540,727532,3232,6181,3352,4022,6971,27.018512172212592,7.7992067098508295,2949,0,638469,9540,730,1,403,2562
14313,0,0,0,1,67,1,183,0,0,6354634,8824864,51.12729212465687,2359,5300,5045,2614,44325,759600,665072,3121,5990,3631,5807,8676,49.3051721424842,15.976142983592842,2869,1,514958,42585,2431,0,762,945
14314,0,0,1,0,61,1,109,0,0,5316972,6875356,47.45524207081869,1806,5059,4613,2252,47515,656395,674713,2607,5305,3499,5414,8112,48.590122453025366,21.27837533522874,2698,1,497692,56642,2361,0,801,692
14315,0,0,1,0,63,1,1350,0,0,7752600,11267820,59.49789912257407,3205,6065,5730,3540,53172,671613,802116,2848,6723,3518,5373,9248,46.79743582719036,19.095501481432372,3875,1,892080,24455,2190,0,357,993
14316,0,0,1,0,65,1,1515,0,0,8567746,12288250,61.48983655857283,3331,6497,6047,3781,53550,731250,773500,2800,7031,3700,5516,9747,47.60252094164762,22.237236599433658,4231,1,899878,41850,2266,0,531,984
14317,0,0,1,0,59,1,950,0,0,2264459,6070721,45.31004303683677,1623,3586,3156,2053,27370,680110,351883,2527,5010,3387,4060,6543,33.21144381083123,20.75536868787238,2483,0,244307,103200,1103,1,904,1854
14318,0,0,1,0,63,1,2619,0,0,1381050,9814662,55.39855593785816,3039,3549,3519,3069,49446,786708,642798,3168,6267,3228,3648,6747,21.213203435596427,5.478746393072713,3099,1,616869,5490,450,0,129,2748
14319,0,0,1,0,61,1,1892,0,0,1761984,7918624,50.75431016179808,2486,3350,3260,2576,43068,682428,596356,2984,5650,3164,3758,6424,26.153393661244042,9.560918316574591,2666,0,499744,14940,684,1,498,2390
14320,0,1,0,1,65,0,1224,0,0,2656537,3698604,33.60059523282288,1034,3577,3482,1129,49203,756756,697788,3181,4405,3371,5629,6853,48.507731342539614,9.747874142570481,1224,1,240477,14915,2353,0,2147,923
14321,0,0,1,0,57,1,555,0,0,3029400,5836440,45.16635916254486,2010,3555,3525,2040,42350,500675,692362,2831,4901,2891,4346,6416,38.535697735995385,5.531194905403055,2070,1,493680,1260,1485,0,821,1376
14322,0,0,1,0,58,1,2155,0,0,3738576,3328480,33.704599092705436,1016,4547,4427,1136,37036,550840,577210,2810,4066,3050,6221,7477,57.367238037053866,11.808089875718325,1256,1,223792,14520,3291,0,1794,361
14323,0,0,1,0,60,1,1209,0,0,5277580,5374985,42.08325082500163,1262,5260,4751,1771,46209,640385,664665,2526,4806,3544,6015,8295,54.589376255824725,23.20709807978049,2280,1,387849,63625,2980,0,1264,55
14324,0,0,1,0,61,1,287,0,0,7610814,8956292,53.907327887774215,2724,5707,5525,2906,30173,650302,440726,2900,5988,3264,5701,8789,51.176166327695945,13.854620689726602,3088,1,415558,37128,2619,0,176,463
14325,0,0,1,0,63,1,414,0,0,6634207,7585007,48.75448697299562,1698,5847,5168,2377,51296,714784,730739,2512,5568,3870,5982,9038,52.82991576748916,26.523370096062088,3056,1,544333,86912,2791,0,814,400
14326,0,0,0,0,61,1,1184,1,0,1629185,6178909,44.710177812216315,1258,3555,2814,1999,46046,782023,562562,2350,5090,3832,3906,6646,28.548204847240395,27.257384428910132,2740,1,363818,151164,815,0,1092,2276
14327,0,0,1,0,60,1,2377,0,0,1554474,1613214,23.108440016582687,251,3728,3445,534,35280,543780,592116,2738,3555,3304,5932,6749,53.95368384086484,18.057890563238146,817,1,104664,31130,2911,0,2487,110
14328,0,0,1,0,60,1,2381,0,0,3557840,3147040,32.2490309931942,661,4840,4461,1040,39710,632434,574940,2647,4066,3405,6447,7866,58.489315263559035,20.35096568052088,1419,1,197600,58745,3421,0,1986,395
14329,0,0,1,0,63,1,506,0,0,7215195,7792215,49.44694126030446,1714,6127,5396,2445,54044,729823,752132,2456,5632,3918,6138,9314,54.323107422164284,27.420593621712417,3176,1,577020,90644,2951,0,742,236
14330,0,0,0,1,68,1,664,0,0,11402225,12709700,61.032778078668514,3390,7121,6786,3725,53250,726756,853000,3077,7137,3747,6473,10533,55.326304774492215,19.537784724155227,4060,1,931250,22780,3061,0,313,351
14331,0,1,1,0,62,0,1595,0,0,1073550,1586100,22.58317958127243,480,2645,2615,510,54692,752620,702860,3080,3620,3140,5215,5755,45.880278987817846,5.477225575051661,540,0,115260,4500,2105,1,2600,1005
14332,0,0,0,1,67,1,771,0,0,11599146,12876501,61.74949392505172,3513,7155,6855,3813,55189,813857,773333,3077,7190,3677,6419,10532,55.154328932550705,18.289903018684413,4113,1,873177,38100,3042,0,436,335
14333,0,0,1,0,62,1,1036,0,0,1782300,6128850,44.15880433163923,1377,3437,2864,1950,55692,748034,735462,2570,5093,3716,4057,6580,30.23243291566195,24.139636713863382,2523,1,456300,77355,914,0,1193,2229
14334,0,0,0,1,67,1,742,0,0,11778663,12864395,61.83041322844284,3553,7174,6904,3823,55647,817695,770585,3095,7188,3635,6446,10539,55.50675634551167,17.387285977754626,4093,1,875467,36180,3081,0,458,284
14335,0,1,1,0,62,0,1431,0,0,1114960,1741600,23.664319132398465,530,2581,2551,560,51863,743290,674870,3080,3670,3140,5101,5691,44.62062303464621,5.478746393072713,590,0,121520,4770,1991,1,2550,1119
14336,0,1,0,1,68,0,1254,0,0,5304640,6006880,41.95235392680606,1598,4936,4774,1760,54253,774751,815707,3251,5173,3575,6427,8349,54.89990892524322,13.043815312217163,1922,1,420640,18954,3014,0,1653,399
14337,0,1,1,0,65,0,1736,0,0,2979200,3509072,32.61901286060018,631,4297,3864,1064,56882,784924,788222,2865,4362,3731,6098,7595,52.91502622129181,20.81666615343374,1497,0,254296,53692,2800,1,2234,498
14338,0,0,1,0,62,1,1057,0,0,1393830,5715614,42.68489194082609,1138,3271,2587,1822,56643,749743,743469,2453,4959,3821,3902,6408,27.65863337187866,26.29203857861957,2506,1,431814,87552,765,0,1315,2372
14339,0,0,0,1,68,1,442,0,0,12355643,12801060,61.180062111769715,3401,7386,7044,3743,56386,796860,827640,3078,7163,3762,6721,10806,57.4543296888929,19.682782462718052,4085,1,905806,39330,3301,0,323,119
14340,0,1,0,1,68,0,1267,0,0,5399550,6050975,42.13074886588179,1585,5007,4817,1775,56105,780661,835205,3219,5184,3599,6451,8416,55.154328932550705,13.919868588335374,1965,1,434875,20520,3042,0,1634,367
14341,0,0,1,0,62,1,1136,0,0,1673945,6158929,44.50842616853577,1497,3310,2826,1981,51865,786577,637345,2625,5090,3593,3954,6419,29.068883707497267,22.035624309222797,2465,1,406105,87604,845,0,1128,2264
14342,0,0,1,0,68,1,469,0,0,12536862,12896247,61.506097258727124,3483,7397,7097,3783,56105,780661,835205,3109,7192,3709,6723,10806,57.56735185849702,18.582596739516166,4083,1,926835,31500,3314,0,374,95
14343,0,1,0,1,67,0,1368,0,0,4928473,5541459,40.48456495999432,1338,4947,4646,1639,56334,831726,774249,3080,5020,3682,6388,8328,54.83611948342078,17.57291618745797,1940,1,375331,43344,3007,0,1742,374
14344,0,0,0,1,67,1,1461,0,0,8290240,12546390,60.83584469702052,3227,6415,5941,3701,51088,840720,698340,2916,7091,3864,5630,9805,47.32863826479693,21.882705402954983,4175,1,762406,84372,2240,0,311,1150
14345,0,0,0,1,68,1,443,0,0,12735138,12951567,61.61980201201558,3488,7460,7151,3797,55350,767475,839106,3102,7208,3720,6765,10871,57.91372894228103,18.818415009596432,4106,1,934062,31827,3354,0,386,57
14346,0,0,1,0,66,1,626,0,0,12905267,12952295,62.601916903558156,3792,7339,7212,3919,49680,684135,793200,3178,7224,3432,6598,10644,57.38466694161429,12.165663908715395,4046,1,940560,7620,3293,0,614,12
14347,0,0,0,1,67,1,1664,0,0,7904400,12662096,61.35144660071187,3445,6183,5864,3764,51045,837636,689620,3045,7128,3683,5464,9547,45.8257569495584,17.937475041485726,4083,1,771620,57420,2100,0,400,1264
14348,0,0,1,0,64,1,97,0,0,9866670,10208000,56.480084985771754,2866,6607,6283,3190,27531,662400,425600,2876,6390,3524,6293,9807,55.614746245937326,18.78705018610672,3514,1,424270,67392,3093,0,10,107
14349,0,0,0,1,68,1,392,0,0,13335233,13165701,62.07253821135398,3518,7649,7314,3853,51129,707319,843999,3082,7270,3752,6878,11066,58.83026432033091,19.489064710427993,4188,1,951691,26800,3461,0,436,44
14350,0,0,1,0,62,1,1695,0,0,5843026,5395672,41.400483088968905,1391,5446,5123,1714,47712,705152,670524,2825,4862,3471,6557,8594,58.38664230798,18.078911998106022,2037,1,365082,47804,3409,0,1434,261
14351,0,1,0,1,67,0,1312,0,0,6000960,6331840,43.3589667773576,1580,5372,5072,1880,56394,788112,811688,3068,5248,3668,6560,8740,56.49778756730214,17.42142869747889,2180,1,453080,35400,3192,0,1488,176
14352,0,1,1,0,66,0,1619,0,0,4226600,4645200,37.416573867739416,1250,4569,4419,1400,56619,806274,773094,3168,4718,3468,6337,7887,54.945427471264615,12.30702509692623,1550,0,326200,19800,3019,1,1918,299
14353,0,0,1,0,61,1,248,0,0,1777545,4494336,38.24918299781056,1271,2870,2678,1463,50160,642048,737280,2880,4535,3264,4287,5942,34.85685011586675,14.16224523360256,1655,1,351120,18048,1215,0,1609,1857
14354,0,0,1,0,64,1,996,0,0,13657437,13526400,65.01538279515087,4185,7500,7458,4227,55671,771200,739200,3158,7427,3242,6431,10700,56.84188596448925,6.488991180673202,4269,0,976437,5922,3231,1,1027,31
14355,0,1,0,1,67,0,1351,0,0,5911752,6196344,42.988370520409354,1614,5281,5047,1848,54990,784602,787955,3119,5201,3587,6552,8634,56.55970296951709,15.36373936684579,2082,1,434280,30420,3199,0,1505,154
14356,0,0,1,0,62,1,258,0,0,10794303,10743048,58.45511098270193,3175,6818,6576,3417,42588,735696,572208,2902,6561,3386,6303,9962,56.20498198558558,15.829634656945002,3659,1,621894,46464,3159,0,273,15
14357,0,1,0,1,66,0,1389,0,0,5830326,6084846,42.638011210655684,1648,5195,5025,1818,54273,793239,766463,3177,5165,3517,6554,8542,56.630380539071076,13.108333333204333,1988,1,416322,24140,3207,0,1529,140
14358,0,0,0,1,67,1,1799,0,0,8086206,13101750,62.30569797378086,3511,6336,5965,3882,47674,816750,664875,3004,7257,3746,5458,9711,45.639894828976104,19.358889276734608,4253,1,764754,68264,2083,0,507,1292
14359,0,0,1,0,64,1,819,0,0,13958632,13350104,64.5600495662759,4108,7577,7517,4168,45787,695051,675833,3143,7371,3263,6552,10780,57.87054518492115,7.780166052320878,4228,0,879448,8520,3349,1,965,146
14360,0,0,0,1,67,1,1821,0,0,8120062,13192662,62.465990746965666,3507,6378,5983,3902,46031,814821,645771,2986,7283,3776,5462,9759,45.617978911828175,19.98454459400971,4297,1,745282,75050,2081,0,521,1300
14361,0,0,1,0,62,1,758,0,0,13098680,12576340,63.387695966961914,3958,7338,7278,4018,51480,688600,732420,3070,7148,3190,6390,10468,57.09640969448079,7.765259411425052,4078,0,940212,7020,3260,1,888,130
14362,0,0,1,0,60,1,40,0,0,1345200,3469020,33.76388603226827,805,2655,2320,1140,45333,629901,666417,2708,4183,3378,4223,5698,34.351128074635334,18.42511611728293,1475,1,249660,40535,1180,0,1903,1863
14363,0,0,1,0,65,1,1751,0,0,5223756,10846272,57.645468165329355,3196,5022,4895,3323,54587,806208,721344,3137,6587,3391,4836,8286,39.64845520319802,11.273792045560366,3450,0,734383,20320,1572,1,59,1692
14364,0,0,0,1,70,1,100,0,0,14958924,13720836,62.5939294181153,3588,8066,7736,3918,56404,836978,826472,3172,7420,3832,7320,11568,61.78996682310163,18.531111587647825,4248,1,924648,43230,3818,0,416,316
14365,0,0,1,0,69,1,223,0,0,14860160,13784832,62.99206299209449,3710,7971,7713,3968,54216,750384,871974,3216,7442,3732,7219,11445,61.196405123176966,16.75901954553288,4226,1,995968,20124,3745,0,494,271
14366,0,0,1,0,66,1,493,0,0,14742494,13657584,63.984373092185564,3852,7937,7695,4094,38936,523752,827328,3094,7430,3578,6937,11273,60.00833275470999,15.60104761947802,4336,1,1015312,0,3601,0,758,265
14367,0,1,0,1,68,0,1294,0,0,7533791,7425141,46.61544808322666,1812,6001,5640,2173,52750,720987,854250,3056,5590,3778,6884,9418,58.881236400062114,19.014562633801113,2534,1,543250,28519,3467,0,1244,50
14368,0,1,0,1,67,0,1370,0,0,6896571,6825556,45.044422518220834,1757,5700,5428,2029,52664,763628,780448,3092,5393,3636,6763,9064,58.30094338859364,16.58986273313849,2301,1,470728,35088,3399,0,1335,35
14369,0,1,0,1,66,0,1449,0,0,6315940,6310267,43.485629810317796,1796,5326,5231,1891,51736,744151,774184,3242,5228,3432,6677,8663,57.79273310719956,9.80698324197389,1986,1,438712,11685,3340,0,1446,3
14370,0,1,1,0,61,0,755,0,0,894836,1958255,25.317977802344327,310,2368,2037,641,56406,727090,724035,2724,3696,3386,4451,5423,37.36308338453881,18.273249983663323,972,0,151917,43030,1396,1,2414,1659
14371,0,0,1,0,63,1,1546,0,0,1393392,6879600,46.73328578219169,2031,2975,2822,2184,44377,702450,626850,2997,5334,3303,3788,6125,25.25866188063018,12.60665128010484,2337,0,434616,24939,638,1,966,2512
14372,0,0,1,0,63,1,1487,0,0,3505418,8789746,52.51666402200353,2691,4096,4029,2758,51294,793563,656522,3120,5945,3254,4458,7283,35.651086939951774,8.20171446926608,2825,0,568148,11993,1271,1,429,1916
14373,0,0,1,0,68,1,250,0,0,15264656,13893096,63.51377803280167,3842,8010,7818,4034,55000,757680,861000,3252,7478,3636,7228,11454,61.514225996918796,14.435603895983952,4226,1,1008500,16512,3784,0,590,340
14374,0,1,0,1,67,0,1363,0,0,7344788,7139827,45.967379738244816,1800,5902,5589,2113,49434,723106,780549,3066,5492,3692,6855,9281,58.957611891934704,17.70483892550094,2426,1,488103,35369,3476,0,1266,97
14375,0,0,1,0,61,1,1493,0,0,798798,5904990,43.71498598878879,1844,2396,2329,1911,38115,713790,509850,3023,5001,3157,3508,5486,20.445048300260872,8.499160266369426,1978,0,315315,13668,418,1,1179,2672
14376,0,0,0,0,60,1,899,1,0,555720,4003560,36.3318042491699,832,2229,1741,1320,44954,749151,552006,2545,4353,3521,3454,5262,20.518284528683193,22.23405299677519,1808,1,240240,99064,421,0,1713,2612
14377,0,0,1,0,63,1,803,0,0,14804090,13587140,65.34523701081817,4210,7797,7737,4270,48756,649128,760498,3122,7452,3242,6649,10979,58.881236400062114,7.748117453886108,4330,0,1020530,5340,3467,1,1088,285
14378,0,1,0,1,67,0,1397,0,0,7000530,6847680,45.14421336118285,1804,5707,5473,2038,47925,715680,756000,3126,5398,3594,6795,9067,58.60887304837041,15.396927999526204,2272,1,458550,28080,3435,0,1322,75
14379,0,1,1,0,62,0,683,0,0,1981530,3452733,33.27160951922825,860,3144,2897,1107,53592,723608,720489,2872,4226,3366,4909,6263,42.30839160261236,15.727106176144607,1354,0,255717,33098,1790,1,2012,1329
14380,0,0,1,0,65,1,843,0,0,15906448,14483776,66.57326790837296,4432,8021,8021,4432,44620,633992,751640,3268,7700,3268,6857,11289,59.90826320300064,0.0,4432,0,1019360,0,3589,1,1164,321
14381,0,0,1,0,64,1,943,0,0,15845760,14448000,66.93280212272605,4346,8151,8017,4480,55209,744975,770775,3091,7705,3359,6762,11376,59.472682804797024,11.59897583714774,4614,0,1070720,16214,3537,1,1255,312
14382,0,0,1,0,66,1,510,0,0,9625744,9437116,53.46026561849464,2355,6729,6226,2858,43000,709930,660400,2799,6160,3805,6670,10031,58.034472514187634,22.561289583770712,3361,1,571600,76456,3368,0,444,66
14383,0,1,0,1,69,0,1248,0,0,9090865,8565495,49.54795656734998,2113,6500,6158,2455,47061,659421,868761,3147,5944,3831,7192,9989,60.852280154485584,18.819090221381778,2797,1,611295,18126,3703,0,1034,214
14384,0,1,0,1,67,0,1366,0,0,7937712,7512240,47.07440918375928,2004,6010,5798,2216,52377,749190,803430,3178,5606,3602,6972,9400,59.84981202978001,14.563134575526412,2428,1,525192,23956,3582,0,1174,192
14385,0,1,1,0,60,0,647,0,0,862620,2002440,25.69046515733026,325,2302,1967,660,53586,709956,694786,2699,3694,3369,4341,5336,36.15245496505044,18.47289123594439,995,0,151140,46565,1307,1,2374,1727
14386,0,0,1,0,68,1,209,0,0,16169586,14139102,64.24173098539609,3945,8227,8045,4127,56635,805110,825666,3244,7553,3608,7344,11653,62.5939294181153,13.55904727879147,4309,1,994607,21112,3918,0,701,492
14387,0,0,0,1,65,1,208,0,0,11610465,10893280,57.48912940721924,2656,7467,6818,3305,34615,708640,530656,2647,6601,3945,6809,10763,59.270566050949775,26.05425076789994,3954,1,532105,124608,3513,0,9,217
14388,0,1,1,0,63,0,1046,0,0,3409032,4415548,37.36308338453881,1354,3880,3838,1396,55902,730653,765446,3121,4559,3205,5605,7043,49.416596402423345,6.481658975540136,1438,0,337832,4830,2442,1,1767,721
14389,0,0,0,1,65,1,101,0,0,12090456,11261122,58.540584213005594,2811,7571,6955,3427,36192,683488,571764,2670,6713,3902,6814,10857,59.39696961966999,25.37813404338831,4043,1,596298,105336,3528,0,141,242
14390,0,0,1,0,66,1,482,0,0,9068360,9182340,52.72570530585627,2359,6463,6042,2780,50525,710145,776205,2882,6083,3724,6565,9766,57.113921245174545,20.696569507363446,3201,1,653300,45889,3262,0,523,41
14391,0,1,0,1,68,0,1348,0,0,8533728,7931812,48.2078831727758,2162,6158,5996,2324,53312,764512,812294,3251,5737,3575,7085,9571,60.597029630172464,12.758848143974324,2486,1,553112,18630,3672,0,1089,259
14392,0,0,0,1,69,1,42,0,0,16891659,14176563,63.94528911499267,3914,8395,8220,4089,56635,814745,835547,3292,7556,3642,7598,11862,64.27285585688566,13.601470508735444,4264,1,985449,20125,4131,0,622,664
14393,0,0,1,0,66,1,388,0,0,9529013,9627579,53.842362503887216,2481,6604,6186,2899,48124,753867,704052,2903,6220,3739,6608,9925,57.33236433289665,20.71490315474096,3317,1,614588,63536,3287,0,422,34
14394,0,0,1,0,61,1,1386,0,0,3229227,3763116,35.11409973215888,1032,4053,3852,1233,45771,668388,637868,2851,4285,3253,5671,7105,51.176166327695945,14.283714794538563,1434,0,257697,29547,2619,1,1819,433
14395,0,1,0,1,69,0,1299,0,0,9247140,8521440,49.59838707054898,2218,6461,6219,2460,44408,630448,845216,3222,5924,3706,7223,9925,61.310684223877324,15.84624764074158,2702,1,600240,12100,3759,0,1004,295
14396,0,1,0,1,67,0,1323,0,0,8185450,7723625,47.69696007084728,2151,5997,5873,2275,52170,753690,797825,3271,5670,3519,6993,9392,59.983331017875294,11.135709774976435,2399,1,534625,14632,3598,0,1120,203
14397,0,1,0,1,67,0,1282,0,0,7339775,7245483,46.292547996410825,1942,5769,5568,2143,52206,764106,781011,3180,5524,3582,6806,9150,58.52349955359813,14.18060408792329,2344,1,495033,25728,3425,0,1238,44
14398,0,1,0,1,66,0,1223,0,0,6310878,6531966,44.429719783046124,1764,5381,5171,1974,52664,751143,767688,3099,5283,3519,6506,8690,56.542019772908716,14.542450268973452,2184,1,457968,26880,3197,0,1335,112
14399,0,1,0,1,67,0,1282,0,0,7947000,7623000,47.43416490252569,2126,5906,5782,2250,51296,775852,758912,3264,5638,3512,6920,9294,59.430631832414505,11.147098121756736,2374,1,504000,17360,3532,0,1138,144
14400,0,1,1,0,60,0,749,0,0,294690,855285,16.881943016134134,135,1469,1319,285,54285,693231,705235,2851,3286,3151,4035,4470,32.155870381627054,12.420125667085228,435,0,66975,19050,1034,1,2716,1967
14401,0,0,0,1,69,1,1158,0,0,11984859,14131584,63.94528911499267,3373,7736,7020,4089,54000,864000,746496,2740,7545,4172,6387,11192,54.13871073455665,27.024746225572446,4805,1,883224,119572,2931,0,633,525
14402,0,0,0,1,65,1,248,0,0,13860249,12578532,62.0403094769844,3488,7811,7450,3849,37989,656868,617652,2907,7117,3629,6869,11079,60.00833275470999,19.605512436163284,4210,1,727461,53067,3601,0,581,333
14403,0,0,0,1,65,1,166,0,0,13557600,12314820,61.36774397026503,3340,7792,7366,3766,38728,673620,614760,2844,7036,3696,6870,11062,60.0,21.213229624687973,4192,1,708008,65604,3600,0,496,330
14404,0,1,1,0,62,0,777,0,0,2666430,4024800,35.91656999213594,1290,3357,3357,1290,55647,758160,714480,3120,4410,3120,5187,6477,45.46427168667722,0.0,1290,0,295410,0,2067,1,1830,1053
14405,0,0,1,0,68,1,103,0,0,17407104,14361600,64.99230723708769,4224,8345,8345,4224,56640,802400,816000,3400,7624,3400,7521,11745,64.19501538281614,0.0,4224,0,1013760,0,4121,1,824,721
14406,0,0,1,0,67,1,309,0,0,17236000,14517021,65.64297372910524,4214,8404,8309,4309,54587,744549,832143,3274,7678,3464,7369,11773,63.245553203367585,9.833118885374187,4404,0,1064323,9120,4000,1,940,631
14407,0,1,0,1,68,0,1277,0,0,9255090,8506680,49.699094559156705,2317,6370,6217,2470,38479,554484,823116,3291,5914,3597,7191,9814,61.212743771211564,12.651333531125456,2623,1,590330,3978,3747,0,974,303
14408,0,1,0,1,67,0,1208,0,0,7774793,7608367,47.4236228055175,2154,5801,5706,2249,54755,788239,795005,3288,5632,3478,6840,9184,58.7962583843564,9.751111384664751,2344,1,528515,12350,3457,0,1134,74
14409,0,1,1,0,60,0,587,0,0,524600,1469368,22.090722034374522,260,1791,1563,488,53020,725651,662420,2783,3499,3239,4086,4802,32.78719262151,15.178134930780391,716,0,107360,35796,1075,1,2523,1936
14410,0,0,0,1,65,1,62,0,0,13512015,12207151,60.88513775955508,3173,7886,7352,3707,39270,691530,615791,2759,7000,3827,6938,11179,60.37383539249432,23.653842073654356,4241,1,693209,85440,3645,0,414,352
14411,0,1,0,1,71,0,1279,0,0,10425012,9438468,51.49757275833493,2434,6801,6583,2652,53984,797216,857719,3341,6211,3777,7490,10360,62.69768735766894,15.010950964762177,2870,1,639132,23980,3931,0,907,372
14412,0,1,0,1,68,0,1238,0,0,8998808,8351148,49.4368283772331,2354,6216,6126,2444,45784,662898,806412,3327,5861,3507,7099,9633,60.67948582511226,9.601845894041878,2534,1,576784,7200,3682,0,973,265
14413,0,1,0,1,66,0,1111,0,0,6632010,6918912,45.59605246071199,1989,5359,5269,2079,48300,698880,765440,3238,5407,3418,6518,8687,56.480084985771754,9.497356383238309,2169,1,478170,9900,3190,0,1249,138
14414,0,0,1,0,57,1,348,0,0,402688,2384512,28.844410203711913,657,1491,1316,832,51714,670644,633386,2691,3698,3041,3350,4357,22.0,13.480748117239651,1007,1,183872,26250,484,0,2034,2382
14415,0,0,1,0,65,1,1931,0,0,4583262,10876548,57.56735185849702,3067,4944,4697,3314,45720,833628,590760,3035,6596,3529,4665,8226,37.1887079635741,15.894094740962279,3561,1,596520,50388,1383,0,32,1899
14416,0,0,0,1,67,1,1966,0,0,5338832,11753816,59.1100668245266,3118,5398,5022,3494,45018,827544,615612,2988,6858,3740,4892,8762,39.08964057138413,19.65096914548261,3870,1,639402,75576,1528,0,130,1836
14417,0,0,0,1,68,1,1117,0,0,12615698,14310530,64.45153217728807,3596,7749,7191,4154,55822,850915,778570,2887,7599,4003,6482,11194,55.10898293381942,23.890529327374704,4712,1,938804,84258,3037,0,709,408
14418,0,0,0,1,66,1,37,0,0,12323268,11719809,59.405386961116584,2988,7562,7021,3529,40205,714015,621027,2780,6850,3862,6813,10883,59.09314681077663,23.2880425021314,4070,1,659923,90347,3492,0,208,171
14419,0,0,0,1,66,1,168,0,0,9504000,9951000,54.772255750516614,2715,6453,6168,3000,56400,779495,796080,3032,6317,3602,6485,9770,56.28498911788115,17.31444271261726,3285,1,720000,34485,3168,0,317,149
14420,0,1,0,1,68,0,1210,0,0,9052736,8434272,49.63869458396343,2374,6228,6138,2464,42688,629832,794136,3333,5887,3513,7097,9651,60.61352984276695,9.678858787534972,2554,1,571648,6390,3674,0,959,251
14421,0,0,1,0,67,1,133,0,0,18079334,14628453,65.71909920259102,4259,8565,8505,4319,54990,795945,792558,3327,7706,3447,7573,11952,64.69930447848725,7.822290851349969,4379,0,1010646,7980,4186,1,932,799
14422,0,0,0,1,66,1,141,0,0,13600062,12446049,61.310684223877324,3207,7929,7377,3759,37740,675444,612535,2759,7070,3863,6929,11240,60.149812967290266,24.05150137826539,4311,1,695415,85008,3618,0,448,307
14423,0,0,0,1,66,1,83,0,0,12441534,11874063,59.74110812497538,3045,7579,7055,3569,40232,711978,625476,2803,6896,3851,6813,10906,59.04235767650204,22.93129048604795,4093,1,670972,85412,3486,0,242,159
14424,0,0,1,0,62,1,994,0,0,4878687,5546613,42.035699113967404,1377,4918,4528,1767,47053,699997,662329,2749,4906,3529,5900,8057,52.54521862167861,19.775659756785416,2157,1,372837,57720,2761,0,1372,378
14425,0,1,0,1,70,0,1217,0,0,9904958,9141440,50.96076922496363,2363,6645,6411,2597,45448,647680,869440,3286,6117,3754,7334,10165,61.75759062657804,15.319637286414302,2831,1,641459,11232,3814,0,923,294
14426,0,1,1,0,60,0,620,0,0,451500,1296020,20.73644135332772,268,1642,1480,430,52664,699248,684178,2852,3444,3176,4064,4656,32.4037034920393,12.72901313522338,592,0,97610,22518,1050,1,2584,1964
14427,0,0,1,0,68,1,1067,0,0,13143938,14403338,64.79197481170026,3755,7772,7329,4198,55328,847457,768544,2988,7629,3874,6562,11203,55.95533933415113,21.285481865558804,4641,1,940352,68222,3131,0,767,300
14428,0,1,1,0,63,0,805,0,0,3572550,4825620,39.11521443121589,1422,3973,3865,1530,49608,668648,738036,3046,4684,3262,5489,7127,48.321837713398274,10.44206354473662,1638,0,358020,11556,2335,1,1624,819
14429,0,0,1,0,68,1,918,0,0,13866823,14321611,64.89221833163049,3916,7799,7504,4211,56350,782230,833245,3106,7612,3696,6694,11200,57.38466694161429,17.302485883351352,4506,1,1031695,30680,3293,0,810,108
14430,0,0,1,0,67,1,203,0,0,18492600,14855722,66.35510530471637,4373,8633,8603,4403,55430,813134,776020,3344,7777,3404,7574,12007,64.8074069840786,5.501408174353464,4433,0,1012690,4320,4200,1,1029,826
14431,0,0,0,1,66,1,323,0,0,15588270,13704516,64.13267497929586,3737,8279,7903,4113,39798,669732,659736,2956,7445,3708,7122,11611,61.56297588648554,20.09263565796327,4489,1,814374,51512,3790,0,781,458
14432,0,0,0,1,66,1,234,0,0,14041312,12885378,62.177166226839255,3335,8029,7498,3866,38570,676599,633270,2802,7199,3864,6965,11362,60.266076693277455,23.68545737926311,4397,1,734540,78057,3632,0,533,299
14433,0,0,1,0,61,1,1514,0,0,65352,4748912,39.44616584663204,1466,1688,1598,1556,54560,756896,671440,2962,4608,3142,3094,4740,6.48074069840786,9.638070910968185,1646,1,342320,14580,42,0,1496,3010
14434,0,0,0,1,67,1,1951,0,0,10489706,14738756,66.01514977639603,3576,7547,6765,4358,54780,842118,744040,2600,7740,4164,5789,10929,49.06118628814432,28.164329833931223,5140,1,958760,125120,2407,0,976,975
14435,0,0,1,0,67,1,1026,0,0,13874431,14502562,65.36818798161687,3996,7797,7520,4273,55278,753468,845106,3117,7667,3671,6641,11191,56.9824534396335,16.772016903539466,4550,1,1063977,24376,3247,0,879,147
14436,0,0,0,1,67,1,378,0,0,16205179,14150526,64.95382975621992,3829,8450,8060,4219,40385,687570,660738,2964,7573,3744,7195,11804,61.97580172938467,20.597356745212366,4609,1,831143,55380,3841,0,865,487
14437,0,0,1,0,63,1,271,0,0,6874890,7943100,49.8998997994986,2366,5375,5251,2490,38368,695420,561440,3066,5680,3314,5951,8565,52.54521862167861,11.255953434413934,2614,1,438240,22444,2761,0,700,429
14438,0,0,1,0,63,1,686,0,0,5167752,6184872,44.22668877499196,1510,5044,4598,1956,46004,686154,670344,2716,5118,3608,5804,8206,51.40038910358559,21.165377707116726,2402,1,414672,62440,2642,0,1206,520
14439,0,0,0,1,67,1,1917,0,0,11014848,14880636,66.4304147209695,3747,7575,6909,4413,55527,839628,751956,2706,7785,4038,5868,10947,49.95998398718719,26.024274699437782,5079,1,984099,103230,2496,0,1041,876
14440,0,0,1,0,67,1,1095,0,0,13819050,14602560,65.612498809297,4028,7792,7515,4305,56133,783552,824256,3115,7697,3669,6602,11184,56.65686189686118,16.81082874730089,4582,1,1046115,29085,3210,0,913,182
14441,0,0,1,0,67,1,121,0,0,19307970,15017805,66.74578638386096,4413,8831,8789,4455,55460,795556,792185,3329,7826,3413,7705,12202,65.83312236253116,6.503581472166948,4497,0,1046925,5544,4334,1,1084,963
14442,0,0,0,1,67,1,426,0,0,16764631,14517558,65.67343450741707,3971,8542,8200,4313,37818,666468,642906,3024,7679,3708,7253,11908,62.34580980306536,19.53144621384319,4655,1,823783,48222,3887,0,947,521
14443,0,0,1,0,63,1,841,0,0,4577760,5566880,41.95235392680606,1171,4950,4361,1760,44702,686371,651578,2574,4923,3752,5764,8113,51.0,24.3341389564868,2349,1,362560,87172,2601,0,1403,562
14444,0,0,0,0,57,1,237,1,0,476658,2347254,28.61817604250837,591,1629,1401,819,40672,710768,470024,2638,3685,3094,3448,4495,24.124676163629637,15.128632192459419,1047,1,134316,45372,582,0,2047,2284
14445,0,0,1,0,67,1,1907,0,0,11442548,15012480,66.84309986827361,3902,7595,7029,4468,55278,836640,745920,2794,7828,3926,5921,10955,50.60632371551998,23.981605019755463,5034,1,991896,89428,2561,0,1108,799
14446,0,0,1,0,67,1,865,0,0,15159750,14633400,65.95452979136459,4320,7865,7835,4350,51706,844364,692984,3334,7714,3394,6849,11229,59.033888572581766,5.5503012171862105,4380,1,896100,5400,3485,0,986,121
14447,0,0,1,0,67,1,211,0,0,19706910,15247284,67.42403132415029,4479,8948,8881,4546,54934,811668,761358,3287,7900,3421,7689,12302,65.84071688552609,8.230562448445415,4613,0,1031942,9983,4335,1,1192,981
14448,0,0,0,1,67,1,784,0,0,15750480,14804400,66.18156843109719,4295,8061,7976,4380,50750,845000,686140,3295,7760,3465,6976,11441,59.9666574022598,9.231007614073922,4465,1,889140,15640,3596,0,1000,216
14449,0,0,0,1,67,1,426,0,0,13291735,13106215,62.16912416947821,3398,7771,7304,3865,38916,701937,637508,2924,7256,3858,6830,11162,58.642987645583,21.655841685400247,4332,1,726620,72385,3439,0,474,48
14450,0,0,1,0,64,1,1,0,0,7325142,8672730,52.01922721455981,2616,5503,5413,2706,34869,631385,567285,3115,5911,3295,5912,8708,52.028838157314254,9.638070910968185,2796,1,478962,13860,2707,0,499,498
14451,0,1,1,0,64,0,881,0,0,4059866,5230950,40.27406113120453,1352,4395,4125,1622,49028,664350,767550,2955,4847,3495,5728,7620,50.02999100539596,16.47260276247394,1892,0,386036,25110,2503,1,1603,722
14452,0,0,0,1,67,1,2039,0,0,7613042,13273311,62.93647591023825,3557,6287,5883,3961,56088,824346,764028,2947,7312,3755,5273,9638,43.840620433565945,20.2574848037377,4365,1,903108,59388,1922,0,610,1429
14453,0,0,1,0,66,1,1121,0,0,14558432,14761614,66.46051459325304,4309,7821,7713,4417,55304,828816,745266,3234,7759,3450,6638,11163,57.41080037762929,10.400314334861214,4525,1,984991,16956,3296,0,1075,46
14454,0,0,1,0,67,1,129,0,0,20295370,15387190,67.60177512462228,4540,9041,9011,4570,50808,781144,737373,3337,7937,3397,7808,12408,66.64082832618455,5.478746393072713,4600,0,1000830,4500,4441,1,1203,1074
14455,0,0,0,1,67,1,512,0,0,14857233,13992243,64.17943595888016,3515,8330,7726,4119,38592,682797,652224,2793,7516,4001,7004,11727,60.05830500438719,25.300691448957522,4723,1,790848,86372,3607,0,722,210
14456,0,0,1,0,62,1,867,0,0,4165560,5188767,40.65710270051225,1005,4821,4173,1653,47025,706275,656051,2491,4792,3787,5659,7960,50.19960159204453,25.67848440897649,2301,1,345477,99792,2520,0,1486,619
14457,0,0,0,1,68,1,530,0,0,14271144,13801112,63.655321851358195,3475,8151,7574,4052,38773,691418,650546,2829,7458,3983,6928,11557,59.34644049983116,24.08127387171686,4629,1,773932,84819,3522,0,646,116
14458,0,0,0,1,64,1,293,0,0,9241430,10335600,56.480084985771754,3160,6117,6087,3190,54747,767880,748440,3210,6430,3270,6137,9357,53.823786563191554,5.478746393072713,3220,1,736890,4140,2897,0,50,343
14459,0,0,1,0,61,1,569,0,0,375360,1192941,19.77371993328519,227,1969,1351,391,47264,643761,683424,2433,3442,3669,4011,5020,30.983866769659336,25.685819443398202,1009,1,87584,73542,960,0,2660,2091
14460,0,0,0,1,68,1,565,0,0,14235066,13889456,63.76519426771944,3502,8131,7567,4066,38784,690032,655872,2852,7482,3980,6917,11547,59.16924876994806,23.8345232961918,4630,1,780672,81780,3501,0,650,85
14461,0,0,0,1,64,1,343,0,0,9331128,10484595,56.84188596448925,3231,6119,6119,3231,51296,726880,743105,3245,6476,3245,6133,9364,53.74011537017761,0.0,3231,1,739899,0,2888,0,14,357
14462,0,1,1,0,65,0,933,0,0,4437184,5556626,41.12177038990418,1423,4583,4315,1691,55575,739350,811642,3018,4977,3554,5910,7869,51.22499389946279,16.500441727537666,1959,1,417677,26532,2624,0,1595,662
14463,0,0,0,1,66,1,2040,0,0,7526929,13111934,62.82515419798029,3597,6204,5854,3947,56350,813890,764060,2972,7269,3672,5229,9526,43.669211121796096,18.778485981099177,4297,1,907810,50050,1907,0,625,1415
14464,0,0,0,1,66,1,2041,0,0,7693560,13204296,63.05553108173778,3600,6287,5911,3976,56364,810324,767151,2945,7297,3697,5256,9608,43.98863489584554,19.45092472863846,4352,1,918456,53016,1935,0,655,1386
14465,0,0,0,1,67,1,964,0,0,16153980,15211740,67.30527468185537,4360,8266,8096,4530,50500,839500,678316,3188,7888,3528,6924,11624,59.715994507334464,13.0402090593671,4700,1,915060,31280,3566,0,1172,208
14466,0,1,1,0,60,0,624,0,0,116100,456000,12.24744871391589,42,1032,924,150,39991,617120,598880,2932,3190,3148,3814,4072,27.820855486487112,10.669676460233537,258,0,29550,15120,774,1,2890,2266
14467,0,0,1,0,62,1,686,0,0,949440,2172810,26.267851073127396,180,2576,2066,690,53074,702227,749462,2639,3839,3659,4525,5725,37.094473981982816,22.832211645959735,1200,1,164220,58650,1376,0,2459,1773
14468,0,0,1,0,64,1,352,0,0,7842660,9670626,54.607691765904185,2952,5642,5612,2982,38340,690759,583740,3213,6225,3273,5873,8885,51.28352561983234,5.652706486041966,3012,0,536760,5130,2630,1,261,613
14469,0,0,1,0,62,1,699,0,0,896940,2073720,25.69046515733026,161,2518,2019,660,54014,710092,750938,2643,3802,3641,4501,5660,36.864617182333525,22.554951992369954,1159,1,157740,58383,1359,0,2482,1783
14470,0,0,0,1,66,1,1305,0,0,15117550,15237020,67.7864293203293,4565,7915,7885,4595,51336,822368,686412,3286,7911,3346,6606,11231,57.358521598799946,5.477225575051661,4625,1,951165,5340,3290,0,1279,26
14471,0,0,0,1,68,1,674,0,0,12875247,13592509,62.77738446287803,3618,7531,7208,3941,48178,762229,751882,3126,7390,3772,6716,10980,57.15767664977295,18.396271700261583,4264,1,859138,44897,3267,0,492,182
14472,0,0,1,0,57,1,19,0,0,169242,1203218,20.518284528683193,271,973,823,421,35371,465854,620186,2708,3279,3008,3260,3831,20.049937655763422,12.410850817228189,571,1,91357,9300,402,0,2437,2456
14473,0,0,1,0,63,1,1907,0,0,1393644,7825657,49.70915408654627,2261,3245,3035,2471,56628,741078,766414,2957,5638,3377,3731,6412,23.748684174075834,14.555357889997133,2681,1,597982,24570,564,0,696,2603
14474,0,0,1,0,65,1,2033,0,0,9630218,14014986,65.43699259593154,3864,6949,6531,4282,55388,798612,742971,2855,7555,3691,5522,10222,47.4236228055175,20.539436772032378,4700,1,972014,62282,2249,0,1009,1024
14475,0,0,0,1,65,1,620,0,0,9625824,11271264,58.54912467321779,3343,6321,6236,3428,44298,680616,703632,3203,6716,3373,6096,9609,52.99056519796708,9.219544457292887,3513,1,733592,10625,2808,0,140,480
14476,0,0,0,1,64,1,272,0,0,4616913,6486672,44.91102314577124,1122,5201,4306,2017,45144,694656,672144,2321,5233,4111,5505,8417,47.843494855622744,30.279639799481323,2912,1,421553,127985,2289,0,1199,927
14477,0,0,0,1,65,1,617,0,0,8829984,10791104,57.41080037762929,3169,6102,5975,3296,46870,713732,703910,3147,6570,3401,5953,9376,51.75905717843013,11.270999429035628,3423,1,708640,17780,2679,0,22,595
14478,0,0,0,1,65,1,106,0,0,5032727,7492814,47.92702786528704,1422,5363,4488,2297,39800,649138,652400,2387,5559,4137,5453,8625,46.8081189538738,29.727808691311296,3172,1,459400,114625,2191,0,965,1071
14479,0,0,0,1,65,1,222,0,0,5176963,7847865,48.877397639399746,1525,5420,4556,2389,39390,640575,663570,2421,5674,4149,5452,8705,46.551047249229526,29.569062503835827,3253,1,482578,107136,2167,0,896,1118
14480,0,0,0,1,64,1,17,0,0,4745790,7094628,46.76537180435969,1197,5347,4357,2187,41205,665020,652044,2254,5431,4234,5414,8591,46.58325879540846,31.575425928074566,3177,1,439587,137610,2170,0,1057,1074
14481,0,0,0,1,66,1,439,0,0,5791292,8727796,51.34199061197374,1978,5491,4833,2636,43780,728420,658889,2653,5947,3969,5508,8802,46.87216658103186,25.905781769011035,3294,1,524564,103964,2197,0,675,1114
14482,0,1,1,0,61,0,844,0,0,770592,1691880,23.49468024894146,522,1978,1948,552,45173,695755,609935,3035,3617,3095,4461,5043,37.36308338453881,5.531194905403055,582,0,109848,5010,1396,1,2513,1669
14483,0,0,1,0,65,1,2040,0,0,3742569,10451613,56.630380539071076,2865,4716,4374,3207,55430,785419,749570,2917,6466,3601,4426,7975,34.161381705077446,18.507494999839363,3549,1,737610,48906,1167,0,52,2092
14484,0,0,0,1,67,1,889,0,0,11318262,12960926,61.95159400693416,3730,6895,6787,3838,49486,736186,766579,3269,7215,3485,6326,10272,54.30469592954186,10.57476984710039,3946,1,871226,13284,2949,0,461,428
14485,0,0,0,1,66,1,805,0,0,9058326,11369334,58.642987645583,3331,6181,6073,3439,49088,687648,780216,3198,6745,3414,5940,9487,51.32250968142536,10.419152549993726,3547,1,811604,10692,2634,0,133,672
14486,0,0,0,1,66,1,453,0,0,5586948,8630118,51.0,1858,5492,4749,2601,41184,690144,656964,2575,5919,4061,5466,8810,46.34652090502587,27.520940007441677,3344,1,514998,108478,2148,0,717,1170
14487,0,0,0,1,68,1,856,0,0,19459440,16528860,69.7137002317335,4478,9246,8864,4860,45458,809438,649591,3019,8261,3783,7405,12647,63.2771680782255,19.56407892490962,5242,1,928260,71434,4004,0,1459,603
14488,0,0,0,1,66,1,577,0,0,5931524,9102861,52.354560450833695,2103,5543,4905,2741,42098,720657,644274,2683,6062,3959,5485,8864,46.51881339845203,25.520780120234082,3379,1,531754,102080,2164,0,580,1157
14489,0,0,1,0,65,1,114,0,0,4474207,6704104,45.37620521815371,1009,5282,4232,2059,40068,690272,615384,2206,5315,4306,5429,8538,46.61544808322666,32.81549939769546,3109,1,389151,168000,2173,0,1197,1083
14490,0,0,1,0,61,0,248,0,0,1737600,3697200,34.64101615137755,972,2876,2648,1200,51051,711711,680901,2853,4281,3309,4529,5957,38.05259518088089,15.152330459825967,1428,0,265200,33516,1448,1,1881,1633
14491,0,0,0,1,67,1,967,0,0,11404560,13215735,62.4099351065197,3720,6998,6823,3895,45305,695565,749853,3218,7288,3568,6321,10391,54.11099703387473,13.442213731224724,4070,1,860795,20125,2928,0,502,465
14492,0,0,0,1,66,1,709,0,0,6492086,9752764,54.101755978895916,2460,5612,5145,2927,42210,699720,669732,2865,6259,3799,5550,8944,47.095647357266465,21.84426416226335,3394,1,588327,67715,2218,0,405,1114
14493,0,0,0,1,66,1,680,0,0,6254976,9537120,53.51635264103861,2330,5582,5048,2864,42016,692640,672660,2796,6194,3864,5514,8912,46.73328578219169,23.349772705896665,3398,1,578528,75294,2184,0,466,1146
14494,0,0,0,1,65,1,1866,0,0,15145515,16231215,70.24955515873393,4773,8166,8004,4935,47600,782782,657800,3127,8224,3451,6358,11455,55.39855593785816,12.730952129625969,5097,1,987000,28836,3069,0,1646,220
14495,0,0,0,1,68,1,953,0,0,19785150,16869600,70.35623639735144,4631,9266,8947,4950,44415,800880,644112,3089,8358,3727,7405,12674,63.221831672294975,17.878096776391473,5269,1,935550,59334,3997,0,1542,589
14496,0,0,0,1,67,1,1024,0,0,10568537,12873155,61.66846844214635,3650,6735,6582,3803,49950,761625,751470,3232,7188,3538,6164,10120,52.716221412388805,12.385270088696593,3956,1,844266,21114,2779,0,418,606
14497,0,0,1,0,65,1,955,0,0,8542476,11341822,58.642987645583,3409,5953,5923,3439,46830,735454,692580,3268,6737,3328,5782,9251,49.839743177508446,5.477225575051661,3469,0,722190,4500,2484,1,141,814
14498,0,0,0,1,65,1,63,0,0,4187170,6607185,44.88875137492688,875,5233,4093,2015,40446,701706,619731,2139,5294,4419,5357,8512,45.58508528016593,34.20116408143833,3155,1,380835,185820,2078,0,1264,1201
14499,0,0,1,0,64,1,1999,0,0,12746556,15264801,68.60757975617562,4647,7475,7415,4707,44694,758862,619413,3183,7950,3303,5951,10718,52.03844732503075,7.810249675906654,4767,1,899037,10980,2708,0,1464,535
14500,0,0,0,1,67,1,1119,0,0,19095390,16821420,70.46275611981126,4773,9003,8811,4965,45872,826672,636944,3196,8353,3580,7234,12391,62.01612693485461,13.910218760291485,5157,1,933420,37440,3846,0,1577,458
14501,0,0,0,1,69,1,751,0,0,21393240,17325264,70.8237248385031,4517,9780,9281,5016,44655,790966,673530,2955,8470,3953,7719,13234,65.30696746902278,22.36573157638876,5515,1,978120,86327,4265,0,1562,811
14502,0,0,1,0,66,1,992,0,0,8385828,11356238,58.60034129593445,3374,5936,5876,3434,37925,677935,611795,3247,6741,3367,5749,9243,49.416596402423345,7.789174875971784,3494,0,635290,9360,2442,1,127,865
14503,0,0,0,1,65,1,124,0,0,4252125,6972125,46.09772228646444,941,5310,4126,2125,42387,698853,652919,2097,5406,4465,5282,8591,44.73253849269008,34.829232412815074,3309,1,422875,178784,2001,0,1156,1280
14504,0,0,1,0,59,0,153,0,0,60970,997630,18.303005217723125,293,559,517,335,46060,699830,583688,2936,3313,3020,3160,3537,13.490737563232042,6.503581472166948,377,0,65660,7476,182,1,2643,2796
14505,0,0,1,0,66,1,1045,0,0,8592500,11581500,59.16079783099616,3470,5985,5955,3500,42784,741216,632019,3279,6809,3339,5764,9294,49.54795656734998,5.531194905403055,3530,0,668500,5160,2455,1,191,854
14506,0,1,1,0,62,0,1036,0,0,2140380,3208502,32.155870381627054,1034,3104,3104,1034,50175,698175,691969,3103,4137,3103,5173,6207,45.4972526643093,0.0,1034,0,230582,0,2070,1,2069,1033
14507,0,0,1,0,62,1,1794,0,0,381312,6178446,44.56455991031439,1689,2475,2178,1986,55575,768417,699975,2814,5097,3408,3303,5586,13.856406460551018,17.23608076477008,2283,1,446850,43659,192,0,1125,2919
14508,0,0,1,0,62,1,1989,0,0,348462,6708969,46.37887450122092,1961,2503,2313,2151,55552,773512,698656,2929,5270,3309,3281,5622,12.727922061357855,13.893096626134744,2341,1,481824,28310,162,0,968,2957
14509,0,0,1,0,67,1,1119,0,0,9600012,12425508,60.89334939055332,3666,6339,6297,3708,53984,750624,807591,3309,7059,3393,5940,9690,50.882216932834204,6.538739683827756,3750,0,893628,4620,2589,1,357,762
14510,0,1,1,0,62,0,1046,0,0,2308920,3370156,32.92415526630866,1084,3214,3214,1084,52432,721288,702634,3109,4193,3109,5239,6323,46.151923036857305,0.0,1084,0,244984,0,2130,1,2025,979
14511,0,0,0,1,68,1,1077,0,0,20235448,17351187,71.19691004531025,4813,9317,9061,5069,43428,790713,643524,3167,8492,3679,7415,12740,63.182275995725256,16.05108538429488,5325,1,952972,46848,3992,0,1646,569
14512,0,0,1,0,65,1,1984,0,0,12440832,15150624,68.23488843692792,4522,7462,7328,4656,43010,748420,608498,3120,7910,3388,5926,10716,51.69139193328034,11.779285910768088,4790,1,870672,24522,2672,0,1402,582
14513,0,0,1,0,65,1,1979,0,0,12863010,15392280,68.62943974709395,4518,7633,7441,4710,42966,754908,607848,3076,7978,3460,5999,10901,52.25897052181568,14.042896465990824,4902,1,876060,35520,2731,0,1442,537
14514,0,0,0,1,69,1,1006,0,0,21304440,17830890,71.73562573784382,4837,9595,9286,5146,41724,790020,634095,3156,8611,3774,7605,13060,64.34283176858165,17.666832349207784,5455,1,941718,57165,4140,0,1681,675
14515,0,0,0,1,67,1,1207,0,0,8206044,11920656,59.42221806698232,3404,5982,5855,3531,24047,584048,469264,3249,6907,3503,5700,9358,48.2078831727758,11.94434784660679,3658,1,490809,20447,2324,0,155,1052
14516,0,0,0,1,69,1,1010,0,0,21600600,17984960,71.97221686178632,4880,9650,9350,5180,46400,805504,694400,3172,8652,3772,7642,13122,64.57553716385176,17.42142869747889,5480,1,1036000,51300,4170,0,1708,698
14517,0,0,0,1,69,1,883,0,0,22476960,18168876,72.131823767322,4799,9927,9523,5203,44197,799668,673956,3088,8695,3896,7812,13419,65.72670690061993,20.14883045516439,5607,1,1004179,71104,4320,0,1711,828
14518,0,0,0,1,69,1,1118,0,0,21207840,17985080,72.09715667070374,4970,9506,9278,5198,43758,809640,647020,3232,8658,3688,7540,12966,63.874877690685246,15.20892758594158,5426,1,972026,42636,4080,0,1738,620
14519,0,0,0,1,69,1,1148,0,0,21330240,18104564,72.30490993010088,5027,9509,9308,5228,45120,813805,664896,3262,8691,3664,7543,12972,63.874877690685246,14.296051987722665,5429,1,1003776,36783,4080,0,1765,617
14520,0,0,1,0,60,1,803,0,0,908988,4338156,37.89459064299283,1376,2129,2069,1436,52756,731082,658578,2961,4457,3081,3654,5150,25.15949125081825,7.745966692414834,1496,1,313048,9600,633,0,1585,2388
14521,0,0,1,0,64,1,1965,0,0,10280656,13996608,65.84831053261732,4202,6841,6707,4336,37518,716616,545532,3094,7564,3362,5599,10069,48.692915295759406,11.757812605679836,4470,1,732784,25728,2371,0,1108,857
14522,0,0,0,1,69,1,1231,0,0,21109020,18147456,72.46378405796926,5101,9421,9271,5251,42602,822528,618624,3306,8707,3606,7476,12877,63.40346993658943,12.410850817228189,5401,1,939929,29850,4020,0,1795,564
14523,0,0,0,1,69,1,1207,0,0,21580328,18333496,72.71863585079137,5138,9519,9369,5288,47718,835547,686466,3317,8755,3617,7548,12986,63.88270501473775,12.345470001201512,5438,1,1047024,27300,4081,0,1821,614
14524,0,1,1,0,63,0,1098,0,0,1548199,2562760,28.478061731796284,691,2840,2720,811,47034,739440,635160,3040,3971,3280,5069,6000,43.69210454990696,11.009004714545675,931,0,163011,20760,1909,1,2349,1251
14525,0,0,0,1,68,1,1343,0,0,21018410,18249200,72.83543093852057,5238,9334,9267,5305,44213,849680,615760,3373,8745,3507,7402,12774,62.94441992742486,8.345174736691893,5372,1,949595,13735,3962,0,1865,522
14526,0,0,1,0,58,1,708,0,0,220428,2762886,30.692018506445613,674,1444,1176,942,44280,721518,527940,2665,3875,3201,3167,4377,15.297058540778355,16.862371888525946,1210,1,169560,47168,234,0,1991,2699
14527,0,0,0,1,68,1,1935,0,0,17592664,17972248,72.60853944268538,4848,9033,8609,5272,43240,784070,640892,2985,8681,3833,6746,12442,57.766772456144714,20.662476487570366,5696,1,991136,77168,3337,0,1863,72
14528,0,0,0,1,73,1,1547,0,0,19342388,19248086,72.38093671679029,4085,10085,8931,5239,41552,778888,720104,2520,8913,4828,7366,13759,60.76183012385325,34.60171958726829,6393,1,1026844,176562,3692,0,1565,18
14529,0,0,0,1,73,1,1551,0,0,18631210,18951192,71.84010022264724,3989,9943,8771,5161,40994,756432,730728,2500,8833,4844,7282,13615,60.08327554319921,34.84413982733852,6333,1,1027039,166424,3610,0,1489,62
14530,0,0,0,1,73,1,1552,0,0,18398705,18850585,71.65891430938652,3956,9897,8718,5135,41208,748884,741542,2492,8806,4850,7254,13568,59.85816569190874,34.937277661550965,6314,1,1037270,160344,3583,0,1464,88
14531,0,0,0,1,68,1,1931,0,0,16577850,17515150,71.76350047203663,4619,8900,8369,5150,43776,775428,652992,2870,8551,3932,6620,12301,56.73623181001713,23.092337171997734,5681,1,988800,93456,3219,0,1749,182
14532,0,0,0,1,68,1,1931,0,0,16829820,17627540,71.97221686178632,4671,8938,8429,5180,44655,779287,663585,2894,8583,3912,6652,12341,57.0,22.608965816416916,5689,1,1010100,88057,3249,0,1777,154
14533,0,0,0,1,68,1,1930,0,0,17593191,17988366,72.58787777583802,4823,9054,8608,5269,43659,788634,645246,2968,8683,3860,6753,12468,57.784080852774665,21.198548527030937,5715,1,995841,81172,3339,0,1855,75
14534,0,0,0,1,73,1,1576,0,0,19092656,19249496,72.30490993010088,4039,10069,8880,5228,42387,784266,732718,2493,8910,4871,7334,13751,60.43177971895251,35.11618404991048,6417,1,1040372,179539,3652,0,1546,30
14535,0,0,1,0,60,1,1738,0,0,898635,6514565,46.42197755374064,2028,2699,2572,2155,49530,767842,589485,2896,5178,3150,3440,5722,20.42057785666214,11.298832705339896,2282,1,420225,24384,417,0,868,2606
14536,0,0,1,0,63,1,1884,0,0,3930661,9931742,56.00892785976178,2945,4582,4390,3137,53410,775670,690188,2974,6303,3358,4419,7748,35.397740040855716,13.857909732226029,3329,1,683866,31296,1253,0,29,1913
14537,0,0,1,0,64,1,1865,0,0,3343200,9552000,54.63515351859094,2877,4213,4105,2985,15096,435200,355200,3092,6185,3308,4320,7413,33.46640106136302,10.76472236032903,3093,1,331335,15012,1120,0,215,2080
14538,0,0,0,1,74,1,1788,0,0,16966989,18918627,71.47726911403373,3995,9544,8430,5109,46176,822066,770224,2589,8812,4817,7024,13247,57.62811813689564,33.94322247983967,6223,1,1062672,167100,3321,0,1406,382
14539,0,0,1,0,62,0,176,0,0,917700,2717266,29.563490998188964,216,2582,1924,874,48410,730615,640454,2451,3983,3767,4159,5691,32.4037034920393,25.73663762844742,1532,0,180044,110544,1050,1,2235,2059
14540,0,0,0,1,74,1,1797,0,0,18574704,19666710,72.80796659706958,4224,9882,8805,5301,49648,860720,793940,2633,9011,4787,7214,13592,59.19459434779497,33.29991853888795,6378,1,1134414,168012,3504,0,1591,206
14541,0,0,0,1,74,1,1813,0,0,17185550,19096200,71.76350047203663,4019,9618,8487,5150,44268,804636,756432,2577,8858,4839,7045,13326,57.766772456144714,34.072716974017084,6281,1,1050600,169650,3337,0,1442,371
14542,0,0,0,1,74,1,1841,0,0,17185442,19200572,71.88184749990779,4064,9596,8493,5167,41764,787792,732052,2613,8883,4819,7042,13312,57.67148342118486,33.69815273706867,6270,1,1017899,166553,3326,0,1451,390
14543,0,1,1,0,64,0,1152,0,0,2929860,3982740,35.07135583350036,921,3921,3612,1230,40158,670266,628172,2929,4468,3547,5620,7159,48.80573736764972,17.845149706069463,1539,1,238620,46041,2382,0,2008,856
14544,0,0,0,1,69,1,1874,0,0,15242256,17178488,70.37044834303673,4092,8890,8030,4952,42136,794401,638296,2609,8421,4329,6547,12359,55.47972602672079,29.954861189503738,5812,1,911168,159100,3078,0,1483,391
14545,0,0,0,1,74,1,1856,0,0,15883280,18759740,70.8519583356734,3946,9258,8184,5020,39964,769822,724978,2663,8757,4811,6901,12995,56.24944444170093,33.51073377736597,6094,1,973880,158952,3164,0,1283,573
14546,0,0,0,1,69,1,1861,0,0,14819730,16917969,69.93568473962345,4009,8803,7921,4891,41174,823242,598407,2577,8350,4341,6489,12262,55.04543577809154,30.32832084014552,5773,1,846143,180810,3030,0,1432,429
14547,0,0,0,1,69,1,1862,0,0,15053339,17066028,70.14983962918234,4022,8879,7980,4921,41238,821916,603432,2569,8389,4367,6527,12347,55.308227236099334,30.623704571056116,5820,1,856254,181598,3059,0,1453,409
14548,0,0,0,1,74,1,1883,0,0,18760634,19996654,73.30757123244501,4421,9818,8865,5374,44352,833504,736758,2768,9095,4674,7212,13539,59.08468498688979,31.494190985101998,6327,1,1064052,157245,3491,0,1653,230
14549,0,0,0,1,74,1,1871,0,0,17013510,19317100,71.8679344353238,4145,9479,8459,5165,40257,796620,706860,2720,8905,4760,7034,13219,57.39337940912697,32.58105765079426,6185,1,976185,165240,3294,0,1425,446
14550,0,0,0,1,75,1,1870,0,0,15755859,18823815,70.80254232723568,3948,9221,8156,5013,40352,781040,728470,2690,8768,4820,6898,12976,56.06246516163912,33.30046692290216,6078,1,972522,158685,3143,0,1258,612
14551,0,0,0,1,67,1,1824,0,0,12476160,15371760,67.52777206453653,3713,8143,7296,4560,45756,829266,627006,2524,7931,4218,6107,11514,52.306787322488084,29.447957797653558,5407,1,848160,167706,2736,0,1189,635
14552,0,0,1,0,63,1,1759,0,0,6470652,11366493,59.75784467331465,3315,5639,5383,3571,41255,709809,588855,2927,6754,3439,4995,8822,42.567593307585526,16.122189342008447,3827,1,660635,45312,1812,0,388,1371
14553,0,0,0,1,67,1,1816,0,0,12512640,15367200,67.52777206453653,3690,8174,7304,4560,44835,825650,616710,2500,7930,4240,6114,11544,52.38320341483518,29.83422355617758,5430,1,834480,174870,2744,0,1190,626
14554,0,0,0,1,75,1,1908,0,0,17451109,19703879,72.38093671679029,4392,9417,8570,5239,45030,891357,714590,2914,9000,4608,7092,13178,57.7148161220323,30.061238164986463,6086,1,995410,157542,3331,0,1478,430
14555,0,0,1,0,63,0,659,0,0,1058910,4485210,37.54996671103717,1286,2285,2161,1410,45938,709363,655286,3057,4591,3305,3932,5466,27.40437921208944,11.138424455647513,1534,1,290460,19220,751,0,1771,2430
14556,0,0,0,1,67,1,1803,0,0,13029418,15668580,67.98529252713413,3669,8394,7441,4622,42120,793260,610200,2437,8012,4343,6209,11784,53.094255809833136,31.231951185554077,5575,1,831960,184882,2819,0,1232,571
14557,0,0,0,1,76,1,1909,0,0,14933310,18762870,70.24955515873393,3978,8918,7961,4935,42532,825034,745192,2845,8737,4759,6828,12720,55.00909015790027,31.95419403871362,5892,1,967260,151206,3026,0,1133,776
14558,0,0,0,1,76,1,1927,0,0,15779324,19219055,71.07038764492565,4217,9009,8175,5051,36504,821880,643045,2971,8856,4639,6929,12814,55.89275444992848,30.132791640285557,5885,1,853619,154290,3124,0,1246,681
14559,0,0,0,1,76,1,1924,0,0,15066557,18926215,70.43436661176133,4069,8890,7998,4961,41495,820225,736295,2923,8776,4707,6852,12705,55.10898293381942,31.069451729456585,5853,1,957473,143612,3037,0,1146,778
14560,0,0,0,1,76,1,1922,0,0,12304248,17587350,67.80855403265875,3536,8336,7274,4598,45154,818550,807075,2763,8423,4887,6501,12161,51.73006862551025,32.605671490312766,5660,1,970178,146556,2676,0,773,1149
14561,0,0,0,1,76,1,1945,0,0,13742300,18470420,69.31810730249349,3887,8583,7665,4805,49374,899496,811084,2926,8649,4762,6704,12427,53.47896782848375,31.612881935255693,5723,1,1013855,148716,2860,0,961,984
14562,0,0,0,1,76,1,1938,0,0,11136664,17104956,66.66333324999583,3553,7841,6950,4444,38874,804441,715914,2958,8293,4740,6355,11690,50.05996404313531,29.89958960411851,5335,1,826584,142560,2506,0,595,1343
14563,0,0,0,1,67,1,514,0,0,1359587,4910184,38.09199390948182,898,2941,2388,1451,52272,730944,818928,2831,4835,3937,4321,6325,30.610455730027933,24.449489781974652,2004,1,351142,54747,937,0,1933,2447
14564,0,0,0,1,67,1,331,0,0,1324016,4454112,36.4417343165772,818,2835,2325,1328,51240,704340,818376,2844,4682,3864,4351,6189,31.575306807693888,23.382166456378435,1838,1,324032,45390,997,0,2026,2357
14565,0,0,0,1,66,1,297,0,0,1294704,4335120,36.0,816,2775,2295,1296,50470,689070,819525,2865,4641,3825,4344,6120,31.606961258558215,22.70470517827882,1776,1,317520,38880,999,0,2049,2346
14566,0,0,1,0,65,1,1601,0,0,7001660,11611205,59.70762095411272,3007,6087,5529,3565,49647,804479,654657,2699,6822,3815,5221,9344,44.31703961232068,23.995513788572232,4123,1,716565,102672,1964,0,308,1293
14567,0,0,1,0,58,1,310,0,0,1006200,3446820,34.20526275297414,1046,2154,2030,1170,33425,562686,515550,2822,4116,3070,3806,5100,29.32575659723036,11.682184754555195,1294,1,204750,18352,860,0,1776,2086
14568,0,0,1,0,59,1,920,0,0,2464896,6281712,45.78209256903839,1862,3506,3272,2096,49588,758241,587412,2763,5093,3231,4173,6503,34.292856398964496,16.040677134954095,2330,1,410816,44460,1176,0,901,1821
14569,0,0,1,0,63,1,1526,0,0,6033015,10625310,57.74945887192364,2889,5590,5144,3335,39040,777384,509760,2740,6521,3632,4995,8776,42.532340636273474,21.174652818590285,3781,1,533600,97674,1809,0,149,1377
14570,0,0,0,1,68,1,912,0,0,1146960,5525820,40.24922359499622,1161,2787,2328,1620,56350,835695,784530,2952,5031,3870,4119,6198,26.60826939130014,22.903978313563208,2079,1,372600,65178,708,0,1791,2703
14571,0,0,0,1,67,1,508,0,0,1203360,4653360,37.14835124201342,985,2647,2252,1380,53165,731724,826140,2977,4752,3767,4244,6019,29.5296461204668,21.20665311725019,1775,1,338100,37920,872,0,1992,2500
14572,0,0,1,0,58,1,424,0,0,867081,2190364,27.258026340878022,22,2631,1910,743,45333,645612,610236,2227,3691,3669,4115,5579,34.161381705077446,26.916303702356533,1464,1,153801,107429,1167,0,2205,1781
14573,0,0,0,1,68,1,787,0,0,1136790,5203530,39.11521443121589,1113,2690,2273,1530,56350,833245,782230,2984,4931,3818,4144,6091,27.258026340878022,21.980463285311387,1947,1,351900,60048,743,0,1871,2658
14574,0,0,0,1,67,1,1128,0,0,995220,5791770,41.352146256270665,1315,2687,2292,1710,55224,799332,792558,2992,5097,3782,3969,6074,24.124676163629637,21.356030455954155,2105,1,400140,45425,582,0,1677,2805
14575,0,0,0,1,67,1,881,0,0,1059240,5277480,39.496835316262995,1199,2600,2239,1560,54093,835601,740877,3022,4943,3744,4062,5983,26.057628441590765,20.61187485593295,1921,1,341640,53428,679,0,1823,2704
14576,0,0,0,1,66,1,344,0,0,1154160,4165560,35.4964786985977,960,2476,2176,1260,51250,677730,826500,3006,4566,3606,4222,5782,30.265491900843113,18.302026586942322,1560,1,315000,16500,916,0,2046,2390
14577,0,0,0,1,63,1,50,0,0,1155000,3314850,32.4037034920393,700,2500,2150,1050,52539,666127,786093,2807,4207,3507,4257,5657,33.166247903554,18.708286933869708,1400,1,261450,22400,1100,0,2107,2057
14578,0,0,1,0,63,0,292,0,0,285600,1298256,20.199009876724155,192,1324,1108,408,41140,770044,540940,2966,3590,3398,3882,4506,26.457513110645905,14.787141465807673,624,1,69360,45360,700,0,2774,2482
14579,0,0,1,0,63,1,1487,0,0,6734508,10996942,58.677082408722406,2849,5993,5399,3443,44781,808082,565338,2600,6637,3788,5150,9187,44.22668877499196,24.62517428248489,4037,1,609411,122364,1956,0,249,1238
14580,0,0,1,0,60,1,1069,0,0,822066,1575756,22.759613353482084,306,2317,2105,518,56394,711828,733122,2830,3560,3254,4629,5359,39.83716857408418,14.701031829420534,730,0,124838,23532,1587,1,2524,1455
14581,0,0,1,0,65,0,232,0,0,840320,3389360,32.2490309931942,716,2172,1848,1040,46487,661577,746311,2935,4299,3583,4067,5431,28.42534080710379,18.01712232972779,1364,1,238160,33372,808,0,2219,2451
14582,0,0,1,0,58,1,355,0,0,2023416,4699287,40.13726448077895,1449,3029,2867,1611,46655,632989,627155,2755,4528,3079,4173,5946,35.4400902933387,12.865825024943737,1773,1,346365,22194,1256,0,1306,1661
14583,0,0,0,1,66,1,1021,0,0,919872,5276488,39.96248240537617,1350,2420,2173,1597,47672,779744,667408,3057,4901,3551,3880,5724,24.0,16.923822904063098,1844,1,322594,33592,576,0,1707,2728
14584,0,0,1,0,62,1,225,0,0,1099314,2932446,30.692018506445613,647,2404,2109,942,52500,653730,778250,2818,4055,3408,4280,5517,34.161381705077446,17.175761397478542,1237,0,235500,23305,1167,1,2171,1946
14585,0,0,1,0,60,1,132,0,0,1170700,3059090,31.906112267087632,828,2358,2168,1018,54225,676125,724205,2815,4023,3195,4155,5363,33.91164991562634,14.044701627992035,1208,1,245338,21090,1150,0,1987,1855
14586,0,0,1,0,63,0,1162,0,0,461675,991271,17.69180601295413,0,2101,1788,313,48204,741078,652402,2854,3480,3480,4642,5268,38.40572873934304,17.69221231691028,626,0,64478,51958,1475,1,2854,1692
14587,0,0,0,1,64,1,499,0,0,1056056,4187628,36.15245496505044,1187,2235,2115,1307,50907,682452,765756,3084,4511,3324,4012,5439,28.42534080710379,11.35235258913941,1427,1,312373,8400,808,0,1897,2396
14588,0,0,1,0,64,0,214,0,0,578375,2117844,25.709920264364882,391,1806,1536,661,45978,759348,621576,2934,3865,3474,4079,5010,29.58039891549808,16.482158661538314,931,0,128234,49410,875,1,2543,2329
14589,0,0,0,1,69,1,1486,0,0,11565312,14703744,64.99230723708769,3025,8161,6962,4224,41360,818035,612656,2282,7705,4680,6219,11642,52.32590180780452,35.341760445457474,5423,1,743424,238601,2738,0,743,743
14590,0,0,1,0,67,1,1480,0,0,10001904,13507356,63.150613615387776,2901,7583,6496,3988,35866,768849,535146,2300,7375,4474,5895,10970,50.07993610219566,33.47408869433644,5075,1,630104,226096,2508,0,601,879
14591,0,1,1,0,64,0,1156,0,0,3681932,4597424,37.76241517699841,1426,4008,4008,1426,54054,744744,754416,3224,4650,3224,5806,7232,50.813384063650005,0.0,1426,0,333684,0,2582,1,1798,642
14592,0,0,1,0,62,1,882,0,0,599400,1405800,21.213203435596427,20,2212,1782,450,54500,681032,781000,2694,3574,3554,4456,5336,36.49657518178932,20.86865738561942,880,1,112500,37410,1332,0,2674,1792
14593,0,0,1,0,60,1,297,0,0,1280970,3000846,31.51190251317746,963,2313,2283,993,50544,628576,734346,2992,4015,3052,4312,5335,35.91656999213594,5.5503012171862105,1023,1,241299,2640,1290,0,2029,1732
14594,0,0,1,0,61,1,166,0,0,1106136,3523248,33.734255586866,1096,2152,2110,1138,55930,736848,727560,3054,4234,3138,4068,5248,31.176914536239792,6.5252844928085345,1180,0,267430,4998,972,1,1958,2124
14595,0,0,1,0,64,0,518,0,0,470208,1518222,21.77154105707724,324,1616,1466,474,47200,755908,640600,3053,3677,3353,4195,4819,31.496031496047245,12.325090945468352,624,0,94800,26400,992,1,2729,2211
14596,0,0,1,0,64,0,446,0,0,688152,2060640,25.219040425836983,594,1760,1718,636,48510,748440,680400,3198,3876,3282,4322,5000,32.89376840679705,6.488991180673202,678,0,133560,6678,1082,0,2604,2158
14597,0,0,0,1,64,1,1629,0,0,452782,6048943,43.255057507764334,1721,2263,2113,1871,55404,737124,785619,3083,5104,3383,3475,5496,15.556349186104045,12.393026621210916,2021,1,454653,16500,242,0,1362,2991
14598,0,0,1,0,59,1,490,0,0,950000,2243520,27.568097504180443,437,2333,2010,760,27560,625824,383760,2629,3712,3275,4202,5285,35.35533905932738,19.26754960638108,1083,1,98800,69768,1250,0,2192,1702
14599,0,0,1,0,54,1,72,0,0,748660,2457950,30.033314835362415,902,1732,1732,902,48399,602225,596775,2725,3627,2725,3555,4457,28.809720581775867,0.0,902,0,197538,0,830,1,1823,1895
14600,0,0,0,1,64,1,1650,0,0,428184,6073452,43.3358973600409,1754,2230,2106,1878,52170,717948,759990,3110,5112,3358,3462,5464,15.0996688705415,11.265233092802442,2002,1,441330,14632,228,0,1356,3006
14601,0,0,1,0,56,1,336,0,0,897220,2228758,28.178005607210743,794,1924,1924,794,45200,634382,561400,2807,3601,2807,3937,4731,33.61547262794322,0.0,794,0,158800,0,1130,1,2013,1677
14602,0,0,1,0,57,1,1099,0,0,867692,1540140,23.065125189341593,331,2364,2163,532,43734,570315,642690,2694,3427,3096,4526,5259,40.38564101261734,14.336946952226079,733,1,118104,20703,1631,0,2363,1264
14603,0,0,1,0,61,1,1381,0,0,826232,1391335,21.236760581595302,128,2606,2283,451,40296,675615,567640,2762,3536,3408,4917,5691,42.80186911806539,18.296804569605385,774,0,82984,55879,1832,1,2634,1253
14604,0,0,1,0,58,1,985,0,0,1008486,1828546,25.019992006393608,370,2493,2237,626,43143,575437,639699,2665,3547,3177,4532,5414,40.13726448077895,16.282991563399886,882,1,137094,27136,1611,0,2295,1310
14605,0,0,0,1,63,1,567,0,0,1052788,4254288,36.71511950137164,1224,2253,2129,1348,46605,615420,754284,3032,4504,3280,3937,5409,27.94637722496424,11.144389776194219,1472,1,322172,9548,781,0,1808,2375
14606,0,0,1,0,55,1,308,0,0,1104128,3345216,34.87119154832539,1216,2124,2124,1216,53874,676746,602469,2751,3967,2751,3659,4875,30.133038346638727,0.0,1216,0,266304,0,908,1,1535,1843
14607,0,0,1,0,63,0,290,0,0,1213296,3089268,31.080540535840107,636,2552,2222,966,47508,709956,684372,2868,4164,3528,4454,5750,35.4400902933387,18.16627744150972,1296,1,206724,47520,1256,0,2232,1942
14608,0,0,1,0,60,1,653,0,0,1133280,2378314,28.053520278211074,702,2312,2227,787,48590,682972,649730,2937,3809,3107,4462,5334,37.94733192202055,9.219544457292887,872,0,169205,12580,1440,1,2235,1582
14609,0,0,1,0,63,1,493,0,0,1738860,3459105,33.090784215548595,603,3175,2683,1095,36815,628641,584415,2667,4254,3651,4747,6334,39.84971769034255,22.32625435285308,1587,1,202575,72816,1588,0,2064,1571
14610,0,0,1,0,59,1,732,0,0,1332565,2502890,29.068883707497267,611,2656,2422,845,47040,622020,663488,2728,3807,3196,4539,5618,39.71145930332956,15.301526466348786,1079,1,189280,27612,1577,0,2117,1385
14611,0,0,0,1,65,1,2080,0,0,63300,6882820,45.93473631142341,1986,2264,2140,2110,47752,613256,828548,3138,5372,3386,3292,5526,5.477225575051661,11.33917216041645,2234,1,535940,4464,30,0,1152,3232
14612,0,0,1,0,64,0,293,0,0,1254308,3153464,31.352830813181765,706,2536,2259,983,50167,728216,708968,2931,4191,3485,4484,5744,35.7211421989835,16.652473881125413,1260,1,217243,39334,1276,0,2225,1932
14613,0,0,0,1,63,1,846,0,0,1017907,4848332,38.948684188300895,1342,2363,2188,1517,48278,645592,763844,3021,4713,3371,3867,5559,25.903667693977237,13.231455475499132,1692,1,362563,15050,671,0,1679,2525
14614,0,0,0,1,64,1,1687,0,0,501810,6290130,44.10215414239989,1878,2270,2203,1945,43875,727650,630630,3167,5179,3301,3492,5504,16.06237840420901,8.222029866439447,2012,1,379275,11323,258,0,1289,2976
14615,0,0,0,1,64,1,1526,0,0,623435,6027779,43.139309220245984,1753,2304,2196,1861,41472,699624,621888,3131,5100,3347,3574,5543,18.303005217723125,10.429745618880121,1969,1,357312,17388,335,0,1378,2904
14616,0,0,0,1,64,1,1415,0,0,703950,5853615,42.485291572496,1671,2329,2195,1805,41514,719946,606441,3109,5048,3377,3633,5572,19.748417658131498,11.627706147355314,1939,1,337535,23316,390,0,1438,2853
14617,0,0,0,1,64,1,1191,0,0,852082,5481784,41.15823125451335,1482,2409,2197,1694,45492,660144,721628,3024,4930,3448,3739,5645,22.427661492005804,14.64762860497819,1906,1,377762,23320,503,0,1542,2733
14618,0,0,0,1,63,1,853,0,0,1035810,4889880,39.11521443121589,1380,2357,2207,1530,51120,680748,767040,3046,4726,3346,3873,5553,26.019223662515376,12.250849366392371,1680,1,367200,14850,677,0,1666,2519
14619,0,0,0,1,68,1,2103,0,0,2656008,10214265,54.69003565550127,2857,4013,3879,2991,53760,819600,764960,3281,6406,3549,4303,7428,29.79932885150268,11.575836902790225,3125,1,669984,20234,888,0,424,2527
14620,0,0,0,1,64,1,1729,0,0,505920,6418240,44.54211490264017,1917,2306,2239,1984,43357,734345,617885,3168,5219,3302,3490,5541,15.968719422671311,8.222029866439447,2051,1,378944,11792,255,0,1251,2980
14621,0,0,0,1,64,1,1468,0,0,693344,5985624,42.941821107167776,1694,2370,2220,1844,41688,701136,626478,3096,5090,3396,3622,5616,19.390719429665317,12.30152264982736,1994,1,355892,24000,376,0,1402,2870
14622,0,0,0,1,63,1,859,0,0,1055412,4932971,39.28103868280471,1416,2354,2227,1543,47632,664976,732113,3070,4740,3324,3881,5551,26.153393661244042,11.275710766281223,1670,1,353347,13843,684,0,1654,2513
14623,0,0,0,1,63,1,692,0,0,1127973,4656729,38.24918299781056,1378,2319,2234,1463,49234,655698,760737,3098,4646,3268,3954,5502,27.76688675382964,9.227509513928014,1548,1,349657,7820,771,0,1720,2412
14624,0,0,0,0,61,1,377,1,0,2129780,3943942,35.81898937714463,1216,3010,2943,1283,53192,670132,750056,3007,4357,3141,4734,6084,40.74309757492672,8.261328108906353,1350,1,313052,6633,1660,0,1791,1414
14625,0,0,0,1,65,1,2020,0,0,512544,7402664,47.41307836451879,2206,2518,2476,2248,50953,668479,826543,3251,5541,3335,3521,5811,15.0996688705415,6.589126398255297,2290,1,564248,2856,228,0,1045,3065
14626,0,0,0,1,64,1,1085,0,0,963456,5393024,40.792156108742276,1463,2444,2243,1664,39919,619031,677369,3040,4905,3442,3820,5685,24.06241883103193,14.289801709712407,1865,1,347776,22311,579,0,1577,2662
14627,0,0,0,1,63,1,698,0,0,1150583,4704245,38.43175770115127,1417,2316,2256,1477,48410,656110,748475,3125,4662,3245,3964,5501,27.910571473905726,7.759379671981613,1537,1,347095,5880,779,0,1708,2406
14628,0,0,0,1,63,1,588,0,0,1192725,4514400,37.749172176353746,1395,2292,2262,1425,40446,598752,677952,3138,4593,3198,4005,5460,28.930952282978865,5.514871952411144,1455,1,304950,3060,837,0,1743,2331
14629,0,0,1,0,63,1,596,0,0,1217645,4579498,37.960505792204614,1441,2286,2286,1441,39200,622888,635600,3178,4619,3178,4023,5464,29.068883707497267,0.0,1441,0,288200,0,845,1,1737,2333
14630,0,0,1,0,61,1,315,0,0,2385450,4260330,37.3496987939662,1300,3200,3105,1395,46008,650502,659664,2959,4449,3149,4764,6254,41.352146256270665,9.749223385359247,1490,1,301320,12540,1710,0,1659,1344
14631,0,0,0,1,68,1,2102,0,0,2859480,10367136,55.154328932550705,2934,4090,3982,3042,53460,828144,749760,3300,6450,3516,4348,7498,30.659419433511783,10.393195703494003,3150,1,669240,17172,940,0,366,2468
14632,0,0,1,0,63,1,14,0,0,1782176,4258166,36.6333181680284,467,3545,2670,1342,43475,745655,587005,2298,4515,4048,4501,6718,36.4417343165772,29.588518711321193,2217,1,248270,167125,1328,0,1831,1845
14633,0,0,1,0,64,0,407,0,0,541520,1808240,23.664319132398465,44,2043,1527,560,46134,752357,639342,2713,3789,3745,4196,5272,31.096623610932426,22.758701468789766,1076,0,110880,90300,967,1,2669,2262
14634,0,0,0,1,68,1,2102,0,0,3487848,10904316,56.515484603779164,3194,4286,4286,3194,49500,675972,853500,3414,6608,3414,4506,7700,33.04542328371661,0.0,3194,1,798500,0,1092,0,220,2322
14635,0,0,0,1,68,1,2096,0,0,2243280,9784152,53.62835071116769,2706,3826,3656,2876,56165,799470,813078,3232,6278,3572,4182,7228,27.92848008753788,13.182183539989362,3046,1,687364,20910,780,0,526,2622
14636,0,0,1,0,63,1,1180,0,0,1564589,2520154,28.160255680657446,211,3348,2766,793,45080,730940,622888,2596,3971,3760,5151,6526,44.41846462902562,24.62356691260769,1375,1,155428,100686,1973,0,2385,1205
14637,0,0,1,0,61,1,345,0,0,2525446,4379246,37.76241517699841,1341,3282,3197,1426,47088,669478,663336,2986,4497,3156,4842,6353,42.08325082500163,9.227509513928014,1511,1,308016,11645,1771,0,1645,1300
14638,0,0,0,1,65,1,1998,0,0,892624,7824704,48.72371086031933,2374,2750,2750,2374,51040,764672,725120,3296,5670,3296,3672,6046,19.390719429665317,0.0,2374,1,522280,0,376,0,922,2920
14639,0,0,1,0,64,0,601,0,0,1212722,2729886,29.0,476,2648,2283,841,44935,697890,678414,2881,4087,3611,4688,5894,37.97367509209505,19.18704342521298,1206,1,175769,51830,1442,0,2405,1804
14640,0,0,1,0,64,1,672,0,0,1315129,4912979,39.1279950930277,1471,2450,2390,1531,43452,683517,654636,3149,4740,3269,4068,5659,29.30870177950569,7.754559014766193,1591,0,312324,8700,859,1,1678,2350
14641,0,0,0,1,67,1,2073,0,0,1996924,9371040,52.81098370604357,2747,3547,3505,2789,54988,782880,792960,3318,6149,3402,4076,6907,26.758176320519304,6.503581472166948,2831,1,658204,5334,716,0,571,2644
14642,0,0,1,0,61,1,433,0,0,7316210,9036120,54.12947441089743,2449,5908,5427,2930,32400,740160,416340,2603,6014,3565,5581,8992,49.969990994595946,22.535928938270988,3411,1,395550,113035,2497,0,154,587
14643,0,0,0,1,66,1,2033,0,0,1697484,8917129,51.66236541235796,2669,3305,3305,2669,56628,808522,781794,3341,6010,3341,3977,6646,25.219040425836983,0.0,2669,1,624546,0,636,0,672,2705
14644,0,0,1,0,57,1,234,0,0,1918411,3661148,35.679125549822544,1146,2907,2780,1273,49784,563696,730504,2749,4149,3003,4383,5783,38.82009788756334,11.45501536000853,1400,1,323342,6350,1507,0,1603,1369
14645,0,0,1,0,65,0,534,0,0,649512,1894992,24.124676163629637,94,2186,1698,582,46221,706552,693528,2768,3838,3744,4372,5442,33.406586176980134,22.16568555699899,1070,0,123966,67832,1116,1,2674,2140
14646,0,0,1,0,62,1,42,0,0,5021640,7100418,47.56048780237646,1696,5048,4482,2262,37128,527352,693719,2573,5401,3705,5359,8187,47.11687595755899,24.717338169695896,2828,1,499902,35092,2220,0,877,919
14647,0,0,0,1,66,1,1918,0,0,1363440,8264620,49.699094559156705,2362,3130,3022,2470,35908,629048,639086,3238,5816,3454,3898,6476,23.49468024894146,10.700008142562027,2578,1,471770,13716,552,0,876,2794
14648,0,0,1,0,64,0,1542,0,0,1085175,1692075,22.9128784747792,255,2862,2592,525,42423,576917,763851,2953,3748,3493,5290,6085,45.46427168667722,16.6117754205124,795,1,124425,15390,2067,0,2698,1156
14649,0,0,1,0,58,1,508,0,0,4404480,6945344,48.662100242385755,2085,4511,4228,2368,37515,601265,536739,2650,5301,3216,4793,7444,43.12771730569565,17.22395988155976,2651,1,433344,44431,1860,0,565,1073
14650,0,0,0,1,67,1,1905,0,0,1559214,8479803,50.22947341949744,2396,3268,3141,2523,48517,803279,682283,3234,5884,3488,3979,6629,24.859605789312106,11.377048979465448,2650,1,512169,22225,618,0,838,2743
14651,0,0,1,0,63,1,121,0,0,4458996,6539724,45.2990066116245,1657,4620,4225,2052,46440,688392,685205,2792,5239,3582,5360,7807,46.61544808322666,20.31811086320183,2447,1,441180,54115,2173,0,1135,1014
14652,0,0,1,0,58,1,227,0,0,4802948,6730128,48.041648597857254,2096,4601,4389,2308,41340,568620,618192,2704,5224,3128,4997,7517,45.617978911828175,14.774444774483948,2520,1,489296,23744,2081,0,608,835
14653,0,0,0,1,64,1,71,0,0,1960140,4429425,36.945906403822335,771,3395,2801,1365,28143,574365,515955,2651,4610,3839,4681,6640,37.89459064299283,24.48740944297246,1959,1,217035,86724,1436,0,1880,1809
14654,0,0,1,0,59,1,1129,0,0,1826100,2676600,30.0,615,3214,2929,900,42813,633462,597774,2689,3874,3259,5003,6188,45.044422518220834,16.95647879301624,1185,1,180900,42180,2029,0,2074,945
14655,0,0,1,0,56,1,74,0,0,2737656,4757904,41.13392760240627,1568,3434,3310,1692,51408,607392,669256,2688,4504,2936,4430,6246,40.22437072223753,11.546879086349044,1816,1,402696,13268,1618,0,1120,1194
14656,0,0,0,1,65,1,296,0,0,2156672,4358496,36.4417343165772,573,3707,2952,1328,34680,669528,557940,2527,4610,4037,4906,6989,40.29888335921977,27.803482415982295,2083,1,225760,128350,1624,0,1954,1658
14657,0,0,0,1,65,1,451,0,0,2221706,4222908,35.805027579936315,503,3794,3015,1282,35280,645624,592920,2515,4576,4073,5027,7088,41.6293165929973,28.31253522202713,2061,1,230760,116850,1733,0,2012,1561
14658,0,0,0,1,65,1,829,0,0,1820522,6000236,42.731721238442994,1692,2957,2823,1826,46200,657200,759066,3152,5112,3420,4283,6243,31.575306807693888,11.639773040550214,1960,1,421806,12730,997,0,1460,2289
14659,0,0,0,1,65,1,655,0,0,1885076,5672618,41.701318923986086,1497,3065,2823,1739,49248,704592,743736,3020,5001,3504,4346,6327,32.92415526630866,15.575505532814164,1981,1,396492,28798,1084,0,1523,2178
14660,0,0,1,0,59,1,1116,0,0,1992960,2871360,30.983866769659336,692,3304,3036,960,38916,619137,562308,2723,3951,3259,5067,6295,45.56314299957807,16.46112489689083,1228,1,180480,41540,2076,0,2031,915
14661,0,0,1,0,59,1,631,0,0,3508560,6560830,47.06378650300037,2065,3949,3799,2215,35526,565742,550932,2812,5177,3112,4546,6911,39.7994974842648,12.376180362832391,2365,1,411990,20550,1584,0,747,1378
14662,0,0,1,0,60,1,1028,0,0,2110485,3092297,32.046840717924134,665,3444,3082,1027,37245,587145,575101,2649,4038,3373,5066,6455,45.332107826572546,19.04080001540113,1389,1,196157,49594,2055,0,1984,956
14663,0,0,1,0,56,1,66,0,0,3167311,5076400,42.579337712087536,1723,3650,3560,1813,50429,590800,669200,2710,4613,2890,4547,6450,41.79712908801273,9.740037464252968,1903,1,433307,8820,1747,0,987,1053
14664,0,0,1,0,55,1,99,0,0,3275460,5178240,43.12771730569565,1830,3651,3621,1860,47610,576288,640320,2754,4644,2814,4545,6435,41.96427051671457,5.623413251903491,1890,1,427800,3180,1761,0,924,1023
14665,0,0,1,0,60,1,211,0,0,6903140,7683056,50.23942674832188,2296,5487,5259,2524,35186,733604,444424,2816,5568,3272,5779,8531,52.29722745997153,16.12505215855987,2752,1,368504,51984,2735,0,520,309
14666,0,0,0,1,66,1,824,0,0,2008832,6232288,43.45112196480086,1713,3127,2952,1888,45507,650297,762531,3126,5189,3476,4365,6428,32.61901286060018,13.228756555322953,2063,1,436128,15925,1064,0,1413,2237
14667,0,0,1,0,55,1,72,0,0,3307465,5184725,43.069710934716056,1795,3698,3638,1855,49184,592540,648440,2735,4650,2855,4578,6493,42.22558466143482,7.9730082341141015,1915,1,430360,6600,1783,0,940,1012
14668,0,0,1,0,62,1,2469,0,0,310680,377520,10.954451150103322,81,2910,2709,120,43200,755040,566280,2945,3266,3347,5735,6056,50.882216932834204,14.179639608858487,321,1,21600,40200,2589,0,3026,557
14669,0,0,1,0,59,1,405,0,0,5944356,6682632,47.37087712930804,2110,5027,4893,2244,42173,539018,693874,2844,5222,3112,5627,8005,51.468436929831086,12.019627717482168,2378,1,522852,8844,2649,0,734,329
14670,0,0,0,1,66,1,1014,0,0,2086912,6778388,45.14421336118285,1978,3122,3062,2038,49476,758328,721742,3266,5364,3386,4350,6448,32.0,7.780166052320878,2098,1,442246,8880,1024,0,1288,2302
14671,0,0,1,0,64,0,2066,0,0,1429311,1773921,23.388031127053,216,3491,3160,547,56595,794535,749133,2912,3790,3574,5856,6734,51.11751167652823,18.579635058910004,878,1,126357,46340,2613,0,2696,630
14672,0,0,0,1,67,1,1416,0,0,2142612,7930932,48.31148931672465,2064,3522,3252,2334,46736,625232,863092,3128,5732,3668,4316,6920,30.298514815086232,16.772599750023893,2604,1,592836,0,918,0,1064,2480
14673,0,0,0,1,66,1,895,0,0,2191406,6608116,44.654227123532216,1844,3243,3093,1994,51624,715824,792046,3164,5308,3464,4413,6557,33.15116890850155,12.24744871391589,2144,1,476566,15750,1099,0,1320,2215
14674,0,0,0,1,65,1,778,0,0,2226443,6362645,43.94314508543966,1703,3312,3084,1931,49742,688655,784210,3067,5226,3523,4448,6607,33.95585369269929,15.102282400517431,2159,1,459578,22344,1153,0,1364,2142
14675,0,0,1,0,65,1,1177,0,0,1334580,6209190,43.41658669218482,985,3493,2593,1885,44505,708210,681858,2394,5179,4194,4002,6787,26.60826939130014,30.07638370690063,2785,1,390195,128700,708,0,1409,2586
14676,0,0,1,0,61,1,1342,0,0,3106755,3747060,34.85685011586675,1148,3839,3772,1215,38796,564372,653808,3017,4299,3151,5641,6923,50.566787519082126,8.345174736691893,1282,1,257580,6499,2557,0,1869,527
14677,0,0,1,0,60,1,663,0,0,2493490,3870358,35.805027579936315,530,3979,3227,1282,43316,591724,667199,2267,4301,3771,4964,6998,44.10215414239989,27.607151970298496,2034,1,283322,77456,1945,0,1737,1074
14678,0,0,1,0,58,1,257,0,0,2885400,4605300,39.68626966596886,1028,3954,3407,1575,48108,616964,666672,2377,4499,3471,4756,6878,42.80186911806539,23.86713718364299,2122,1,359100,61811,1832,0,1349,1092
14679,0,0,1,0,56,1,51,0,0,3420000,5167392,42.708313008125245,1582,3941,3699,1824,50218,597763,674254,2591,4657,3075,4708,6774,43.30127018922193,15.79777293046628,2066,1,434112,23958,1875,0,1009,958
14680,0,0,0,1,68,0,443,0,0,363744,2962656,29.393876913398138,164,1985,1285,864,55104,768096,843534,2729,4293,4129,3850,5414,20.518284528683193,26.51611857242469,1564,1,212544,72100,421,0,2565,3008
14681,0,0,1,0,60,1,628,0,0,5884320,6447168,46.17358552246078,1942,5082,4892,2132,36838,492912,683424,2834,5156,3214,5784,8106,52.53570214625479,14.605765483509789,2322,1,481832,9310,2760,0,892,264
14682,0,0,0,1,66,1,1105,0,0,2294900,7200790,46.52956049652737,2165,3225,3225,2165,44928,778284,638592,3326,5491,3326,4386,6551,32.55764119219941,0.0,2165,1,415680,0,1060,0,1161,2266
14683,0,0,1,0,55,1,40,0,0,3825536,5522920,44.45222154178574,1886,4002,3912,1976,53815,656825,640055,2705,4771,2885,4731,6797,44.0,9.501147918471748,2066,1,452504,12510,1936,0,819,859
14684,0,0,0,1,69,1,1566,0,0,2530440,8894880,50.556898639058154,2271,3831,3546,2556,51666,758640,824760,3195,6036,3765,4470,7311,31.464265445104548,16.945237688130096,2841,1,605772,22800,990,0,924,2490
14685,0,0,0,1,69,1,1542,0,0,2506680,8788572,50.3189825016365,2237,3817,3522,2532,50544,721968,843453,3176,6003,3766,4461,7288,31.464265445104548,17.219799652250742,2827,1,615276,17995,990,0,939,2481
14686,0,0,1,0,66,1,1334,0,0,1258136,6539152,44.40720662234904,1068,3514,2610,1972,41778,699676,656568,2412,5288,4220,3954,6830,25.25866188063018,30.183358420787705,2876,1,390456,135600,638,0,1344,2678
14687,0,0,0,1,65,1,819,0,0,2636260,6827184,45.65084884205331,1909,3524,3349,2084,38600,632268,655200,3101,5360,3451,4541,6800,35.566838487557476,13.555134321639665,2259,1,416800,21700,1265,0,1192,2011
14688,0,0,0,1,65,1,828,0,0,2705020,6925020,45.93473631142341,1948,3554,3392,2110,41989,653118,692502,3120,5392,3444,4564,6836,35.805027579936315,12.966644717521362,2272,1,445210,19278,1282,0,1172,2000
14689,0,0,1,0,63,0,1242,0,0,2139280,3071464,31.11269837220809,908,3238,3178,968,50578,663157,767866,3113,4141,3233,5383,6411,47.01063709417264,7.864259938752337,1028,0,234256,5520,2210,1,2205,963
14690,0,0,1,0,63,0,2050,0,0,1515779,1844669,24.020824298928627,300,3481,3204,577,55822,789659,722522,2920,3774,3474,5824,6678,51.254268114957995,16.671929506701524,854,1,130402,40996,2627,0,2620,570
14691,0,0,1,0,63,1,1005,0,0,3809734,4832522,38.897300677553446,1453,4091,4031,1513,43078,760172,578114,3134,4707,3254,5712,7285,50.17967716117751,7.7992067098508295,1573,0,273853,11820,2518,1,1681,676
14692,0,0,0,1,68,1,1457,0,0,2747198,8660529,50.38849074937649,2297,3863,3621,2539,56133,787941,828873,3169,5950,3653,4493,7274,32.89376840679705,15.560597523821299,2781,1,616977,27346,1082,0,872,2329
14693,0,0,0,1,68,1,1432,0,0,2727344,8572012,50.15974481593781,2274,3842,3600,2516,55671,787017,821087,3165,5923,3649,4491,7249,32.92415526630866,15.695002637885558,2758,1,606356,28314,1084,0,891,2323
14694,0,0,1,0,59,1,335,0,0,3388896,4979122,41.0,1023,4355,3697,1681,47686,624982,669412,2304,4643,3620,4978,7317,44.8998886412873,26.224488207804043,2339,1,379906,76328,2016,0,1281,946
14695,0,0,1,0,56,1,11,0,0,4167692,5729304,45.12205669071391,1916,4203,4083,2036,45024,565614,630336,2694,4850,2934,4861,7017,45.24378410345447,11.111005581829925,2156,1,456064,12600,2047,0,778,767
14696,0,0,1,0,56,1,5,0,0,4225074,5776806,45.36518488885502,1968,4201,4111,2058,46512,572628,639996,2717,4865,2897,4860,7008,45.31004303683677,9.601845894041878,2148,1,469224,9450,2053,0,749,754
14697,0,0,0,1,68,1,1421,0,0,2823990,8631675,50.34878350069642,2319,3865,3649,2535,54747,786555,806985,3189,5940,3621,4519,7270,33.37663853655727,14.792473605492738,2751,1,600795,26784,1114,0,870,2291
14698,0,0,1,0,56,1,11,0,0,4386900,5886300,45.8257569495584,2040,4249,4189,2100,47765,574615,653099,2743,4903,2863,4892,7052,45.70557952810576,7.849311256600636,2160,0,489300,5880,2089,1,703,714
14699,0,0,1,0,55,1,26,0,0,4447712,5933112,46.06517122512408,2092,4248,4218,2122,49665,601140,645876,2766,4918,2826,4892,7044,45.78209256903839,5.531194905403055,2152,0,490182,3420,2096,1,674,700
14700,0,0,1,0,63,0,1372,0,0,933629,1574844,22.338307903688676,222,2647,2370,499,36720,643824,568080,2879,3655,3433,5027,5803,43.255057507764334,16.738160657857883,776,0,89820,44320,1871,1,2657,1285
14701,0,0,1,0,56,1,43,0,0,4323858,5828256,45.36518488885502,1908,4309,4159,2058,46762,583392,642864,2682,4890,2982,4933,7141,45.83666654546336,12.514175867137965,2208,1,467166,16200,2101,0,774,731
14702,0,0,1,0,65,1,1185,0,0,3906976,4782221,38.353617821530214,1281,4317,4127,1471,39746,773738,542917,3061,4722,3441,5907,7568,51.536394906900505,13.965249839823185,1661,1,245657,39900,2656,0,1780,595
14703,0,0,1,0,56,1,52,0,0,4430349,5898123,45.59605246071199,1929,4360,4210,2079,46920,578748,652510,2687,4916,2987,4968,7197,46.16275555033516,12.561867176898298,2229,1,478170,15300,2131,0,758,706
14704,0,0,1,0,62,1,1134,0,0,5433712,5761640,42.80186911806539,1395,5235,4798,1832,50298,635290,783105,2708,4977,3582,6111,8380,54.46099521676041,22.108927257155557,2269,1,456168,30590,2966,0,1313,179
14705,0,0,1,0,56,1,28,0,0,4652453,6053975,46.292547996410825,2053,4404,4314,2143,47066,570650,658225,2735,4968,2915,4996,7229,46.593991028886975,9.808573176892017,2233,1,499319,8460,2171,0,682,654
14706,0,0,1,0,56,1,36,0,0,4760800,6121956,46.51881339845203,2074,4454,4364,2164,45738,560142,653499,2739,4993,2919,5029,7283,46.9041575982343,9.82680210338744,2254,1,499884,8370,2200,0,665,629
14707,0,0,1,0,64,1,1406,0,0,3614520,4263280,36.38681079732051,1264,4114,4054,1324,44620,740600,624680,3160,4544,3280,5950,7334,52.24940191045253,7.83531632499182,1384,0,256856,10560,2730,1,1896,490
14708,0,0,0,1,68,1,1431,0,0,3510090,9254121,52.16320542297991,2679,4053,4011,2721,54948,775428,819641,3359,6122,3443,4691,7454,35.91656999213594,6.484411467763075,2763,1,655761,4788,1290,0,680,2111
14709,0,0,0,0,58,1,488,1,0,6180468,8001156,52.364109846344185,2530,5208,4996,2742,42186,691566,519404,2706,5660,3130,5172,8126,47.47630988187688,14.843417048062975,2954,1,488076,41976,2254,0,176,664
14710,0,0,1,0,62,1,1437,0,0,4052664,8887872,53.44155686354955,2732,4399,4275,2856,45150,669080,653520,2988,5968,3236,4531,7511,37.66961640367472,11.363102531111466,2980,1,599760,17484,1419,0,256,1693
14711,0,0,1,0,62,1,677,0,0,3721140,5077080,40.24922359499622,1500,4037,3917,1620,40586,698882,570388,3014,4754,3254,5431,7171,47.92702786528704,11.167976299283184,1740,1,294840,21600,2297,0,1514,837
14712,0,0,1,0,62,1,215,0,0,3839850,5750500,43.069710934716056,1125,4655,3925,1855,39432,576600,657200,2370,4955,3830,5170,7755,45.4972526643093,27.089529825761932,2585,1,393260,73730,2070,0,1245,1030
14713,0,0,0,0,65,1,2250,1,0,1703104,1959646,24.454038521274967,364,4408,3446,598,52500,819250,688170,2315,3875,4239,6125,7685,53.36665625650534,31.049326606825908,1560,1,125580,167388,2848,0,2679,429
14714,0,0,1,0,66,0,539,0,0,1448892,3184092,31.04834939252005,706,2725,2467,964,39150,743175,574722,3045,4267,3561,4806,6028,38.768543949960254,16.268379127922124,1222,0,167736,49020,1503,1,2339,1800
14715,0,0,1,0,63,1,2049,0,0,2723706,9366819,54.47017532558529,2616,4236,3885,2967,41724,577731,719796,2806,6124,3508,4075,7393,30.298514815086232,19.075939487639204,3318,1,676476,26325,918,0,190,2239
14716,0,0,1,0,62,0,972,0,0,148204,418214,11.575836902790225,67,1441,1240,134,43384,724072,583627,2920,3255,3322,4227,4562,33.25657829663178,14.283714794538563,335,0,25058,37185,1106,1,2987,2015
14717,0,0,0,1,67,0,568,0,0,118260,2474700,27.018512172212592,50,1672,892,730,48952,715290,786480,2610,4120,4170,3552,5062,12.727922061357855,28.29310594204143,1510,1,169360,85020,162,0,2660,3228
14718,0,0,0,0,57,1,721,1,0,6400620,8435988,54.0,2874,5153,5111,2916,45864,729036,526526,2851,5809,2935,5088,8046,46.850827100489916,6.570697549716149,2958,1,530712,8568,2195,0,23,698
14719,0,0,1,0,63,1,1175,0,0,3463196,4347068,36.932370625238775,674,4593,3903,1364,47436,640587,752132,2497,4551,3877,5726,7780,50.38849074937649,27.096770582717934,2054,1,321904,61410,2539,0,1823,648
14720,0,0,1,0,57,1,339,0,0,5158276,7047360,49.467160824126545,2297,4705,4555,2447,43052,541440,659520,2730,5327,3030,4988,7585,45.91296113299599,12.75511514473605,2597,1,560363,12150,2108,0,433,772
14721,0,0,1,0,62,0,1773,0,0,1532124,1989408,25.219040425836983,512,3169,3045,636,52341,747592,685032,3004,3764,3252,5537,6297,49.08156476723211,11.135709774976435,760,0,139284,19468,2409,0,2492,719
14722,0,0,1,0,64,1,342,0,0,4144608,6040944,43.266615305567875,1805,4153,4086,1872,37185,596995,648627,3160,5099,3294,5441,7380,47.05316142407437,8.361900766312248,1939,1,376272,7504,2214,0,1355,1013
14723,0,0,0,1,66,1,152,0,0,4646873,7440356,47.25462940284264,2083,4464,4314,2233,41418,589764,779688,3182,5565,3482,5413,7796,45.617978911828175,12.449381359612769,2383,1,522522,8700,2081,0,1099,1251
14724,0,0,1,0,64,0,709,0,0,428610,1252680,19.748417658131498,53,1932,1489,390,27348,680944,414348,2769,3602,3655,4311,5144,33.15116890850155,21.423471714184274,833,0,50310,96131,1099,1,2822,2113
14725,0,0,1,0,63,1,2326,0,0,814215,980148,17.578395831246947,432,3685,2944,309,51054,805688,637572,2431,3481,3913,5807,6857,51.332251070842396,27.29833881759886,1050,0,62109,137085,2635,1,2863,537
14726,0,0,0,1,70,0,538,0,0,1032240,4647720,36.3318042491699,780,2642,2102,1320,53572,830956,799267,2981,4841,4061,4303,6163,27.964262908219126,23.25350379291277,1860,1,299640,77760,782,0,2201,2739
14727,0,0,0,1,68,0,431,0,0,464070,3187110,30.495901363953813,297,2062,1429,930,53590,788210,798491,2794,4357,4060,3926,5489,22.338307903688676,25.225553145555725,1563,1,216690,82290,499,0,2497,2928
14728,0,0,1,0,64,1,1180,0,0,2381004,3402648,32.58834147360065,319,4047,3304,1062,54054,749736,740124,2461,4266,3947,5446,7251,47.34976240700686,27.258075716843337,1805,1,245322,101791,2242,0,2142,962
14729,0,0,1,0,67,0,463,0,0,1323510,4736255,37.48332962798263,655,3097,2347,1405,55224,788814,795556,2621,4776,4121,4313,6468,30.692018506445613,27.81532752558179,2155,0,331580,96750,942,0,1966,2429
14730,0,0,1,0,64,1,1187,0,0,2247914,3270990,31.921779399024736,276,3968,3225,1019,54285,754350,741510,2467,4229,3953,5416,7178,46.968074263269514,27.258026340878022,1762,1,235389,101791,2206,0,2191,1004
14731,0,0,1,0,63,1,1497,0,0,1432080,2109666,25.748786379167466,332,3154,2823,663,52611,785954,677766,2851,3845,3513,5342,6336,46.475800154489,18.217270652845272,994,0,141219,56270,2160,1,2519,1022
14732,0,0,0,1,68,1,660,0,0,4766364,8733258,50.37856687124,2214,4740,4416,2538,47559,657231,856809,3117,5979,3765,5319,8181,43.3358973600409,18.178441789728122,2862,1,631962,17820,1878,0,903,1563
14733,0,0,1,0,64,1,546,0,0,3573571,6996515,46.72258554489466,1943,4060,3820,2183,55328,791635,717920,2965,5388,3445,4842,7265,40.45985664828782,15.513673112502369,2423,1,488992,34800,1637,0,1022,1568
14734,0,0,1,0,66,1,2291,0,0,530636,8302451,50.02999100539596,1903,3315,2715,2503,39516,736374,590426,2717,5820,3917,3529,6632,14.560219778561036,25.01692680124297,3103,1,445534,110400,212,0,814,3105
14735,0,0,1,0,64,1,1217,0,0,1947734,2924800,30.23243291566195,182,3777,3045,914,56120,780800,736000,2468,4114,3932,5331,6977,46.16275555033516,27.056760760007197,1646,1,210220,104676,2131,0,2286,1069
14736,0,0,1,0,59,1,1562,0,0,6465639,10267944,58.66003750424986,3399,5362,5320,3441,43005,701240,546072,2942,6425,3026,4863,8346,43.347433603386484,6.481658975540136,3483,0,629703,8064,1879,1,457,1105
14737,0,0,1,0,64,0,58,0,0,2464059,4958938,39.25557285278104,1299,3382,3140,1541,56088,733704,791628,2976,4759,3460,4817,6600,39.98749804626441,15.739623448814104,1783,0,379086,24442,1599,1,1677,1619
14738,0,0,1,0,67,1,94,0,0,5403416,8024476,48.703182647543684,2102,4920,4650,2372,36064,757792,544663,3113,5755,3653,5661,8303,47.7283982551269,16.739866349049535,2642,1,381892,54270,2278,0,1011,1105
14739,0,0,1,0,66,0,140,0,0,363549,1789821,23.173260452512935,111,1640,1214,537,20566,606606,376629,2907,3870,3759,4010,4973,26.019223662515376,21.153898694828236,963,1,60681,83922,677,0,2796,2656
14740,0,0,1,0,60,1,807,0,0,3321010,4409482,38.24918299781056,966,4230,3733,1463,51815,648010,726374,2517,4477,3511,5284,7244,47.644516998286385,22.41934651933988,1960,0,352583,49700,2270,1,1551,744
14741,0,0,1,0,64,1,675,0,0,3678850,7323425,47.80167361086848,2165,4015,3895,2285,56153,772405,746765,3085,5490,3325,4815,7220,40.124805295477756,11.015556749295067,2405,1,532405,16680,1610,0,920,1595
14742,0,0,0,1,68,1,765,0,0,5182866,9224748,51.87484939737175,2516,4792,4617,2691,54064,747304,850144,3253,6119,3603,5354,8220,43.88621651498338,13.28071670500598,2866,1,667368,15925,1926,0,737,1502
14743,0,0,1,0,65,0,277,0,0,378348,1619172,22.181073012818835,169,1584,1261,492,52030,707565,796422,2968,3783,3614,4060,4875,27.730849247724095,18.135507721016413,815,1,119064,31977,769,0,2799,2522
14744,0,0,1,0,66,0,158,0,0,464355,2015847,24.63736998950984,189,1790,1372,607,46656,637632,807003,2903,3928,3739,4086,5111,27.65863337187866,20.68827380115816,1025,1,147501,27588,765,0,2714,2556
14745,0,0,1,0,60,1,1960,0,0,6476129,11302643,60.88513775955508,3612,5549,5454,3707,43776,695172,585408,2954,6756,3144,4796,8598,41.79712908801273,9.751111384664751,3802,0,711744,16720,1747,1,658,1302
14746,0,0,0,1,68,0,116,0,0,797661,3257354,30.870698080866262,611,2132,1790,953,50140,786140,745124,3076,4371,3760,4255,5550,28.930952282978865,18.4935977473728,1295,1,207754,50958,837,0,2465,2581
14747,0,0,1,0,68,0,208,0,0,1021440,3827040,33.46640106136302,355,2797,2032,1120,51272,792744,755157,2652,4537,4182,4329,6214,30.199337741083,28.17977093569965,1885,1,247520,112455,912,0,2297,2505
14748,0,0,1,0,67,0,215,0,0,544214,2151974,25.25866188063018,114,2015,1491,638,25942,735314,401387,2849,4011,3897,4226,5388,29.206163733020468,23.464415321277425,1162,1,75922,120520,853,0,2735,2520
14749,0,0,0,1,68,0,109,0,0,615612,2498316,27.055498516937366,96,2209,1573,732,48391,761099,740621,2777,4145,4049,4254,5622,29.0,25.904401207217898,1368,1,158844,90312,841,0,2681,2572
14750,0,0,1,0,65,1,766,0,0,4188035,8033435,49.64876634922564,2465,4164,4164,2465,49862,697426,759347,3259,5724,3259,4958,7423,41.2189276910499,0.0,2465,1,574345,0,1699,0,794,1560
14751,0,0,1,0,62,1,1146,0,0,1164955,2032019,25.475478405713993,31,3062,2444,649,54675,760833,704475,2513,3780,3749,4926,6193,42.36744032862972,24.99037844696803,1267,1,146025,93936,1795,0,2482,1336
14752,0,0,0,1,68,0,37,0,0,780230,2955705,29.410882339705484,515,2117,1767,865,51513,789327,761991,3067,4282,3767,4319,5534,30.033314835362415,18.887471972336023,1215,1,192895,50050,902,0,2552,2515
14753,0,0,0,1,68,0,98,0,0,993603,3599586,32.357379374726875,260,2783,1996,1047,44946,780426,680724,2651,4485,4225,4387,6221,30.805843601498726,28.549150354117995,1834,1,207306,132216,949,0,2391,2489
14754,0,0,1,0,61,1,2201,0,0,6016932,11738322,61.554853586049575,3542,5624,5377,3789,40179,703246,548346,2851,6887,3345,4686,8722,39.84971769034255,15.716813225066717,4036,0,670653,46930,1588,1,691,1510
14755,0,0,1,0,67,0,422,0,0,613200,2020200,24.49489742783178,90,2132,1622,600,37604,801346,531986,2857,3967,3877,4389,5499,31.96873472629156,22.591011461406204,1110,0,94800,111180,1022,1,2767,2345
14756,0,0,0,1,68,0,55,0,0,960624,3445344,31.74901573277509,752,2217,1961,1008,51700,803230,751960,3162,4426,3674,4371,5635,30.870698080866262,16.003904820302886,1264,1,221760,38912,953,0,2410,2465
14757,0,0,1,0,61,1,2123,0,0,6772128,11929632,62.22539674441618,3782,5711,5621,3872,42560,690144,585390,2991,6953,3171,4830,8792,41.82104733265297,9.494144610579708,3962,0,735680,15570,1749,1,791,1332
14758,0,0,0,1,68,0,4,0,0,1069152,3528408,32.12475680841802,842,2258,2068,1032,49056,765856,748761,3229,4451,3609,4455,5677,32.18695387886216,14.241925542717267,1222,1,226008,26790,1036,0,2387,2383
14759,0,0,1,0,62,1,1255,0,0,593286,1138992,19.131126469708992,223,2576,1987,366,54934,753104,706424,2523,3478,3701,4733,5688,40.26164427839479,24.312927249717948,955,0,83082,87172,1621,1,2746,1491
14760,0,0,0,1,71,0,315,0,0,2473174,6209874,41.689327171351664,1453,3446,3161,1738,51205,875385,746757,3288,5311,3858,4996,7019,37.72267222772003,17.205092336640153,2023,1,363242,49590,1423,0,1835,2150
14761,0,0,1,0,66,0,320,0,0,815289,2526109,27.51363298439521,545,2046,1834,757,53655,730803,817565,3125,4094,3549,4414,5383,32.817678162843876,14.807819595695104,969,1,185465,20988,1077,0,2580,2260
14762,0,0,1,0,62,1,1728,0,0,2932228,8738262,52.744667976962376,2512,4106,3836,2782,44496,647046,678456,2871,5923,3411,4195,7247,32.46536616149585,16.46140513061128,3052,0,600912,32670,1054,1,359,2087
14763,0,0,0,1,61,1,1710,0,0,5971896,10562748,58.68560300448484,2826,5796,5178,3444,34744,619534,527524,2449,6511,3685,4801,8863,41.641325627314025,24.99327728879534,4062,1,592368,101970,1734,0,377,1333
14764,0,0,1,0,64,1,2333,0,0,4107860,11384240,59.20304046246274,2750,5432,4677,3505,41995,737296,600880,2493,6753,4003,4420,8680,34.23448553724738,27.48810272485741,4260,0,648425,136655,1172,1,257,2076
14765,0,0,1,0,66,0,262,0,0,960960,2872584,29.29163703175362,678,2158,1978,858,55278,743256,833652,3168,4206,3528,4468,5506,33.46640106136302,13.698197470491724,1038,1,213642,16380,1120,0,2490,2228
14766,0,0,1,0,67,0,205,0,0,1070054,3142698,30.610455730027933,762,2254,2079,937,56376,815022,778128,3179,4291,3529,4496,5608,33.793490497431605,13.359104871799886,1112,1,217384,23625,1142,0,2417,2212
14767,0,0,1,0,63,1,1880,0,0,2772144,9046544,53.40411969127476,2492,4184,3824,2852,45333,656604,694668,2812,6024,3532,4144,7356,31.176914536239792,19.07950396343732,3212,1,624588,42840,972,0,320,2200
14768,0,0,0,1,71,0,226,0,0,2477315,6038561,41.12177038990418,1408,3439,3156,1691,50370,821330,782049,3288,5262,3854,5036,7010,38.27531841800928,17.133370372883824,1974,1,370329,41884,1465,0,1880,2106
14769,0,0,1,0,68,0,254,0,0,1141647,3263611,30.805843601498726,278,2823,2152,949,41238,815043,598386,2768,4388,4110,4642,6262,34.68429039204925,26.64536266754182,1620,1,165126,136213,1203,0,2490,2236
14770,0,0,1,0,61,1,726,0,0,1493856,2788896,30.199337741083,672,2790,2550,912,56069,694166,755326,2818,3970,3298,4696,5848,40.47221268969612,15.511329085692061,1152,0,225264,23040,1638,1,2146,1420
14771,0,0,0,1,62,1,1902,0,0,6112800,11239200,60.0,2982,5916,5298,3600,35055,640010,533862,2504,6722,3740,4820,9038,41.20679555607303,25.04727374248012,4218,1,615600,105060,1698,0,478,1424
14772,0,0,0,1,71,0,185,0,0,2343066,5809698,40.32369030731191,1349,3344,3067,1626,47064,757476,793206,3296,5199,3850,5014,6917,37.960505792204614,17.444503331792227,1903,1,360972,33794,1441,0,1947,2132
14773,0,0,0,1,66,0,137,0,0,1422138,3733816,33.555923471125034,1096,2419,2389,1126,55695,779260,785892,3286,4442,3346,4579,5735,35.53871128783372,5.483301264452448,1156,1,266862,3840,1263,0,2190,2053
14774,0,0,0,1,66,0,144,0,0,1485657,3813531,33.896902513356586,1149,2442,2442,1149,52206,750094,766689,3319,4468,3319,4612,5761,35.958309192730404,0.0,1149,1,265419,0,1293,0,2170,2026
14775,0,0,0,1,68,0,412,0,0,1291589,3232294,30.805843601498726,465,2794,2310,949,40044,725478,640328,2922,4355,3890,4767,6200,36.89173349139343,22.701308245146826,1433,1,178412,78892,1361,0,2457,2045
14776,0,0,0,1,68,0,445,0,0,1348800,3275520,30.983866769659336,517,2808,2365,960,39140,702872,648280,2969,4372,3855,4817,6220,37.48332962798263,21.867157176773976,1403,1,182400,66893,1405,0,2452,2007
14777,0,0,1,0,60,1,646,0,0,1643355,3003993,31.606961258558215,932,2711,2644,999,56880,721680,712659,2940,4006,3074,4652,5718,40.55859958134649,8.2732738280919,1066,0,236763,8509,1645,1,2008,1362
14778,0,0,0,1,67,0,123,0,0,1844458,4348300,36.02776706930364,1203,2814,2719,1298,43904,656600,750400,3255,4648,3445,4771,6164,37.69615364994153,9.924396939761625,1393,1,290752,9405,1421,0,2052,1929
14779,0,0,0,1,67,0,554,0,0,1528560,3363030,31.464265445104548,713,2811,2534,990,17548,557108,363479,3120,4387,3674,4941,6208,39.293765408777,17.66900817916837,1267,1,105930,49860,1544,0,2407,1853
14780,0,0,1,0,66,1,1990,0,0,3155271,10035641,55.054518434003214,2413,4690,4072,3031,44655,645645,758219,2693,6342,3929,4352,8001,32.264531609803356,24.86747799391919,3649,1,694099,56238,1041,0,280,2270
14781,0,0,0,1,66,0,161,0,0,1855380,4284708,35.832945734337834,1176,2837,2729,1284,49680,690759,800880,3229,4621,3445,4782,6174,38.01315561749642,10.480278705357403,1392,1,308160,9936,1445,0,2053,1892
14782,0,0,0,1,68,0,473,0,0,1563324,3562804,32.18695387886216,590,2991,2545,1036,43472,715312,718751,2993,4475,3885,4948,6430,38.84584919911006,22.044684301421768,1482,1,216524,59318,1509,0,2403,1930
14783,0,0,0,1,69,0,305,0,0,1647300,3950100,33.76388603226827,603,3122,2585,1140,42173,807345,627165,2928,4605,4002,4910,6587,38.01315561749642,23.624090706405457,1677,1,206340,103104,1445,0,2325,2020
14784,0,0,1,0,66,1,2108,0,0,3786453,10839906,57.15767664977295,3033,4660,4426,3267,54780,729960,826182,3084,6585,3552,4477,7978,34.044089061098404,15.455495813746403,3501,0,813483,21294,1159,1,51,2159
14785,0,0,0,1,66,0,183,0,0,1900170,4294410,35.91656999213594,1223,2830,2763,1290,52756,725722,805618,3262,4619,3396,4802,6159,38.379682124790975,8.250220863768833,1357,1,312180,6901,1473,0,2039,1856
14786,0,0,1,0,59,1,586,0,0,1712432,3134568,32.37282811247729,963,2767,2682,1048,53536,714849,669984,2906,4039,3076,4625,5758,40.422765862815474,9.224644470006377,1133,0,234752,12835,1634,1,1943,1357
14787,0,0,0,1,66,0,173,0,0,2004660,4439556,36.49657518178932,1265,2904,2837,1332,53946,739926,809919,3266,4665,3400,4838,6237,38.79432948254165,8.2143728690235,1399,1,323676,7102,1505,0,2001,1828
14788,0,0,0,1,69,0,458,0,0,1713800,3797200,33.166247903554,591,3167,2658,1100,46830,769796,724920,2943,4552,3961,5010,6619,39.4715087119811,23.40912698347576,1609,1,231000,76350,1558,0,2352,1894
14789,0,0,1,0,64,0,1236,0,0,3638101,4484171,37.242448899072144,628,4769,4010,1387,46410,714493,678930,2474,4620,3992,5856,8002,51.21523210920751,27.606700458148218,2146,0,291270,112332,2623,1,1846,610
14790,0,0,0,1,69,0,482,0,0,1876800,3984750,33.91164991562634,641,3291,2782,1150,44485,751905,710325,2956,4615,3974,5097,6756,40.39801975344831,23.449074029780512,1659,1,235750,75332,1632,0,2315,1833
14791,0,0,0,1,69,0,470,0,0,1874096,3998610,33.97057550292606,623,3309,2778,1154,44517,738045,724185,2934,4619,3996,5089,6774,40.29888335921977,23.934811563083073,1685,1,241186,73809,1624,0,2311,1841
14792,0,0,0,1,69,0,477,0,0,1966624,4103744,34.40930106817051,842,3187,2845,1184,22360,596152,450580,3124,4650,3808,5127,6653,40.755367744629666,19.694738237204916,1526,1,153920,57798,1661,0,2282,1805
14793,0,0,0,1,69,0,516,0,0,1981197,4078521,34.249087579087416,797,3238,2862,1173,39597,698877,684969,3101,4650,3853,5166,6715,41.09744517606904,20.63692353367132,1549,1,231081,51512,1689,0,2304,1788
14794,0,0,0,1,69,0,540,0,0,2000700,4070430,34.20526275297414,744,3306,2880,1170,45732,772338,716674,3053,4649,3905,5189,6785,41.352146256270665,21.844456034445244,1596,1,241020,65604,1710,0,2309,1769
14795,0,0,0,1,69,0,502,0,0,2059848,4213764,34.72751070837067,816,3304,2914,1206,41208,712776,705788,3104,4700,3884,5202,6798,41.32795663954365,21.057532281335725,1596,1,243612,53040,1708,0,2288,1786
14796,0,0,0,1,68,0,367,0,0,2167100,4449900,36.05551275463989,1045,3222,2967,1300,34602,811251,499758,3168,4723,3678,5090,6645,40.82891132518721,16.68868233948606,1555,1,189800,57630,1667,0,2123,1756
14797,0,0,0,1,69,0,503,0,0,2140488,4298238,35.11409973215888,702,3500,2969,1233,46216,759948,739032,2955,4719,4017,5222,6986,41.66533331199932,24.022772111750527,1764,1,261396,75402,1736,0,2253,1750
14798,0,0,0,1,69,0,417,0,0,2130678,4406946,35.58089374931439,757,3458,2949,1266,40934,734491,675314,2972,4747,3990,5164,6939,41.02438299353203,22.953338923545335,1775,1,245604,77877,1683,0,2215,1798
14799,0,0,0,1,69,0,48,0,0,2968153,5864948,41.2189276910499,1604,3541,3446,1699,54560,759440,856096,3357,5151,3547,5199,6993,41.79712908801273,9.863740202967753,1794,1,421352,8835,1747,0,1753,1705
14800,0,0,0,1,66,0,202,0,0,2495688,4949880,38.49675310984031,1482,3166,3166,1482,47610,768200,691380,3340,4822,3340,5024,6506,41.036569057366385,0.0,1482,1,306774,0,1684,0,1858,1656
14801,0,0,0,1,69,0,511,0,0,2240562,4412922,35.53871128783372,806,3494,3037,1263,49060,768680,779162,3037,4757,3951,5268,6988,42.118879377305376,22.435657311668727,1720,1,281649,59867,1774,0,2231,1720
14802,0,0,0,1,69,0,378,0,0,2238343,4611224,36.318039594669756,895,3440,3016,1319,51744,807576,783104,3072,4815,3920,5193,6936,41.19465984809196,21.23913547290664,1743,1,295456,60632,1697,0,2177,1799
14803,0,0,0,1,68,0,383,0,0,2333388,4647904,36.71511950137164,1065,3362,3079,1348,32190,765456,499960,3165,4796,3731,5179,6810,41.60528812542944,16.84152879264993,1631,1,195460,60562,1731,0,2100,1717
14804,0,0,0,1,70,0,497,0,0,2323728,4541184,36.0,822,3563,3089,1296,47686,739344,791904,3030,4800,3978,5297,7067,42.34383071948026,22.805026335465765,1770,1,292896,54984,1793,0,2208,1711
14805,0,0,0,1,69,0,436,0,0,2401701,4709112,36.701498607005135,981,3496,3130,1347,38078,842536,552368,3130,4843,3862,5279,6992,42.22558466143482,19.21628182427153,1713,1,212826,80154,1783,0,2149,1713
14806,0,0,0,1,68,0,333,0,0,2562768,4935060,37.986839826445156,1293,3369,3219,1443,37556,783180,560880,3270,4863,3570,5196,6789,42.14261501141095,12.296281753706847,1593,1,236652,30600,1776,0,1977,1644
14807,0,0,0,1,70,0,507,0,0,2516580,4749030,36.78314831549904,840,3726,3213,1353,45938,782730,723060,2997,4863,4023,5370,7236,43.12771730569565,22.734422019330164,1866,1,278718,79515,1860,0,2157,1650
14808,0,0,0,1,68,0,91,0,0,3381690,6178536,42.35563716909474,1764,3709,3679,1794,41140,644028,757680,3414,5238,3474,5329,7153,43.41658669218482,5.514871952411144,1824,1,394680,2730,1885,0,1650,1559
14809,0,0,0,1,68,0,113,0,0,3289218,6019392,41.92851058647326,1698,3689,3629,1758,46464,657408,828608,3364,5182,3484,5295,7113,43.255057507764334,7.765259411425052,1818,1,425436,4080,1871,0,1666,1553
14810,0,0,0,1,70,0,525,0,0,2728350,4966020,37.54996671103717,857,3898,3345,1410,44472,767796,718488,2969,4932,4075,5457,7420,43.98863489584554,23.623351169750936,1963,1,287640,82950,1935,0,2112,1587
14811,0,0,1,0,60,1,550,0,0,546896,1567186,22.67156809750927,361,1731,1578,514,47460,640290,689074,2896,3563,3202,4113,4780,32.61901286060018,12.537074729344036,667,0,116164,17595,1064,1,2535,1985
14812,0,0,1,0,66,1,2308,0,0,7934220,14008726,64.79197481170026,3699,6587,6088,4198,42173,777521,603997,2838,7535,3836,5227,9924,43.474130238568314,22.649352691468806,4697,0,759838,95808,1890,1,861,1447
14813,0,0,0,1,67,0,190,0,0,3148704,5678432,41.012193308819754,1652,3584,3554,1682,38064,702208,617808,3346,5058,3406,5248,6960,43.266615305567875,5.5503012171862105,1712,1,307806,4860,1872,0,1694,1504
14814,0,0,0,1,67,0,263,0,0,2970420,5418621,39.96248240537617,1567,3487,3457,1597,36134,688779,603954,3363,4990,3423,5253,6880,43.12771730569565,5.623413251903491,1627,1,284266,4830,1860,0,1796,1533
14815,0,0,0,1,70,0,470,0,0,2787371,5095912,38.09199390948182,1051,3772,3372,1451,43848,814784,663768,3112,4963,3912,5433,7284,43.829214001622255,20.130743611676213,1851,1,274239,73200,1921,0,2061,1591
14816,0,0,1,0,60,1,445,0,0,896250,2255250,27.386127875258307,750,1945,1945,750,54960,688603,721680,3007,3757,3007,4202,4952,34.56877203488721,0.0,750,0,180000,0,1195,1,2257,1812
14817,0,0,0,1,69,0,435,0,0,2985516,5323332,39.03844259188627,1223,3784,3483,1524,43896,824348,649698,3192,5017,3794,5452,7277,44.26059195266146,17.449775452303943,1825,1,283464,57190,1959,0,1969,1534
14818,0,0,0,1,70,0,468,0,0,2990269,5311165,38.87158345115362,1120,3881,3490,1511,47236,847115,688940,3124,5026,3906,5494,7396,44.48595283907045,19.92157112322162,1902,1,296156,71944,1979,0,2004,1536
14819,0,0,1,0,63,1,3324,0,0,997477,11433175,60.00833275470999,3324,4155,3878,3601,53928,679450,800100,2898,6776,3452,3452,7330,16.64331697709324,16.782604634904654,3878,1,907452,20221,277,0,426,2898
14820,0,0,0,1,68,0,251,0,0,3430842,5921751,41.60528812542944,1597,3847,3713,1731,38325,749199,598675,3287,5152,3555,5403,7268,44.51965857910413,11.683282254829438,1865,1,302925,24522,1982,0,1690,1439
14821,0,0,0,1,70,0,445,0,0,3301224,5653728,40.099875311526844,1285,3984,3661,1608,40950,791100,639912,3193,5124,3839,5569,7500,45.31004303683677,17.993008616382102,1931,1,292656,59109,2053,0,1908,1463
14822,0,0,0,1,67,0,73,0,0,4440224,6941992,45.50824101193101,1831,4455,4215,2071,42292,650288,730736,3112,5423,3592,5496,7807,46.3033476111609,15.593206950958663,2311,1,451478,24960,2144,0,1281,1208
14823,0,0,1,0,65,1,2443,0,0,4611308,12142988,60.76183012385325,3246,5387,4941,3692,53352,749892,769626,2843,6981,3735,4538,8676,35.34119409414458,21.128287319768038,4138,1,863928,55750,1249,0,403,2040
14824,0,0,0,1,70,0,403,0,0,3533388,5926701,41.09744517606904,1499,3971,3781,1689,40809,782507,642147,3319,5198,3699,5601,7480,45.73838650411709,13.80547664970171,1879,1,309087,33820,2092,0,1820,1417
14825,0,0,1,0,64,1,2918,0,0,5931240,13830964,65.55913361233506,4298,5678,5678,4298,42136,736922,592112,3218,7516,3218,4598,8896,37.14835124201342,0.0,4298,0,790832,0,1380,1,1080,1838
14826,0,0,1,0,63,1,3408,0,0,2548609,12835942,63.55312738174259,3648,5061,4670,4039,37224,629244,597464,2787,7217,3569,3809,8239,25.11971337416094,20.133960572363357,4430,1,759332,56304,631,0,861,2547
14827,0,0,0,1,71,0,443,0,0,4102344,6492200,42.61455150532503,1516,4375,4075,1816,39960,772200,661375,3275,5391,3875,5834,7950,47.52893855326458,17.62789433832266,2116,1,335960,50400,2259,0,1759,1316
14828,0,0,1,0,64,1,3578,0,0,2728704,13660416,64.99230723708769,3781,5313,4870,4224,44310,682374,679140,2791,7458,3677,3880,8547,25.41653005427767,21.047672428315717,4667,1,887040,60248,646,0,990,2588
14829,0,0,0,1,72,0,433,0,0,4729538,7096276,44.37341546466758,1660,4680,4371,1969,43800,789276,720800,3295,5573,3913,6006,8284,49.01020301937138,18.11064401939884,2278,1,393800,48513,2402,0,1635,1202
14830,0,0,1,0,63,1,3817,0,0,1770230,13513885,65.07687761409578,4235,4653,4653,4235,41140,702020,596717,3191,7426,3191,3609,7844,20.445048300260872,0.0,4235,1,791945,0,418,0,1044,2773
14831,0,0,1,0,63,1,3653,0,0,2464770,13437655,65.07687761409578,4235,4817,4817,4235,48760,729790,672676,3173,7408,3173,3755,7990,24.124676163629637,0.0,4235,0,897820,0,582,1,1062,2591
14832,0,0,1,0,64,1,3813,0,0,2355514,14024234,65.98484674529449,4179,5070,4895,4354,48348,763377,657084,3046,7575,3396,3762,8291,23.259406699226016,13.324894335252607,4529,1,888216,30100,541,0,1133,2680
14833,0,0,1,0,64,1,3690,0,0,4141984,14822976,67.76429738438966,4315,5771,5494,4592,37840,710160,555216,2951,7820,3505,4130,8999,30.033314835362415,16.772016903539466,4869,1,789824,51522,902,0,1364,2326
14834,0,0,1,0,65,1,3820,0,0,3986069,15308748,68.3593446428504,4481,5718,5526,4673,45540,720720,678132,3084,7949,3468,4129,8994,29.206163733020468,13.89020567938961,4865,1,967311,28992,853,0,1397,2423
14835,0,0,0,1,66,0,2134,0,0,4864011,4601241,37.1887079635741,1341,4942,4900,1383,48837,741921,728613,3285,4710,3369,6844,8269,59.30430001273095,6.481658975540136,1425,1,302877,5838,3517,0,1944,190
14836,0,0,1,0,61,1,2832,0,0,4538308,12267738,63.03967004989794,3308,5782,5116,3974,37448,765576,466137,2421,7061,3753,4229,8869,33.793490497431605,25.807106709634898,4640,1,600074,147852,1142,0,887,1945
14837,0,0,1,0,63,1,2763,0,0,1911528,10618488,57.758116312774604,3051,4194,3909,3336,56350,779835,732090,2898,6519,3468,3756,7377,23.93741840717165,17.305525652487873,3621,1,767280,40185,573,0,153,2610
14838,0,0,1,0,63,0,2001,0,0,469156,668012,14.560219778561036,65,2702,2425,212,56404,753089,743636,2874,3363,3428,5364,5853,47.042533945356304,16.925060583549502,489,1,50032,36010,2213,0,2939,938
14839,0,0,1,0,66,0,2609,0,0,3412662,3182025,30.93541659651604,527,4953,4523,957,53536,744800,794675,2895,4282,3755,6891,8278,59.715994507334464,20.737815048115877,1387,1,228723,49020,3566,0,2368,241
14840,0,0,1,0,67,0,1268,0,0,7544805,7372190,46.74398357008097,2185,5638,5638,2185,55552,836752,755776,3374,5559,3374,6827,9012,58.762232769015846,0.0,2185,1,489440,0,3453,0,1189,79
14841,0,0,1,0,61,1,2035,0,0,2687664,9097389,54.286278192559855,2652,4154,3859,2947,54750,771750,676053,2792,6034,3382,3999,7241,30.199337741083,17.177340033898513,3242,1,645393,47200,912,0,140,2175
14842,0,0,1,0,62,0,2322,0,0,262440,339012,10.392304845413264,42,2688,2538,108,56404,750221,740804,2989,3247,3289,5569,5827,49.29503017546495,12.459604606992961,258,1,25488,19500,2430,0,3031,709
14843,0,0,1,0,65,0,1407,0,0,8472118,7541972,47.86439177509728,2101,6179,5989,2291,48057,819708,635356,3102,5583,3482,6990,9471,60.81118318204309,13.880774245913715,2481,1,442163,32870,3698,0,1001,406
14844,0,0,1,0,64,0,1285,0,0,9274850,7990450,49.699094559156705,2440,6255,6225,2470,55029,805515,714935,3205,5705,3265,6990,9490,61.27805479941412,5.684275577662207,2500,0,545870,4680,3755,1,765,520
14845,0,0,0,1,66,0,2423,0,0,6269010,5248510,39.6232255123179,1071,6062,5563,1570,48768,849122,641856,2844,4913,3842,7336,9405,63.190189111918315,22.340124344443534,2069,1,301440,96806,3993,0,1773,650
14846,0,0,1,0,67,0,3231,0,0,3463920,2850942,29.13760456866693,637,5141,4929,849,55454,782414,799204,3146,4207,3570,7438,8499,63.874877690685246,14.627860319333173,1061,1,202062,26500,4080,0,2509,722
14847,0,0,0,1,66,0,1734,0,0,10046107,8072203,49.18333050943175,2329,6662,6572,2419,46662,674074,770847,3247,5756,3427,7490,9999,64.4437739428721,9.494144610579708,2509,1,558789,8910,4153,0,918,816
14848,0,0,0,0,53,1,1359,1,0,5876086,8574354,56.542019772908716,2955,5277,5035,3197,56628,649044,627588,2440,5879,2924,4520,7959,42.871902220452036,15.701012843427549,3439,1,748098,31702,1838,0,515,844
14849,0,0,1,0,66,0,3140,0,0,5026269,3893112,34.161381705077446,509,6132,5474,1167,53383,844008,703896,2678,4503,3994,7643,9468,65.62773803811922,26.17557191587687,1825,1,246237,111860,4307,0,2169,971
14850,0,0,0,0,53,1,1123,1,0,5186088,7845993,53.91660226683428,2607,4991,4691,2907,55575,666653,607275,2399,5606,2999,4483,7690,42.23742416388575,17.68963858560639,3207,1,654075,43200,1784,0,208,915
14851,0,0,1,0,64,0,3063,0,0,5882800,4313162,36.565010597564445,1060,6014,5737,1337,48260,819404,612940,2949,4563,3503,7626,9240,66.332495807108,16.97189250944288,1614,0,254030,53738,4400,1,1889,1174
14852,0,0,1,0,63,0,3160,0,0,6088500,4270050,36.742346141747674,1242,5968,5860,1350,51359,800239,642089,3055,4513,3271,7673,9131,67.15653356152326,10.448863694758844,1458,0,274050,19872,4510,1,1813,1347
14853,0,0,1,0,63,0,4130,0,0,1314819,948618,17.233687939614086,120,5141,4724,297,56882,763366,760172,2777,3491,3611,7621,8335,66.53570470055908,20.664658287030907,714,0,70686,52542,4427,1,2897,1233
14854,0,0,1,0,55,1,591,0,0,430360,2811550,31.85906464414798,862,1592,1439,1015,55104,681420,620480,2617,3785,2923,3194,4362,20.591260281974,12.519275369364598,1168,1,227360,23715,424,0,1755,2346
14855,0,0,1,0,63,0,3600,0,0,5959089,3887649,35.11409973215888,1083,6216,6066,1233,48590,677895,712578,3003,4386,3303,7986,9369,69.5197813575388,12.263881625621906,1383,0,278658,18150,4833,1,1920,1680
14856,0,0,1,0,52,1,721,0,0,8416892,8581092,57.30619512757761,3254,5877,5847,3284,56628,632346,611442,2583,5897,2643,5176,8490,50.62608023538856,5.623413251903491,3314,0,768456,4020,2563,0,671,50
14857,0,0,0,0,51,1,241,0,1,3130782,4882732,43.520110293977886,1704,3737,3547,1894,51912,649656,531068,2388,4472,2768,4231,6315,40.65710270051225,14.241925542717267,2084,1,390164,32300,1653,0,684,925
14858,0,0,1,0,66,0,3249,0,0,8373442,5603752,41.15823125451335,1385,6946,6637,1694,45156,704604,701296,2999,5002,3617,8251,10254,70.30647196382421,17.591682245196367,2003,0,359128,41715,4943,1,1614,1635
14859,0,0,0,0,50,1,119,0,1,4391772,5478396,46.4327470649756,2066,4283,4193,2156,53599,627627,551397,2451,4697,2631,4578,6824,45.13313638558703,9.505517133991825,2246,1,467852,14850,2037,0,385,504
14860,0,0,0,0,50,1,94,0,0,5269407,5904360,48.40454524112379,2343,4592,4592,2343,53680,614880,554400,2520,4863,2520,4769,7112,47.4236228055175,0.0,2343,0,515460,0,2249,0,177,271
14861,0,0,0,0,51,1,146,0,1,1599960,3451840,36.60601043544625,1106,2768,2534,1340,46435,646576,476560,2342,3916,2810,3770,5344,34.55430508634199,15.637590964712755,1574,1,247900,43524,1194,0,1236,1382
14862,0,0,0,0,50,1,77,0,0,5532774,6027711,48.8978527135906,2331,4765,4705,2391,52884,589914,569746,2461,4912,2581,4835,7286,48.104053883222775,7.748117453886108,2451,0,540366,8580,2314,0,130,207
14863,0,0,0,0,50,1,73,0,0,2693190,4206746,40.963398296528084,1678,3283,3283,1678,51500,626750,516442,2507,4185,2507,4112,5790,40.06245124802026,0.0,1678,0,345668,0,1605,0,829,902
14864,0,0,1,0,66,0,3648,0,0,7464249,4849059,38.22302970723278,910,7121,6570,1461,45200,663800,750094,2768,4780,3870,8428,10440,71.47726911403373,23.48852858436431,2012,1,330186,56202,5109,0,1858,1790
14865,0,0,0,0,50,1,47,0,0,4142708,5190739,45.37620521815371,2059,4071,4071,2059,56120,615124,579830,2521,4580,2521,4533,6592,44.85532298401161,0.0,2059,0,473570,0,2012,0,462,509
14866,0,0,0,0,52,1,62,0,1,981120,2679684,31.96873472629156,699,2305,1982,1022,51414,645012,547998,2299,3644,2945,3582,4927,30.983866769659336,18.752040407655507,1345,1,213598,48450,960,0,1600,1662
14867,0,0,0,0,53,1,66,0,1,559912,2109836,27.964262908219126,722,1558,1498,782,52371,682594,558486,2638,3480,2758,3414,4256,26.758176320519304,7.83531632499182,842,1,161874,10440,716,0,1916,1982
14868,0,0,1,0,62,0,4610,0,0,509544,338148,10.392304845413264,82,5016,4826,108,55448,726392,748309,2941,3239,3321,7849,8147,68.68769904429759,13.886846184065407,298,0,25812,22990,4718,1,3023,1587
14869,0,0,0,0,50,1,8,0,0,3583433,4770955,43.55456348076513,1867,3816,3786,1897,45144,525635,543240,2485,4412,2545,4404,6331,43.46262762420146,5.490867587491313,1927,0,409752,3750,1889,0,618,626
14870,0,0,0,0,50,1,37,1,0,5273570,5792954,47.7283982551269,2170,4701,4593,2278,48108,536573,579804,2435,4821,2651,4858,7244,48.11444689487763,10.44206354473662,2386,1,519384,12204,2315,0,265,228
14871,0,0,0,0,49,1,144,1,0,1753092,3123714,35.41186241925155,1224,2682,2652,1254,48792,567948,533074,2461,3745,2521,3889,5173,37.389838191679836,5.490867587491313,1284,1,268356,4560,1398,0,1237,1093
14872,0,0,0,0,50,1,196,1,0,2312972,3579260,37.76241517699841,1426,3048,3048,1426,46782,567260,519570,2510,3936,2510,4132,5558,40.27406113120453,0.0,1426,1,295182,0,1622,0,1084,888
14873,0,0,1,0,63,0,5009,0,0,2497962,1445034,21.37755832643195,256,6124,5923,457,52341,692478,755718,2961,3619,3363,8628,9286,73.93240155709809,14.255752335575957,658,0,109223,21909,5466,1,2705,2304
14874,0,0,0,0,52,1,107,1,0,6553298,6903574,51.12729212465687,2413,5322,5121,2614,39200,517636,528200,2440,5255,2842,5148,7963,50.06995106848019,14.283714794538563,2815,1,522800,25728,2507,0,27,134
14875,0,0,0,0,48,1,731,0,0,235466,591448,15.556349186104045,242,1215,1215,242,52704,596336,527904,2444,2686,2444,3417,3659,31.192947920964443,0.0,242,0,52272,0,973,0,2202,1471
14876,0,0,0,0,51,1,606,0,1,1658520,2626500,31.937438845342623,953,2713,2646,1020,55692,602550,612850,2508,3595,2642,4201,5288,40.32369030731191,8.299636160530056,1087,1,242760,8308,1626,0,1555,949
14877,0,0,0,0,51,1,553,1,0,1288940,2301360,29.866369046136157,807,2422,2337,892,54731,616620,590820,2495,3472,2665,4025,5002,38.01315561749642,9.220820253968727,977,1,204268,12155,1445,0,1688,1135
14878,0,0,0,0,51,1,524,1,0,660672,1527360,24.331050121192877,458,1842,1708,592,52341,616620,565020,2446,3172,2714,3696,4422,33.406586176980134,11.581634647011523,726,1,129648,21038,1116,0,1988,1464
14879,0,0,0,0,51,1,502,1,0,630888,1501560,24.124676163629637,455,1793,1666,582,52998,624360,565020,2453,3162,2707,3664,4373,32.92415526630866,11.30350933966113,709,1,127458,20193,1084,0,1998,1496
14880,0,0,0,0,54,1,25,1,0,3306786,4919544,42.49705872175156,1806,3637,3637,1806,49450,585660,626520,2724,4530,2724,4555,6361,42.790185790669334,0.0,1806,1,415380,0,1831,0,918,893
14881,0,0,0,0,56,1,473,1,0,4181490,6490260,47.90615826801394,1964,4448,4117,2295,43855,692860,506212,2497,5123,3159,4650,7276,42.68489194082609,18.249974133466164,2626,1,410805,67524,1822,0,533,1006
14882,0,0,0,0,50,1,393,1,0,803194,1836387,26.851443164195103,721,1835,1835,721,53820,595998,585810,2547,3268,2547,3661,4382,33.37663853655727,0.0,721,1,165830,0,1114,0,1826,1433
14883,0,0,0,0,59,1,1078,0,1,8084715,10147948,58.59180830116101,3102,6119,5788,3433,52320,709440,644408,2625,6389,3287,5311,9075,48.52834223420371,18.479510633051476,3764,1,748394,52629,2355,0,477,601
14884,0,0,0,0,53,1,153,1,0,2407510,3970176,38.43175770115127,1295,3289,3107,1477,51884,639744,585984,2506,4165,2870,4318,5977,40.3732584763727,13.493282342130057,1659,1,321986,28392,1630,0,1211,1058
14885,0,0,1,0,55,1,422,0,0,3127440,5569632,44.63182720884279,1962,3592,3562,1992,46830,623508,587160,2766,4788,2826,4366,6388,39.6232255123179,5.531194905403055,2022,1,418320,4530,1570,0,804,1226
14886,0,0,1,0,56,1,759,0,0,3946486,6826484,49.01020301937138,1982,4465,4045,2402,45156,605346,602504,2422,5244,3262,4485,7307,40.53393639902249,20.53793630882251,2822,1,509224,56700,1643,0,440,1199
14887,0,0,0,0,50,1,209,1,0,670530,1813315,26.851443164195103,679,1693,1651,721,45080,462760,616175,2473,3236,2557,3445,4208,30.495901363953813,6.570697549716149,763,1,176645,2142,930,0,1794,1585
14888,0,0,0,0,48,1,35,0,1,286454,1249934,22.759613353482084,518,1071,1071,518,48260,458470,612902,2413,2931,2413,2966,3484,23.515952032609693,0.0,518,1,131572,0,553,0,1895,1860
14889,0,0,0,0,47,1,17,0,1,272934,1231544,22.67156809750927,514,1045,1045,514,51308,483992,608584,2396,2910,2396,2927,3441,23.043437243605826,0.0,514,1,130556,0,531,0,1882,1865
14890,0,0,0,0,48,1,16,0,1,180561,1058685,20.808652046684813,313,970,850,433,27378,572130,286065,2325,2878,2565,2862,3415,20.42057785666214,11.489290135793457,553,1,50661,29040,417,0,2012,2028
14891,0,0,0,0,48,1,26,0,1,313431,1314988,23.388031127053,517,1150,1120,547,47752,451952,610616,2374,2951,2434,2977,3554,23.93741840717165,6.249099805534655,577,1,138938,1110,573,0,1857,1831
14892,0,0,0,0,48,1,162,0,1,0,0,0.0,124,286,162,0,55144,585600,542400,2276,2400,2524,2562,2686,12.727922061357855,11.137157851700797,124,1,0,18724,162,0,2400,2238
14893,0,0,0,0,47,1,8,1,0,358785,1436949,24.55605831561735,543,1258,1198,603,47200,476600,562388,2323,2986,2443,2978,3641,24.392621835300936,7.748117453886108,663,1,142308,5280,595,0,1780,1788
14894,0,0,1,0,57,1,1356,0,0,6594652,9615256,57.7408001330082,3239,5407,5312,3334,52070,732536,591220,2789,6218,2979,4862,8291,44.474711915874174,9.815189597405173,3429,1,683470,16720,1978,0,450,906
14895,0,0,0,0,48,1,19,1,0,424362,1589705,25.709920264364882,594,1370,1303,661,37296,404040,533910,2338,3066,2472,3047,3775,25.337718918639855,8.416522024785497,728,1,146742,4154,642,0,1744,1763
14896,0,0,0,0,47,1,94,0,1,3720,70920,5.477225575051661,12,196,154,30,52371,598092,489348,2322,2394,2406,2488,2560,11.135528725660043,6.609134537568676,72,1,6210,7392,124,0,2334,2240
14897,0,0,0,0,48,1,12,1,0,476064,1690584,26.38181191654584,588,1488,1380,696,35840,388640,544096,2321,3125,2537,3113,3917,26.153393661244042,10.8528199128497,804,1,155904,4968,684,0,1733,1745
14898,0,0,0,0,52,1,241,1,0,1869236,3311540,35.38361202590826,1051,2946,2745,1252,52864,624220,592480,2444,3897,2846,4138,5591,38.63935817272331,14.473434607486176,1453,1,280448,29547,1493,0,1393,1152
14899,0,0,0,0,47,1,175,0,0,16214,158321,8.18535277187245,67,309,309,67,50429,498593,564757,2363,2430,2363,2605,2672,15.556349186104045,0.0,67,0,16013,0,242,0,2296,2121
14900,0,0,0,0,54,1,684,1,0,2199520,5105496,43.174066289845804,1646,3262,3044,1864,55161,621753,665577,2521,4603,2957,3919,6001,34.351128074635334,14.90638655193511,2082,1,452952,23980,1180,0,875,1559
14901,0,0,0,0,47,1,173,0,0,54270,385560,12.727922061357855,162,497,497,162,48174,528360,516460,2380,2542,2380,2715,2877,18.303005217723125,0.0,162,0,35154,0,335,0,2218,2045
14902,0,0,0,0,52,1,131,0,1,1951512,3812256,38.262252939417984,1434,2827,2797,1464,47058,484344,658812,2574,4068,2634,3937,5431,36.51027252705737,5.5965095842615735,1494,1,370392,1110,1333,0,1140,1271
14903,0,0,0,0,48,1,8,1,0,538740,1770250,27.018512172212592,603,1595,1468,730,37975,424375,526225,2298,3155,2552,3163,4020,27.16615541441225,11.714665076908231,857,1,158410,10033,738,0,1695,1687
14904,0,0,0,0,48,1,32,0,1,27300,438984,13.490737563232042,2,512,332,182,40080,578880,402804,2232,2594,2592,2562,2924,12.24744871391589,13.763095854381014,362,1,30394,38160,150,0,2230,2262
14905,0,0,0,0,48,1,30,0,1,31104,460992,13.856406460551018,42,504,354,192,34602,569037,350546,2251,2593,2551,2563,2905,12.727922061357855,12.54961581009077,342,1,28032,33900,162,0,2209,2239
14906,0,0,0,0,51,1,98,1,0,1114848,2598624,31.74901573277509,874,2248,2114,1008,38805,513022,502710,2444,3586,2712,3684,4826,33.25657829663178,11.683282254829438,1142,1,196560,18492,1106,0,1570,1472
14907,0,0,0,0,49,1,10,1,0,729291,2121730,29.30870177950569,604,1963,1708,859,30336,390260,474240,2215,3329,2725,3319,4433,29.13760456866693,16.434268214661433,1114,1,164928,21420,849,0,1611,1621
14908,0,0,0,0,46,1,21,0,1,36180,420300,13.416407864998739,150,411,381,180,48608,579080,457660,2305,2515,2365,2536,2746,14.177446878757825,5.478746393072713,210,1,35280,5700,201,0,2155,2134
14909,0,0,0,0,56,1,1382,1,0,2926544,7171808,50.35871324805669,2451,3775,3690,2536,54970,650440,675892,2743,5364,2913,3982,6603,33.97057550292606,9.383858473517451,2621,1,606104,8670,1154,0,292,1674
14910,0,0,0,0,57,1,1457,1,0,3084990,7498130,51.28352561983234,2477,3956,3803,2630,48192,547392,715601,2698,5481,3004,4024,6807,34.249087579087416,12.639835959643802,2783,1,660130,8109,1173,0,221,1678
14911,0,0,0,0,52,1,439,0,1,1890876,4244396,40.149719799769464,1488,2909,2785,1612,50922,545031,647718,2509,4245,2757,3806,5542,34.249087579087416,11.515574071079046,1736,1,396552,10044,1173,0,1021,1460
14912,0,0,0,0,49,1,123,1,0,579150,1731834,26.49528259898354,512,1717,1527,702,29028,404588,436659,2277,3169,2657,3292,4184,28.722813232690143,13.838706257176828,892,1,124254,20900,825,0,1765,1642
14913,0,0,0,0,53,1,897,1,0,1888318,5085390,43.520110293977886,1767,3018,2891,1894,55388,609495,655140,2558,4579,2812,3682,5703,31.575306807693888,11.444189009687426,2021,1,462136,13716,997,0,791,1688
14914,0,0,0,0,56,1,1524,1,0,2912517,7450992,51.29327441292864,2507,3862,3738,2631,48888,549408,713664,2708,5463,2956,3939,6694,33.27160951922825,11.265233092802442,2755,1,663012,6572,1107,0,201,1725
14915,0,0,0,0,50,1,382,0,1,1865160,4001930,39.6232255123179,1540,2788,2758,1570,41832,642348,423134,2519,4119,2579,3737,5337,34.46737587922817,5.531194905403055,1600,1,260620,6420,1188,0,979,1361
14916,0,0,0,0,46,1,30,1,0,38584,426244,13.490737563232042,182,394,394,182,55647,569106,536318,2342,2524,2342,2554,2736,14.560219778561036,0.0,182,1,41678,0,212,0,2160,2130
14917,0,0,0,0,50,1,375,0,1,1890000,4011525,39.68626966596886,1480,2870,2775,1575,31440,611280,333657,2452,4122,2642,3747,5417,34.64101615137755,10.295171956693528,1670,1,206325,20900,1200,0,972,1347
14918,0,0,0,0,51,1,109,1,0,1241370,2728892,32.57299494980466,657,2635,2231,1061,46284,522116,586416,2168,3633,2976,3742,5207,34.20526275297414,20.10172132324973,1465,1,241908,42016,1170,0,1511,1402
14919,0,0,0,0,48,1,30,0,1,415800,1527750,25.099800796022265,630,1290,1290,630,53966,586850,540775,2425,3055,2425,3085,3715,25.69046515733026,0.0,630,1,140490,0,660,0,1795,1765
14920,0,0,0,0,54,1,1624,1,0,1234032,5920728,46.776062254106,2128,2812,2752,2188,47443,565554,614262,2646,4894,2766,3270,5518,23.748684174075834,7.759379671981613,2248,1,496676,6720,564,0,518,2142
14921,0,0,0,0,49,1,395,0,0,1610934,3656094,38.49675310984031,1482,2569,2569,1482,53130,624151,518070,2467,3949,2467,3554,5036,32.96968304366907,0.0,1482,0,311220,0,1087,0,985,1380
14922,0,0,0,0,54,1,1667,0,1,3477084,7888868,53.62835071116769,2876,4085,4085,2876,45287,693979,490997,2743,5619,2743,3952,6828,34.77067730142742,0.0,2876,1,514804,0,1209,0,133,1534
14923,0,0,0,0,51,1,36,0,1,1557180,3174630,35.07135583350036,1060,2666,2496,1230,51359,652993,523943,2411,3811,2751,3847,5247,35.58089374931439,13.490839382040427,1400,1,249690,29580,1266,0,1351,1315
14924,0,0,0,0,50,1,33,0,1,1634290,3277645,35.98610843089316,1133,2719,2557,1295,43516,640343,435332,2369,3826,2693,3793,5250,35.52463933666322,13.577862376145214,1457,1,222740,33372,1262,0,1236,1269
14925,0,0,0,0,50,1,104,0,1,1579860,3074094,34.72751070837067,1098,2624,2516,1206,50200,639799,509800,2441,3755,2657,3859,5173,36.193922141707716,10.62681426149494,1314,1,241200,18360,1310,0,1343,1239
14926,0,0,0,0,50,1,762,0,1,1047303,3744366,38.379682124790975,1473,2184,2184,1473,55647,617706,582118,2542,4015,2542,3253,4726,26.664583251946766,0.0,1473,1,337317,0,711,0,1069,1831
14927,0,0,0,0,50,1,676,0,1,1102365,3670227,37.960505792204614,1399,2248,2206,1441,54750,636750,557793,2505,3988,2589,3312,4795,27.65863337187866,6.570697549716149,1483,1,315579,6720,765,0,1106,1782
14928,0,0,0,0,53,1,1426,0,1,589935,4670172,41.96427051671457,1719,2138,2096,1761,56643,633828,628524,2610,4413,2694,2987,4790,18.303005217723125,6.488991180673202,1803,1,417357,5376,335,0,891,2317
14929,0,0,0,0,47,1,107,1,0,230910,1011790,20.73644135332772,388,1009,967,430,46168,468247,545896,2311,2783,2395,2890,3362,23.173260452512935,6.5252844928085345,472,1,99760,3906,537,0,1923,1816
14930,0,0,0,0,55,1,1590,0,1,4980136,8754788,56.24944444170093,2813,5089,4738,3164,30000,664080,345875,2416,5931,3118,4341,7856,39.67366884975475,19.276874771675395,3515,1,395500,81783,1574,0,397,1193
14931,0,0,0,0,53,1,1678,1,0,400680,5082210,43.474130238568314,1860,2132,2102,1890,54635,599647,658805,2659,4579,2719,2901,4821,14.560219778561036,5.5503012171862105,1920,1,463050,3060,212,0,799,2477
14932,0,0,0,0,50,1,446,1,0,984560,3121080,35.21363372331802,1180,2094,2034,1240,31659,435441,460611,2457,3757,2577,3311,4611,28.178005607210743,7.759379671981613,1300,1,226920,7020,794,0,1277,1723
14933,0,0,0,0,50,1,356,1,0,1031277,3030963,34.77067730142742,1167,2104,2062,1209,37492,456274,516442,2465,3716,2549,3360,4611,29.206163733020468,6.73127350780198,1251,1,249054,4284,853,0,1298,1654
14934,0,0,0,0,48,1,68,0,0,1244300,2618440,32.89376840679705,1082,2232,2232,1082,54934,585640,549340,2420,3502,2420,3570,4652,33.91164991562634,0.0,1082,0,245614,0,1150,0,1338,1270
14935,0,0,0,0,51,1,99,0,1,751842,2093364,28.61817604250837,389,2167,1737,819,56088,628776,582768,2126,3375,2986,3474,4723,30.298514815086232,21.608572411569206,1249,1,186732,61060,918,0,1737,1638
14936,0,0,0,0,54,1,1565,0,1,5040200,8566760,56.213877290220786,2859,5056,4755,3160,36556,669617,401228,2410,5871,3012,4306,7767,39.93745109543172,17.62647935057963,3461,1,467680,65919,1595,0,449,1116
14937,0,0,0,0,55,1,1575,0,1,4363900,8449960,54.954526656136345,2630,4855,4465,3020,56644,665924,665924,2408,5818,3188,4243,7653,38.01315561749642,20.626219908738804,3410,1,718760,47580,1445,0,222,1353
14938,0,0,0,0,52,1,1106,1,0,562815,3886245,38.535697735995385,1390,1959,1864,1485,55671,604527,630697,2522,4102,2712,2996,4576,19.467922333931785,9.76859066112806,1580,1,357885,11115,379,0,1132,2238
14939,0,0,0,0,50,1,194,0,1,960816,2227992,29.79932885150268,528,2330,1970,888,49352,622232,499291,2149,3397,2869,3591,4839,32.89376840679705,19.608165863723432,1248,1,176712,59040,1082,0,1621,1427
14940,0,0,0,0,49,1,360,0,1,1294704,2401812,31.176914536239792,797,2479,2304,972,55250,617750,546091,2296,3443,2646,3803,4950,36.49657518178932,13.688948077295926,1147,1,214812,27475,1332,0,1499,1139
14941,0,0,0,0,50,1,165,0,1,718246,1946339,27.730849247724095,379,2093,1703,769,53535,630219,544165,2141,3300,2921,3465,4624,30.56141357987225,20.50403060115154,1159,1,165335,60060,934,0,1762,1597
14942,0,0,0,0,48,1,301,0,1,1210560,2345280,30.983866769659336,875,2306,2221,960,45034,618079,434854,2358,3403,2528,3704,4749,35.510561809129406,9.67057657670449,1045,1,170880,17510,1261,0,1483,1182
14943,0,0,0,0,54,1,1536,0,1,2944576,7247576,51.45872132107443,2371,4037,3760,2648,53592,632247,634984,2460,5385,3014,3849,6774,33.34666400106613,17.075267028553355,2925,1,614336,36287,1112,0,89,1625
14944,0,0,0,0,52,1,1258,0,1,321768,3898116,38.41874542459709,1368,1802,1694,1476,54208,591584,639122,2533,4117,2749,2859,4443,14.7648230602334,10.669676460233537,1584,1,357192,11772,218,0,1165,2423
14945,0,0,0,0,51,1,1100,0,1,430236,3631698,37.49666651850535,1364,1754,1712,1406,40672,423612,640584,2541,3989,2625,2889,4337,17.4928556845359,6.63067838716079,1448,1,348688,0,306,0,1177,2277
14946,0,0,0,0,51,1,892,0,1,557984,3367644,36.27671429443411,1316,1740,1740,1316,55527,637191,570657,2559,3875,2559,2983,4299,20.591260281974,0.0,1316,1,293468,0,424,0,1243,2135
14947,0,0,0,0,50,1,211,0,1,836190,2615274,32.03123475609393,749,2118,1841,1026,50702,514898,639799,2272,3575,2826,3364,4667,28.548204847240395,16.828954222814524,1303,1,257526,18282,815,0,1523,1734
14948,0,0,0,0,48,1,271,0,1,943020,2028845,29.068883707497267,803,2003,1961,845,54656,537824,585844,2359,3246,2443,3517,4404,33.406586176980134,6.5252844928085345,887,1,206180,4410,1116,0,1556,1285
14949,0,0,0,0,52,1,1115,0,1,395634,3654372,37.389838191679836,1274,1805,1681,1398,56144,606448,632588,2490,4012,2738,2897,4419,16.822603841260722,11.247002231352543,1522,1,338316,14508,283,0,1216,2331
14950,0,0,0,0,47,1,630,0,1,245344,639472,16.492422502470642,5,1451,1174,272,51750,486657,587750,2074,2623,2628,3253,3802,30.033314835362415,16.95591470437829,549,1,68000,20498,902,0,2079,1449
14951,0,0,0,0,50,1,678,0,1,610983,3013230,34.51086785347479,1161,1734,1704,1191,44022,640090,440220,2500,3721,2560,3043,4264,22.64950330581225,5.478746393072713,1221,1,207234,6180,513,0,1339,2017
14952,0,0,0,0,47,1,413,1,0,876080,1801792,27.422618401604176,752,1917,1917,752,46487,548684,486388,2396,3148,2396,3561,4313,34.132096331752024,0.0,752,1,152656,0,1165,0,1644,1231
14953,0,0,0,0,48,1,306,0,1,677160,1646388,26.153393661244042,599,1759,1674,684,50851,580087,507877,2322,3091,2492,3397,4166,31.464265445104548,9.219544457292887,769,1,144324,14195,990,0,1723,1417
14954,0,0,0,0,50,1,698,0,1,593915,3007815,34.56877203488721,1195,1692,1692,1195,55680,583944,604080,2517,3712,2517,3014,4209,22.293496809607955,0.0,1195,1,286800,0,497,0,1322,2020
14955,0,0,0,0,48,1,415,1,0,826500,1741450,26.92582403567252,695,1895,1865,725,44268,521234,490008,2372,3127,2432,3542,4297,33.76388603226827,5.623413251903491,755,1,147900,4500,1140,0,1677,1262
14956,0,0,0,0,49,1,174,1,0,807840,2013888,28.5657137141714,626,1996,1806,816,42588,449176,577512,2278,3284,2658,3458,4464,31.464265445104548,14.279423560316674,1006,1,190944,12350,990,0,1652,1478
14957,0,0,0,0,50,1,433,0,1,671384,2694048,32.61901286060018,974,1785,1695,1064,41917,635532,422844,2442,3596,2622,3163,4317,25.11971337416094,9.52871847115494,1154,1,177688,18630,631,0,1468,1901
14958,0,0,0,0,47,1,382,0,0,608328,1446156,24.73863375370596,612,1606,1606,612,55822,583661,534038,2363,2975,2363,3357,3969,31.52776554086889,0.0,612,0,138312,0,994,0,1751,1369
14959,0,0,0,0,54,1,1424,0,1,2937792,6956712,50.67543783727971,2312,3968,3712,2568,55596,666414,612234,2453,5277,2965,3853,6677,33.823069050575526,16.611557267908257,2824,1,580368,38656,1144,0,141,1565
14960,0,0,0,0,50,1,1348,0,1,800124,4515498,42.35563716909474,1794,2240,2240,1794,50292,639318,498366,2517,4311,2517,2963,4757,21.118712081942874,0.0,1794,1,355212,0,446,0,723,2071
14961,0,0,0,0,50,1,318,0,1,687055,2532575,31.670175244226233,918,1773,1688,1003,44528,638825,444400,2440,3528,2610,3210,4298,26.1725046566048,9.53016293865306,1088,1,176528,17595,685,0,1522,1840
14962,0,0,0,0,51,1,23,0,1,736890,2219370,29.49576240750525,636,1951,1717,870,54780,561220,635199,2317,3421,2785,3398,4502,29.103264421710495,15.601376800644807,1104,1,216630,19422,847,0,1681,1704
14963,0,0,0,0,47,1,397,0,1,535920,1322720,23.664319132398465,530,1547,1517,560,48112,458228,585776,2332,2922,2392,3319,3909,30.93541659651604,5.5503012171862105,590,1,138880,1830,957,0,1802,1405
14964,0,0,0,0,51,1,1853,1,0,3566310,7850730,55.04543577809154,2963,4274,4207,3030,47916,513018,627022,2524,5621,2658,3768,6865,34.307433596816885,8.19263674150144,3097,1,733260,5092,1177,0,439,1414
14965,0,0,0,0,53,1,1623,0,1,3049018,7283157,52.316345438113316,2652,3936,3851,2737,34545,651945,375201,2576,5398,2746,3775,6597,33.37663853655727,10.06192246325636,2822,1,385917,19465,1114,0,76,1547
14966,0,0,0,0,53,1,1379,0,1,1758120,5802888,46.73328578219169,1875,3298,2989,2184,52002,568598,645651,2348,4841,2966,3462,5955,28.372521918222215,18.021608862150686,2493,1,530712,29973,805,0,473,1852
14967,0,0,0,0,51,1,1363,1,0,1305788,5196996,44.85532298401161,1842,2831,2661,2012,46937,483021,648333,2413,4595,2753,3232,5414,25.475478405713993,13.113990339086167,2182,1,505012,7480,649,0,571,1934
14968,0,0,0,0,47,1,408,0,1,513409,1287580,23.259406699226016,481,1550,1490,541,46563,445060,592620,2320,2921,2440,3329,3930,30.805843601498726,8.06225774829855,601,1,134709,2940,949,0,1839,1431
14969,0,0,0,0,51,1,1876,1,0,3471552,7850304,54.99090833947008,2939,4257,4172,3024,44650,493240,610060,2511,5620,2681,3744,6853,33.88214869219483,9.2729914971827,3109,1,710640,6375,1148,0,428,1448
14970,0,0,0,0,51,1,1341,0,1,1404112,5275072,45.077710678338576,1820,2935,2723,2032,46116,475068,654192,2384,4628,2808,3287,5531,26.28687885618983,14.68187375456548,2244,1,512064,7420,691,0,564,1905
14971,0,0,0,0,51,1,1327,1,0,1202010,5000595,44.10215414239989,1795,2713,2563,1945,56165,614469,604185,2421,4516,2721,3189,5284,24.859605789312106,12.449381359612769,2095,1,457075,20100,618,0,626,1953
14972,0,0,0,0,50,1,1308,1,0,1026720,4703940,43.12771730569565,1770,2502,2412,1860,48000,485568,632250,2439,4389,2619,3081,5031,23.49468024894146,9.522065445080457,1950,1,465000,4860,552,0,669,1977
14973,0,0,0,0,49,1,447,0,1,658170,2655045,32.63433774416144,1035,1713,1683,1065,53460,548460,605799,2463,3558,2523,3111,4206,24.859605789312106,5.477225575051661,1095,1,258795,3090,618,0,1428,1875
14974,0,0,0,0,48,1,442,0,1,587963,1399802,24.020824298928627,376,1797,1596,577,50668,514312,579814,2225,3003,2627,3445,4223,31.921779399024736,14.250658389083577,778,1,137903,19899,1019,0,1849,1407
14975,0,0,0,0,47,1,395,0,0,440550,1163250,22.24859546128699,495,1385,1385,495,53536,526400,561650,2350,2845,2350,3240,3735,29.832867780352597,0.0,495,0,118305,0,890,0,1855,1460
14976,0,0,0,0,50,1,819,0,1,605830,3222500,35.90264614203248,1289,1759,1759,1289,53212,627500,530000,2500,3789,2500,2970,4259,21.6794833886788,0.0,1289,1,273268,0,470,0,1211,2030
14977,0,0,0,0,48,1,458,1,0,605280,1423572,24.124676163629637,340,1864,1622,582,45120,469632,574810,2204,3028,2688,3486,4310,32.2490309931942,15.713399221972097,824,1,136770,18876,1040,0,1864,1406
14978,0,0,0,0,51,1,1882,1,0,3166688,7641998,54.35071296680477,2869,4111,4026,2954,49560,543270,610532,2502,5541,2672,3659,6698,32.7414110874898,9.227509513928014,3039,1,697144,8670,1072,0,367,1515
14979,0,0,0,0,53,1,1315,0,1,1916250,5803500,46.79743582719036,1918,3337,3065,2190,55695,622750,628050,2378,4840,2922,3525,5987,29.58039891549808,17.3137683897897,2462,1,519030,30736,875,0,460,1775
14980,0,0,0,0,50,1,1156,0,1,795885,4112346,40.50925820105819,1611,2156,2126,1641,52371,634018,518742,2476,4147,2536,2991,4662,22.02271554554524,5.501408174353464,1671,1,339687,5340,485,0,865,2021
14981,0,0,0,0,47,1,384,0,1,214137,726459,17.578395831246947,219,1092,1002,309,51660,493710,578346,2261,2660,2441,3044,3443,26.324893162176366,9.497356383238309,399,1,76014,7740,693,0,2042,1658
14982,0,0,0,0,46,1,428,0,1,203205,665190,16.881943016134134,255,1028,998,285,54960,534486,560160,2304,2619,2364,3047,3362,26.70205984563738,5.477225575051661,315,1,68400,3540,713,0,2049,1621
14983,0,0,0,0,50,1,1161,0,1,1073176,4469504,42.04759208325728,1660,2483,2375,1768,40275,452512,568800,2420,4296,2636,3135,5011,24.63736998950984,10.640744280253392,1876,1,397800,7992,607,0,760,1921
14984,0,0,0,0,49,1,399,0,1,700660,2640460,32.55764119219941,926,1855,1721,1060,56386,602822,580403,2357,3551,2625,3152,4346,25.709920264364882,11.577287155571419,1194,1,246980,18224,661,0,1431,1830
14985,0,0,0,0,51,1,1417,0,1,2281920,6175446,48.75448697299562,2227,3487,3337,2377,49088,613128,540384,2448,4975,2748,3558,6085,30.983866769659336,12.932914451756053,2527,1,494416,19650,960,0,221,1638
14986,0,0,0,0,49,1,1005,0,1,861574,3848260,39.4715087119811,1558,2111,2111,1558,55575,610090,555750,2470,4028,2470,3023,4581,23.515952032609693,0.0,1558,1,350550,0,553,0,912,1917
14987,0,0,0,0,49,1,740,0,1,728000,3231800,36.05551275463989,1240,1920,1860,1300,56088,566808,611556,2426,3786,2546,3046,4406,23.664319132398465,7.759379671981613,1360,1,319800,5880,560,0,1186,1926
14988,0,0,0,0,50,1,167,0,1,699468,1893257,27.51363298439521,637,1801,1681,757,51706,627751,515206,2381,3258,2621,3425,4302,30.397368307141328,11.15593165433301,877,1,155942,21600,924,0,1744,1577
14989,0,0,0,0,49,1,771,0,1,777796,3337648,36.71511950137164,1281,1992,1925,1348,55304,614048,552148,2409,3824,2543,3053,4468,24.020824298928627,8.20759886765899,1415,1,300604,9849,577,0,1128,1899
14990,0,0,0,0,49,1,201,0,1,698022,1849536,27.2213151776324,646,1778,1683,741,50652,628992,501696,2401,3237,2591,3438,4274,30.692018506445613,10.115242524801646,836,1,148941,17575,942,0,1755,1554
14991,0,0,0,0,49,1,906,1,0,918391,3737110,38.897300677553446,1483,2150,2120,1513,52560,592800,540930,2440,3983,2500,3077,4620,24.63736998950984,5.477225575051661,1543,1,331347,4710,607,0,957,1863
14992,0,0,0,0,49,1,10,0,1,729291,2120012,29.30870177950569,829,1738,1708,859,52430,528152,604660,2438,3327,2498,3317,4206,29.13760456866693,5.490867587491313,889,1,210455,2760,849,0,1609,1619
14993,0,0,0,0,50,1,1564,0,1,2081357,6166535,49.22397789695587,2381,3324,3282,2423,52576,631160,539540,2503,4968,2587,3404,5869,29.30870177950569,6.78953034358522,2465,1,513676,6426,859,0,122,1686
14994,0,0,0,0,49,1,696,0,1,847152,3267396,36.49657518178932,1302,1998,1968,1332,56153,591173,571549,2423,3785,2483,3089,4451,25.219040425836983,5.490867587491313,1362,1,310356,3840,636,0,1121,1817
14995,0,0,0,0,49,1,390,0,1,782811,2712864,33.18132004607411,1059,1854,1812,1101,48768,625856,473088,2422,3565,2506,3175,4318,26.664583251946766,7.066112858657135,1143,1,211392,8064,711,0,1363,1753
14996,0,0,0,0,49,1,859,0,1,1026630,3782160,39.11521443121589,1488,2243,2201,1530,53088,553728,585864,2430,4002,2514,3143,4715,25.903667693977237,6.503581472166948,1572,1,362610,4956,671,0,942,1801
14997,0,0,0,0,50,1,1783,1,0,2002484,6466408,50.635955604688654,2504,3405,3345,2564,44472,514488,549796,2462,5086,2582,3303,5927,27.94637722496424,7.83531632499182,2624,1,558952,7080,781,0,42,1741
14998,0,0,0,0,49,1,716,0,1,970140,3458760,37.49666651850535,1406,2096,2096,1406,49950,546120,553500,2460,3866,2460,3150,4556,26.267851073127396,0.0,1406,1,316350,0,690,0,1054,1770
14999,0,0,0,0,50,1,1870,1,0,1968371,6662582,51.19570294468082,2526,3467,3372,2621,38709,475354,526194,2447,5163,2637,3293,6009,27.40437921208944,9.756499634156611,2716,1,542547,10260,751,0,79,1791
15000,0,0,0,0,50,1,951,0,1,1413580,4418096,41.90465367951393,1661,2656,2561,1756,56876,606356,593776,2421,4272,2611,3321,5172,28.372521918222215,9.799287634083276,1851,1,414416,12160,805,0,760,1711
15001,0,0,0,0,50,1,1773,1,0,1814274,6344961,49.98999899979995,2414,3310,3225,2499,38610,502722,495105,2454,5038,2624,3265,5849,26.94438717061496,9.265143265380413,2584,1,487305,11560,726,0,40,1813
15002,0,0,0,0,49,1,730,0,1,1121175,3662010,38.535697735995385,1485,2240,2240,1485,52122,586908,540054,2466,3951,2466,3221,4706,27.477263328068172,0.0,1485,1,325215,0,755,0,981,1711
15003,0,0,0,0,48,1,123,0,1,845380,2394588,31.352830813181765,941,1885,1843,983,48076,492072,579768,2394,3419,2478,3296,4321,29.32575659723036,6.481658975540136,1025,1,233954,3696,860,0,1453,1576
15004,0,0,0,0,48,1,105,1,0,863074,2131784,29.631064780058107,878,1861,1861,878,44408,592432,441896,2428,3306,2428,3411,4289,31.352830813181765,0.0,878,1,159796,0,983,0,1550,1445
15005,0,0,0,0,47,1,501,0,1,114070,400860,13.038404810405298,0,1011,841,170,55125,530550,577710,2188,2528,2528,3029,3369,25.903667693977237,13.174427865266022,340,1,41650,17850,671,0,2188,1687
15006,0,0,0,0,48,1,225,1,0,847600,1986155,28.548204847240395,785,1885,1855,815,51940,597065,516644,2407,3252,2467,3477,4322,32.2490309931942,5.477225575051661,845,1,172780,5100,1040,0,1622,1397
15007,0,0,0,0,47,1,512,0,1,143313,476370,14.177446878757825,26,1089,914,201,53599,514290,585390,2195,2571,2545,3083,3459,26.70205984563738,13.470838687753037,376,1,49647,16100,713,0,2169,1657
15008,0,0,0,0,49,1,1049,1,0,1675112,4789053,43.829214001622255,1831,2883,2793,1921,40788,493614,513558,2403,4414,2583,3365,5376,29.5296461204668,9.491514370027666,2011,1,395726,11250,872,0,572,1621
15009,0,0,0,0,50,1,889,1,0,1724802,4617782,42.790185790669334,1746,2858,2773,1831,37925,466570,517010,2437,4353,2607,3464,5380,30.692018506445613,9.370214040084857,1916,1,375355,9095,942,0,691,1580
15010,0,0,0,0,50,1,835,1,0,1739766,4527714,42.43819034784589,1734,2834,2767,1801,38745,475146,515370,2447,4315,2581,3480,5348,31.080540535840107,8.2732738280919,1868,1,369205,7504,966,0,713,1548
15011,0,0,0,0,48,1,441,0,1,785862,1668744,26.324893162176366,663,1857,1827,693,47530,467152,589960,2378,3101,2438,3542,4265,33.67491648096547,5.514871952411144,723,1,169785,2010,1134,0,1715,1274
15012,0,0,0,0,50,1,1327,1,0,1538010,5243310,45.4972526643093,1920,2963,2813,2070,34390,458473,481270,2383,4603,2683,3276,5496,27.258026340878022,12.68159626954734,2220,1,393300,17850,743,0,463,1790
15013,0,0,0,0,50,1,613,1,0,1477320,3921840,39.496835316262995,1470,2597,2507,1560,38208,500286,482688,2424,4074,2604,3461,5111,30.773365106858236,9.65116822864259,1650,1,299520,12690,947,0,954,1567
15014,0,0,0,0,51,1,1934,0,1,1311912,6401736,49.658836071740545,2104,3360,2998,2466,45684,630828,488048,2234,5062,2958,3128,5956,23.065125189341593,19.222021996786484,2828,1,463608,70590,532,0,130,2064
15015,0,0,0,0,52,1,1938,0,1,1260328,6387460,49.51767361255979,2117,3301,2966,2452,45795,554865,560075,2270,5057,2940,3119,5906,22.67156809750927,18.546178948106043,2787,1,527180,44555,514,0,153,2091
15016,0,0,0,0,50,1,702,1,0,1723680,4333140,41.352146256270665,1590,2838,2718,1710,32400,456120,456120,2414,4244,2654,3542,5372,31.74901573277509,11.167976299283184,1830,1,307800,15360,1008,0,824,1526
15017,0,0,0,0,50,1,533,1,0,1450500,3781500,38.72983346207417,1366,2601,2467,1500,41412,511763,514284,2387,4021,2655,3488,5122,31.096623610932426,11.727705886231366,1634,1,306000,17688,967,0,1021,1554
15018,0,0,0,0,51,1,1879,0,1,1432302,6324770,49.60846701924985,2085,3419,3043,2461,51500,642500,529420,2194,5031,2946,3152,5989,24.124676163629637,19.56130731457345,2837,1,506966,68056,582,0,109,1988
15019,0,0,0,0,52,1,1935,0,1,1073250,6224850,48.83646178829912,2023,3197,2835,2385,53592,602910,605520,2248,4995,2972,3060,5807,21.213203435596427,19.326347233173056,2747,1,553320,47422,450,0,225,2160
15020,0,0,0,0,49,1,312,0,1,971668,2090686,29.017236257093817,662,2176,1996,842,39155,509015,474253,2303,3325,2663,3637,4659,33.97057550292606,13.719158219336459,1022,1,160822,27000,1154,0,1641,1329
15021,0,0,0,0,50,1,206,1,0,1334991,3206757,35.53871128783372,924,2659,2320,1263,41256,548424,484949,2200,3802,2878,3596,5198,32.51153641401772,18.57386350768938,1602,1,241233,55257,1057,0,1276,1482
15022,0,0,0,0,51,1,1268,1,0,1420544,5126656,44.54211490264017,1707,2977,2700,1984,40200,516800,519384,2307,4568,2861,3300,5561,26.758176320519304,17.1125053421481,2261,1,398784,36564,716,0,600,1868
15023,0,0,0,0,52,1,1853,0,1,946590,5936050,47.644516998286385,1879,3078,2687,2270,47385,635445,509925,2224,4885,3006,3032,5693,20.42057785666214,20.37911477969389,2661,1,442650,73117,417,0,345,2198
15024,0,0,0,0,52,1,947,1,0,1551354,4697406,42.49705872175156,1534,2937,2665,1806,44702,535806,564417,2329,4407,2873,3460,5538,29.30870177950569,17.033687642810225,2078,1,391902,32912,859,0,795,1742
15025,0,0,0,0,51,1,485,1,0,1695494,4038159,39.585350825778974,1297,2919,2649,1567,40560,502515,536016,2307,4144,2847,3659,5496,32.89376840679705,16.8425230770233,1837,1,325936,31590,1082,0,1010,1495
15026,0,0,0,0,48,1,457,0,1,482880,1221284,22.427661492005804,413,1553,1463,503,56404,573008,580292,2338,2931,2518,3388,3981,30.983866769659336,9.808573176892017,593,1,120217,11250,960,0,1925,1468
15027,0,0,0,0,47,1,446,0,1,261635,790600,18.303005217723125,275,1176,1116,335,53676,502680,594720,2300,2695,2420,3141,3536,27.94637722496424,7.9332512824338455,395,1,84420,4320,781,0,2025,1579
15028,0,0,0,0,46,1,442,0,1,232059,724914,17.578395831246947,279,1090,1060,309,55000,516120,586500,2316,2655,2376,3097,3436,27.40437921208944,5.514871952411144,339,1,77250,2610,751,0,2037,1595
15029,0,0,0,0,51,1,1917,0,1,862168,5915940,47.885279575251516,1922,3040,2669,2293,45034,652740,459240,2209,4873,2951,2956,5620,19.390719429665317,19.693330879883774,2664,1,408154,76426,376,0,287,2204
15030,0,0,0,0,48,1,457,0,1,834210,1732590,26.70205984563738,618,1978,1883,713,45750,444690,607500,2335,3143,2525,3600,4408,34.20526275297414,10.21168317809702,808,1,178250,3800,1170,0,1717,1260
15031,0,0,0,0,52,1,803,1,0,1585160,4495307,41.50903516103452,1423,2943,2643,1723,45144,563544,545281,2309,4332,2909,3529,5552,30.331501776206203,17.322865108115078,2023,1,360107,42900,920,0,886,1689
15032,0,0,0,0,46,1,409,0,1,256842,801648,18.49324200890693,312,1123,1093,342,48024,485208,543808,2314,2686,2374,3095,3467,27.40437921208944,5.572104574801163,372,1,79344,3060,751,0,2002,1593
15033,0,0,0,0,52,1,1164,0,1,1411605,4968240,43.64630568559039,1526,3025,2646,1905,38363,592016,440752,2229,4513,2987,3349,5633,27.2213151776324,19.851638565211402,2284,1,321945,74663,741,0,703,1867
15034,0,0,0,0,52,1,816,1,0,1573297,4516105,41.557189510360296,1450,2915,2638,1727,46428,572685,554380,2338,4342,2892,3526,5530,30.18277654557314,16.652473881125413,2004,1,366124,39611,911,0,888,1704
15035,0,0,0,0,52,1,523,1,0,1664790,4104378,39.72404813208241,1366,2845,2633,1578,44702,535806,564417,2389,4179,2813,3656,5446,32.48076353782343,14.560219778561036,1790,1,342426,25652,1055,0,1023,1546
15036,0,0,0,0,50,1,1934,0,1,560640,5582310,46.79743582719036,1867,2769,2446,2190,53500,637250,545486,2226,4739,2872,2805,5318,16.0,18.31868267314312,2513,1,468660,51034,256,0,359,2293
15037,0,0,0,0,51,1,116,0,1,1658157,3467178,36.701498607005135,1119,2806,2578,1347,45760,566280,535392,2346,3921,2802,3805,5380,35.08560958569767,15.137937485589164,1575,1,280176,33972,1231,0,1227,1343
15038,0,0,0,0,50,1,1937,0,1,450870,5423322,46.33573135281238,1805,2699,2357,2147,54692,611292,570876,2184,4673,2868,2736,5225,14.491376746189438,18.673368975059056,2489,1,485222,44802,210,0,379,2316
15039,0,0,0,0,51,1,1849,0,1,588902,5485080,46.10856753359401,1766,2763,2403,2126,40913,647580,420540,2220,4706,2940,2857,5343,16.64331697709324,19.78777073987115,2486,1,346538,77040,277,0,454,2303
15040,0,0,0,0,52,1,783,0,1,1577268,4475754,41.31585652022719,1495,2843,2631,1707,49056,587328,574218,2410,4329,2834,3546,5465,30.397368307141328,14.59250857348724,1919,1,373833,29892,924,0,915,1698
15041,0,0,0,0,47,1,372,0,1,451213,1220779,22.60530911091463,444,1461,1394,511,56133,551859,580527,2322,2900,2456,3272,3850,29.715315916207253,8.345174736691893,578,1,124173,7504,883,0,1878,1506
15042,0,0,0,0,49,1,1917,0,1,274834,5111092,45.28796749689701,1766,2470,2185,2051,41500,623000,413672,2207,4543,2777,2626,4962,11.575836902790225,17.103868119025655,2336,1,340466,58140,134,0,441,2358
15043,0,0,0,0,47,1,292,0,0,343500,1079048,21.400934559032695,458,1208,1208,458,52896,537168,546592,2356,2814,2356,3106,3564,27.386127875258307,0.0,458,0,106256,0,750,0,1898,1606
15044,0,0,0,0,49,1,1929,0,1,219996,5080278,45.13313638558703,1825,2357,2145,2037,56619,581102,606042,2282,4531,2706,2602,4851,10.392304845413264,14.743339197993663,2249,1,494991,23320,108,0,457,2386
15045,0,0,0,0,52,1,1159,0,1,1291080,4863810,43.069710934716056,1520,2886,2551,1855,46986,645012,500802,2287,4477,2957,3318,5508,26.38181191654584,18.316201395491056,2190,1,354305,64990,696,0,767,1926
15046,0,0,0,0,52,1,1078,0,1,1383915,4826289,42.81354925721529,1556,2865,2588,1833,53100,621388,592425,2356,4466,2910,3388,5498,27.477263328068172,16.688736125797796,2110,1,412425,40442,755,0,800,1878
15047,0,0,0,0,49,1,1852,0,1,266124,4943154,44.56455991031439,1774,2332,2120,1986,47188,624739,467932,2277,4475,2701,2623,4821,11.575836902790225,14.871544504108725,2198,1,373368,38584,134,0,503,2355
15048,0,0,0,0,52,1,730,0,1,1622400,4415970,41.10960958218893,1630,2710,2650,1690,52640,585312,614055,2553,4303,2673,3573,5323,30.983866769659336,7.789174875971784,1750,1,397150,7200,960,0,923,1653
15049,0,0,0,0,51,1,261,0,1,1753200,3767919,38.22302970723278,1431,2691,2661,1461,53775,580275,616381,2549,4040,2609,3779,5270,34.64101615137755,5.501408174353464,1491,1,349179,3450,1200,0,1118,1379
15050,0,0,0,0,50,1,256,0,1,1771185,3067233,34.77067730142742,1089,2794,2674,1209,56168,603806,598732,2417,3746,2657,4002,5331,38.27531841800928,10.97739094653235,1329,1,285324,15720,1465,0,1328,1072
15051,0,0,0,0,49,1,387,0,1,1309318,2391391,31.096623610932426,877,2411,2321,967,52877,516857,625669,2383,3440,2563,3827,4884,36.796738985948195,9.535934250532243,1057,1,244651,5760,1354,0,1506,1119
15052,0,0,0,0,49,1,385,0,1,1467246,2572592,32.155870381627054,967,2520,2453,1034,52459,519992,624488,2421,3522,2555,3907,5008,37.66961640367472,8.521468497772455,1101,1,259534,4154,1419,0,1454,1069
15053,0,0,0,0,47,1,268,1,0,531125,1453765,24.63736998950984,512,1577,1482,607,24505,404755,347275,2300,3002,2490,3270,3972,29.58039891549808,9.937924380926386,702,1,88015,14250,875,0,1788,1520
15054,0,0,0,0,51,1,166,0,1,1796760,3657690,37.76241517699841,1426,2686,2686,1426,54960,587385,615600,2565,3991,2565,3825,5251,35.4964786985977,0.0,1426,1,342240,0,1260,0,1139,1305
15055,0,0,0,0,49,1,1571,1,0,706640,4762560,44.0,1894,2343,2301,1936,46221,533820,523980,2418,4396,2502,2825,4803,19.1049731745428,6.481658975540136,1978,1,412368,5838,365,0,524,2095
15056,0,0,0,0,52,1,1111,0,1,1103952,4546608,41.7612260356422,1368,2753,2377,1744,54366,641322,576147,2231,4351,2983,3240,5360,25.15949125081825,20.56934849168123,2120,1,385424,59784,633,0,863,1974
15057,0,0,0,0,47,1,320,1,0,950544,1984716,28.77498913987632,798,2006,1976,828,42750,455430,539325,2367,3225,2427,3545,4403,33.88214869219483,5.490867587491313,858,1,186300,2670,1148,0,1569,1249
15058,0,0,0,0,48,1,1628,0,0,482304,4581888,43.40506882842141,1854,2170,2140,1884,55696,573952,573952,2402,4316,2462,2688,4602,16.0,5.5965095842615735,1914,0,444624,3900,256,0,548,2176
15059,0,0,0,0,48,1,1562,0,1,376088,4303724,42.118879377305376,1774,1986,1986,1774,54587,599222,536146,2426,4200,2426,2638,4412,14.560219778561036,0.0,1774,1,392054,0,212,0,652,2214
15060,0,0,0,0,51,1,1130,0,1,946400,4328090,41.10960958218893,1435,2505,2250,1690,46872,645372,476346,2306,4251,2816,3121,5066,23.664319132398465,17.170825351091562,1945,1,314340,47430,560,0,871,2001
15061,0,0,0,0,49,1,197,1,0,541604,1597764,25.37715508089904,402,1727,1485,644,39576,506124,481314,2239,3125,2723,3322,4208,29.0,16.36871080859975,886,1,124936,35090,841,0,1837,1640
15062,0,0,0,0,48,1,1530,0,0,377136,4228812,41.78516483155236,1746,1962,1962,1746,51623,598234,506198,2422,4168,2422,2638,4384,14.696938456699069,0.0,1746,0,364914,0,216,0,676,2206
15063,0,0,0,0,48,1,1510,0,0,408096,4225712,41.7612260356422,1744,1978,1978,1744,54934,586366,550021,2423,4167,2423,2657,4401,15.297058540778355,0.0,1744,0,395888,0,234,0,679,2189
15064,0,0,0,0,48,1,1431,0,0,519300,4187289,41.60528812542944,1731,2031,2031,1731,49276,614426,469286,2419,4150,2419,2719,4450,17.320508075688775,0.0,1731,0,335814,0,300,0,688,2119
15065,0,0,0,0,52,1,730,0,1,1294800,4060680,39.496835316262995,1263,2687,2390,1560,54216,653353,562248,2306,4163,2900,3433,5290,28.809720581775867,17.233687939614086,1857,1,336960,48114,830,0,1043,1773
15066,0,0,0,0,48,1,280,0,1,1091316,2227418,30.23243291566195,764,2258,2108,914,42228,504459,497148,2287,3351,2587,3631,4695,34.55430508634199,12.250849366392371,1064,1,186456,20550,1194,0,1523,1243
15067,0,0,0,0,49,1,230,0,1,908375,2071095,29.068883707497267,644,2121,1920,845,41768,556377,450984,2250,3296,2652,3526,4572,32.78719262151,14.391857620917467,1046,1,155480,36783,1075,0,1606,1376
15068,0,0,0,0,48,1,1451,1,0,460692,4204674,41.46082488325576,1652,2054,1987,1719,36040,415820,518552,2379,4165,2513,2714,4500,16.3707055437449,8.2732738280919,1786,1,364428,5226,268,0,727,2178
15069,0,0,0,0,51,1,868,0,1,1102140,4011350,39.6232255123179,1328,2514,2272,1570,42500,638750,434350,2313,4125,2797,3257,5069,26.49528259898354,16.64656967921078,1812,1,266900,47916,702,0,985,1853
15070,0,0,0,0,50,1,788,0,1,1096925,3817299,38.897300677553446,1323,2428,2238,1513,45682,633273,459186,2333,4036,2713,3248,4951,26.92582403567252,14.972964030462668,1703,1,275366,35530,725,0,1010,1798
15071,0,0,0,0,49,1,1246,1,0,560547,3931814,39.96248240537617,1477,2068,1948,1597,41944,482552,526868,2342,4059,2582,2813,4530,18.734993995195193,11.232917923179112,1717,1,341758,13440,351,0,865,2111
15072,0,0,0,0,49,1,88,0,1,1732553,3165951,35.679125549822544,1033,2874,2634,1273,52164,626724,514809,2247,3760,2727,3848,5361,36.89173349139343,15.744173612522722,1513,1,263511,40320,1361,0,1214,1126
15073,0,0,0,0,48,1,942,0,1,874368,3694812,38.961519477556315,1488,2124,2094,1518,37297,601198,367534,2404,3952,2464,3010,4558,24.0,6.148342568763683,1548,1,229218,6360,576,0,916,1858
15074,0,0,0,0,49,1,909,0,1,905400,3701577,38.84584919911006,1467,2151,2109,1509,42160,608344,417010,2411,3962,2495,3053,4604,24.49489742783178,7.308452739417186,1551,1,256530,8106,600,0,944,1853
15075,0,0,0,0,48,1,383,0,1,1899600,2916000,34.64101615137755,944,3039,2783,1200,56105,556470,595350,2174,3630,2686,4013,5469,39.786932528155525,16.21534010968369,1456,1,294000,25856,1583,0,1230,847
15076,0,0,0,0,48,1,331,0,1,1599510,2680650,33.31666249791537,768,2893,2551,1110,46376,598920,451605,2073,3525,2757,3856,5308,37.960505792204614,18.583648574695868,1452,1,207570,68058,1441,0,1305,974
15077,0,0,0,0,50,1,992,1,0,864900,3912200,39.370039370059054,1520,2138,2108,1550,39246,469464,532564,2494,4074,2554,3082,4662,23.62202362203543,5.501408174353464,1580,1,327050,3060,558,0,974,1966
15078,0,0,0,0,49,1,82,0,1,1397808,3056328,34.9857113690718,984,2606,2366,1224,51600,599280,536855,2257,3721,2737,3639,5103,33.793490497431605,16.032129653376607,1464,1,263160,32400,1142,0,1273,1355
15079,0,0,0,0,48,1,367,0,1,1723278,2763640,33.793490497431605,952,2841,2651,1142,55912,583220,561440,2230,3562,2610,3929,5261,38.84584919911006,14.016733822252778,1332,1,264944,24320,1509,0,1278,911
15080,0,0,0,0,49,1,883,1,0,752780,3519105,37.61648574760805,1160,2202,1947,1415,36765,425277,534705,2232,3902,2742,3019,4689,23.065125189341593,16.338816522758744,1670,1,304225,19125,532,0,1072,1955
15081,0,0,0,0,47,1,573,0,0,1023570,3199158,36.578682316343766,1308,2133,2103,1338,52750,597750,504501,2361,3729,2421,3156,4524,27.65863337187866,5.531194905403055,1368,0,282318,5220,765,0,1053,1626
15082,0,0,0,0,48,1,748,1,0,844188,3327576,36.959437225152655,1191,2159,1984,1366,40950,443352,548100,2261,3802,2611,3054,4595,24.859605789312106,13.31865546831378,1541,1,307350,13650,618,0,1070,1818
15083,0,0,0,0,51,1,775,1,0,945006,3711192,37.86819245752297,1404,2123,2093,1434,32448,496896,437372,2558,4022,2618,3247,4711,25.67099530598687,5.753771868478424,1464,1,242346,4680,659,0,1154,1929
15084,0,0,0,0,48,1,615,1,0,936684,3193722,36.373066958946424,1189,2165,2031,1323,45154,509354,516596,2280,3737,2548,3122,4579,26.60826939130014,11.59192030070629,1457,1,283122,17420,708,0,1091,1706
15085,0,0,0,0,48,1,565,1,0,975950,3149240,36.193922141707716,1202,2163,2055,1310,39900,504840,456760,2296,3714,2512,3149,4567,27.294688127912362,10.400314334861214,1418,1,248900,16956,745,0,1094,1659
15086,0,0,0,0,48,1,217,0,1,1194930,2919733,34.741905532080416,1147,2257,2197,1207,52118,612007,498314,2359,3626,2479,3409,4676,31.464265445104548,7.822290851349969,1267,1,248642,10500,990,0,1212,1429
15087,0,0,0,0,48,1,64,0,1,1260105,2810115,33.98529093593286,1065,2336,2246,1155,54612,598518,540126,2343,3588,2523,3524,4769,33.03028912982749,9.70850005632103,1245,1,256410,12780,1091,0,1278,1342
15088,0,0,0,0,52,1,741,1,0,875772,3584331,37.107950630558946,1243,2147,2013,1377,37944,531012,484158,2469,3980,2737,3239,4750,25.219040425836983,12.168439873279091,1511,1,256122,20502,636,0,1226,1967
15089,0,0,0,0,49,1,685,1,0,840156,3301179,36.345563690772494,1044,2234,1957,1321,29580,362355,509796,2222,3820,2776,3135,4733,25.219040425836983,17.08444904987593,1598,1,269484,13850,636,0,1178,1863
15090,0,0,0,0,48,1,97,0,1,1219778,2789218,33.97057550292606,1112,2253,2211,1154,53172,609084,509987,2375,3571,2459,3474,4670,32.51153641401772,6.609134537568676,1196,1,243494,6930,1057,0,1263,1360
15091,0,0,0,0,52,1,683,1,0,894408,3521058,36.701498607005135,1197,2161,2011,1347,38793,525414,504502,2464,3961,2764,3278,4775,25.768197453450252,12.68159626954734,1497,1,259971,21450,664,0,1267,1950
15092,0,0,0,0,50,1,638,1,0,846915,3269997,35.958309192730404,974,2267,1948,1293,30340,374292,518445,2210,3822,2848,3184,4796,25.592967784139454,18.480619776049597,1612,1,265065,17226,655,0,1236,1874
15093,0,0,0,0,48,1,128,0,0,1184004,2774216,33.97057550292606,1154,2180,2180,1154,53217,584172,526476,2404,3558,2404,3430,4584,32.03123475609393,0.0,1154,0,252726,0,1026,0,1250,1378
15094,0,0,0,0,48,1,13,1,0,1160964,2598246,32.72613634390714,1004,2222,2155,1071,29548,402716,431828,2359,3497,2493,3510,4648,32.92415526630866,8.361900766312248,1138,1,190638,7437,1084,0,1355,1342
15095,0,0,0,0,48,1,194,1,0,1207200,2424460,31.71750305430741,976,2236,2206,1006,36642,448260,474770,2380,3416,2440,3610,4646,34.64101615137755,5.623413251903491,1036,1,198182,3570,1200,0,1404,1210
15096,0,0,0,0,49,1,168,0,1,1045620,2750580,33.31666249791537,918,2244,2052,1110,31262,381612,503034,2286,3588,2670,3420,4722,30.692018506445613,14.382791456300165,1302,1,225330,12672,942,0,1368,1536
15097,0,0,0,0,53,1,391,1,0,1003200,3226048,34.87119154832539,1024,2233,2041,1216,45000,596925,530600,2461,3869,2845,3478,4886,28.722813232690143,14.01173814462286,1408,1,243200,31296,825,0,1437,1828
15098,0,0,0,0,53,1,276,1,0,1021356,3081438,34.02939905434711,924,2274,2040,1158,47912,601386,564132,2427,3819,2895,3543,4935,29.698484809834994,15.436568313836048,1392,1,245496,35568,882,0,1503,1779
15099,0,0,0,0,50,1,17,1,0,1047480,2551710,31.85906464414798,759,2303,2047,1015,29250,377100,490230,2258,3529,2770,3546,4817,32.12475680841802,16.692284873124617,1271,1,197925,17664,1032,0,1499,1482
15100,0,0,0,0,50,1,47,1,0,964754,2534114,31.71750305430741,539,2432,1965,1006,33768,506319,423192,2052,3525,2986,3478,4951,30.967725134404045,21.94714737393287,1473,1,169008,78923,959,0,1513,1560
15101,0,0,0,0,49,1,369,1,0,1105516,2203968,29.715315916207253,733,2285,2135,883,37856,454272,519168,2346,3379,2646,3748,4781,35.38361202590826,12.312788037888811,1033,1,183664,14850,1252,0,1613,1244
15102,0,0,0,0,51,1,122,1,0,1024475,2454928,30.870698080866262,670,2311,2028,953,41391,486864,564144,2293,3529,2859,3651,4887,32.78719262151,16.850314261454166,1236,1,208707,27168,1075,0,1623,1501
15103,0,0,0,0,51,1,444,1,0,1028160,2091408,28.5657137141714,731,2161,2076,816,29388,404954,476718,2478,3379,2648,3823,4724,35.4964786985977,9.251281740554573,901,1,151776,7735,1260,0,1747,1303
15104,0,0,0,0,51,1,257,0,1,946830,2188798,29.206163733020468,432,2384,1963,853,48216,631236,502936,2145,3419,2987,3676,4950,33.31666249791537,20.549729161403363,1274,1,167188,79569,1110,0,1713,1456
15105,0,0,0,0,49,1,829,1,0,871652,1505360,24.63736998950984,457,2193,2043,607,37442,481120,478640,2330,3087,2630,3916,4673,37.89459064299283,12.439392632724381,757,1,117151,19950,1436,0,1873,1044
15106,0,0,0,0,53,1,201,1,0,957172,2345248,29.715315916207253,359,2491,1967,883,50127,576352,613536,2132,3539,3180,3740,5147,32.92415526630866,22.916535346729997,1407,1,203973,61308,1084,0,1773,1572
15107,0,0,0,0,52,1,358,0,1,950040,2111200,28.495613697550013,482,2312,1982,812,42244,613600,465400,2270,3412,2930,3770,4912,34.20526275297414,18.16590212458495,1142,1,145348,65010,1170,0,1788,1430
15108,0,0,0,0,51,1,497,1,0,973554,1994017,27.730849247724095,649,2155,2035,769,40850,492670,557495,2473,3362,2713,3859,4748,35.58089374931439,10.96129127279285,889,1,165335,12120,1266,0,1824,1327
15109,0,0,0,0,52,1,601,1,0,973692,1900600,27.03701166919155,731,2063,2063,731,45113,512200,595400,2600,3331,2600,3932,4663,36.49657518178932,0.0,731,1,167399,0,1332,0,1869,1268
15110,0,0,0,0,50,1,741,1,0,891940,1615152,25.37715508089904,577,2096,2029,644,35292,433884,511632,2441,3152,2575,3893,4604,37.21558813185679,8.185808589931957,711,1,131376,6097,1385,0,1864,1123
15111,0,0,0,0,52,1,654,1,0,895072,1759140,25.96150997149434,614,2062,2002,674,46662,527220,602910,2550,3284,2670,3938,4672,36.4417343165772,7.7992067098508295,734,1,155694,5880,1328,0,1936,1282
15112,0,0,0,0,52,1,672,1,0,742729,1531400,24.269322199023193,465,1974,1850,589,37736,462800,551200,2476,3189,2724,3861,4574,35.510561809129406,11.135528725660043,713,1,124868,11036,1261,0,2011,1339
15113,0,0,0,0,53,1,461,1,0,1019130,2163840,28.372521918222215,362,2514,2071,805,53655,588672,658560,2245,3493,3131,3954,5202,35.58089374931439,21.050245899818037,1248,1,197225,43857,1266,0,1883,1422
15114,0,0,0,0,53,1,501,1,0,898630,1949100,27.018512172212592,106,2585,1961,730,54225,600750,643470,2046,3400,3294,3901,5255,35.08560958569767,24.9892250360104,1354,1,175930,69888,1231,0,1940,1439
15115,0,0,0,0,52,1,622,0,1,846120,1720620,25.69046515733026,402,2200,1942,660,42670,654357,443190,2349,3267,2865,3889,4807,35.805027579936315,16.06533360284493,918,1,112200,55212,1282,0,1947,1325
15116,0,0,0,0,52,1,707,0,1,818850,1608654,24.859605789312106,15,2576,1943,618,55029,575263,648147,1970,3221,3236,3928,5179,36.40054944640259,25.73625632776293,1251,1,153882,57603,1325,0,1985,1278
15117,0,0,0,0,49,1,852,0,1,397645,834820,18.303005217723125,30,1887,1522,335,55000,548240,623000,2127,2827,2857,3679,4379,34.45286635390443,19.577886023045806,700,1,83750,30295,1187,0,2157,1305
15118,0,0,0,0,49,1,690,0,1,225544,601854,15.556349186104045,24,1392,1174,242,54273,589419,569523,2269,2729,2705,3419,3879,30.528675044947494,15.500331465316451,460,1,55418,25942,932,0,2245,1555
15119,0,0,0,0,49,1,644,0,1,246780,668250,16.431676725154983,49,1503,1184,270,46116,603900,467775,2156,2745,2794,3389,3978,30.23243291566195,18.121744530788348,589,1,51030,52316,914,0,2205,1561
